start,end,chrom,gene_symbol,segment_id,length
577,647,chrMT,MT-TF,chrMT:577-647,70
648,1601,chrMT,MT-RNR1,chrMT:648-1601,953
1602,1670,chrMT,MT-TV,chrMT:1602-1670,68
1671,3229,chrMT,MT-RNR2,chrMT:1671-3229,1558
3230,3304,chrMT,MT-TL1,chrMT:3230-3304,74
3307,4262,chrMT,MT-ND1,chrMT:3307-4262,955
4263,4331,chrMT,MT-TI,chrMT:4263-4331,68
4329,4400,chrMT,MT-TQ,chrMT:4329-4400,71
4402,4469,chrMT,MT-TM,chrMT:4402-4469,67
4470,5511,chrMT,MT-ND2,chrMT:4470-5511,1041
5512,5579,chrMT,MT-TW,chrMT:5512-5579,67
5587,5655,chrMT,MT-TA,chrMT:5587-5655,68
5657,5729,chrMT,MT-TN,chrMT:5657-5729,72
5761,5826,chrMT,MT-TC,chrMT:5761-5826,65
5826,5891,chrMT,MT-TY,chrMT:5826-5891,65
5904,7445,chrMT,MT-CO1,chrMT:5904-7445,1541
7446,7514,chrMT,MT-TS1,chrMT:7446-7514,68
7518,7585,chrMT,MT-TD,chrMT:7518-7585,67
7586,8269,chrMT,MT-CO2,chrMT:7586-8269,683
8295,8364,chrMT,MT-TK,chrMT:8295-8364,69
8366,8572,chrMT,MT-ATP8,chrMT:8366-8572,206
8527,9207,chrMT,MT-ATP6,chrMT:8527-9207,680
9207,9990,chrMT,MT-CO3,chrMT:9207-9990,783
9991,10058,chrMT,MT-TG,chrMT:9991-10058,67
10059,10404,chrMT,MT-ND3,chrMT:10059-10404,345
10405,10469,chrMT,MT-TR,chrMT:10405-10469,64
10470,10766,chrMT,MT-ND4L,chrMT:10470-10766,296
10760,12137,chrMT,MT-ND4,chrMT:10760-12137,1377
12138,12206,chrMT,MT-TH,chrMT:12138-12206,68
12207,12265,chrMT,MT-TS2,chrMT:12207-12265,58
12266,12336,chrMT,MT-TL2,chrMT:12266-12336,70
12337,14148,chrMT,MT-ND5,chrMT:12337-14148,1811
14149,14673,chrMT,MT-ND6,chrMT:14149-14673,524
14674,14742,chrMT,MT-TE,chrMT:14674-14742,68
14747,15887,chrMT,MT-CYB,chrMT:14747-15887,1140
15888,15953,chrMT,MT-TT,chrMT:15888-15953,65
15956,16023,chrMT,MT-TP,chrMT:15956-16023,67
8280198,8282209,chrY,TSPY24P,chrY:8280198-8282209,2011
7853686,7854876,chrY,ZNF92P1Y,chrY:7853686-7854876,1190
5207215,5208069,chrY,VDAC1P6,chrY:5207215-5208069,854
9610571,9621276,chrY,RBMY3AP,chrY:9610571-9621276,10705
7694707,7810305,chrY,RFTN1P1,chrY:7694707-7810305,115598
4801685,4802848,chrY,SERBP1P2,chrY:4801685-4802848,1163
7687739,7689548,chrY,TSPY12P,chrY:7687739-7689548,1809
11332329,11333595,chrY,DUX4L19,chrY:11332329-11333595,1266
7803996,7810683,chrY,TTTY12,chrY:7803996-7810683,6687
9706824,9715262,chrY,TTTY7B,chrY:9706824-9715262,8438
9030594,9039988,chrY,OFD1P3Y,chrY:9030594-9039988,9394
7671743,7676024,chrY,RBMY2HP,chrY:7671743-7676024,4281
21130870,21131181,chrY,TOMM22P1,chrY:21130870-21131181,311
22439593,22441458,chrY,TTTY6,chrY:22439593-22441458,1865
17464879,17465214,chrY,ELOCP35,chrY:17464879-17465214,335
11340579,11385687,chrY,SLC9B1P1,chrY:11340579-11385687,45108
25393154,25394056,chrY,LINC00265-3P,chrY:25393154-25394056,902
3682805,3683868,chrY,USP12PY,chrY:3682805-3683868,1063
25482908,25486705,chrY,CSPG4P1Y,chrY:25482908-25486705,3797
24081704,24090346,chrY,USP9YP31,chrY:24081704-24090346,8642
9910798,9911962,chrY,TTTY23,chrY:9910798-9911962,1164
20570222,20570519,chrY,KDM5DP1,chrY:20570222-20570519,297
6449468,6457906,chrY,TTTY7,chrY:6449468-6457906,8438
25378300,25394719,chrY,LINC00266-4P,chrY:25378300-25394719,16419
8550518,8713825,chrY,LINC00279,chrY:8550518-8713825,163307
11314921,11316187,chrY,DUX4L17,chrY:11314921-11316187,1266
22490397,22514637,chrY,PRY,chrY:22490397-22514637,24240
9869664,9870781,chrY,TSPY18P,chrY:9869664-9870781,1117
10173853,10174207,chrY,PCMTD1P1,chrY:10173853-10174207,354
23936727,23941622,chrY,TTTY3B,chrY:23936727-23941622,4895
26626520,26627159,chrY,CCNQP2,chrY:26626520-26627159,639
25871931,25898653,chrY,OFD1P18Y,chrY:25871931-25898653,26722
22537047,22537849,chrY,HSFY7P,chrY:22537047-22537849,802
25266584,25273531,chrY,RBMY2YP,chrY:25266584-25273531,6947
23659466,23667822,chrY,USP9YP18,chrY:23659466-23667822,8356
26002254,26008856,chrY,USP9YP26,chrY:26002254-26008856,6602
20907344,20907562,chrY,TMEM167AP1,chrY:20907344-20907562,218
23762838,23765583,chrY,TRAPPC2P9,chrY:23762838-23765583,2745
21493519,21501968,chrY,RBMY1HP,chrY:21493519-21501968,8449
5337745,5338964,chrY,EIF4A1P2,chrY:5337745-5338964,1219
8350931,8352143,chrY,ZNF736P6Y,chrY:8350931-8352143,1212
5887504,5888740,chrY,TUSC2P1,chrY:5887504-5888740,1236
21927521,21937150,chrY,RBMY2AP,chrY:21927521-21937150,9629
9458613,9466003,chrY,FAM197Y5,chrY:9458613-9466003,7390
6406244,6462091,chrY,TTTY2B,chrY:6406244-6462091,55847
14056227,14056958,chrY,VCY1B,chrY:14056227-14056958,731
23715922,23726808,chrY,XKRYP3,chrY:23715922-23726808,10886
9717653,9721296,chrY,TTTY21,chrY:9717653-9721296,3643
15348662,15456074,chrY,PUDPP1,chrY:15348662-15456074,107412
11085476,11086061,chrY,CDRT15P10,chrY:11085476-11086061,585
12537650,12860839,chrY,USP9Y,chrY:12537650-12860839,323189
9166085,9167702,chrY,CDY3P,chrY:9166085-9167702,1617
8068445,8126293,chrY,ZNF736P9Y,chrY:8068445-8126293,57848
21468158,21470683,chrY,TSPY14P,chrY:21468158-21470683,2525
24276245,24277026,chrY,LINC00265-2P,chrY:24276245-24277026,781
22071756,22096007,chrY,PRY2,chrY:22071756-22096007,24251
25675060,25697346,chrY,OFD1P13Y,chrY:25675060-25697346,22286
25991241,25991572,chrY,ELOCP11,chrY:25991241-25991572,331
9624183,9626352,chrY,TSPY25P,chrY:9624183-9626352,2169
21696570,21698220,chrY,CDY11P,chrY:21696570-21698220,1650
26508213,26579690,chrY,TPTE2P4,chrY:26508213-26579690,71477
23919905,23921510,chrY,USP9YP13,chrY:23919905-23921510,1605
21972313,22005349,chrY,OFD1P8Y,chrY:21972313-22005349,33036
3777997,3779546,chrY,RNF19BPY,chrY:3777997-3779546,1549
22183850,22186021,chrY,TSPY23P,chrY:22183850-22186021,2171
25752388,25752870,chrY,XKRYP5,chrY:25752388-25752870,482
9517599,9526926,chrY,FAM197Y2,chrY:9517599-9526926,9327
17516836,17519038,chrY,TUBB1P2,chrY:17516836-17519038,2202
25388992,25391811,chrY,CICP1,chrY:25388992-25391811,2819
10171590,10172725,chrY,DUX4L31,chrY:10171590-10172725,1135
9905595,9908139,chrY,TSPY13P,chrY:9905595-9908139,2544
11395699,11397076,chrY,ACTR3BP1,chrY:11395699-11397076,1377
12244752,12245457,chrY,RPS24P1,chrY:12244752-12245457,705
22308859,22321825,chrY,RBMY2FP,chrY:22308859-22321825,12966
25730011,25735160,chrY,USP9YP9,chrY:25730011-25735160,5149
24183434,24187231,chrY,CSPG4P2Y,chrY:24183434-24187231,3797
26123674,26133308,chrY,RBMY2DP,chrY:26123674-26133308,9634
6390431,6411564,chrY,TTTY1B,chrY:6390431-6411564,21133
21661926,21674008,chrY,USP9YP3,chrY:21661926-21674008,12082
19986575,19987852,chrY,RCC2P2,chrY:19986575-19987852,1277
7913422,7914090,chrY,ZNF736P8Y,chrY:7913422-7914090,668
25431156,25437315,chrY,UBE2Q2P5Y,chrY:25431156-25437315,6159
25486640,25487322,chrY,DNM1P48,chrY:25486640-25487322,682
9951553,9959423,chrY,RBMY2OP,chrY:9951553-9959423,7870
20575776,20593154,chrY,EIF1AY,chrY:20575776-20593154,17378
20808776,20811809,chrY,HSFY4P,chrY:20808776-20811809,3033
5573145,5574431,chrY,KRT18P10,chrY:5573145-5574431,1286
25564122,25566033,chrY,CDY19P,chrY:25564122-25566033,1911
21221106,21222089,chrY,NEFLP1,chrY:21221106-21222089,983
6303957,6305074,chrY,TSPY19P,chrY:6303957-6305074,1117
22973819,23005465,chrY,BPY2,chrY:22973819-23005465,31646
11445418,11445564,chrY,MTND1P12,chrY:11445418-11445564,146
23945927,23952293,chrY,USP9YP12,chrY:23945927-23952293,6366
24104107,24106018,chrY,CDY18P,chrY:24104107-24106018,1911
15547216,15593331,chrY,STSP1,chrY:15547216-15593331,46115
56855244,56855488,chrY,CTBP2P1,chrY:56855244-56855488,244
8363536,8363959,chrY,MTND6P1,chrY:8363536-8363959,423
6158802,6159265,chrY,DLGAP5P1,chrY:6158802-6159265,463
10190377,10192298,chrY,CDC27P2,chrY:10190377-10192298,1921
6470773,6473630,chrY,TTTY8B,chrY:6470773-6473630,2857
11335627,11337693,chrY,PABPC1P5,chrY:11335627-11337693,2066
22305925,22307951,chrY,TSPY22P,chrY:22305925-22307951,2026
25699451,25702562,chrY,TRAPPC2P5,chrY:25699451-25702562,3111
23674379,23675392,chrY,CDY14P,chrY:23674379-23675392,1013
11781052,11782527,chrY,RCC2P1,chrY:11781052-11782527,1475
12537773,12544883,chrY,SHROOM2P1,chrY:12537773-12544883,7110
9740584,9758476,chrY,TTTY2,chrY:9740584-9758476,17892
24494709,24495583,chrY,TRIM60P5Y,chrY:24494709-24495583,874
26011435,26012237,chrY,HSFY8P,chrY:26011435-26012237,802
9183694,9185803,chrY,USP9YP22,chrY:9183694-9185803,2109
8682594,8700977,chrY,TTTY18,chrY:8682594-8700977,18383
9954532,10035299,chrY,RBMY2QP,chrY:9954532-10035299,80767
11321557,11322823,chrY,DUX4L18,chrY:11321557-11322823,1266
23934953,23940101,chrY,USP9YP11,chrY:23934953-23940101,5148
23734193,23736249,chrY,USP9YP25,chrY:23734193-23736249,2056
14081075,14086600,chrY,PNPLA4P1,chrY:14081075-14086600,5525
9640249,9640716,chrY,TSPY16P,chrY:9640249-9640716,467
22649245,22658878,chrY,RBMY2BP,chrY:22649245-22658878,9633
25994684,25995697,chrY,CDY23P,chrY:25994684-25995697,1013
6328052,6343323,chrY,RBMY2GP,chrY:6328052-6343323,15271
25478269,25483630,chrY,CSPG4P4Y,chrY:25478269-25483630,5361
24278337,24281140,chrY,CICP2,chrY:24278337-24281140,2803
23808821,23809059,chrY,ELOCP9,chrY:23808821-23809059,238
26549425,26549743,chrY,CYCSP49,chrY:26549425-26549743,318
22866544,22867756,chrY,ZNF736P11Y,chrY:22866544-22867756,1212
22580989,22614081,chrY,OFD1P9Y,chrY:22580989-22614081,33092
21382954,21386360,chrY,PRORY,chrY:21382954-21386360,3406
7932997,7937640,chrY,BPY2DP,chrY:7932997-7937640,4643
25904518,25907250,chrY,TRAPPC2P4,chrY:25904518-25907250,2732
23678504,23678835,chrY,ELOCP16,chrY:23678504-23678835,331
23581595,23614640,chrY,OFD1P10Y,chrY:23581595-23614640,33045
25918323,25918895,chrY,RAB9AP3,chrY:25918323-25918895,572
24186509,24191870,chrY,CSPG4P3Y,chrY:24186509-24191870,5361
25709908,25713557,chrY,RAB9AP2,chrY:25709908-25713557,3649
25748596,25750206,chrY,USP9YP19,chrY:25748596-25750206,1610
8127130,8144203,chrY,RBMY2JP,chrY:8127130-8144203,17073
25454561,25460572,chrY,GOLGA2P3Y,chrY:25454561-25460572,6011
11412548,11418716,chrY,CHEK2P1,chrY:11412548-11418716,6168
21430697,21437245,chrY,RBMY2TP,chrY:21430697-21437245,6548
23740258,23746693,chrY,USP9YP29,chrY:23740258-23746693,6435
25579790,25588444,chrY,USP9YP36,chrY:25579790-25588444,8654
22198429,22203712,chrY,RBMY2UP,chrY:22198429-22203712,5283
17552800,17579754,chrY,FAM224B,chrY:17552800-17579754,26954
20001185,20012204,chrY,ZNF886P,chrY:20001185-20012204,11019
23771232,23798150,chrY,OFD1P11Y,chrY:23771232-23798150,26918
22517242,22517573,chrY,ELOCP8,chrY:22517242-22517573,331
21817579,21818218,chrY,OFD1P16Y,chrY:21817579-21818218,639
22330452,22332500,chrY,TTTY25P,chrY:22330452-22332500,2048
9544917,9547147,chrY,FAM197Y1,chrY:9544917-9547147,2230
26198331,26208148,chrY,REREP2Y,chrY:26198331-26208148,9817
11922536,11923769,chrY,ASS1P6,chrY:11922536-11923769,1233
11178306,11178816,chrY,SNX18P1Y,chrY:11178306-11178816,510
9831418,9846696,chrY,RBMY2NP,chrY:9831418-9846696,15278
9753156,9774289,chrY,TTTY1,chrY:9753156-9774289,21133
9189629,9204611,chrY,USP9YP4,chrY:9189629-9204611,14982
24500263,24501505,chrY,ZNF736P12Y,chrY:24500263-24501505,1242
21677246,21681118,chrY,USP9YP8,chrY:21677246-21681118,3872
12618983,12634402,chrY,MED14P1,chrY:12618983-12634402,15419
24232826,24238984,chrY,UBE2Q2P4Y,chrY:24232826-24238984,6158
22048554,22049347,chrY,HSFY5P,chrY:22048554-22049347,793
20390051,20396796,chrY,ZNF885P,chrY:20390051-20396796,6745
12252321,12258033,chrY,ARSFP1,chrY:12252321-12258033,5712
7990987,7991806,chrY,ZNF736P7Y,chrY:7990987-7991806,819
17192826,17193652,chrY,SURF6P1,chrY:17192826-17193652,826
12440046,12507369,chrY,XGY1,chrY:12440046-12507369,67323
11173618,11173821,chrY,ANKRD20A6P,chrY:11173618-11173821,203
26055779,26088493,chrY,OFD1P15Y,chrY:26055779-26088493,32714
24049878,24051487,chrY,CDY17P,chrY:24049878-24051487,1609
9691100,9693957,chrY,TTTY8,chrY:9691100-9693957,2857
23751188,23751760,chrY,RAB9AP1,chrY:23751188-23751760,572
25168599,25169841,chrY,ZNF736P4Y,chrY:25168599-25169841,1242
8264449,8277188,chrY,RBMY2KP,chrY:8264449-8277188,12739
23657839,23659058,chrY,HSFY6P,chrY:23657839-23659058,1219
22400403,22402568,chrY,TSPY21P,chrY:22400403-22402568,2165
23855522,23857091,chrY,CDY15P,chrY:23855522-23857091,1569
8704472,8705283,chrY,TTTY19,chrY:8704472-8705283,811
25923388,25929826,chrY,USP9YP20,chrY:25923388-25929826,6438
6520463,6520929,chrY,TSPY17P,chrY:6520463-6520929,466
22936455,22973284,chrY,TTTY4,chrY:22936455-22973284,36829
9548108,9550681,chrY,TSPY15P,chrY:9548108-9550681,2573
25943268,25954152,chrY,XKRYP6,chrY:25943268-25954152,10884
24077799,24079812,chrY,USP9YP35,chrY:24077799-24079812,2013
20861337,20862337,chrY,GAPDHP17,chrY:20861337-20862337,1000
9230915,9231247,chrY,ELOCP4,chrY:9230915-9231247,332
6242446,6245283,chrY,TTTY23B,chrY:6242446-6245283,2837
25723016,25724186,chrY,USP9YP30,chrY:25723016-25724186,1170
9784372,9833895,chrY,TTTY22,chrY:9784372-9833895,49523
6266593,6269275,chrY,TSPY11P,chrY:6266593-6269275,2682
9487313,9489893,chrY,TSPY9P,chrY:9487313-9489893,2580
11957208,11987386,chrY,MXRA5Y,chrY:11957208-11987386,30178
11306918,11308181,chrY,DUX4L16,chrY:11306918-11308181,1263
9527880,9530682,chrY,TSPY10,chrY:9527880-9530682,2802
8364032,8365150,chrY,MTCYBP1,chrY:8364032-8365150,1118
5634480,5634655,chrY,SNX3P1Y,chrY:5634480-5634655,175
22049755,22058113,chrY,USP9YP17,chrY:22049755-22058113,8358
23956569,23960218,chrY,RAB9AP5,chrY:23956569-23960218,3649
22851584,22852715,chrY,TTTY17A,chrY:22851584-22852715,1131
3293808,3294826,chrY,AGPAT5P1,chrY:3293808-3294826,1018
10036195,10038375,chrY,TSPY20P,chrY:10036195-10038375,2180
17500958,17515018,chrY,FAM41AY1,chrY:17500958-17515018,14060
22144966,22146831,chrY,TTTY6B,chrY:22144966-22146831,1865
22068820,22069151,chrY,ELOCP15,chrY:22068820-22069151,331
24283062,24283230,chrY,LINC00266-2P,chrY:24283062-24283230,168
9479053,9486313,chrY,FAM197Y4,chrY:9479053-9486313,7260
8413037,8414054,chrY,TRIM60P3Y,chrY:8413037-8414054,1017
23681440,23694579,chrY,PRYP3,chrY:23681440-23694579,13139
25933833,25935881,chrY,USP9YP21,chrY:25933833-25935881,2048
8371663,8372030,chrY,MTND1P1,chrY:8371663-8372030,367
24570202,24607025,chrY,TTTY4B,chrY:24570202-24607025,36823
25590323,25592345,chrY,USP9YP33,chrY:25590323-25592345,2022
25975549,25988069,chrY,PRYP4,chrY:25975549-25988069,12520
5793300,5793737,chrY,RPL26P37,chrY:5793300-5793737,437
6357219,6369921,chrY,LINC00280,chrY:6357219-6369921,12702
3549652,3549810,chrY,PRRC2CP1,chrY:3549652-3549810,158
21511372,21549326,chrY,RBMY1A1,chrY:21511372-21549326,37954
25182277,25213389,chrY,TTTY17C,chrY:25182277-25213389,31112
10066554,10069151,chrY,TSPY5P,chrY:10066554-10069151,2597
21631683,21632015,chrY,ELOCP5,chrY:21631683-21632015,332
23967564,23970694,chrY,TRAPPC2P10,chrY:23967564-23970694,3130
23917241,23917723,chrY,XKRYP4,chrY:23917241-23917723,482
25728490,25733388,chrY,TTTY3,chrY:25728490-25733388,4898
8418791,8419900,chrY,ZNF736P10Y,chrY:8418791-8419900,1109
26400611,26401230,chrY,CYCSP48,chrY:26400611-26401230,619
9466955,9469749,chrY,TSPY1,chrY:9466955-9469749,2794
22064698,22065712,chrY,CDY12P,chrY:22064698-22065712,1014
5000226,5742224,chrY,PCDH11Y,chrY:5000226-5742224,741998
8372241,8372710,chrY,MTND2P3,chrY:8372241-8372710,469
25618644,25620253,chrY,CDY20P,chrY:25618644-25620253,1609
22520681,22521695,chrY,CDY13P,chrY:22520681-22521695,1014
22209331,22216580,chrY,RBMY1KP,chrY:22209331-22216580,7249
22403461,22417881,chrY,RBMY1J,chrY:22403461-22417881,14420
24168187,24174494,chrY,GOLGA6L11P,chrY:24168187-24174494,6307
8783310,8817382,chrY,TTTY11,chrY:8783310-8817382,34072
23972780,23995081,chrY,OFD1P12Y,chrY:23972780-23995081,22301
25813013,25814566,chrY,CDY22P,chrY:25813013-25814566,1553
20756108,20781032,chrY,RPS4Y2,chrY:20756108-20781032,24924
21637475,21639041,chrY,CDY10P,chrY:21637475-21639041,1566
6443434,6450685,chrY,TTTY21B,chrY:6443434-6450685,7251
26409815,26420535,chrY,ANKRD36P1,chrY:26409815-26420535,10720
24179316,24183505,chrY,DNM1P24,chrY:24179316-24183505,4189
12354096,12387328,chrY,ARSDP1,chrY:12354096-12387328,33232
21511338,21549094,chrY,RBMY1B,chrY:21511338-21549094,37756
22296798,22298876,chrY,TTTY5,chrY:22296798-22298876,2078
24396604,24403526,chrY,RBMY2XP,chrY:24396604-24403526,6922
12801973,12803830,chrY,CDY4P,chrY:12801973-12803830,1857
25860943,25861268,chrY,ELOCP17,chrY:25860943-25861268,325
25495651,25501958,chrY,GOLGA6L16P,chrY:25495651-25501958,6307
25622162,25624902,chrY,CDY1,chrY:25622162-25624902,2740
21880076,21894526,chrY,RBMY1D,chrY:21880076-21894526,14450
22762851,22769787,chrY,RBMY2WP,chrY:22762851-22769787,6936
22528281,22536639,chrY,USP9YP24,chrY:22528281-22536639,8358
24006911,24007237,chrY,ELOCP10,chrY:24006911-24007237,326
21565092,21605081,chrY,TTTY13,chrY:21565092-21605081,39989
25662900,25663226,chrY,ELOCP34,chrY:25662900-25663226,326
26277923,26354418,chrY,PPP1R12BP1,chrY:26277923-26354418,76495
24485332,24486463,chrY,TTTY17B,chrY:24485332-24486463,1131
26586642,26591601,chrY,SLC25A15P1,chrY:26586642-26591601,4959
20464916,20575519,chrY,TTTY10,chrY:20464916-20575519,110603
3866306,3866722,chrY,UBE2V1P3,chrY:3866306-3866722,416
12321623,12322835,chrY,FAM8A4P,chrY:12321623-12322835,1212
26594851,26634652,chrY,PARP4P1,chrY:26594851-26634652,39801
24607560,24639207,chrY,BPY2B,chrY:24607560-24639207,31647
24209567,24215581,chrY,GOLGA2P2Y,chrY:24209567-24215581,6014
12339813,12347495,chrY,ARSLP1,chrY:12339813-12347495,7682
21394991,21401585,chrY,RBMY2EP,chrY:21394991-21401585,6594
23025594,23026663,chrY,TRIM60P8Y,chrY:23025594-23026663,1069
6256267,6265595,chrY,FAM197Y9,chrY:6256267-6265595,9328
20727254,20742900,chrY,TBL1YP1,chrY:20727254-20742900,15646
9497287,9506596,chrY,FAM197Y3,chrY:9497287-9506596,9309
14907898,14908068,chrY,MED13P1,chrY:14907898-14908068,170
9507596,9510175,chrY,TSPY6P,chrY:9507596-9510175,2579
14941547,14941750,chrY,CYCSP46,chrY:14941547-14941750,203
4174985,4175090,chrY,RNU6-303P,chrY:4174985-4175090,105
5019076,5019266,chrY,RNU2-57P,chrY:5019076-5019266,190
10090410,10090528,chrY,RNA5SP518,chrY:10090410-10090528,118
12273473,12273764,chrY,RN7SL702P,chrY:12273473-12273764,291
17557864,17557976,chrY,RNA5SP520,chrY:17557864-17557976,112
17559774,17559889,chrY,RNA5SP521,chrY:17559774-17559889,115
16248935,16249041,chrY,RNU6-109P,chrY:16248935-16249041,106
10200155,10200306,chrY,RNA5-8SP6,chrY:10200155-10200306,151
23946618,23946771,chrY,RNU1-86P,chrY:23946618-23946771,153
10092875,10092993,chrY,RNA5SP519,chrY:10092875-10092993,118
24210958,24211216,chrY,RN7SL818P,chrY:24210958-24211216,258
16336283,16336389,chrY,RNU6-184P,chrY:16336283-16336389,106
25723342,25723495,chrY,RNU1-107P,chrY:25723342-25723495,153
25458926,25459184,chrY,RN7SL725P,chrY:25458926-25459184,258
25928979,25929142,chrY,RNU1-40P,chrY:25928979-25929142,163
26360989,26361092,chrY,RNU6-1314P,chrY:26360989-26361092,103
26247384,26247521,chrY,SNORA70,chrY:26247384-26247521,137
23740942,23741105,chrY,RNU1-97P,chrY:23740942-23741105,163
18674033,18739197,chrY,OFD1P6Y,chrY:18674033-18739197,65164
18731440,18773735,chrY,HSFY2,chrY:18731440-18773735,42295
18741843,18741986,chrY,GPM6BP2,chrY:18741843-18741986,143
18776279,18779427,chrY,USP9YP2,chrY:18776279-18779427,3148
18787750,18788080,chrY,ELOCP14,chrY:18787750-18788080,330
18790709,18791051,chrY,PRYP6,chrY:18790709-18791051,342
18811338,18811829,chrY,XKRYP2,chrY:18811338-18811829,491
18826107,18829487,chrY,USP9YP10,chrY:18826107-18829487,3380
18833002,18839313,chrY,USP9YP28,chrY:18833002-18839313,6311
18833729,18833890,chrY,RNU1-41P,chrY:18833729-18833890,161
18848264,18867280,chrY,OFD1P7Y,chrY:18848264-18867280,19016
18872102,18872272,chrY,MTCYBP2,chrY:18872102-18872272,170
18985175,18986398,chrY,ZNF839P1,chrY:18985175-18986398,1223
18992467,18992709,chrY,CD24P4,chrY:18992467-18992709,242
19018983,19019087,chrY,RNU6-255P,chrY:19018983-19019087,104
19327569,19328573,chrY,GAPDHP19,chrY:19327569-19328573,1004
17621259,17625832,chrY,CLUHP1,chrY:17621259-17625832,4573
17628513,17629402,chrY,TAF9P1,chrY:17628513-17629402,889
17721598,17723177,chrY,CDY5P,chrY:17721598-17723177,1579
17726752,17727080,chrY,ELOCP36,chrY:17726752-17727080,328
17729528,17744596,chrY,PRYP1,chrY:17729528-17744596,15068
17757001,17758125,chrY,ACTG1P2,chrY:17757001-17758125,1124
17768980,17777400,chrY,XKRY,chrY:17768980-17777400,8420
17782210,17784815,chrY,USP9YP23,chrY:17782210-17784815,2605
17788315,17789484,chrY,USP9YP27,chrY:17788315-17789484,1169
17789003,17789162,chrY,RNU1-128P,chrY:17789003-17789162,159
17797983,17800696,chrY,TRAPPC2P3,chrY:17797983-17800696,2713
17809807,17825329,chrY,OFD1P1Y,chrY:17809807-17825329,15522
17837201,17837528,chrY,ELOCP6,chrY:17837201-17837528,327
17882099,17883708,chrY,CDY6P,chrY:17882099-17883708,1609
17908755,17910806,chrY,USP9YP7,chrY:17908755-17910806,2051
17912699,17921630,chrY,USP9YP6,chrY:17912699-17921630,8931
17951589,17953500,chrY,CDY7P,chrY:17951589-17953500,1911
17984349,17993260,chrY,USP9YP34,chrY:17984349-17993260,8911
17995201,17997252,chrY,USP9YP32,chrY:17995201-17997252,2051
18022299,18023908,chrY,CDY8P,chrY:18022299-18023908,1609
18068483,18068810,chrY,ELOCP12,chrY:18068483-18068810,327
18080681,18096202,chrY,OFD1P2Y,chrY:18080681-18096202,15521
18105314,18108102,chrY,TRAPPC2P8,chrY:18105314-18108102,2788
18116527,18117695,chrY,USP9YP15,chrY:18116527-18117695,1168
18116848,18117007,chrY,RNU1-95P,chrY:18116848-18117007,159
18121195,18123799,chrY,USP9YP16,chrY:18121195-18123799,2604
18128610,18137029,chrY,XKRY2,chrY:18128610-18137029,8419
18147884,18149008,chrY,ACTG1P11,chrY:18147884-18149008,1124
18161366,18176484,chrY,PRYP2,chrY:18161366-18176484,15118
18178932,18179260,chrY,ELOCP26,chrY:18178932-18179260,328
18182835,18184414,chrY,CDY9P,chrY:18182835-18184414,1579
18276607,18277495,chrY,TAF9P2,chrY:18276607-18277495,888
18280178,18284761,chrY,CLUHP2,chrY:18280178-18284761,4583
18326253,18353210,chrY,FAM224A,chrY:18326253-18353210,26957
18346123,18346238,chrY,RNA5SP522,chrY:18346123-18346238,115
18348035,18348147,chrY,RNA5SP523,chrY:18348035-18348147,112
18386974,18389151,chrY,TUBB1P1,chrY:18386974-18389151,2177
18390994,18405046,chrY,FAM41AY2,chrY:18390994-18405046,14052
18440797,18441125,chrY,ELOCP13,chrY:18440797-18441125,328
18453150,18472137,chrY,OFD1P4Y,chrY:18453150-18472137,18987
18481087,18487400,chrY,USP9YP14,chrY:18481087-18487400,6313
18486511,18486672,chrY,RNU1-48P,chrY:18486511-18486672,161
18490915,18494295,chrY,USP9YP5,chrY:18490915-18494295,3380
18508577,18509068,chrY,XKRYP1,chrY:18508577-18509068,491
18529358,18529623,chrY,PRYP5,chrY:18529358-18529623,265
18532326,18532656,chrY,ELOCP7,chrY:18532326-18532656,330
18540980,18544128,chrY,USP9YP1,chrY:18540980-18544128,3148
18578417,18578560,chrY,GPM6BP1,chrY:18578417-18578560,143
18581206,18590521,chrY,TTTY9B,chrY:18581206-18590521,9315
18582063,18629077,chrY,OFD1P5Y,chrY:18582063-18629077,47014
18649671,18650279,chrY,RAB9AP4,chrY:18649671-18650279,608
18655520,18656190,chrY,TRAPPC2P7,chrY:18655520-18656190,670
18772706,19077416,chrY,TTTY14,chrY:18772706-19077416,304710
19703865,19744939,chrY,KDM5D,chrY:19703865-19744939,41074
18546691,18588963,chrY,HSFY1,chrY:18546691-18588963,42272
3579067,3580041,chrY,TGIF2LY,chrY:3579067-3580041,974
22168542,22182982,chrY,RBMY1F,chrY:22168542-22182982,14440
18025787,18027746,chrY,CDY2A,chrY:18025787-18027746,1959
23049247,23051195,chrY,ZNF736P3Y,chrY:23049247-23051195,1948
23058030,23059186,chrY,TRIM60P9Y,chrY:23058030-23059186,1156
7273972,7381548,chrY,PRKY,chrY:7273972-7381548,107576
7324297,7324595,chrY,RN7SKP282,chrY:7324297-7324595,298
7341531,7341642,chrY,Y_RNA,chrY:7341531-7341642,111
7378672,7378779,chrY,RNU6-941P,chrY:7378672-7378779,107
7423054,7423158,chrY,RNU6-521P,chrY:7423054-7423158,104
24045229,24048019,chrY,CDY1B,chrY:24045229-24048019,2790
6718962,6719180,chrY,SRIP3,chrY:6718962-6719180,218
6837707,6838252,chrY,GOT2P5,chrY:6837707-6838252,545
6900753,6901372,chrY,ATP5PFP1,chrY:6900753-6901372,619
24659337,24660406,chrY,TRIM60P10Y,chrY:24659337-24660406,1069
24683657,24684935,chrY,ZNF736P2Y,chrY:24683657-24684935,1278
24691791,24692932,chrY,TRIM60P11Y,chrY:24691791-24692932,1141
24985201,24986476,chrY,ZNF736P1Y,chrY:24985201-24986476,1275
25018499,25019303,chrY,ZNF736P5Y,chrY:25018499-25019303,804
25030901,25062548,chrY,BPY2C,chrY:25030901-25062548,31647
25063083,25099892,chrY,TTTY4C,chrY:25063083-25099892,36809
24833843,24907040,chrY,DAZ4,chrY:24833843-24907040,73197
17878260,17880220,chrY,CDY2B,chrY:17878260-17880220,1960
2752083,2854641,chrY,XGY2,chrY:2752083-2854641,102558
2784749,2784853,chrY,RNU6-1334P,chrY:2784749-2784853,104
2786855,2787682,chrY,SRY,chrY:2786855-2787682,827
2789827,2790328,chrY,RNASEH2CP1,chrY:2789827-2790328,501
2827982,2828218,chrY,TOMM22P2,chrY:2827982-2828218,236
2841602,2932000,chrY,RPS4Y1,chrY:2841602-2932000,90398
2881683,2890551,chrY,HSFY3P,chrY:2881683-2890551,8868
2929001,2931120,chrY,NAP1L1P2,chrY:2929001-2931120,2119
2935281,2982506,chrY,ZFY,chrY:2935281-2982506,47225
2966844,3002626,chrY,ZFY-AS1,chrY:2966844-3002626,35782
2995067,2995273,chrY,EEF1A1P41,chrY:2995067-2995273,206
13286638,13287378,chrY,PSMA6P1,chrY:13286638-13287378,740
13083790,13095805,chrY,SFPQP1,chrY:13083790-13095805,12015
13153931,13162214,chrY,TAB3P1,chrY:13153931-13162214,8283
13230884,13231439,chrY,DPPA2P1,chrY:13230884-13231439,555
12904108,12920478,chrY,DDX3Y,chrY:12904108-12920478,16370
12930165,12948182,chrY,CASKP1,chrY:12930165-12948182,18017
13234577,13480673,chrY,UTY,chrY:13234577-13480673,246096
13703899,13706024,chrY,TMSB4Y,chrY:13703899-13706024,2125
13703902,13915824,chrY,ANOS2P,chrY:13703902-13915824,211922
13985772,13986473,chrY,VCY,chrY:13985772-13986473,701
24763069,24813492,chrY,DAZ3,chrY:24763069-24813492,50423
23129355,23199010,chrY,DAZ1,chrY:23129355-23199010,69655
23379484,23392697,chrY,PPP1R12BP2,chrY:23379484-23392697,13213
23462465,23472280,chrY,REREP1Y,chrY:23462465-23472280,9815
23537308,23546942,chrY,RBMY2CP,chrY:23537308-23546942,9634
6865918,6911752,chrY,AMELY,chrY:6865918-6911752,45834
6910686,7101970,chrY,TBL1Y,chrY:6910686-7101970,191284
7100733,7106502,chrY,GPR143P,chrY:7100733-7106502,5769
23219447,23291356,chrY,DAZ2,chrY:23219447-23291356,71909
6246223,6249019,chrY,TSPY2,chrY:6246223-6249019,2796
9311130,9322869,chrY,RBMY1A3P,chrY:9311130-9322869,11739
9329880,9334832,chrY,TTTY20,chrY:9329880-9334832,4952
9337464,9340284,chrY,TSPY4,chrY:9337464-9340284,2820
9347511,9356814,chrY,FAM197Y8,chrY:9347511-9356814,9303
9357797,9360599,chrY,TSPY8,chrY:9357797-9360599,2802
9367803,9375681,chrY,FAM197Y7,chrY:9367803-9375681,7878
9378122,9380871,chrY,TSPY7P,chrY:9378122-9380871,2749
9388122,9396027,chrY,FAM197Y6,chrY:9388122-9396027,7905
9398421,9401223,chrY,TSPY3,chrY:9398421-9401223,2802
14639096,14640358,chrY,AGKP1,chrY:14639096-14640358,1262
14793642,14804033,chrY,NLGN4Y-AS1,chrY:14793642-14804033,10391
21903618,21918042,chrY,RBMY1E,chrY:21903618-21918042,14424
14522573,14845654,chrY,NLGN4Y,chrY:14522573-14845654,323081
19455431,19567092,chrY,BCORP1,chrY:19455431-19567092,111661
3002887,3200509,chrY,LINC00278,chrY:3002887-3200509,197622
12088010,12421587,chrY,GYG2P1,chrY:12088010-12421587,333577
19567313,19606274,chrY,TXLNGY,chrY:19567313-19606274,38961
316737,500722,chr18,COLEC12,chr18:316737-500722,183985
9310522,9334445,chr18,TWSG1-DT,chr18:9310522-9334445,23923
5081171,5098780,chr18,LINC01892,chr18:5081171-5098780,17609
6728821,6729862,chr18,ARHGAP28-AS1,chr18:6728821-6729862,1041
11454478,11465996,chr18,LINC01928,chr18:11454478-11465996,11518
1159198,1160404,chr18,SLC25A3P3,chr18:1159198-1160404,1206
8688022,8688410,chr18,TOMM20P3,chr18:8688022-8688410,388
5236724,5238598,chr18,LINC00526,chr18:5236724-5238598,1874
5002759,5003254,chr18,PPIAP14,chr18:5002759-5003254,495
11851413,11854444,chr18,CHMP1B,chr18:11851413-11854444,3031
11981025,12030877,chr18,IMPA2,chr18:11981025-12030877,49852
3496032,4455307,chr18,DLGAP1,chr18:3496032-4455307,959275
8705661,8832778,chr18,MTCL1,chr18:8705661-8832778,127117
8412129,8414304,chr18,COP1P1,chr18:8412129-8414304,2175
11745626,11747581,chr18,ASNSP6,chr18:11745626-11747581,1955
9708275,9862551,chr18,RAB31,chr18:9708275-9862551,154276
22900486,22900995,chr18,UBE2CP2,chr18:22900486-22900995,509
1254383,1408344,chr18,LINC00470,chr18:1254383-1408344,153961
12912844,12913906,chr18,EIF4A2P1,chr18:12912844-12913906,1062
9785108,9787805,chr18,ZNF415P1,chr18:9785108-9787805,2697
1176790,1177012,chr18,COX6CP3,chr18:1176790-1177012,222
12739490,12776140,chr18,LINC01882,chr18:12739490-12776140,36650
11851414,11852751,chr18,CHMP1B-AS1,chr18:11851414-11852751,1337
5882072,5895955,chr18,TMEM200C,chr18:5882072-5895955,13883
10405133,10414515,chr18,LINC01254,chr18:10405133-10414515,9382
721588,812546,chr18,YES1,chr18:721588-812546,90958
22586465,22587227,chr18,RPS4XP18,chr18:22586465-22587227,762
34976928,35143470,chr18,MAPRE2,chr18:34976928-35143470,166542
24689914,24690161,chr18,PPIAP57,chr18:24689914-24690161,247
11486205,11523087,chr18,LINC01255,chr18:11486205-11523087,36882
6446723,6528459,chr20,CASC20,chr20:6446723-6528459,81736
8248704,8256918,chr20,PLCB1-IT1,chr20:8248704-8256918,8214
4220630,4249287,chr20,ADRA1D,chr20:4220630-4249287,28657
958452,1002311,chr20,RSPO4,chr20:958452-1002311,43859
227258,229886,chr20,DEFB129,chr20:227258-229886,2628
9615264,9619363,chr18,PPP4R1-AS1,chr18:9615264-9619363,4099
5132749,5133229,chr18,BOD1P2,chr18:5132749-5133229,480
869900,916334,chr20,ANGPT4,chr20:869900-916334,46434
12658043,12725740,chr18,PSMG2,chr18:12658043-12725740,67697
10576292,10576587,chr21,CYCSP41,chr21:10576292-10576587,295
13792635,13793141,chr21,FAM207CP,chr21:13792635-13793141,506
13544210,13545185,chr21,OR4K11P,chr21:13544210-13545185,975
13704853,13705518,chr21,LONRF2P5,chr21:13704853-13705518,665
1629152,1657779,chr20,SIRPG,chr20:1629152-1657779,28627
9082601,9083101,chr21,SOWAHCP2,chr21:9082601-9083101,500
17479085,17479431,chr20,DYNLT3P1,chr20:17479085-17479431,346
13905960,13906488,chr21,SNX18P13,chr21:13905960-13906488,528
5750393,5864395,chr20,SHLD1,chr20:5750393-5864395,114002
7129103,7130287,chr21,CTBP2P10,chr21:7129103-7130287,1184
17763315,17792523,chr21,C21orf91-OT1,chr21:17763315-17792523,29208
15744004,15745080,chr21,RBPMSLP,chr21:15744004-15745080,1076
19739709,19740150,chr21,SREK1IP1P1,chr21:19739709-19740150,441
10136419,10137004,chr21,CDRT15P8,chr21:10136419-10137004,585
6084364,6091407,chr21,CH507-42P11.6,chr21:6084364-6091407,7043
7347451,7367933,chr20,LINC01706,chr20:7347451-7367933,20482
18561265,18760320,chr21,MIR548XHG,chr21:18561265-18760320,199055
7977346,8019805,chr20,TMX4,chr20:7977346-8019805,42459
20388334,20388845,chr21,FDPSP6,chr21:20388334-20388845,511
17500679,17500824,chr21,RPL39P40,chr21:17500679-17500824,145
17210469,17211347,chr21,NEK4P1,chr21:17210469-17211347,878
13824406,13825635,chr21,GXYLT1P2,chr21:13824406-13825635,1229
10435305,10636829,chr20,SLX4IP,chr20:10435305-10636829,201524
18857779,18858276,chr21,PPIAP22,chr21:18857779-18858276,497
19244543,19246392,chr21,SLC6A6P1,chr21:19244543-19246392,1849
13762338,13764332,chr21,FEM1AP1,chr21:13762338-13764332,1994
13882044,13915707,chr18,MC2R,chr18:13882044-13915707,33663
5911510,5925353,chr20,CHGB,chr20:5911510-5925353,13843
18782424,18783690,chr20,EEF1A1P34,chr20:18782424-18783690,1266
87250,97094,chr20,DEFB125,chr20:87250-97094,9844
14554384,14636524,chr20,MACROD2-IT1,chr20:14554384-14636524,82140
21511017,21514064,chr20,NKX2-2,chr20:21511017-21514064,3047
7626344,7627528,chr21,CTBP2P9,chr21:7626344-7627528,1184
17835016,17885608,chr21,CHODL-AS1,chr21:17835016-17885608,50592
3471018,3651118,chr20,ATRN,chr20:3471018-3651118,180100
23352929,23423778,chr21,D21S2088E,chr21:23352929-23423778,70849
32672673,32773023,chr18,KLHL14,chr18:32672673-32773023,100350
23407658,23409128,chr21,TUBAP1,chr21:23407658-23409128,1470
18269116,18485879,chr21,TMPRSS15,chr21:18269116-18485879,216763
4264602,4295405,chr18,DLGAP1-AS5,chr18:4264602-4295405,30803
44280768,44579953,chr18,LINC01478,chr18:44280768-44579953,299185
10357400,10358620,chr21,VN1R7P,chr21:10357400-10358620,1220
23090028,23091831,chr21,ZNF299P,chr21:23090028-23091831,1803
14819699,14918552,chr21,LINC02246,chr21:14819699-14918552,98853
7784482,7793954,chr21,SMIM34B,chr21:7784482-7793954,9472
13525599,13528579,chr21,SNX19P1,chr21:13525599-13528579,2980
5079294,5128413,chr21,GATD3B,chr21:5079294-5128413,49119
26421139,26438041,chr18,LINC01543,chr18:26421139-26438041,16902
12984694,12991173,chr18,CEP192-DT,chr18:12984694-12991173,6479
15247429,15247997,chr18,BNIP3P3,chr18:15247429-15247997,568
6767686,6780246,chr20,BMP2,chr20:6767686-6780246,12560
31962178,31963618,chr18,PGDP1,chr18:31962178-31963618,1440
9020029,9020764,chr18,RPS4XP19,chr18:9020029-9020764,735
1978757,1994285,chr20,PDYN,chr20:1978757-1994285,15528
26655737,27190698,chr18,AQP4-AS1,chr18:26655737-27190698,534961
10612455,10613379,chr21,SLC25A15P4,chr21:10612455-10613379,924
27143344,27143949,chr21,GPX1P2,chr21:27143344-27143949,605
7146467,7254202,chr20,LINC01428,chr20:7146467-7254202,107735
17513043,17593579,chr21,CXADR,chr21:17513043-17593579,80536
16586333,16586693,chr20,RPLP0P1,chr20:16586333-16586693,360
18794529,18796067,chr20,LINC00653,chr20:18794529-18796067,1538
833715,857463,chr20,FAM110A,chr20:833715-857463,23748
9102630,9134345,chr18,NDUFV2,chr18:9102630-9134345,31715
5990943,6005821,chr20,MCM8-AS1,chr20:5990943-6005821,14878
20368104,20370949,chr20,INSM1,chr20:20368104-20370949,2845
1633508,1648472,chr20,SIRPG-AS1,chr20:1633508-1648472,14964
4192932,4195953,chr20,LINC01433,chr20:4192932-4195953,3021
187853,189711,chr20,DEFB128,chr20:187853-189711,1858
6200989,6202191,chr20,TARDBPP1,chr20:6200989-6202191,1202
6731080,6736326,chr20,LINC01713,chr20:6731080-6736326,5246
10649400,10649835,chr21,IGHV1OR21-1,chr21:10649400-10649835,435
28887280,28889272,chr21,HSPD1P7,chr21:28887280-28889272,1992
6111131,6123778,chr21,SIK1B,chr21:6111131-6123778,12647
4120980,4187747,chr20,SMOX,chr20:4120980-4187747,66767
11882622,11908366,chr18,MPPE1,chr18:11882622-11908366,25744
22008756,22098518,chr21,LINC01687,chr21:22008756-22098518,89762
23101223,23103074,chr21,MSANTD2P1,chr21:23101223-23103074,1851
19759359,19760128,chr21,C1QBPP1,chr21:19759359-19760128,769
29004384,29019360,chr21,RWDD2B,chr21:29004384-29019360,14976
30541535,30541864,chr21,KRTAP19-6,chr21:30541535-30541864,329
27420380,27421023,chr21,RPL10P1,chr21:27420380-27421023,643
21723293,21737319,chr21,LINC00317,chr21:21723293-21737319,14026
13665868,13667546,chr21,GRAMD4P1,chr21:13665868-13667546,1678
30514613,30514799,chr21,KRTAP19-10P,chr21:30514613-30514799,186
9781910,9838011,chr21,LINC01667,chr21:9781910-9838011,56101
29077471,29175889,chr21,MAP3K7CL,chr21:29077471-29175889,98418
18809728,18830153,chr20,SCP2D1-AS1,chr20:18809728-18830153,20425
142590,145751,chr20,DEFB126,chr20:142590-145751,3161
11890723,11926609,chr20,BTBD3,chr20:11890723-11926609,35886
21395365,21397526,chr20,NKX2-4,chr20:21395365-21397526,2161
2075555,2075822,chr20,RPL7P2,chr20:2075555-2075822,267
14757563,14758056,chr20,RPS10P2,chr20:14757563-14758056,493
20659710,20659964,chr20,EIF4E2P1,chr20:20659710-20659964,254
5068232,5113103,chr20,TMEM230,chr20:5068232-5113103,44871
30635206,30635619,chr21,KRTAP20-2,chr21:30635206-30635619,413
28539318,28540355,chr21,LINC00161,chr21:28539318-28540355,1037
29748175,29764002,chr21,GRIK1-AS1,chr21:29748175-29764002,15827
28048404,28137611,chr21,LINC01697,chr21:28048404-28137611,89207
24304546,24321377,chr21,LINC01689,chr21:24304546-24321377,16831
30487043,30487436,chr21,KRTAP19-2,chr21:30487043-30487436,393
20424949,20426206,chr21,KRT18P2,chr21:20424949-20426206,1257
29370019,29376339,chr21,BACH1-AS1,chr21:29370019-29376339,6320
32311018,32393012,chr21,URB1,chr21:32311018-32393012,81994
17226107,17484578,chr20,PCSK2,chr20:17226107-17484578,258471
14829154,14829989,chr21,RBMX2P1,chr21:14829154-14829989,835
30289145,30289514,chr21,KRTAP25-1,chr21:30289145-30289514,369
8801362,8801880,chr21,SNX18P10,chr21:8801362-8801880,518
30746794,30747259,chr21,KRTAP21-2,chr21:30746794-30747259,465
30436466,30436964,chr21,KRTAP13-5P,chr21:30436466-30436964,498
8603547,8603984,chr21,RPSAP68,chr21:8603547-8603984,437
25639258,25717562,chr21,JAM2,chr21:25639258-25717562,78304
2481817,2524702,chr20,ZNF343,chr20:2481817-2524702,42885
23390258,23390996,chr21,EEF1A1P1,chr21:23390258-23390996,738
3962353,4024150,chr18,DLGAP1-AS4,chr18:3962353-4024150,61797
6060340,6076305,chr21,LINC01669,chr21:6060340-6076305,15965
19893113,19900043,chr21,LINC01683,chr21:19893113-19900043,6930
30741780,30742595,chr21,KRTAP21-4P,chr21:30741780-30742595,815
29024629,29054488,chr21,USP16,chr21:29024629-29054488,29859
37243040,37565827,chr18,CELF4,chr18:37243040-37565827,322787
12380056,12381255,chr20,PA2G4P2,chr20:12380056-12381255,1199
21511447,21512309,chr20,NKX2-2-AS1,chr20:21511447-21512309,862
23491101,23496010,chr20,CST8,chr20:23491101-23496010,4909
5928085,5929318,chr20,KANK1P1,chr20:5928085-5929318,1233
25368275,25368766,chr20,PPIAP2,chr20:25368275-25368766,491
13221274,13300651,chr20,ISM1,chr20:13221274-13300651,79377
25294742,25390835,chr20,ABHD12,chr20:25294742-25390835,96093
30263380,30263881,chr21,RPL8P2,chr21:30263380-30263881,501
20256752,20258820,chr21,LINC02573,chr21:20256752-20258820,2068
24840550,25057746,chr21,LINC01692,chr21:24840550-25057746,217196
30165565,30166805,chr21,CLDN17,chr21:30165565-30166805,1240
29496047,29500386,chr21,BACH1-IT3,chr21:29496047-29500386,4339
26466209,26573286,chr21,CYYR1,chr21:26466209-26573286,107077
14322985,14337614,chr20,FLRT3,chr20:14322985-14337614,14629
28997613,28998033,chr21,RPL23P2,chr21:28997613-28998033,420
17518526,17518993,chr21,BTF3L4P1,chr21:17518526-17518993,467
29222321,29223257,chr21,GAPDHP14,chr21:29222321-29223257,936
23875934,23879748,chr20,CST5,chr20:23875934-23879748,3814
33559542,33588706,chr21,DONSON,chr21:33559542-33588706,29164
21610787,21703585,chr20,LINC01726,chr20:21610787-21703585,92798
31440632,31450257,chr20,DEFB123,chr20:31440632-31450257,9625
5142911,5197503,chr18,AKAIN1,chr18:5142911-5197503,54592
18383367,18467281,chr20,DZANK1,chr20:18383367-18467281,83914
45212995,45683688,chr18,SLC14A2,chr18:45212995-45683688,470693
9475009,9538114,chr18,RALBP1,chr18:9475009-9538114,63105
30430230,30431026,chr21,KRTAP13-4,chr21:30430230-30431026,796
34073224,34143034,chr21,MRPS6,chr21:34073224-34143034,69810
17894193,17894485,chr21,RPL37P3,chr21:17894193-17894485,292
28901779,28903697,chr21,THUMPD1P1,chr21:28901779-28903697,1918
29193480,29288205,chr21,LINC00189,chr21:29193480-29288205,94725
20828127,20828622,chr21,PPIAP1,chr21:20828127-20828622,495
32511663,32514634,chr18,WBP11P1,chr18:32511663-32514634,2971
25762938,25763333,chr21,LLPHP2,chr21:25762938-25763333,395
27638613,27675024,chr21,LINC01673,chr21:27638613-27675024,36411
49782164,49813953,chr18,ACAA2,chr18:49782164-49813953,31789
30281309,30282950,chr21,KRTAP24-1,chr21:30281309-30282950,1641
5937228,5950558,chr20,TRMT6,chr20:5937228-5950558,13330
30598590,30598902,chr21,KRTAP6-2,chr21:30598590-30598902,312
29127701,29128188,chr21,RPL12P9,chr21:29127701-29128188,487
30616425,30616699,chr21,KRTAP20-1,chr21:30616425-30616699,274
30755015,30755428,chr21,KRTAP21-1,chr21:30755015-30755428,413
30620627,30620850,chr21,KRTAP20-4,chr21:30620627-30620850,223
33503931,33543491,chr21,GART,chr21:33503931-33543491,39560
18504633,18505066,chr20,RPS19P1,chr20:18504633-18505066,433
11621051,11621477,chr20,PGAM3P,chr20:11621051-11621477,426
10696949,10754033,chr20,LINC01752,chr20:10696949-10754033,57084
24469629,24666616,chr20,SYNDIG1,chr20:24469629-24666616,196987
22054074,22074654,chr20,LINC01432,chr20:22054074-22074654,20580
11345383,11345855,chr20,RPS11P1,chr20:11345383-11345855,472
7882985,7940458,chr20,HAO1,chr20:7882985-7940458,57473
26016253,26091217,chr18,SS18,chr18:26016253-26091217,74964
33187391,33188292,chr20,SOCS2P1,chr20:33187391-33188292,901
7302056,7307432,chr20,LINC01751,chr20:7302056-7307432,5376
22732802,22734089,chr20,KRT18P3,chr20:22732802-22734089,1287
21303331,21389825,chr20,XRN2,chr20:21303331-21389825,86494
5544439,5611006,chr20,GPCPD1,chr20:5544439-5611006,66567
1665283,1708200,chr20,SIRPB3P,chr20:1665283-1708200,42917
18674395,18698709,chr20,DTD1-AS1,chr20:18674395-18698709,24314
16729961,16742564,chr20,SNRPB2,chr20:16729961-16742564,12603
12865202,12952519,chr20,LINC01722,chr20:12865202-12952519,87317
31368601,31373923,chr20,DEFB118,chr20:31368601-31373923,5322
13392677,13393674,chr20,GAPDHP2,chr20:13392677-13393674,997
29321310,29321666,chr20,PCMTD1P7,chr20:29321310-29321666,356
23519146,23542018,chr20,CST13P,chr20:23519146-23542018,22872
23079360,23086324,chr20,CD93,chr20:23079360-23086324,6964
24306939,24547942,chr21,LINC01684,chr21:24306939-24547942,241003
31341371,31344471,chr20,HAUS6P2,chr20:31341371-31344471,3100
5548840,5549481,chr20,EIF4EP1,chr20:5548840-5549481,641
25407673,25452628,chr20,GINS1,chr20:25407673-25452628,44955
29351634,29361894,chr21,BACH1-IT1,chr21:29351634-29361894,10260
29370497,29373709,chr21,BACH1-IT2,chr21:29370497-29373709,3212
24949269,24959928,chr20,CST7,chr20:24949269-24959928,10659
34073578,34106260,chr21,SLC5A3,chr21:34073578-34106260,32682
27492118,27492261,chr21,NCSTNP1,chr21:27492118-27492261,143
8845566,8846646,chr21,MTCO1P1,chr21:8845566-8846646,1080
30718525,30718777,chr21,KRTAP21-3,chr21:30718525-30718777,252
36385392,36419015,chr21,CHAF1B,chr21:36385392-36419015,33623
14003508,14003699,chr20,RPS3P1,chr20:14003508-14003699,191
18420160,18421454,chr20,GCNT1P1,chr20:18420160-18421454,1294
23918538,23928954,chr20,CSTP1,chr20:23918538-23928954,10416
24962925,24992751,chr20,APMAP,chr20:24962925-24992751,29826
14179097,14252140,chr18,ANKRD20A5P,chr18:14179097-14252140,73043
28116094,28228667,chr21,LINC01695,chr21:28116094-28228667,112573
17493905,17569220,chr20,BFSP1,chr20:17493905-17569220,75315
21746973,21797415,chr21,LINC01425,chr21:21746973-21797415,50442
47630112,47630848,chr18,TPMTP1,chr18:47630112-47630848,736
51845007,51845628,chr18,RPS8P3,chr18:51845007-51845628,621
20430443,20430762,chr21,RPS3AP1,chr21:20430443-20430762,319
31671000,31732118,chr21,SCAF4,chr21:31671000-31732118,61118
23994213,24015339,chr18,TTC39C-AS1,chr18:23994213-24015339,21126
41789162,41789395,chr18,NPM1P1,chr18:41789162-41789395,233
46756487,46802449,chr18,ST8SIA5-DT,chr18:46756487-46802449,45962
9136228,9285985,chr18,ANKRD12,chr18:9136228-9285985,149757
29480147,29497179,chr20,FRG1EP,chr20:29480147-29497179,17032
1947246,2030028,chr20,PDYN-AS1,chr20:1947246-2030028,82782
25845497,25845862,chr20,BSNDP2,chr20:25845497-25845862,365
29641778,29641976,chr20,CFTRP2,chr20:29641778-29641976,198
6006093,6040053,chr20,CRLS1,chr20:6006093-6040053,33960
23985050,23988779,chr20,GGTLC1,chr20:23985050-23988779,3729
14337423,14342524,chr18,CYP4F35P,chr18:14337423-14342524,5101
46173553,46266992,chr18,C18orf25,chr18:46173553-46266992,93439
25762384,25868225,chr20,FAM182B,chr20:25762384-25868225,105841
15611759,15613096,chr22,NEK2P2,chr22:15611759-15613096,1337
15854195,15855243,chr22,TOMM40P2,chr22:15854195-15855243,1048
16590751,16592810,chr22,CCT8L2,chr22:16590751-16592810,2059
16921443,16922173,chr22,IGKV2OR22-3,chr22:16921443-16922173,730
15490530,15490767,chr21,CYCSP42,chr21:15490530-15490767,237
16654066,16675540,chr22,ANKRD62P1-PARP4P3,chr22:16654066-16675540,21474
27367014,27367947,chr21,EIF4A1P1,chr21:27367014-27367947,933
30209151,30211783,chr21,LINC00307,chr21:30209151-30211783,2632
16857619,16860718,chr22,ZNF402P,chr22:16857619-16860718,3099
25361821,25381756,chr21,RPL13AP7,chr21:25361821-25381756,19935
30496824,30497165,chr21,KRTAP19-4,chr21:30496824-30497165,341
16595089,16595485,chr22,FABP5P11,chr22:16595089-16595485,396
16503304,16509475,chr22,CHEK2P4,chr22:16503304-16509475,6171
31475288,31484895,chr20,REM1,chr20:31475288-31484895,9607
11124337,11125705,chr22,ACTR3BP7,chr22:11124337-11125705,1368
30501657,30502141,chr21,KRTAP19-5,chr21:30501657-30502141,484
16904219,16904696,chr22,IGKV1OR22-5,chr22:16904219-16904696,477
50375040,50394168,chr18,SKA1,chr18:50375040-50394168,19128
29055805,29073797,chr21,CCT8,chr21:29055805-29073797,17992
16387694,16390887,chr22,ABCD1P4,chr22:16387694-16390887,3193
16645695,16646581,chr22,SLC25A15P5,chr22:16645695-16646581,886
16423943,16426031,chr22,PABPC1P9,chr22:16423943-16426031,2088
34475924,34476474,chr20,FDX1P1,chr20:34475924-34476474,550
16827474,16829335,chr22,HSFY1P1,chr22:16827474-16829335,1861
23989292,23990454,chr20,POM121L3P,chr20:23989292-23990454,1162
23125068,23132635,chr20,LINC00656,chr20:23125068-23132635,7567
23823769,23826729,chr20,CST2,chr20:23823769-23826729,2960
17178790,17258235,chr22,ADA2,chr22:17178790-17258235,79445
23475700,23479798,chr20,CST12P,chr20:23475700-23479798,4098
17570075,17609919,chr20,DSTN,chr20:17570075-17609919,39844
50823577,50824120,chr18,RPL17P46,chr18:50823577-50824120,543
49650350,49651160,chr18,SMUG1P1,chr18:49650350-49651160,810
51612639,51613110,chr18,RSL24D1P9,chr18:51612639-51613110,471
45847609,45967329,chr18,EPG5,chr18:45847609-45967329,119720
30214765,30214976,chr20,CFTRP3,chr20:30214765-30214976,211
18467389,18484646,chr20,POLR3F,chr20:18467389-18484646,17257
25734264,25735093,chr20,VN1R108P,chr20:25734264-25735093,829
33007704,33023703,chr20,BPIFB2,chr20:33007704-33023703,15999
2101827,2177038,chr20,STK35,chr20:2101827-2177038,75211
16746628,16748645,chr22,LINC01665,chr22:16746628-16748645,2017
20998409,21543329,chr21,NCAM2,chr21:20998409-21543329,544920
18527802,18530573,chr22,TMEM191B,chr22:18527802-18530573,2771
29448517,29449306,chr20,DUX4L35,chr20:29448517-29449306,789
30278906,30289956,chr20,LINC01597,chr20:30278906-30289956,11050
47853233,47853457,chr18,MTCO2P2,chr18:47853233-47853457,224
26255698,26256355,chr18,SINHCAFP1,chr18:26255698-26256355,657
26098839,26099226,chr18,RPS24P18,chr18:26098839-26099226,387
34213495,34215892,chr20,XPOTP1,chr20:34213495-34215892,2397
6040546,6054060,chr20,LRRN4,chr20:6040546-6054060,13514
17256859,17266733,chr22,CECR3,chr22:17256859-17266733,9874
5532878,5533335,chr20,RPS18P1,chr20:5532878-5533335,457
15349467,15350043,chr22,BNIP3P2,chr22:15349467-15350043,576
16671090,16679493,chr22,ANKRD62P1,chr22:16671090-16679493,8403
661596,675802,chr20,SCRT2,chr20:661596-675802,14206
15326037,15343065,chr22,ZNF72P,chr22:15326037-15343065,17028
13237801,13239674,chr20,ISM1-AS1,chr20:13237801-13239674,1873
15749156,15750825,chr22,GRAMD4P2,chr22:15749156-15750825,1669
15635180,15644330,chr22,MED15P7,chr22:15635180-15644330,9150
46080248,46104334,chr18,ATP5F1A,chr18:46080248-46104334,24086
34689097,34825651,chr20,NCOA6,chr20:34689097-34825651,136554
30425265,30425968,chr21,KRTAP13-3,chr21:30425265-30425968,703
30319124,30320315,chr21,KRTAP26-1,chr21:30319124-30320315,1191
15852990,15893942,chr22,NBEAP3,chr22:15852990-15893942,40952
30396031,30396822,chr21,KRTAP13-1,chr21:30396031-30396822,791
25643489,25644216,chr21,RNGTTP1,chr21:25643489-25644216,727
30356515,30356885,chr21,KRTAP13-6P,chr21:30356515-30356885,370
20707691,20859417,chr22,PI4KA,chr22:20707691-20859417,151726
13581060,13582004,chr21,OR4K12P,chr21:13581060-13582004,944
28928144,28992956,chr21,LTN1,chr21:28928144-28992956,64812
32958888,32960566,chr21,LINC01690,chr21:32958888-32960566,1678
19593841,19594108,chr21,RPL37P4,chr21:19593841-19594108,267
26170871,26217381,chr21,APP-DT,chr21:26170871-26217381,46510
54954403,54954732,chr18,MAP1LC3P,chr18:54954403-54954732,329
25880550,26171128,chr21,APP,chr21:25880550-26171128,290578
50063795,50064440,chr18,ADAD1P2,chr18:50063795-50064440,645
25919499,25919681,chr20,CFTRP1,chr20:25919499-25919681,182
26599408,26600338,chr18,CIAPIN1P,chr18:26599408-26600338,930
157454,159163,chr20,DEFB127,chr20:157454-159163,1709
50227193,50266495,chr18,CFAP53,chr18:50227193-50266495,39302
23045633,23049672,chr20,THBD,chr20:23045633-23049672,4039
32277651,32335011,chr20,KIF3B,chr20:32277651-32335011,57360
14222008,14222331,chr18,RHOT1P1,chr18:14222008-14222331,323
12950288,13008417,chr20,LINC01723,chr20:12950288-13008417,58129
35984387,36067576,chr18,RPRD1A,chr18:35984387-36067576,83189
18623339,18625289,chr22,SUSD2P2,chr22:18623339-18625289,1950
12602466,12626642,chr22,FRG1GP,chr22:12602466-12626642,24176
37602852,37603185,chr20,GLRXP1,chr20:37602852-37603185,333
31360790,31360930,chr20,DEFB117,chr20:31360790-31360930,140
16925952,16926444,chr22,IGKV3OR22-2,chr22:16925952-16926444,492
13008972,13169103,chr20,SPTLC3,chr20:13008972-13169103,160131
20338805,20354372,chr22,FAM230G,chr22:20338805-20354372,15567
18501794,18512187,chr22,FAM247B,chr22:18501794-18512187,10393
15805263,15820884,chr22,BMS1P22,chr22:15805263-15820884,15621
29318824,29319579,chr20,DUX4L32,chr20:29318824-29319579,755
33193585,33210462,chr20,BPIFA4P,chr20:33193585-33210462,16877
16575363,16582707,chr22,KCNMB3P1,chr22:16575363-16582707,7344
16914235,16914981,chr22,IGKV2OR22-4,chr22:16914235-16914981,746
15699361,15703403,chr22,POTEH-AS1,chr22:15699361-15703403,4042
39932922,39933239,chr20,HSPE1P1,chr20:39932922-39933239,317
21501395,21501968,chr20,GSTM3P1,chr20:21501395-21501968,573
14884250,14929528,chr20,MACROD2-AS1,chr20:14884250-14929528,45278
16653892,16659628,chr22,PARP4P3,chr22:16653892-16659628,5736
17036570,17060825,chr22,CECR7,chr22:17036570-17060825,24255
25985210,26086917,chr20,FAM182A,chr20:25985210-26086917,101707
42743227,43115691,chr18,RIT2,chr18:42743227-43115691,372464
17116297,17121367,chr22,TMEM121B,chr22:17116297-17121367,5070
16837522,16837666,chr22,GPM6BP3,chr22:16837522-16837666,144
16428947,16476870,chr22,SLC9B1P4,chr22:16428947-16476870,47923
15826566,15827187,chr22,DUXAP8,chr22:15826566-15827187,621
18650023,18653617,chr22,PPP1R26P2,chr22:18650023-18653617,3594
33235995,33243311,chr20,BPIFA1,chr20:33235995-33243311,7316
21207973,21227637,chr22,GGT2,chr22:21207973-21227637,19664
22413599,22417915,chr18,CTAGE1,chr18:22413599-22417915,4316
54406889,54407114,chr18,SNRPGP2,chr18:54406889-54407114,225
18422244,18500594,chr22,FAM230A,chr22:18422244-18500594,78350
3977649,3978615,chr18,GAPDHP66,chr18:3977649-3978615,966
48478561,48479228,chr18,POLR3GP2,chr18:48478561-48479228,667
17084954,17115694,chr22,IL17RA,chr22:17084954-17115694,30740
12661833,12702777,chr18,CEP76,chr18:12661833-12702777,40944
16876218,16876421,chr22,MTND1P17,chr22:16876218-16876421,203
15622601,15632051,chr22,NF1P6,chr22:15622601-15632051,9450
34872146,34927962,chr20,ACSS2,chr20:34872146-34927962,55816
18636445,18638405,chr22,CA15P2,chr22:18636445-18638405,1960
21360601,21361299,chr22,FAM246A,chr22:21360601-21361299,698
20602595,20656914,chr22,SMPD4P1,chr22:20602595-20656914,54319
14377546,14378757,chr18,TERF1P2,chr18:14377546-14378757,1211
43267892,43277535,chr18,SYT4,chr18:43267892-43277535,9643
20697962,20698934,chr22,BCRP5,chr22:20697962-20698934,972
16601887,16698742,chr22,TPTEP1,chr22:16601887-16698742,96855
24460637,24479961,chr18,HRH4,chr18:24460637-24479961,19324
21290760,21294586,chr22,BCRP6,chr22:21290760-21294586,3826
18516344,18518161,chr22,GGTLC3,chr22:18516344-18518161,1817
20587496,20592218,chr22,CCDC74BP1,chr22:20587496-20592218,4722
17192936,17193308,chr22,RPL32P5,chr22:17192936-17193308,372
19179473,19291719,chr22,CLTCL1,chr22:19179473-19291719,112246
22798261,23026488,chr18,RBBP8,chr18:22798261-23026488,228227
13676022,13677116,chr21,CXADRP1,chr21:13676022-13677116,1094
38894917,38895252,chr21,RPSAP64,chr21:38894917-38895252,335
37951425,38121360,chr21,DSCR4,chr21:37951425-38121360,169935
36388878,36389112,chr21,ATP5MFP1,chr21:36388878-36389112,234
30590105,30590397,chr21,KRTAP22-2,chr21:30590105-30590397,292
31840341,31840858,chr21,TPT1P1,chr21:31840341-31840858,517
33432485,33479974,chr21,TMEM50B,chr21:33432485-33479974,47489
30479706,30480367,chr21,KRTAP19-1,chr21:30479706-30480367,661
32772100,32955437,chr21,C21orf62-AS1,chr21:32772100-32955437,183337
34135432,34136071,chr21,RPS5P2,chr21:34135432-34136071,639
38323635,38333421,chr21,LINC01423,chr21:38323635-38333421,9786
17438821,17450104,chr21,LINC01549,chr21:17438821-17450104,11283
30592440,30593075,chr21,KRTAP6-3,chr21:30592440-30593075,635
30214006,30216097,chr21,CLDN8,chr21:30214006-30216097,2091
13826696,13827627,chr21,CNN2P7,chr21:13826696-13827627,931
37187666,37193926,chr21,TTC3-AS1,chr21:37187666-37193926,6260
10413477,10516431,chr21,BAGE2,chr21:10413477-10516431,102954
34400112,34401072,chr21,FAM243A,chr21:34400112-34401072,960
33518610,33519108,chr21,BTF3P6,chr21:33518610-33519108,498
30491462,30492013,chr21,KRTAP19-3,chr21:30491462-30492013,551
38121451,38156511,chr21,DSCR8,chr21:38121451-38156511,35060
6511416,6590653,chr18,LINC01387,chr18:6511416-6590653,79237
6256747,6260934,chr18,L3MBTL4-AS1,chr18:6256747-6260934,4187
55881688,55998219,chr18,LINC01416,chr18:55881688-55998219,116531
22711689,22713203,chr22,IGLV3-21,chr22:22711689-22713203,1514
27722379,27751233,chr21,LINC00113,chr21:27722379-27751233,28854
23992773,24135610,chr18,TTC39C,chr18:23992773-24135610,142837
17329034,17329232,chr22,CECR9,chr22:17329034-17329232,198
13776086,13777266,chr21,TERF1P1,chr21:13776086-13777266,1180
36485983,36487411,chr21,PSMD4P1,chr21:36485983-36487411,1428
16933521,16934003,chr22,IGKV1OR22-1,chr22:16933521-16934003,482
32020966,32021782,chr21,HUNK-AS1,chr21:32020966-32021782,816
17213516,17214155,chr22,FAM32BP,chr22:17213516-17214155,639
18633984,18634682,chr22,FAM246B,chr22:18633984-18634682,698
15746630,15778297,chr22,PSLNR,chr22:15746630-15778297,31667
31873020,32044633,chr21,HUNK,chr21:31873020-32044633,171613
18605815,18611919,chr22,RIMBP3,chr22:18605815-18611919,6104
22873212,22873440,chr22,IGLV3-2,chr22:22873212-22873440,228
18533646,18577968,chr22,PI4KAP1,chr22:18533646-18577968,44322
14774301,14775262,chr21,GAPDHP16,chr21:14774301-14775262,961
10330732,10331537,chr21,EIF3FP1,chr21:10330732-10331537,805
17788974,17819386,chr21,C21orf91,chr21:17788974-17819386,30412
45423764,45483218,chr18,SLC14A2-AS1,chr18:45423764-45483218,59454
10888582,10889088,chr20,FAT1P1,chr20:10888582-10889088,506
29324092,29325049,chr20,DUX4L33,chr20:29324092-29325049,957
14127400,14128336,chr20,AIMP1P1,chr20:14127400-14128336,936
31257664,31259632,chr20,DEFB115,chr20:31257664-31259632,1968
52340197,53535903,chr18,DCC,chr18:52340197-53535903,1195706
22098616,22116605,chr21,LINC00308,chr21:22098616-22116605,17989
26167817,26251546,chr20,MIR663AHG,chr20:26167817-26251546,83729
9364467,9365225,chr21,SNX18P12,chr21:9364467-9365225,758
38006544,38010618,chr21,DSCR4-IT1,chr21:38006544-38010618,4074
20632619,20632751,chr22,IGLL4P,chr22:20632619-20632751,132
36320189,36386148,chr21,MORC3,chr21:36320189-36386148,65959
22661299,22661542,chr22,IGLV3-29,chr22:22661299-22661542,243
20495913,20587632,chr22,MED15,chr22:20495913-20587632,91719
32733899,32771792,chr21,PAXBP1,chr21:32733899-32771792,37893
50560087,50731826,chr18,MAPK4,chr18:50560087-50731826,171739
52419189,52419644,chr18,VN1R76P,chr18:52419189-52419644,455
22418829,22419294,chr18,ATP7BP1,chr18:22418829-22419294,465
45825675,45844094,chr18,SIGLEC15,chr18:45825675-45844094,18419
46326809,46463140,chr18,RNF165,chr18:46326809-46463140,136331
34704339,34713439,chr20,TP53INP2,chr20:34704339-34713439,9100
14153001,14157342,chr18,NF1P5,chr18:14153001-14157342,4341
23711320,23711406,chr20,CST2P1,chr20:23711320-23711406,86
54744750,54745581,chr18,RPSAP57,chr18:54744750-54745581,831
23547764,23550652,chr20,CST9LP1,chr20:23547764-23550652,2888
54412763,54424632,chr18,CUPIN1P,chr18:54412763-54424632,11869
25669857,25670386,chr20,MED28P7,chr20:25669857-25670386,529
17516843,17517307,chr20,RPS27AP2,chr20:17516843-17517307,464
50795120,50825402,chr18,MRO,chr18:50795120-50825402,30282
10637684,10673999,chr20,JAG1,chr20:10637684-10673999,36315
333933,386955,chrX,PPP2R3B,chrX:333933-386955,53022
19620695,19621545,chr21,NIPA2P3,chr21:19620695-19621545,850
33481580,33482195,chr21,RPS5P3,chr21:33481580-33482195,615
32790673,32813743,chr21,C21orf62,chr21:32790673-32813743,23070
30510307,30510497,chr21,KRTAP19-9P,chr21:30510307-30510497,190
37208503,37221736,chr21,DSCR9,chr21:37208503-37221736,13233
1008503,1010101,chrX,RPL14P5,chrX:1008503-1010101,1598
5168918,5169439,chrX,MTND6P12,chrX:5168918-5169439,521
5305714,5307128,chrX,HADHBP1,chrX:5305714-5307128,1414
3659487,3668192,chrX,PRKX-AS1,chrX:3659487-3668192,8705
3604340,3713649,chrX,PRKX,chrX:3604340-3713649,109309
38206156,38208644,chr21,DSCR10,chr21:38206156-38208644,2488
39127568,39128040,chr21,RPL23AP12,chr21:39127568-39128040,472
13839118,13839409,chr21,ZNF114P1,chr21:13839118-13839409,291
32080316,32197813,chr21,LINC00159,chr21:32080316-32197813,117497
30537278,30537381,chr21,KRTAP19-11P,chr21:30537278-30537381,103
4852356,5010293,chr20,SLC23A2,chr20:4852356-5010293,157937
1401769,1414028,chrX,ASMTL-AS1,chrX:1401769-1414028,12259
20946906,21111813,chr18,ROCK1,chr18:20946906-21111813,164907
8783514,8784461,chrX,DRAXINP1,chrX:8783514-8784461,947
8169944,8171267,chrX,VCX2,chrX:8169944-8171267,1323
33642400,33899861,chr21,ITSN1,chr21:33642400-33899861,257461
8856665,8857059,chrX,ANAPC15P1,chrX:8856665-8857059,394
13310652,13319933,chrX,GS1-600G8.3,chrX:13310652-13319933,9281
10939388,10961338,chr22,FRG1FP,chr22:10939388-10961338,21950
8980425,8982505,chrX,NOLC1P1,chrX:8980425-8982505,2080
1336616,1382689,chrX,IL3RA,chrX:1336616-1382689,46073
22900976,22901437,chr22,IGLC2,chr22:22900976-22901437,461
22715290,22715419,chr22,IGLVI-20,chr22:22715290-22715419,129
21341595,21345258,chr22,PPP1R26P5,chr22:21341595-21345258,3663
16690103,16704477,chr22,VWFP1,chr22:16690103-16704477,14374
22700760,22700970,chr22,IGLVVI-22-1,chr22:22700760-22700970,210
22664473,22664907,chr22,IGLV2-28,chr22:22664473-22664907,434
22850375,22850624,chr22,IGLV3-6,chr22:22850375-22850624,249
22822658,22823289,chr22,IGLV2-8,chr22:22822658-22823289,631
21300990,21325042,chr22,FAM230H,chr22:21300990-21325042,24052
1462581,1537185,chrX,P2RY8,chrX:1462581-1537185,74604
6422092,6422701,chrX,RPS5P8,chrX:6422092-6422701,609
5169512,5170645,chrX,MTCYBP12,chrX:5169512-5170645,1133
3717149,3717600,chrX,RPS27AP20,chrX:3717149-3717600,451
12975110,12977227,chrX,TMSB4X,chrX:12975110-12977227,2117
23536881,23547797,chr22,PCAT14,chr22:23536881-23547797,10916
22771824,22772582,chr22,IGLV3-12,chr22:22771824-22772582,758
16198428,16199289,chrX,RPL6P30,chrX:16198428-16199289,861
1386152,1392113,chrX,SLC25A6,chrX:1386152-1392113,5961
22639177,22644473,chr22,POM121L1P,chr22:22639177-22644473,5296
23649213,23653334,chr22,ASLP1,chr22:23649213-23653334,4121
12911186,12912023,chr18,STK25P1,chr18:12911186-12912023,837
22694439,22694952,chr22,IGLV3-24,chr22:22694439-22694952,513
22887780,22896111,chr22,IGLL5,chr22:22887780-22896111,8331
48252301,48252837,chr18,C18orf12,chr18:48252301-48252837,536
57352557,57371731,chr18,ST8SIA3,chr18:57352557-57371731,19174
11293413,11300761,chrX,AMELX,chrX:11293413-11300761,7348
23768226,23784316,chr22,MMP11,chr22:23768226-23784316,16090
37530039,37530543,chr20,PPIAP3,chr20:37530039-37530543,504
22885670,22886068,chr20,CYB5AP4,chr20:22885670-22886068,398
23564732,23568484,chr20,CST9L,chr20:23564732-23568484,3752
46104378,46128333,chr18,HAUS1,chr18:46104378-46128333,23955
1615059,1643081,chrX,ASMT,chrX:1615059-1643081,28022
20652730,20654750,chr22,SLC9A3P2,chr22:20652730-20654750,2020
22686726,22687271,chr22,IGLV3-25,chr22:22686726-22687271,545
22811747,22812281,chr22,IGLV3-10,chr22:22811747-22812281,534
26071988,26072351,chr20,BSNDP3,chr20:26071988-26072351,363
29548661,29559705,chr20,FAM242B,chr20:29548661-29559705,11044
22819010,22819756,chr22,IGLV3-9,chr22:22819010-22819756,746
22792491,22793007,chr22,IGLV2-11,chr22:22792491-22793007,516
18485265,18486052,chr20,RPL21P3,chr20:18485265-18486052,787
29878636,29879363,chr20,DUX4L37,chr20:29878636-29879363,727
31205264,31205616,chr22,RNF185-AS1,chr22:31205264-31205616,352
2334295,2336410,chrX,DHRSX-IT1,chrX:2334295-2336410,2115
22838602,22838872,chr22,IGLV3-7,chr22:22838602-22838872,270
304529,318819,chrX,GTPBP6,chrX:304529-318819,14290
22513736,22520270,chr22,ZNF280A,chr22:22513736-22520270,6534
45174902,45176544,chr20,PI3,chr20:45174902-45176544,1642
45221373,45224458,chr20,SEMG2,chr20:45221373-45224458,3085
13333952,13403035,chrX,LINC01203,chrX:13333952-13403035,69083
30693782,30907824,chr22,OSBP2,chr22:30693782-30907824,214042
45091214,45101127,chr20,KCNS1,chr20:45091214-45101127,9913
61808067,61894247,chr18,RNF152,chr18:61808067-61894247,86180
54901509,54959461,chr18,CCDC68,chr18:54901509-54959461,57952
39213777,39224748,chr20,LINC01734,chr20:39213777-39224748,10971
22587522,22607517,chr20,LNCNEF,chr20:22587522-22607517,19995
18507520,18561415,chr20,SEC23B,chr20:18507520-18561415,53895
2219506,2502805,chrX,DHRSX,chrX:2219506-2502805,283299
9786429,9949443,chrX,SHROOM2,chrX:9786429-9949443,163014
50457887,50458795,chr18,RPLP0P11,chr18:50457887-50458795,908
47808957,47931146,chr18,SMAD2,chr18:47808957-47931146,122189
21421822,21422294,chrX,RARRES2P3,chrX:21421822-21422294,472
8528874,8732137,chrX,ANOS1,chrX:8528874-8732137,203263
1403139,1453762,chrX,ASMTL,chrX:1403139-1453762,50623
1187549,1212723,chrX,CRLF2,chrX:1187549-1212723,25174
3953056,3953561,chrX,RPL24P9,chrX:3953056-3953561,505
9024232,9295682,chrX,FAM9B,chrX:9024232-9295682,271450
54717860,54895516,chr18,RAB27B,chr18:54717860-54895516,177656
14835961,14873069,chrX,FANCB,chrX:14835961-14873069,37108
59220158,59230774,chr18,GRP,chr18:59220158-59230774,10616
1396427,1399402,chrX,LINC00106,chrX:1396427-1399402,2975
11111301,11123086,chrX,HCCS,chrX:11111301-11123086,11785
11619509,11639699,chr18,NPIPB1P,chr18:11619509-11639699,20190
13389392,13638932,chr20,TASP1,chr20:13389392-13638932,249540
62325287,62391288,chr18,TNFRSF11A,chr18:62325287-62391288,66001
23351013,23351450,chrX,HIKESHIP1,chrX:23351013-23351450,437
5840637,6228867,chrX,NLGN4X,chrX:5840637-6228867,388230
25612935,25624014,chr20,NANP,chr20:25612935-25624014,11079
37693955,37872129,chr20,CTNNBL1,chr20:37693955-37872129,178174
22747383,22747921,chr22,IGLV3-16,chr22:22747383-22747921,538
22547701,22559361,chr22,PRAME,chr22:22547701-22559361,11660
13035617,13044682,chrX,FAM9C,chrX:13035617-13044682,9065
14391913,14393909,chr18,FEM1AP2,chr18:14391913-14393909,1996
56597209,56651600,chr18,TXNL1,chr18:56597209-56651600,54391
11334233,11335901,chrX,GOT2P7,chrX:11334233-11335901,1668
8790795,8801383,chrX,FAM9A,chrX:8790795-8801383,10588
22559343,22566602,chr22,LL22NC03-63E9.3,chr22:22559343-22566602,7259
22858025,22858268,chr22,IGLV3-4,chr22:22858025-22858268,243
22904850,22905025,chr22,IGLJ3,chr22:22904850-22905025,175
21193360,21203755,chr22,FAM247A,chr22:21193360-21203755,10395
21268161,21268903,chr22,E2F6P3,chr22:21268161-21268903,742
22594528,22595056,chr22,IGLV3-32,chr22:22594528-22595056,528
22880706,22881396,chr22,IGLV3-1,chr22:22880706-22881396,690
26644889,26645336,chr22,ISCA2P1,chr22:26644889-26645336,447
22484421,22508742,chr22,ZNF280B,chr22:22484421-22508742,24321
22856762,22857038,chr22,IGLV2-5,chr22:22856762-22857038,276
23752743,23754425,chr22,VPREB3,chr22:23752743-23754425,1682
60519841,60520165,chr18,MRPS5P4,chr18:60519841-60520165,324
48539031,48863217,chr18,CTIF,chr18:48539031-48863217,324186
17021398,17022570,chr22,VN1R9P,chr22:17021398-17022570,1172
20667836,20670984,chr22,ABHD17AP4,chr22:20667836-20670984,3148
38149336,38220924,chrX,SRPX,chrX:38149336-38220924,71588
29788609,29838304,chr22,ASCC2,chr22:29788609-29838304,49695
320990,321851,chrX,LINC00685,chrX:320990-321851,861
16123565,16153518,chrX,GRPR,chrX:16123565-16153518,29953
45607939,45631284,chr20,WFDC9,chr20:45607939-45631284,23345
18341216,18341346,chrX,TMSB10P2,chrX:18341216-18341346,130
18162931,18220886,chrX,BEND2,chrX:18162931-18220886,57955
36777447,36863538,chr20,SOGA1,chr20:36777447-36863538,86091
14873421,14922327,chrX,MOSPD2,chrX:14873421-14922327,48906
64041555,64423601,chr18,LINC01924,chr18:64041555-64423601,382046
53605254,53605725,chr18,RPL29P32,chr18:53605254-53605725,471
53568439,53629990,chr18,LINC01919,chr18:53568439-53629990,61551
23075758,23076767,chrX,FAM3C2P,chrX:23075758-23076767,1009
17970197,18104644,chrX,LINC01456,chrX:17970197-18104644,134447
44619522,44652233,chr20,ADA,chr20:44619522-44652233,32711
34147036,34147586,chrX,FTH1P14,chrX:34147036-34147586,550
15117437,15117768,chrX,RPL35AP37,chrX:15117437-15117768,331
28651732,28653208,chr18,ARIH2P1,chr18:28651732-28653208,1476
27517771,27517881,chrX,RDXP2,chrX:27517771-27517881,110
40760104,40761270,chrX,CLDN7P1,chrX:40760104-40761270,1166
34627075,34657285,chrX,TMEM47,chrX:34627075-34657285,30210
50879080,50954257,chr18,ME2,chr18:50879080-50954257,75177
14244382,14244928,chrX,UBE2E4P,chrX:14244382-14244928,546
38531923,38534174,chrX,UBTFL11,chrX:38531923-38534174,2251
17933349,17934823,chrX,MDM4P1,chrX:17933349-17934823,1474
31521199,31521592,chr22,H2AZP6,chr22:31521199-31521592,393
38479215,38479913,chrX,BAG1P1,chrX:38479215-38479913,698
14834476,14835319,chrX,NPM1P9,chrX:14834476-14835319,843
9179385,9179606,chrX,BRK1P1,chrX:9179385-9179606,221
34387722,34388464,chrX,SRSF2P1,chrX:34387722-34388464,742
22910574,22910606,chr22,IGLJ4,chr22:22910574-22910606,32
27427777,27428231,chrX,PTP4A1P5,chrX:27427777-27428231,454
30239194,30240538,chr22,LIF-AS1,chr22:30239194-30240538,1344
21654690,21658330,chrX,KLHL34,chrX:21654690-21658330,3640
1591604,1602520,chrX,AKAP17A,chrX:1591604-1602520,10916
32507820,33058381,chr22,SYN3,chr22:32507820-33058381,550561
21705978,21758116,chrX,SMPX,chrX:21705978-21758116,52138
43894720,43895468,chr20,LINC01728,chr20:43894720-43895468,748
22580014,22580296,chr22,IGLV2-34,chr22:22580014-22580296,282
18642782,18643634,chr20,DUXAP7,chr20:18642782-18643634,852
37619298,37623119,chr20,LINC00489,chr20:37619298-37623119,3821
25876854,25903247,chr22,MYO18B-AS1,chr22:25876854-25903247,26393
45207033,45209768,chr20,SEMG1,chr20:45207033-45209768,2735
21372801,21654695,chrX,CNKSR2,chrX:21372801-21654695,281894
45629739,45631196,chr20,WFDC10A,chr20:45629739-45631196,1457
44841925,44842539,chr20,PGBD4P2,chr20:44841925-44842539,614
21167758,21192156,chr22,FAM230B,chr22:21167758-21192156,24398
44656451,44663498,chr20,LINC01260,chr20:44656451-44663498,7047
45109452,45115172,chr20,WFDC5,chr20:45109452-45115172,5720
18786065,18794579,chr20,LINC00652,chr20:18786065-18794579,8514
22871507,22872035,chr22,IGLV4-3,chr22:22871507-22872035,528
38805697,38923024,chr20,PPP1R16B,chr20:38805697-38923024,117327
21282881,21284161,chr22,POM121L8P,chr22:21282881-21284161,1280
23462086,23486980,chr22,FAM230I,chr22:23462086-23486980,24894
32124877,32470882,chr18,GAREM1,chr18:32124877-32470882,346005
22734607,22735089,chr22,IGLV2-18,chr22:22734607-22735089,482
22755554,22755797,chr22,IGLV3-15,chr22:22755554-22755797,243
26858634,26968763,chr22,LINC01422,chr22:26858634-26968763,110129
30262829,30266851,chr22,OSM,chr22:30262829-30266851,4022
60794613,60794916,chr18,HMGN1P31,chr18:60794613-60794916,303
20689929,20698938,chr22,POM121L4P,chr22:20689929-20698938,9009
59778572,59778989,chr18,GLUD1P4,chr18:59778572-59778989,417
32134028,32134133,chr22,AP1B1P2,chr22:32134028-32134133,105
23638487,23717356,chr22,GUSBP11,chr22:23638487-23717356,78869
39334872,39335672,chr18,RPL7AP66,chr18:39334872-39335672,800
67516546,67899619,chr18,DSEL-AS1,chr18:67516546-67899619,383073
26103416,26114028,chr20,NCOR1P1,chr20:26103416-26114028,10612
26952201,26952558,chr18,ATP6V1E1P2,chr18:26952201-26952558,357
38210503,38260772,chr20,KIAA1755,chr20:38210503-38260772,50269
45983536,46072272,chr18,PSTPIP2,chr18:45983536-46072272,88736
31399604,31530634,chr22,DRG1,chr22:31399604-31530634,131030
33347720,33354444,chr20,BPIFB9P,chr20:33347720-33354444,6724
47285725,47594550,chr18,MIR4527HG,chr18:47285725-47594550,308825
25673195,25696853,chr20,ZNF337,chr20:25673195-25696853,23658
61957273,61958014,chr18,RPIAP1,chr18:61957273-61958014,741
48026672,48410752,chr18,ZBTB7C,chr18:48026672-48410752,384080
44942130,44960397,chr20,TOMM34,chr20:44942130-44960397,18267
37560480,37569405,chr22,CDC42EP1,chr22:37560480-37569405,8925
33031648,33044047,chr20,BPIFB6,chr20:33031648-33044047,12399
28992721,29018620,chr22,ZNRF3-IT1,chr22:28992721-29018620,25899
23512494,23513602,chr22,LINC02557,chr22:23512494-23513602,1108
22704265,22704822,chr22,IGLV3-22,chr22:22704265-22704822,557
22618572,22619163,chr22,IGLV3-30,chr22:22618572-22619163,591
22910828,22911075,chr22,IGLC4,chr22:22910828-22911075,247
38977711,38978422,chr20,NPM1P19,chr20:38977711-38978422,711
30080464,30177075,chr22,HORMAD2,chr22:30080464-30177075,96611
33272262,33272657,chr20,RPL12P3,chr20:33272262-33272657,395
38961925,38962111,chr20,DHX35-DT,chr20:38961925-38962111,186
42968743,42971492,chr20,PTPRT-AS1,chr20:42968743-42971492,2749
38962299,39039723,chr20,DHX35,chr20:38962299-39039723,77424
36460621,36576569,chr21,CLDN14,chr21:36460621-36576569,115948
32474676,32498829,chr22,FBXO7,chr22:32474676-32498829,24153
46462471,46469306,chr21,DIP2A-IT1,chr21:46462471-46469306,6835
9529934,9559268,chr21,NCOR1P4,chr21:9529934-9559268,29334
37607373,38121345,chr21,KCNJ6,chr21:37607373-38121345,513972
33903453,33915814,chr21,ATP5PO,chr21:33903453-33915814,12361
53480825,53581107,chr18,LINC01917,chr18:53480825-53581107,100282
4459230,4459458,chr18,ELOCP27,chr18:4459230-4459458,228
62523025,62587709,chr18,ZCCHC2,chr18:62523025-62587709,64684
36860988,36878017,chr22,NCF4,chr22:36860988-36878017,17029
18807279,18808018,chr13,SNX18P26,chr13:18807279-18808018,739
18724415,18724904,chr13,GXYLT1P1,chr13:18724415-18724904,489
19304593,19305625,chr13,MRPL3P1,chr13:19304593-19305625,1032
18726706,18727414,chr13,CNN2P12,chr13:18726706-18727414,708
18538880,18551214,chr13,LINC00349,chr13:18538880-18551214,12334
18809830,18810048,chr13,LINC00328-2P,chr13:18809830-18810048,218
18816718,18871967,chr13,ANKRD20A9P,chr13:18816718-18871967,55249
18892260,18895230,chr13,SNX19P2,chr13:18892260-18895230,2970
31311289,31312921,chr13,ANKRD26P4,chr13:31311289-31312921,1632
18680494,18681700,chr13,TERF1P5,chr13:18680494-18681700,1206
15694300,15696581,chr21,RAD23BP3,chr21:15694300-15696581,2281
24307166,24322535,chr13,C1QTNF9,chr13:24307166-24322535,15369
30337013,30337694,chr21,KRTAP27-1,chr21:30337013-30337694,681
37717102,37719569,chr21,KCNJ6-AS1,chr21:37717102-37719569,2467
38974429,38977774,chr21,LINC01700,chr21:38974429-38977774,3345
25692180,25692554,chr21,FDX1P2,chr21:25692180-25692554,374
43914852,44069616,chr20,TOX2,chr20:43914852-44069616,154764
17901263,18267373,chr21,CHODL,chr21:17901263-18267373,366110
19345049,19346749,chr13,LINC00421,chr13:19345049-19346749,1700
24420931,24512778,chr13,PARP4,chr13:24420931-24512778,91847
57147087,57150410,chr18,BOD1L2,chr18:57147087-57150410,3323
59275156,59318649,chr18,CPLX4,chr18:59275156-59318649,43493
46286342,46297751,chr21,YBEY,chr21:46286342-46297751,11409
23453287,23486603,chr18,RIOK3,chr18:23453287-23486603,33316
23738682,23751112,chr22,ZNF70,chr22:23738682-23751112,12430
38425083,38425354,chr20,SNORA71B,chr20:38425083-38425354,271
44694892,44746021,chr20,KCNK15-AS1,chr20:44694892-44746021,51129
22604445,22605165,chr22,IGLV3-31,chr22:22604445-22605165,720
22899481,22899655,chr22,IGLJ2,chr22:22899481-22899655,174
26672747,26780893,chr22,MIATNB,chr22:26672747-26780893,108146
46997596,46998488,chr20,GAPDHP54,chr20:46997596-46998488,892
46894624,47188844,chr20,EYA2,chr20:46894624-47188844,294220
31970823,32037995,chr22,LINC02558,chr22:31970823-32037995,67172
37223420,37267919,chr21,VPS26C,chr21:37223420-37267919,44499
31488688,31618588,chr22,SFI1,chr22:31488688-31618588,129900
38352586,38421446,chrX,OTC,chrX:38352586-38421446,68860
74073353,74147843,chr18,FBXO15,chr18:74073353-74147843,74490
38006553,38128819,chrX,SYTL5,chrX:38006553-38128819,122266
34157724,34190244,chr21,LINC00310,chr21:34157724-34190244,32520
9026821,9027329,chr21,CDRT15P9,chr21:9026821-9027329,508
28013363,28023233,chr21,LINC00314,chr21:28013363-28023233,9870
46598604,46605208,chr21,S100B,chr21:46598604-46605208,6604
16897651,16898521,chrX,SLC35C2P1,chrX:16897651-16898521,870
39401252,39434824,chrX,LINC01283,chrX:39401252-39434824,33572
16094415,16095372,chr21,VDAC2P1,chr21:16094415-16095372,957
46235133,46286297,chr21,MCM3AP,chr21:46235133-46286297,51164
19496378,19497721,chrX,EIF5P2,chrX:19496378-19497721,1343
36962196,36963425,chrX,TFDP1P2,chrX:36962196-36963425,1229
27172259,27182998,chr13,USP12-AS2,chr13:27172259-27182998,10739
25194381,25195207,chrX,METTL1P1,chrX:25194381-25195207,826
37945884,37946775,chrX,SC4MOP,chrX:37945884-37946775,891
45381527,45381995,chrX,PLLPP1,chrX:45381527-45381995,468
37505310,37505860,chrX,FTH1P27,chrX:37505310-37505860,550
23730189,23889400,chr13,MIPEP,chr13:23730189-23889400,159211
16786432,16844519,chrX,TXLNG,chrX:16786432-16844519,58087
50814392,50815730,chr18,HNRNPA3P16,chr18:50814392-50815730,1338
23506184,23586506,chr18,NPC1,chr18:23506184-23586506,80322
10996293,11029455,chr20,LINC02871,chr20:10996293-11029455,33162
45123425,45124465,chr20,WFDC12,chr20:45123425-45124465,1040
36374793,36375183,chrX,RPS15AP40,chrX:36374793-36375183,390
36211096,36211635,chrX,HMGB1P16,chrX:36211096-36211635,539
16803233,16803353,chrX,RPL12P49,chrX:16803233-16803353,120
46439709,46440714,chrX,GAPDHP65,chrX:46439709-46440714,1005
27460207,27463341,chrX,PPP4R3C,chrX:27460207-27463341,3134
14529298,14731812,chrX,GLRA2,chrX:14529298-14731812,202514
44885702,44908532,chr20,YWHAB,chr20:44885702-44908532,22830
17099782,17100239,chrX,CBX1P2,chrX:17099782-17100239,457
23198339,23198690,chrX,PDCL2P1,chrX:23198339-23198690,351
19008259,19026802,chr13,LINC00442,chr13:19008259-19026802,18543
38395369,38395895,chrX,TDGF1P1,chrX:38395369-38395895,526
46646594,46647330,chrX,PGAM1P7,chrX:46646594-46647330,736
45648563,45670270,chr20,WFDC11,chr20:45648563-45670270,21707
19201637,19227432,chr13,PSPC1P1,chr13:19201637-19227432,25795
18989307,19122637,chrX,ADGRG2,chrX:18989307-19122637,133330
18837768,18838098,chr13,RHOT1P3,chr13:18837768-18838098,330
24764169,24879921,chr13,RNF17,chr13:24764169-24879921,115752
57027832,57038845,chr18,WDR7-OT1,chr18:57027832-57038845,11013
31759584,31760880,chr18,SLC25A52,chr18:31759584-31760880,1296
46366050,46432985,chr20,ELMO2,chr20:46366050-46432985,66935
49822789,50195147,chr18,MYO5B,chr18:49822789-50195147,372358
13843133,13848364,chr21,CYP4F29P,chr21:13843133-13848364,5231
8759077,8761335,chr21,LINC01666,chr21:8759077-8761335,2258
29194071,29630751,chr21,BACH1,chr21:29194071-29630751,436680
18418775,18419273,chr14,BNIP3P6,chr14:18418775-18419273,498
19228898,19229945,chr14,CDRT15P13,chr14:19228898-19229945,1047
26393635,26569252,chr21,CYYR1-AS1,chr21:26393635-26569252,175617
30642864,30643136,chr21,KRTAP20-3,chr21:30642864-30643136,272
19026521,19028189,chr14,GRAMD4P4,chr14:19026521-19028189,1668
38238227,38238664,chr21,SPATA20P1,chr21:38238227-38238664,437
16121310,16121644,chr21,RPS26P5,chr21:16121310-16121644,334
30601087,30601382,chr21,KRTAP22-1,chr21:30601087-30601382,295
19267115,19268164,chr14,TOMM40P1,chr14:19267115-19268164,1049
18967434,19003752,chr14,POTEM,chr14:18967434-19003752,36318
30371390,30372271,chr21,KRTAP13-2,chr21:30371390-30372271,881
46072085,46072248,chr21,PSMA6P3,chr21:46072085-46072248,163
14582202,14598303,chr21,SAMSN1-AS1,chr21:14582202-14598303,16101
38733890,38747460,chr21,LINC00114,chr21:38733890-38747460,13570
37073226,37203112,chr21,TTC3,chr21:37073226-37203112,129886
18709478,18712643,chr14,NF1P10,chr14:18709478-18712643,3165
18912805,18916642,chr14,MED15P1,chr14:18912805-18916642,3837
61748082,61758464,chr18,LINC01544,chr18:61748082-61758464,10382
19180291,19181269,chr14,OR11H13P,chr14:19180291-19181269,978
35332227,35345482,chr18,ZNF24,chr18:35332227-35345482,13255
19244904,19269380,chr14,NBEAP6,chr14:19244904-19269380,24476
18899942,18909673,chr14,NF1P7,chr14:18899942-18909673,9731
23359603,23387731,chr22,CES5AP1,chr22:23359603-23387731,28128
24400703,24401029,chr13,CYCSP33,chr13:24400703-24401029,326
19552571,19570288,chr13,MRPS31P2,chr13:19552571-19570288,17717
18692032,18692408,chr14,RPL22P20,chr14:18692032-18692408,376
24408157,24597676,chr13,TPTE2P6,chr13:24408157-24597676,189519
19268853,19337730,chr14,DUXAP10,chr14:19268853-19337730,68877
19674624,19675884,chr13,PSPC1-AS2,chr13:19674624-19675884,1260
22720623,22721145,chr22,IGLV3-19,chr22:22720623-22721145,522
25017404,25017536,chr13,LSP1P1,chr13:25017404-25017536,132
18889084,18890424,chr14,NEK2P1,chr14:18889084-18890424,1340
39570753,39689735,chr22,CACNA1I,chr22:39570753-39689735,118982
22450089,22450139,chr14,TRDJ1,chr14:22450089-22450139,50
18467172,18485448,chr13,ZNF962P,chr13:18467172-18485448,18276
22422371,22423042,chr14,TRDV2,chr14:22422371-22423042,671
18697003,18697507,chr13,FAM207BP,chr13:18697003-18697507,504
59139866,59158832,chr18,SEC11C,chr18:59139866-59158832,18966
22476306,22476362,chr14,TRAJ60,chr14:22476306-22476362,56
28659104,28678959,chr13,POMP,chr13:28659104-28678959,19855
22438547,22438554,chr14,TRDD1,chr14:22438547-22438554,7
22482287,22482346,chr14,TRAJ54,chr14:22482287-22482346,59
22489488,22489543,chr14,TRAJ49,chr14:22489488-22489543,55
22459098,22459156,chr14,TRDJ3,chr14:22459098-22459156,58
22449113,22449125,chr14,TRDD3,chr14:22449113-22449125,12
26443090,26598033,chr14,NOVA1,chr14:26443090-26598033,154943
29872613,29888405,chr13,LINC00297,chr13:29872613-29888405,15792
65750252,65890337,chr18,CDH7,chr18:65750252-65890337,140085
30202630,30307551,chr13,KATNAL1,chr13:30202630-30307551,104921
19130636,19155089,chr14,NBEAP5,chr14:19130636-19155089,24453
22490491,22490553,chr14,TRAJ48,chr14:22490491-22490553,62
22476553,22476606,chr14,TRAJ59,chr14:22476553-22476606,53
19062316,19131167,chr14,DUXAP9,chr14:19062316-19131167,68851
22475316,22475375,chr14,TRAJ61,chr14:22475316-22475375,59
36777647,36829216,chr18,TPGS2,chr18:36777647-36829216,51569
22462932,22465787,chr14,TRDC,chr14:22462932-22465787,2855
22477707,22477769,chr14,TRAJ58,chr14:22477707-22477769,62
22455249,22455296,chr14,TRDJ4,chr14:22455249-22455296,47
24704338,24704788,chr13,RPL26P34,chr13:24704338-24704788,450
30103178,30108895,chr13,LINC00365,chr13:30103178-30108895,5717
32074946,32076793,chr14,ARHGAP5-AS1,chr14:32074946-32076793,1847
26809340,26836458,chr14,LINC02293,chr14:26809340-26836458,27118
40224625,40224862,chr13,RPL17P51,chr13:40224625-40224862,237
37993085,37994720,chr13,HSPD1P9,chr13:37993085-37994720,1635
22263065,22284029,chr20,LINC01427,chr20:22263065-22284029,20964
22492851,22492907,chr14,TRAJ47,chr14:22492851-22492907,56
22456689,22456742,chr14,TRDJ2,chr14:22456689-22456742,53
19633659,19673441,chr13,MPHOSPH8,chr13:19633659-19673441,39782
30437992,30573629,chr14,G2E3-AS1,chr14:30437992-30573629,135637
38127385,38166578,chr20,TGM2,chr20:38127385-38166578,39193
22479521,22479582,chr14,TRAJ56,chr14:22479521-22479582,61
32271857,32272301,chr14,KIAA1143P1,chr14:32271857-32272301,444
31558507,31561334,chr14,NUBPL-DT,chr14:31558507-31561334,2827
26775495,26822107,chr14,LINC02294,chr14:26775495-26822107,46612
31420286,31452883,chr14,HEATR5A-DT,chr14:31420286-31452883,32597
31489956,31861224,chr14,NUBPL,chr14:31489956-31861224,371268
18253526,18270822,chr13,GGT4P,chr13:18253526-18270822,17296
24315725,24321598,chr13,C1QTNF9-AS1,chr13:24315725-24321598,5873
44963794,44966402,chr20,STK4-AS1,chr20:44963794-44966402,2608
30422488,30429758,chr13,UBE2L5,chr13:30422488-30429758,7270
29746181,29748090,chr20,CDC27P3,chr20:29746181-29748090,1909
33316869,33329969,chr20,BPIFB5P,chr20:33316869-33329969,13100
50586108,50691542,chr20,RIPOR3,chr20:50586108-50691542,105434
36431520,36442870,chr13,CCNA1,chr13:36431520-36442870,11350
43595136,43596683,chr14,ARHGAP16P,chr14:43595136-43596683,1547
19301704,19316914,chr14,BMS1P17,chr14:19301704-19316914,15210
22439007,22439015,chr14,TRDD2,chr14:22439007-22439015,8
49577392,49577794,chr14,RPL32P29,chr14:49577392-49577794,402
44444747,44480626,chr14,LINC02277,chr14:44444747-44480626,35879
34561093,34630160,chr14,SNX6,chr14:34561093-34630160,69067
47478214,47479010,chr20,RPL35AP,chr20:47478214-47479010,796
39329014,39329924,chr20,ATG3P1,chr20:39329014-39329924,910
49903391,49915529,chr20,SPATA2,chr20:49903391-49915529,12138
38926312,38953106,chr20,FAM83D,chr20:38926312-38953106,26794
30136673,30137681,chr22,RPS3AP51,chr22:30136673-30137681,1008
23573125,23580302,chr22,IGLL1,chr22:23573125-23580302,7177
46709649,46736347,chr20,SLC2A10,chr20:46709649-46736347,26698
40044817,40335808,chr22,TNRC6B,chr22:40044817-40335808,290991
45640486,45641370,chr20,RPS2P7,chr20:45640486-45641370,884
49293394,49484297,chr20,KCNB1,chr20:49293394-49484297,190903
63897174,63936111,chr18,SERPINB10,chr18:63897174-63936111,38937
44745865,44752313,chr20,KCNK15,chr20:44745865-44752313,6448
46420553,46421034,chr21,RPL18AP2,chr21:46420553-46421034,481
28136843,28138193,chr13,PAN3-AS1,chr13:28136843-28138193,1350
38805183,38824955,chr21,ETS2,chr21:38805183-38824955,19772
33047517,33048152,chr20,PUDPP3,chr20:33047517-33048152,635
19382454,19383072,chr13,CCNQP3,chr13:19382454-19383072,618
46173739,46308498,chr20,CDH22,chr20:46173739-46308498,134759
30617693,30660770,chr13,USPL1,chr13:30617693-30660770,43077
60371062,60372775,chr18,MC4R,chr18:60371062-60372775,1713
67808505,67814822,chr18,LINC01903,chr18:67808505-67814822,6317
57357426,57358369,chr20,MTND1P9,chr20:57357426-57358369,943
49936336,49953885,chr20,RNF114,chr20:49936336-49953885,17549
22483004,22483069,chr14,TRAJ53,chr14:22483004-22483069,65
43540883,43541826,chr14,KRT8P2,chr14:43540883-43541826,943
22493925,22493990,chr14,TRAJ45,chr14:22493925-22493990,65
68673688,68715108,chr18,TMX3,chr18:68673688-68715108,41420
49373966,49374383,chr14,ATP5MC2P2,chr14:49373966-49374383,417
22486228,22486296,chr14,TRAJ52,chr14:22486228-22486296,68
45115599,45135319,chr14,FKBP3,chr14:45115599-45135319,19720
30151886,30159621,chr13,LINC00384,chr13:30151886-30159621,7735
27977717,27988693,chr13,URAD,chr13:27977717-27988693,10976
22679097,22679345,chr22,IGLVVI-25-1,chr22:22679097-22679345,248
22906342,22906803,chr22,IGLC3,chr22:22906342-22906803,461
23765934,23766104,chr13,MTCO3P2,chr13:23765934-23766104,170
19349137,19407962,chr13,PARP4P2,chr13:19349137-19407962,58825
37339583,37427445,chr22,ELFN2,chr22:37339583-37427445,87862
31281594,31292534,chr22,PIK3IP1,chr22:31281594-31292534,10940
30456704,30617597,chr13,HMGB1,chr13:30456704-30617597,160893
22481697,22481753,chr14,TRAJ55,chr14:22481697-22481753,56
34402149,34402696,chr20,CDC42P1,chr20:34402149-34402696,547
49956745,49958032,chr20,KRT18P4,chr20:49956745-49958032,1287
37589552,37596059,chr14,FOXA1,chr14:37589552-37596059,6507
53421199,53421656,chr20,PPIAP10,chr20:53421199-53421656,457
47391925,47412327,chr20,LINC01754,chr20:47391925-47412327,20402
37571103,37591493,chr20,LINC01746,chr20:37571103-37591493,20390
46458891,46570015,chr21,DIP2A,chr21:46458891-46570015,111124
27612577,27639636,chr14,LINC00645,chr14:27612577-27639636,27059
20258407,20267809,chr20,CFAP61-AS1,chr20:20258407-20267809,9402
22895375,22895834,chr22,IGLC1,chr22:22895375-22895834,459
29410348,29411600,chr20,DUX4L34,chr20:29410348-29411600,1252
30008742,30080480,chr22,HORMAD2-AS1,chr22:30008742-30080480,71738
36677921,37172606,chr14,SLC25A21,chr14:36677921-37172606,494685
46345980,46364458,chr20,SLC35C2,chr20:46345980-46364458,18478
30635781,30669016,chr22,SLC35E4,chr22:30635781-30669016,33235
35066136,35087387,chr22,ISX,chr22:35066136-35087387,21251
67137611,67137751,chr18,RPL31P9,chr18:67137611-67137751,140
62442028,62443126,chr18,ACTBP9,chr18:62442028-62443126,1098
39370279,39370756,chr14,GLRX5P3,chr14:39370279-39370756,477
18623852,18626787,chr14,ARHGAP42P5,chr14:18623852-18626787,2935
23503470,23531822,chr18,RMC1,chr18:23503470-23531822,28352
52430596,52552522,chr14,TXNDC16,chr14:52430596-52552522,121926
17800049,17861337,chrX,RAI2,chrX:17800049-17861337,61288
38111495,38214778,chr22,PLA2G6,chr22:38111495-38214778,103283
33180401,33281584,chr13,STARD13-AS,chr13:33180401-33281584,101183
38484752,38485264,chrX,FTLP16,chrX:38484752-38485264,512
44029332,44030921,chrX,RBM39P1,chrX:44029332-44030921,1589
16587999,16712936,chrX,CTPS2,chrX:16587999-16712936,124937
22469041,22469698,chr14,TRDV3,chr14:22469041-22469698,657
36168217,36214588,chr13,SOHLH2,chr13:36168217-36214588,46371
47764954,47795302,chr14,LINC00648,chr14:47764954-47795302,30348
52267698,52276724,chr14,PTGDR,chr14:52267698-52276724,9026
49598761,49614672,chr14,LRR1,chr14:49598761-49614672,15911
57054558,57072119,chr18,LINC-ROR,chr18:57054558-57072119,17561
60663115,60664369,chr18,CTBP2P3,chr18:60663115-60664369,1254
19343893,19361718,chrX,PDHA1,chrX:19343893-19361718,17825
51421063,51421674,chr18,SS18L2P2,chr18:51421063-51421674,611
62415678,62416227,chr18,RPL17P44,chr18:62415678-62416227,549
63752935,63805376,chr18,SERPINB7,chr18:63752935-63805376,52441
19818121,19818619,chr13,ST6GALNAC4P1,chr13:19818121-19818619,498
18665235,18667221,chr13,FEM1AP4,chr13:18665235-18667221,1986
28722386,28724021,chr13,CYP51A1P2,chr13:28722386-28724021,1635
46689659,46690289,chr20,TP53RK-DT,chr20:46689659-46690289,630
25124467,25156314,chr14,LINC02286,chr14:25124467-25156314,31847
29918647,29926651,chr13,LINC00572,chr13:29918647-29926651,8004
58459101,58515399,chr20,APCDD1L,chr20:58459101-58515399,56298
30881933,30933846,chr13,TEX26-AS1,chr13:30881933-30933846,51913
40954693,41149309,chr14,LINC02315,chr14:40954693-41149309,194616
43990539,44386064,chr14,LINC02307,chr14:43990539-44386064,395525
38727275,38728481,chr14,KRT8P1,chr14:38727275-38728481,1206
44504149,44507283,chr14,FSCB,chr14:44504149-44507283,3134
35115364,35147336,chr20,EDEM2,chr20:35115364-35147336,31972
31944853,31950382,chr14,LINC02313,chr14:31944853-31950382,5529
41583657,41604988,chr14,LRFN5-DT,chr14:41583657-41604988,21331
59761558,59761905,chr18,RPS26P54,chr18:59761558-59761905,347
67707929,67708246,chr18,FAM32DP,chr18:67707929-67708246,317
52857268,52952435,chr14,FERMT2,chr14:52857268-52952435,95167
68258080,68264827,chr18,LINC01912,chr18:68258080-68264827,6747
30613431,30613930,chr21,KRTAP6-1,chr21:30613431-30613930,499
46653558,46654022,chr21,DSTNP1,chr21:46653558-46654022,464
19015487,19019336,chr13,USP24P1,chr13:19015487-19019336,3849
46098112,46132848,chr21,COL6A2,chr21:46098112-46132848,34736
44989529,45037669,chr13,GPALPP1,chr13:44989529-45037669,48140
26170726,26171284,chr18,DHFRP1,chr18:26170726-26171284,558
77435253,77437242,chr18,BDP1P,chr18:77435253-77437242,1989
27225742,27247188,chr18,LINC01908,chr18:27225742-27247188,21446
40831844,40832562,chrX,TNIP2P1,chrX:40831844-40832562,718
39787132,39788136,chrX,GAPDHP1,chrX:39787132-39788136,1004
16650158,16654670,chrX,S100G,chrX:16650158-16654670,4512
47983404,47984313,chr20,LINC01523,chr20:47983404-47984313,909
27418884,27420435,chr18,RBM22P1,chr18:27418884-27420435,1551
29080390,29102761,chr20,FRG1DP,chr20:29080390-29102761,22371
48590042,48608869,chrX,WDR13,chrX:48590042-48608869,18827
61333430,61555779,chr18,CDH20,chr18:61333430-61555779,222349
24063255,24226013,chr20,LINC01721,chr20:24063255-24226013,162758
18486540,18497225,chr20,RBBP9,chr20:18486540-18497225,10685
43132209,43143398,chr22,MCAT,chr22:43132209-43143398,11189
47501887,47656877,chr20,NCOA3,chr20:47501887-47656877,154990
46560928,46562749,chrX,MKI67P1,chrX:46560928-46562749,1821
22893692,22893818,chr22,IGLJ1,chr22:22893692-22893818,126
49911620,49912362,chrX,CPSF1P2,chrX:49911620-49912362,742
37990779,37991314,chrX,H2AP,chrX:37990779-37991314,535
44799503,44809630,chr13,LINC00330,chr13:44799503-44809630,10127
13378735,13379340,chrX,GPX1P1,chrX:13378735-13379340,605
31212239,31280080,chr22,LIMK2,chr22:31212239-31280080,67841
46837043,46882358,chrX,RP2,chrX:46837043-46882358,45315
25016434,25017204,chr18,WBP2P1,chr18:25016434-25017204,770
68527970,68528123,chr18,MTL3P,chr18:68527970-68528123,153
31134973,31162388,chr13,HSPH1,chr13:31134973-31162388,27415
37780059,37813461,chrX,CYBB,chrX:37780059-37813461,33402
61404858,61405205,chr18,RPL30P14,chr18:61404858-61405205,347
70335439,70352459,chr18,LINC01909,chr18:70335439-70352459,17020
12785478,12929643,chr18,PTPN2,chr18:12785478-12929643,144165
21839617,21885423,chrX,MBTPS2,chrX:21839617-21885423,45806
46690764,46691226,chr21,RPL23AP4,chr21:46690764-46691226,462
46324141,46445769,chr21,PCNT,chr21:46324141-46445769,121628
37291168,37292227,chrX,MOB1AP2,chrX:37291168-37292227,1059
37541077,37545262,chrX,FAM47DP,chrX:37541077-37545262,4185
30304206,30309390,chrX,NR0B1,chrX:30304206-30309390,5184
35626142,35627064,chrX,SIAH1P1,chrX:35626142-35627064,922
16167481,16171464,chrX,MAGEB17,chrX:16167481-16171464,3983
25591353,25591808,chrX,RPP40P1,chrX:25591353-25591808,455
38335762,38398929,chr22,TPTEP2,chr22:38335762-38398929,63167
34942796,34944915,chrX,FAM47B,chrX:34942796-34944915,2119
18239313,18354688,chrX,SCML2,chrX:18239313-18354688,115375
31446036,31457506,chr14,DTD2,chr14:31446036-31457506,11470
52707178,52728590,chr14,PSMC6,chr14:52707178-52728590,21412
38155549,38307357,chr21,KCNJ15,chr21:38155549-38307357,151808
16946658,17153272,chrX,REPS2,chrX:16946658-17153272,206614
32043261,32113029,chr22,SLC5A1,chr22:32043261-32113029,69768
13038160,13067033,chr21,ANKRD30BP2,chr21:13038160-13067033,28873
26161834,26164303,chr22,LINC02559,chr22:26161834-26164303,2469
45913118,45913871,chrX,SRSF6P1,chrX:45913118-45913871,753
30246205,30246998,chr22,LIF-AS2,chr22:30246205-30246998,793
46418450,46420079,chrX,CTNNBL1P1,chrX:46418450-46420079,1629
22436290,22438349,chr21,MAPK6P2,chr21:22436290-22438349,2059
46684765,46685707,chrX,YBX1P8,chrX:46684765-46685707,942
13095305,13113790,chr21,ZNF355P,chr21:13095305-13113790,18485
50156159,50156371,chrX,PYY3,chrX:50156159-50156371,212
38200767,38216507,chr22,MAFF,chr22:38200767-38216507,15740
48636165,48637135,chrX,VN1R110P,chrX:48636165-48637135,970
54440404,54448032,chrX,TSR2,chrX:54440404-54448032,7628
33589341,33643926,chr21,CRYZL1,chr21:33589341-33643926,54585
14547184,14547623,chr20,RNF11P2,chr20:14547184-14547623,439
25452697,25585531,chr20,NINL,chr20:25452697-25585531,132834
43407665,43408559,chrX,NANOGP10,chrX:43407665-43408559,894
51304108,51331918,chr14,LINC00519,chr14:51304108-51331918,27810
35761499,35762479,chrX,NFYCP1,chrX:35761499-35762479,980
44147872,44343672,chrX,EFHC2,chrX:44147872-44343672,195800
37171888,37173811,chr14,SLC25A21-AS1,chr14:37171888-37173811,1923
22668288,22668806,chr22,IGLV3-27,chr22:22668288-22668806,518
22487183,22487245,chr14,TRAJ51,chr14:22487183-22487245,62
25267064,25267336,chr14,HMGN2P6,chr14:25267064-25267336,272
22630065,22636153,chr22,BCRP4,chr22:22630065-22636153,6088
39743044,39893864,chr22,ENTHD1,chr22:39743044-39893864,150820
45083045,45083977,chr14,PRPF39-DT,chr14:45083045-45083977,932
12947133,12987536,chr18,SEH1L,chr18:12947133-12987536,40403
32583300,32584204,chr22,SYN3-AS1,chr22:32583300-32584204,904
45505388,45632121,chrX,LINC01204,chrX:45505388-45632121,126733
53612724,53613405,chr14,RPS3AP46,chr14:53612724-53613405,681
27748277,27801756,chr22,MN1,chr22:27748277-27801756,53479
50931114,50931548,chrX,HMGB1P15,chrX:50931114-50931548,434
40648305,40735858,chrX,MED14,chrX:40648305-40735858,87553
38291918,38398522,chr22,TPTEP2-CSNK1E,chr22:38291918-38398522,106604
56248732,56249815,chr20,MC3R,chr20:56248732-56249815,1083
30240453,30246759,chr22,LIF,chr22:30240453-30246759,6306
44910060,44959035,chr20,PABPC1L,chr20:44910060-44959035,48975
60179382,60180016,chr14,PSMA3P1,chr14:60179382-60180016,634
44888556,44889041,chr14,RRAGAP1,chr14:44888556-44889041,485
59181593,59181940,chr14,PPIAP5,chr14:59181593-59181940,347
22478872,22478934,chr14,TRAJ57,chr14:22478872-22478934,62
37282027,37315341,chr22,CYTH4,chr22:37282027-37315341,33314
60779978,60780595,chr14,MAD2L1P1,chr14:60779978-60780595,617
60323236,60323907,chr14,LINC02322,chr14:60323236-60323907,671
26598369,26806467,chr14,NOVA1-DT,chr14:26598369-26806467,208098
61277370,61281761,chr14,TMEM30B,chr14:61277370-61281761,4391
60398934,60400013,chr14,GNRHR2P1,chr14:60398934-60400013,1079
59919713,60063559,chr14,LRRC9,chr14:59919713-60063559,143846
60016778,60017441,chr18,SINHCAFP2,chr18:60016778-60017441,663
28872191,28885371,chr21,N6AMT1,chr21:28872191-28885371,13180
59327823,59359265,chr18,LMAN1,chr18:59327823-59359265,31442
46573765,46598496,chrX,CHST7,chrX:46573765-46598496,24731
13349265,13350648,chr21,FGF7P2,chr21:13349265-13350648,1383
45730752,45731688,chrX,MFFP3,chrX:45730752-45731688,936
14757588,14758352,chr21,POLR2CP1,chr21:14757588-14758352,764
44633692,44635232,chrX,CHTF8P1,chrX:44633692-44635232,1540
13384249,13427773,chr21,ANKRD30BP1,chr21:13384249-13427773,43524
13476371,13477263,chr21,VN1R8P,chr21:13476371-13477263,892
13443373,13489176,chr21,GTF2IP2,chr21:13443373-13489176,45803
49879484,49882558,chrX,USP27X,chrX:49879484-49882558,3074
65821255,65822249,chrX,CCNYL5,chrX:65821255-65822249,994
14961235,15065936,chr21,NRIP1,chr21:14961235-15065936,104701
15619494,15619819,chr20,ENSAP1,chr20:15619494-15619819,325
49922596,50099235,chrX,CLCN5,chrX:49922596-50099235,176639
38304150,38337505,chr20,BPI,chr20:38304150-38337505,33355
52552836,52637713,chr14,GPR137C,chr14:52552836-52637713,84877
22738944,22739187,chr22,IGLV3-17,chr22:22738944-22739187,243
44566965,44568247,chr22,KRT18P23,chr22:44566965-44568247,1282
33543038,33577481,chr21,SON,chr21:33543038-33577481,34443
37681673,37693476,chr22,NOL12,chr22:37681673-37693476,11803
60149576,60150365,chr18,RPS3AP49,chr18:60149576-60150365,789
27017554,27017909,chr13,RPS20P32,chr13:27017554-27017909,355
35366694,35377337,chr18,ZNF396,chr18:35366694-35377337,10643
42369259,42369657,chr13,FABP3P2,chr13:42369259-42369657,398
27178263,27251288,chr13,LINC02340,chr13:27178263-27251288,73025
60091911,60169133,chr14,PCNX4,chr14:60091911-60169133,77222
29476515,29490105,chr13,MTUS2-AS1,chr13:29476515-29490105,13590
27355406,27355764,chr18,UBA52P9,chr18:27355406-27355764,358
44939249,44989471,chr13,NUFIP1,chr13:44939249-44989471,50222
62715541,62980433,chr18,PHLPP1,chr18:62715541-62980433,264892
49699320,49792682,chr13,KPNA3,chr13:49699320-49792682,93362
34280268,34311802,chr20,AHCY,chr20:34280268-34311802,31534
45502238,45601135,chr22,FBLN1,chr22:45502238-45601135,98897
22999960,23003589,chrX,DDX53,chrX:22999960-23003589,3629
26873092,26918594,chr14,MIR4307HG,chr14:26873092-26918594,45502
66501083,66604138,chr18,CDH19,chr18:66501083-66604138,103055
51923552,51923740,chrX,UQCR10P1,chrX:51923552-51923740,188
14977959,14978463,chrX,TPT1P14,chrX:14977959-14978463,504
46725164,46725818,chrX,CHMP5P1,chrX:46725164-46725818,654
27218131,27218678,chrX,AMZ2P3,chrX:27218131-27218678,547
27517884,27519759,chrX,RDXP3,chrX:27517884-27519759,1875
37492021,37492548,chrX,FTH1P19,chrX:37492021-37492548,527
35798342,35803735,chrX,MAGEB16,chrX:35798342-35803735,5393
27807990,27823014,chrX,MAGEB10,chrX:27807990-27823014,15024
36719918,36720221,chrX,H2AL1QP,chrX:36719918-36720221,303
50645471,50662275,chr20,RIPOR3-AS1,chr20:50645471-50662275,16804
45891087,46501903,chr14,LINC00871,chr14:45891087-46501903,610816
51921864,51922499,chrX,IPO7P1,chrX:51921864-51922499,635
54748918,54798255,chrX,ITIH6,chrX:54748918-54798255,49337
32983773,33004433,chr20,SUN5,chr20:32983773-33004433,20660
60643421,60658259,chr14,SIX1,chr14:60643421-60658259,14838
48574449,48581162,chrX,RBM3,chrX:48574449-48581162,6713
76528652,76670111,chr18,LINC00683,chr18:76528652-76670111,141459
63371364,63543377,chr14,PPP2R5E,chr14:63371364-63543377,172013
23334849,23404374,chrX,PTCHD1,chrX:23334849-23404374,69525
47976739,47990127,chr20,LINC01522,chr20:47976739-47990127,13388
44594858,44596082,chr13,SMARCE1P5,chr13:44594858-44596082,1224
30995162,30996138,chr13,LINC01066,chr13:30995162-30996138,976
13909574,13980437,chr21,ANKRD20A11P,chr21:13909574-13980437,70863
25783553,25783919,chr20,BSNDP1,chr20:25783553-25783919,366
20403666,20525873,chr13,CRYL1,chr13:20403666-20525873,122207
16719612,16765340,chrX,SYAP1,chrX:16719612-16765340,45728
48624252,48827999,chr20,PREX1,chr20:48624252-48827999,203747
76751305,76751841,chr18,CCND3P2,chr18:76751305-76751841,536
57169615,57171194,chr18,LINC02565,chr18:57169615-57171194,1579
13936993,13937325,chr21,RHOT1P2,chr21:13936993-13937325,332
64268081,64395452,chrX,MTMR8,chrX:64268081-64395452,127371
3878058,3897069,chr18,DLGAP1-AS3,chr18:3878058-3897069,19011
13516107,13574999,chr21,LINC01674,chr21:13516107-13574999,58892
32412214,32413176,chr18,HNRNPA1P7,chr18:32412214-32413176,962
26917922,26967088,chr21,ADAMTS5,chr21:26917922-26967088,49166
45687025,45752520,chr18,SLC14A1,chr18:45687025-45752520,65495
45632292,45633733,chrX,KRT8P14,chrX:45632292-45633733,1441
64697878,64698547,chrX,GRPEL2P2,chrX:64697878-64698547,669
37043023,37043571,chrX,FTHL18P,chrX:37043023-37043571,548
62878811,62884842,chrX,ZFRP1,chrX:62878811-62884842,6031
18425583,18653629,chrX,CDKL5,chrX:18425583-18653629,228046
38502445,38502621,chr21,SNRPGP13,chr21:38502445-38502621,176
5499151,5502542,chr21,LINC01670,chr21:5499151-5502542,3391
6859171,6859256,chr21,MIR8069-1,chr21:6859171-6859256,85
8256781,8256933,chr21,5_8S_rRNA,chr21:8256781-8256933,152
30803206,30810645,chr13,LINC00398,chr13:30803206-30810645,7439
8986999,8987178,chr21,MIR3648-2,chr21:8986999-8987178,179
8249505,8249596,chr21,MIR6724-2,chr21:8249505-8249596,91
19152567,19171194,chr13,SMPD4P2,chr13:19152567-19171194,18627
8388362,8388453,chr21,MIR6724-3,chr21:8388362-8388453,91
8395607,8395759,chr21,RNA5-8SN3,chr21:8395607-8395759,152
8432530,8432621,chr21,MIR6724-4,chr21:8432530-8432621,91
8439823,8439975,chr21,RNA5-8SN1,chr21:8439823-8439975,152
47930153,47932622,chr13,LINC00562,chr13:47930153-47932622,2469
8205315,8205406,chr21,MIR6724-1,chr21:8205315-8205406,91
9646825,9647000,chr21,U1,chr21:9646825-9647000,175
8208473,8208652,chr21,MIR3648-1,chr21:8208473-8208652,179
8212572,8212724,chr21,RNA5-8SN2,chr21:8212572-8212724,152
13644775,13644850,chr21,MIR3118-1,chr21:13644775-13644850,75
13724189,13724274,chr21,MIR8069-2,chr21:13724189-13724274,85
13621577,13621683,chr21,RNU6-286P,chr21:13621577-13621683,106
9902344,9902627,chr21,RN7SL52P,chr21:9902344-9902627,283
17431547,17431647,chr21,RNU6-113P,chr21:17431547-17431647,100
26977543,26977789,chr13,RPS21P8,chr13:26977543-26977789,246
20356653,20356896,chr21,RN7SKP147,chr21:20356653-20356896,243
15614283,15614389,chr21,RNU6-1326P,chr21:15614283-15614389,106
20355748,20355852,chr21,RNU6-772P,chr21:20355748-20355852,104
16718998,16719157,chr21,RNU1-98P,chr21:16718998-16719157,159
23281736,23281909,chr21,RNU2-55P,chr21:23281736-23281909,173
16035413,16035509,chr21,RNU6-426P,chr21:16035413-16035509,96
16284696,16284768,chr21,SNORD74B,chr21:16284696-16284768,72
16539089,16539169,chr21,MIR99A,chr21:16539089-16539169,80
30539597,30543461,chr13,RBM22P2,chr13:30539597-30543461,3864
19345148,19345312,chr21,RNU1-139P,chr21:19345148-19345312,164
22205192,22205332,chr21,RNU4-45P,chr21:22205192-22205332,140
16539828,16539911,chr21,MIRLET7C,chr21:16539828-16539911,83
16590237,16590325,chr21,MIR125B2,chr21:16590237-16590325,88
13406384,13406460,chr21,MIR3156-3,chr21:13406384-13406460,76
27945260,27945415,chr13,ATP5F1EP2,chr13:27945260-27945415,155
25101132,25101415,chr21,RN7SKP236,chr21:25101132-25101415,283
17506453,17506728,chr21,RN7SL163P,chr21:17506453-17506728,275
25573980,25574044,chr21,MIR155,chr21:25573980-25574044,64
23079284,23079392,chr21,MIR6130,chr21:23079284-23079392,108
25202207,25202315,chr21,RNA5SP489,chr21:25202207-25202315,108
26953961,26954043,chr21,MIR4759,chr21:26953961-26954043,82
18686090,18686164,chr21,MIR548X,chr21:18686090-18686164,74
27960918,27969315,chr13,CDX2,chr13:27960918-27969315,8397
13047583,13047689,chr21,RNU6-614P,chr21:13047583-13047689,106
25943044,25943145,chr21,RNU6-123P,chr21:25943044-25943145,101
26190707,26190813,chr21,RNU6-926P,chr21:26190707-26190813,106
29180425,29180639,chr21,U3,chr21:29180425-29180639,214
30375294,30375378,chr21,MIR4327,chr21:30375294-30375378,84
28743208,28743291,chr21,U6,chr21:28743208-28743291,83
37570248,37582616,chr22,LGALS2,chr22:37570248-37582616,12368
37215605,37215903,chr21,RN7SL678P,chr21:37215605-37215903,298
33918995,33919338,chr21,RN7SL740P,chr21:33918995-33919338,343
46525618,46525722,chr21,RNU6-396P,chr21:46525618-46525722,104
38894785,38894867,chr21,SNORA62,chr21:38894785-38894867,82
33550662,33550728,chr21,MIR6501,chr21:33550662-33550728,66
32377187,32377322,chr21,SNORA80A,chr21:32377187-32377322,135
32393130,32393960,chr21,URB1-AS1,chr21:32393130-32393960,830
28138506,28295335,chr13,PAN3,chr13:28138506-28295335,156829
41885112,41954018,chr21,C2CD2,chr21:41885112-41954018,68906
39120167,39152680,chr22,CBX7,chr22:39120167-39152680,32513
43923792,43964488,chr22,PNPLA3,chr22:43923792-43964488,40696
53685139,53850882,chr14,LINC02331,chr14:53685139-53850882,165743
35302566,35412031,chr20,UQCC1,chr20:35302566-35412031,109465
41986831,42010387,chr21,ZBTB21,chr21:41986831-42010387,23556
53153354,53157528,chr14,DDHD1-DT,chr14:53153354-53157528,4174
52730166,52774989,chr14,STYX,chr14:52730166-52774989,44823
23608452,23632321,chr22,DRICH1,chr22:23608452-23632321,23869
40172505,40195361,chr13,LINC00332,chr13:40172505-40195361,22856
42102134,42108534,chr21,UMODL1-AS1,chr21:42102134-42108534,6400
43528744,43812337,chr22,EFCAB6,chr22:43528744-43812337,283593
42009194,42055130,chr21,ZNF295-AS1,chr21:42009194-42055130,45936
49308650,49444064,chr13,CAB39L,chr13:49308650-49444064,135414
34723807,34737204,chr21,LINC00160,chr21:34723807-34737204,13397
49599994,49600572,chr14,RHOQP1,chr14:49599994-49600572,578
34745757,34784886,chr21,LINC01426,chr21:34745757-34784886,39129
53991101,53991995,chr14,ATP5F1CP1,chr14:53991101-53991995,894
35472095,35472432,chr21,RPL34P3,chr21:35472095-35472432,337
59460363,59484408,chr14,L3HYPDH,chr14:59460363-59484408,24045
35599732,35600022,chr21,EZH2P1,chr21:35599732-35600022,290
35720715,35720808,chr21,MIR802,chr21:35720715-35720808,93
35724747,35725100,chr21,RPS20P1,chr21:35724747-35725100,353
35887195,35887807,chr21,PPP1R2P2,chr21:35887195-35887807,612
36016079,36016546,chr21,RPL23AP3,chr21:36016079-36016546,467
36050214,36051377,chr21,RIMKLBP1,chr21:36050214-36051377,1163
36060432,36064408,chr21,SETD4-AS1,chr21:36060432-36064408,3976
72204657,72239027,chrX,ERCC6L,chrX:72204657-72239027,34370
24685772,24686351,chr18,RAC1P1,chr18:24685772-24686351,579
36066545,36066652,chr21,RNU6-992P,chr21:36066545-36066652,107
70430231,70431125,chr18,RPS2P6,chr18:70430231-70431125,894
36069941,36073166,chr21,CBR1,chr21:36069941-36073166,3225
70857163,70857502,chrX,WASHC3P1,chrX:70857163-70857502,339
75409476,75427703,chr18,SMIM21,chr18:75409476-75427703,18227
65528830,65529574,chr14,EIF1AXP2,chr14:65528830-65529574,744
51490011,51496592,chrX,NUDT11,chrX:51490011-51496592,6581
52111122,52129625,chr14,LINC02319,chr14:52111122-52129625,18503
60396469,60515543,chr14,C14orf39,chr14:60396469-60515543,119074
54932961,54998534,chrX,PFKFB1,chrX:54932961-54998534,65573
41465783,41632185,chr18,KC6,chr18:41465783-41632185,166402
36130489,36131376,chr21,MEMO1P1,chr21:36130489-36131376,887
36132450,36133032,chr21,RPS9P1,chr21:36132450-36133032,582
36135079,36146562,chr21,CBR3,chr21:36135079-36146562,11483
36168970,36170180,chr21,RPL3P1,chr21:36168970-36170180,1210
34787801,36004667,chr21,RUNX1,chr21:34787801-36004667,1216866
35972625,35979286,chr18,C18orf21,chr18:35972625-35979286,6661
60212462,60212912,chr14,RPL17P2,chr14:60212462-60212912,450
66111557,66131716,chr14,LINC02290,chr14:66111557-66131716,20159
26454910,26657401,chr18,KCTD1,chr18:26454910-26657401,202491
46762617,47175699,chr22,TBC1D22A,chr22:46762617-47175699,413082
60509146,60512850,chr14,SIX6,chr14:60509146-60512850,3704
70962964,70963293,chrX,RPS23P8,chrX:70962964-70963293,329
35919734,36385317,chrX,CFAP47,chrX:35919734-36385317,465583
32412006,32515397,chr21,EVA1C,chr21:32412006-32515397,103391
60709539,60724351,chr14,SIX4,chr14:60709539-60724351,14812
40863599,40863902,chr13,CYCSP34,chr13:40863599-40863902,303
61294909,61322838,chr14,PRKCH-AS1,chr14:61294909-61322838,27929
40992779,40993331,chr13,RGS17P1,chr13:40992779-40993331,552
42181465,42181921,chr13,CHCHD2P11,chr13:42181465-42181921,456
58646631,59184247,chr14,LINC01500,chr14:58646631-59184247,537616
37934298,38066444,chr13,LINC02334,chr13:37934298-38066444,132146
36108531,36129385,chr18,SLC39A6,chr18:36108531-36129385,20854
45552863,45553136,chr13,TIMM9P3,chr13:45552863-45553136,273
49503874,49568137,chr20,PTGIS,chr20:49503874-49568137,64263
34435450,34640803,chr13,LINC00457,chr13:34435450-34640803,205353
62779250,62780326,chrX,SSBL2P,chrX:62779250-62780326,1076
49044079,49046794,chr13,RAD17P2,chr13:49044079-49046794,2715
72781865,72782660,chrX,FAM236B,chrX:72781865-72782660,795
44146470,44158222,chr13,SMIM2-IT1,chr13:44146470-44158222,11752
43948776,43973395,chrX,NDP,chrX:43948776-43973395,24619
30296147,30296735,chr13,PRDX2P1,chr13:30296147-30296735,588
40789412,40812460,chr13,SLC25A15,chr13:40789412-40812460,23048
32496812,32497311,chr21,EXOSC3P1,chr21:32496812-32497311,499
32563075,32563210,chr21,RNA5SP490,chr21:32563075-32563210,135
21855987,21858740,chrX,YY2,chrX:21855987-21858740,2753
65794345,65795835,chrX,ETF1P3,chrX:65794345-65795835,1490
64612632,64613262,chrX,YWHAZP7,chrX:64612632-64613262,630
35841759,35842617,chr18,NRBF2P1,chr18:35841759-35842617,858
32592079,32612603,chr21,CFAP298,chr21:32592079-32612603,20524
1927727,1929094,chr18,AIDAP3,chr18:1927727-1929094,1367
37836757,37847571,chrX,DYNLT3,chrX:37836757-37847571,10814
23709825,23710287,chr18,RPL23AP77,chr18:23709825-23710287,462
5289019,5297053,chr18,ZBTB14,chr18:5289019-5297053,8034
60493766,60496885,chr14,SALL4P7,chr14:60493766-60496885,3119
8077251,8968360,chr20,PLCB1,chr20:8077251-8968360,891109
30153744,30160592,chr13,LINC00385,chr13:30153744-30160592,6848
50190777,50201007,chrX,AKAP4,chrX:50190777-50201007,10230
60245752,60299087,chr14,PPM1A,chr14:60245752-60299087,53335
24750657,24752171,chr13,ANKRD20A10P,chr13:24750657-24752171,1514
18672827,18676163,chr13,LINC00387,chr13:18672827-18676163,3336
64072158,64072653,chr18,RPL12P39,chr18:64072158-64072653,495
43023203,43114213,chr13,DNAJC15,chr13:43023203-43114213,91010
76686058,76693636,chr18,LINC01879,chr18:76686058-76693636,7578
26204869,26205904,chr18,NPM1P2,chr18:26204869-26205904,1035
77249848,77277900,chr18,GALR1,chr18:77249848-77277900,28052
43766610,43882450,chrX,MAOB,chrX:43766610-43882450,115840
39841174,39924840,chr18,LINC01901,chr18:39841174-39924840,83666
27236282,27250711,chr13,LINC00412,chr13:27236282-27250711,14429
32621084,32622083,chr21,OR7E23P,chr21:32621084-32622083,999
33158587,33164409,chr13,STARD13-IT1,chr13:33158587-33164409,5822
64388031,64463457,chr14,MTHFD1,chr14:64388031-64463457,75426
32402511,32612865,chr21,CFAP298-TCP10L,chr21:32402511-32612865,210354
26755200,26760786,chr13,GPR12,chr13:26755200-26760786,5586
25061924,25352190,chr18,ZNF521,chr18:25061924-25352190,290266
25193107,25210295,chr13,LINC01076,chr13:25193107-25210295,17188
29239379,29250554,chr13,MTUS2-AS2,chr13:29239379-29250554,11175
73274785,73275515,chrX,YWHAZP8,chrX:73274785-73275515,730
70163842,70165206,chrX,IGBP1-AS1,chrX:70163842-70165206,1364
64305047,64306733,chrX,KPNA4P1,chrX:64305047-64306733,1686
66021738,66040125,chrX,VSIG4,chrX:66021738-66040125,18387
45120510,45284893,chr13,GTF2F2,chr13:45120510-45284893,164383
32497967,32587373,chr21,TCP10L,chr21:32497967-32587373,89406
6926944,6928210,chr18,SCML2P1,chr18:6926944-6928210,1266
63949301,63981774,chr18,HMSD,chr18:63949301-63981774,32473
36847372,36870441,chr22,NCF4-AS1,chr22:36847372-36870441,23069
27452514,27453657,chr18,PA2G4P3,chr18:27452514-27453657,1143
68455951,68456877,chr18,AKR1B10P2,chr18:68455951-68456877,926
34347986,34616216,chr13,LINC02343,chr13:34347986-34616216,268230
24426634,24453531,chr18,IMPACT,chr18:24426634-24453531,26897
64915802,65034713,chrX,ZC4H2,chrX:64915802-65034713,118911
32149006,32159322,chr22,C22orf42,chr22:32149006-32159322,10316
34418715,34423951,chr21,SMIM34A,chr21:34418715-34423951,5236
17593653,17612945,chr21,BTG3,chr21:17593653-17612945,19292
28778558,28778937,chr13,POM121L13P,chr13:28778558-28778937,379
19560013,19561269,chr13,ESRRAP1,chr13:19560013-19561269,1256
53408882,53409876,chr13,ZNF646P1,chr13:53408882-53409876,994
44649129,44649719,chrX,RPL19P20,chrX:44649129-44649719,590
46912276,47061242,chrX,JADE3,chrX:46912276-47061242,148966
59262680,59263391,chr13,RPP40P2,chr13:59262680-59263391,711
37641832,37658377,chr22,PDXP-DT,chr22:37641832-37658377,16545
54115783,54142319,chr13,LINC00458,chr13:54115783-54142319,26536
49853844,49890080,chr22,ZBED4,chr22:49853844-49890080,36236
44805617,44818779,chr21,SUMO3,chr21:44805617-44818779,13162
44881162,45010005,chr22,PHF21B,chr22:44881162-45010005,128843
52820497,52821018,chr13,PPIAP26,chr13:52820497-52821018,521
34574204,34574666,chr13,GAMTP2,chr13:34574204-34574666,462
26557683,26688948,chr13,WASF3,chr13:26557683-26688948,131265
9646110,9648502,chr18,LINC02856,chr18:9646110-9648502,2392
68866517,68867028,chr18,SDHCP1,chr18:68866517-68867028,511
55623400,55626192,chrX,FOXR2,chrX:55623400-55626192,2792
25585656,25607517,chr21,MRPL39,chr21:25585656-25607517,21861
72536680,72638521,chr18,CBLN2,chr18:72536680-72638521,101841
46599251,46759118,chrX,SLC9A7,chrX:46599251-46759118,159867
59504539,59576812,chr14,CCDC175,chr14:59504539-59576812,72273
74590317,74598885,chr18,ZNF407-AS1,chr18:74590317-74598885,8568
60158976,60159324,chr14,SCOCP1,chr14:60158976-60159324,348
69775416,69797241,chr14,SLC10A1,chr14:69775416-69797241,21825
2071918,2242121,chr4,POLN,chr4:2071918-2242121,170203
56031830,56135295,chr18,LINC01905,chr18:56031830-56135295,103465
14485228,14658821,chr21,SAMSN1,chr21:14485228-14658821,173593
64044305,64045058,chrX,HNRNPDP1,chrX:64044305-64045058,753
65956289,65957196,chrX,RBMXP5,chrX:65956289-65957196,907
72688950,72712348,chrX,PHKA1-AS1,chrX:72688950-72712348,23398
55452127,55453566,chrX,MAGEH1,chrX:55452127-55453566,1439
46545438,46548841,chrX,ZNF674-AS1,chrX:46545438-46548841,3403
38567715,38622671,chr13,LINC00366,chr13:38567715-38622671,54956
74202834,74204595,chrX,RAB11FIP1P1,chrX:74202834-74204595,1761
74185929,74187153,chrX,BMP2KL,chrX:74185929-74187153,1224
43000174,43000396,chrX,SMIM15P1,chrX:43000174-43000396,222
70925579,70931125,chrX,SLC7A3,chrX:70925579-70931125,5546
60144119,60169856,chr14,DHRS7,chr14:60144119-60169856,25737
26576886,26577675,chr13,RPS3AP44,chr13:26576886-26577675,789
44651812,44701016,chr13,LINC00407,chr13:44651812-44701016,49204
19262797,19344973,chr13,ANKRD26P3,chr13:19262797-19344973,82176
30046276,30047193,chr22,CNN2P1,chr22:30046276-30047193,917
44651835,44652379,chr22,ANP32BP2,chr22:44651835-44652379,544
45284949,45295874,chr22,UPK3A,chr22:45284949-45295874,10925
50365409,50470825,chrX,DGKK,chrX:50365409-50470825,105416
76495521,76498088,chr18,ZNF516-DT,chr18:76495521-76498088,2567
499210,540200,chr4,PIGG,chr4:499210-540200,40990
39875289,39876108,chr22,UQCRFS1P1,chr22:39875289-39876108,819
47461299,47487111,chr22,LINC01644,chr22:47461299-47487111,25812
59267035,59274086,chr18,RAX,chr18:59267035-59274086,7051
39312882,39320389,chr22,RPL3,chr22:39312882-39320389,7507
44320800,44322257,chr18,KRT8P5,chr18:44320800-44322257,1457
46300181,46323875,chr21,C21orf58,chr21:46300181-46323875,23694
64079989,64149088,chr18,LINC00305,chr18:64079989-64149088,69099
69179557,69209924,chrX,LINC00269,chrX:69179557-69209924,30367
43949732,43971582,chrX,NDP-AS1,chrX:43949732-43971582,21850
63349646,63352178,chrX,SPIN4-AS1,chrX:63349646-63352178,2532
15384799,15493564,chrX,PIR,chrX:15384799-15493564,108765
76622136,76639030,chr18,LINC01927,chr18:76622136-76639030,16894
76209422,76221718,chr18,LINC01893,chr18:76209422-76221718,12296
70907405,71115382,chr14,PCNX1,chr14:70907405-71115382,207977
75696044,75712851,chr18,LINC01898,chr18:75696044-75712851,16807
56242937,56243409,chrX,RPL23AP83,chrX:56242937-56243409,472
55599663,55600106,chrX,PSMA5P1,chrX:55599663-55600106,443
65270913,65273019,chrX,CCT4P2,chrX:65270913-65273019,2106
66595637,66639298,chrX,EDA2R,chrX:66595637-66639298,43661
73324941,73349879,chr18,LINC02582,chr18:73324941-73349879,24938
56083356,56137536,chr18,LINC01539,chr18:56083356-56137536,54180
37562583,37598844,chr13,POSTN,chr13:37562583-37598844,36261
64726748,64727048,chrX,BLOC1S2P1,chrX:64726748-64727048,300
64405473,64406136,chrX,PFN5P,chrX:64405473-64406136,663
78271468,78327691,chrX,CYSLTR1,chrX:78271468-78327691,56223
34375480,34416961,chr21,SMIM11A,chr21:34375480-34416961,41481
40579372,40606848,chrX,ATP6AP2,chrX:40579372-40606848,27476
36699115,36749917,chr21,SIM2,chr21:36699115-36749917,50802
76978827,77133683,chr18,MBP,chr18:76978827-77133683,154856
55997357,56005519,chr20,CBLN4,chr20:55997357-56005519,8162
31274170,31274867,chr20,DKKL1P1,chr20:31274170-31274867,697
33055424,33073628,chr20,BPIFB3,chr20:33055424-33073628,18204
36803984,36806284,chr21,HLCS-IT1,chr21:36803984-36806284,2300
36851911,36852028,chr21,RNA5SP491,chr21:36851911-36852028,117
36943267,36944125,chr21,DPRXP5,chr21:36943267-36944125,858
46296870,46330810,chr22,GTSE1,chr22:46296870-46330810,33940
36994643,36995075,chr21,MRPL20P1,chr21:36994643-36995075,432
37006150,37019662,chr21,RIPPLY3,chr21:37006150-37019662,13512
37045530,37045636,chr21,RNU6-696P,chr21:37045530-37045636,106
43659560,43696079,chr21,RRP1B,chr21:43659560-43696079,36519
25955795,25969288,chr20,LINC01733,chr20:25955795-25969288,13493
31485778,31487574,chr20,LINC00028,chr20:31485778-31487574,1796
51596514,51768390,chr20,ATP9A,chr20:51596514-51768390,171876
3889356,3890249,chr4,OR7E163P,chr4:3889356-3890249,893
13647697,13648400,chr4,RPL32P12,chr4:13647697-13648400,703
23723262,23733579,chr4,ERVH-1,chr4:23723262-23733579,10317
652850,656213,chr4,PDE6B-AS1,chr4:652850-656213,3363
31436977,31496108,chr22,EIF4ENIF1,chr22:31436977-31496108,59131
3967034,3967660,chr4,ENPP7P9,chr4:3967034-3967660,626
43719094,43762307,chr21,PDXK,chr21:43719094-43762307,43213
14470465,14888169,chr4,LINC00504,chr4:14470465-14888169,417704
63312835,63318935,chr14,GPHB5,chr14:63312835-63318935,6100
425435,474129,chr4,ABCA11P,chr4:425435-474129,48694
62604113,62605717,chr14,ATP5F1AP4,chr14:62604113-62605717,1604
7058895,7068064,chr4,GRPEL1,chr4:7058895-7068064,9169
70245491,70247801,chr14,ADAM21P1,chr14:70245491-70247801,2310
60639216,60642589,chr14,SALRNA1,chr14:60639216-60642589,3373
34441592,34442025,chr20,ITCH-AS1,chr20:34441592-34442025,433
60734742,60969965,chr14,MNAT1,chr14:60734742-60969965,235223
33993646,34108308,chr20,RALY,chr20:33993646-34108308,114662
10254926,10256621,chr4,RAF1P1,chr4:10254926-10256621,1695
9771153,10054936,chr4,SLC2A9,chr4:9771153-10054936,283783
69569799,69574871,chr14,CCDC177,chr14:69569799-69574871,5072
61556273,61570653,chr14,LINC01303,chr14:61556273-61570653,14380
44897275,44907257,chr14,C14orf28,chr14:44897275-44907257,9982
1056250,1113564,chr4,RNF212,chr4:1056250-1113564,57314
49757627,49758980,chr22,RPL5P35,chr22:49757627-49758980,1353
45133020,45163781,chr22,NUP50-DT,chr22:45133020-45163781,30761
44483495,44483717,chr22,MRPS18CP6,chr22:44483495-44483717,222
22673152,22673602,chr22,IGLV3-26,chr22:22673152-22673602,450
41174591,41197456,chr22,EP300-AS1,chr22:41174591-41197456,22865
72926377,72959703,chr14,DCAF4,chr14:72926377-72959703,33326
34017422,34218796,chr22,LINC01643,chr22:34017422-34218796,201374
43772511,43776330,chr21,CSTB,chr21:43772511-43776330,3819
20052514,20360703,chr20,CFAP61,chr20:20052514-20360703,308189
43783123,43783573,chr21,TMEM97P1,chr21:43783123-43783573,450
43789513,43805293,chr21,RRP1,chr21:43789513-43805293,15780
13526319,13534335,chr4,LINC01097,chr4:13526319-13534335,8016
573880,576295,chr4,TMEM271,chr4:573880-576295,2415
24771467,24772420,chr4,HNRNPA1P65,chr4:24771467-24772420,953
5711201,5814305,chr4,EVC,chr4:5711201-5814305,103104
37010859,37020183,chr22,TST,chr22:37010859-37020183,9324
46761894,46762563,chr22,TBC1D22A-DT,chr22:46761894-46762563,669
76357682,76495242,chr18,ZNF516,chr18:76357682-76495242,137560
44606939,44625419,chr22,LINC00229,chr22:44606939-44625419,18480
74421493,74533917,chrX,SLC16A2,chrX:74421493-74533917,112424
37658723,37666932,chr22,PDXP,chr22:37658723-37666932,8209
46887417,46899703,chrX,LINC01545,chrX:46887417-46899703,12286
44702233,44862706,chr22,PRR5-ARHGAP8,chr22:44702233-44862706,160473
75326772,75327999,chrX,TERF1P7,chrX:75326772-75327999,1227
76334841,76335845,chrX,LDHBP2,chrX:76334841-76335845,1004
55961208,55962482,chrX,GOT2P6,chrX:55961208-55962482,1274
62842542,62843502,chrX,MTND1P31,chrX:62842542-62843502,960
57392646,57395409,chrX,MTHFD1P1,chrX:57392646-57395409,2763
74304180,74305034,chrX,ZCCHC13,chrX:74304180-74305034,854
72618267,72619222,chr18,HNRNPA1P11,chr18:72618267-72619222,955
73223124,73223558,chrX,TOMM20P4,chrX:73223124-73223558,434
54445454,54496234,chrX,FGD1,chrX:54445454-54496234,50780
26906481,27185308,chr18,CHST9,chr18:26906481-27185308,278827
43805758,43812567,chr21,AATBC,chr21:43805758-43812567,6809
43855890,43856342,chr21,MYL6P1,chr21:43855890-43856342,452
24517441,24584554,chr4,DHX15,chr4:24517441-24584554,67113
43865223,43987592,chr21,AGPAT3,chr21:43865223-43987592,122369
9678248,9679493,chr18,KRT18P8,chr18:9678248-9679493,1245
35241030,35267133,chr18,ZNF397,chr18:35241030-35267133,26103
64623117,64624573,chrX,KRT8P27,chrX:64623117-64624573,1456
54807599,54816015,chrX,MAGED2,chrX:54807599-54816015,8416
59484443,59505410,chr14,JKAMP,chr14:59484443-59505410,20967
17427696,17428274,chr4,RPS7P6,chr4:17427696-17428274,578
5748084,5893086,chr4,CRMP1,chr4:5748084-5893086,145002
21981121,22051159,chr18,LINC01900,chr18:21981121-22051159,70038
49982980,49988886,chr20,SNAI1,chr20:49982980-49988886,5906
24445391,24446314,chr20,GAPDHP53,chr20:24445391-24446314,923
50040716,50041504,chr20,TRERNA1,chr20:50040716-50041504,788
6919496,6929966,chr18,LINC00668,chr18:6919496-6929966,10470
52890162,52890386,chr20,RPL36P1,chr20:52890162-52890386,224
33358839,33401561,chr20,CDK5RAP1,chr20:33358839-33401561,42722
39120293,39120566,chr22,COX5BP7,chr22:39120293-39120566,273
24522273,24522919,chr18,EIF4A3P1,chr18:24522273-24522919,646
45920366,45977162,chr22,WNT7B,chr22:45920366-45977162,56796
23197144,23437961,chr18,TMEM241,chr18:23197144-23437961,240817
43919795,43919901,chr21,RNU6-859P,chr21:43919795-43919901,106
43996322,43996420,chr21,RNU6-1150P,chr21:43996322-43996420,98
44012309,44106552,chr21,TRAPPC10,chr21:44012309-44106552,94243
56232356,56291531,chrX,KLF8,chrX:56232356-56291531,59175
43955442,44010531,chr22,SAMM50,chr22:43955442-44010531,55089
60919240,60920155,chr14,SRMP2,chr14:60919240-60920155,915
85849410,85850139,chrX,SFR1P2,chrX:85849410-85850139,729
80529037,80530027,chrX,HNRNPH3P1,chrX:80529037-80530027,990
70290104,70420886,chrX,KIF4A,chrX:70290104-70420886,130782
63204114,63293508,chr14,RHOJ,chr14:63204114-63293508,89394
55027230,55049489,chr14,SOCS4,chr14:55027230-55049489,22259
2247432,2262109,chr4,MXD4,chr4:2247432-2262109,14677
62699464,63102037,chr14,KCNH5,chr14:62699464-63102037,402573
44046347,44047041,chr21,H2AZP1,chr21:44046347-44047041,694
44107373,44131181,chr21,PWP2,chr21:44107373-44131181,23808
22727375,22727950,chr4,CDC42P6,chr4:22727375-22727950,575
53286,88208,chr4,ZNF595,chr4:53286-88208,34922
46267961,46294008,chr22,TTC38,chr22:46267961-46294008,26047
74396871,74399550,chrX,THAP12P1,chrX:74396871-74399550,2679
80709928,80710705,chrX,PSMA1P1,chrX:80709928-80710705,777
75537547,75538702,chrX,PCNPP4,chrX:75537547-75538702,1155
52369021,52375680,chrX,XAGE2,chrX:52369021-52375680,6659
70452958,70455994,chrX,DLG3-AS1,chrX:70452958-70455994,3036
86128893,86129570,chrX,TPMTP4,chrX:86128893-86129570,677
75884546,75885136,chrX,SAR1AP4,chrX:75884546-75885136,590
44158740,44160076,chr21,LINC01678,chr21:44158740-44160076,1336
77447389,77457278,chrX,FGF16,chrX:77447389-77457278,9889
60971441,60981170,chr14,TRMT5,chr14:60971441-60981170,9729
8592660,8619759,chr4,CPZ,chr4:8592660-8619759,27099
79084936,79085848,chrX,P2RY10BP,chrX:79084936-79085848,912
76222637,76223097,chrX,MMADHCP1,chrX:76222637-76223097,460
88747225,88754785,chrX,CPXCR1,chrX:88747225-88754785,7560
44373665,44397714,chr13,SERP2,chr13:44373665-44397714,24049
37365573,37526358,chr21,DYRK1A,chr21:37365573-37526358,160785
78519593,78520186,chrX,HMGN1P34,chrX:78519593-78520186,593
72969451,73027131,chr14,ZFYVE1,chr14:72969451-73027131,57680
77970637,77993731,chr18,LINC01029,chr18:77970637-77993731,23094
53815419,53939960,chr13,LINC00558,chr13:53815419-53939960,124541
44966479,45080021,chr20,STK4,chr20:44966479-45080021,113542
72329516,72573101,chrX,HDAC8,chrX:72329516-72573101,243585
43400331,43409681,chr22,LINC01639,chr22:43400331-43409681,9350
66068750,66069647,chr18,PRPF19P1,chr18:66068750-66069647,897
47307082,47307301,chr13,GNG5P5,chr13:47307082-47307301,219
36129444,36180557,chr18,ELP2,chr18:36129444-36180557,51113
40769630,40819399,chr22,SLC25A17,chr22:40769630-40819399,49769
48975912,49209779,chr13,FNDC3A,chr13:48975912-49209779,233867
9512905,9513874,chr4,OR7E83P,chr4:9512905-9513874,969
2418974,2462942,chr4,CFAP99,chr4:2418974-2462942,43968
24659856,24671568,chr4,LINC02473,chr4:24659856-24671568,11712
5051480,5500994,chr4,STK32B,chr4:5051480-5500994,449514
52192159,52670578,chr20,LINC01524,chr20:52192159-52670578,478419
13654374,14003756,chr4,LINC01182,chr4:13654374-14003756,349382
21354563,21358067,chr22,LINC01651,chr22:21354563-21358067,3504
32121977,32133469,chr22,AP1B1P1,chr22:32121977-32133469,11492
11371975,11372892,chr4,RNPS1P1,chr4:11371975-11372892,917
4859665,4863936,chr4,MSX1,chr4:4859665-4863936,4271
37697048,37776556,chr22,TRIOBP,chr22:37697048-37776556,79508
3576869,3590711,chr4,LINC00955,chr4:3576869-3590711,13842
14505865,14506480,chr4,MTND2P31,chr4:14505865-14506480,615
69611596,69715144,chr14,SUSD6,chr14:69611596-69715144,103548
3901566,3902594,chr4,OR7E162P,chr4:3901566-3902594,1028
4844188,4850827,chr4,LINC01396,chr4:4844188-4850827,6639
17460261,17512206,chr4,QDPR,chr4:17460261-17512206,51945
63123007,63123201,chr14,PARP1P2,chr14:63123007-63123201,194
59135488,59136421,chr14,AKR1B1P5,chr14:59135488-59136421,933
57358447,57359498,chr20,MTRNR2L3,chr20:57358447-57359498,1051
64465499,64474503,chr14,AKAP5,chr14:64465499-64474503,9004
62952707,62969585,chr20,SLC17A9,chr20:62952707-62969585,16878
71085482,71085833,chr14,PTTG4P,chr14:71085482-71085833,351
74482985,74483435,chr14,RAP1AP,chr14:74482985-74483435,450
60397757,60398281,chr14,RBM8B,chr14:60397757-60398281,524
59969116,60091783,chr14,PCNX4-DT,chr14:59969116-60091783,122667
69885340,69886140,chr14,RPL7AP6,chr14:69885340-69886140,800
43274824,43275697,chr14,TUBBP3,chr14:43274824-43275697,873
15004942,15427914,chr4,C1QTNF7-AS1,chr4:15004942-15427914,422972
986997,1004564,chr4,IDUA,chr4:986997-1004564,17567
65879592,65881070,chr14,NCOA4P1,chr14:65879592-65881070,1478
71292729,71321882,chr14,SIPA1L1-AS1,chr14:71292729-71321882,29153
65266638,65267690,chr14,RPL21P7,chr14:65266638-65267690,1052
73057925,73059415,chr14,RBM25-AS1,chr14:73057925-73059415,1490
65411170,65412690,chr14,FUT8-AS1,chr14:65411170-65412690,1520
34485979,34486447,chr14,RPL23AP71,chr14:34485979-34486447,468
25248085,25298012,chr20,PYGB,chr20:25248085-25298012,49927
41798225,41879482,chr21,PRDM15,chr21:41798225-41879482,81257
33924227,34462774,chr14,EGLN3,chr14:33924227-34462774,538547
42255873,42256575,chr13,FHP1,chr13:42255873-42256575,702
16256308,16256555,chr4,RPS21P4,chr4:16256308-16256555,247
672436,674330,chr4,ATP5ME,chr4:672436-674330,1894
36168794,36297842,chr13,CCDC169-SOHLH2,chr13:36168794-36297842,129048
26241331,26254092,chr22,SEZ6L-AS1,chr22:26241331-26254092,12761
31292499,31338021,chr22,PIK3IP1-DT,chr22:31292499-31338021,45522
19172335,19456994,chr4,LINC02438,chr4:19172335-19456994,284659
47612231,47631569,chr22,LINC00898,chr22:47612231-47631569,19338
59936663,59940305,chr20,PPP1R3D,chr20:59936663-59940305,3642
5014586,5019458,chr4,CYTL1,chr4:5014586-5019458,4872
54208087,54228052,chr20,PFDN4,chr20:54208087-54228052,19965
43166622,43187134,chr22,TTLL12,chr22:43166622-43187134,20512
673580,682033,chr4,MYL5,chr4:673580-682033,8453
25647304,26143305,chr14,LINC02306,chr14:25647304-26143305,496001
34432788,34462240,chr14,SPTSSA,chr14:34432788-34462240,29452
31303212,31308585,chr20,DEFB116,chr20:31303212-31308585,5373
62136733,62143440,chr20,PSMA7,chr20:62136733-62143440,6707
75278826,75282230,chr14,FOS,chr14:75278826-75282230,3404
38821798,38827570,chr13,FREM2-AS1,chr13:38821798-38827570,5772
32954057,32954401,chr13,TOMM22P3,chr13:32954057-32954401,344
28214513,28215897,chr13,EEF1A1P3,chr13:28214513-28215897,1384
40882577,40921774,chr13,SUGT1P3,chr13:40882577-40921774,39197
8436140,8493531,chr4,TRMT44,chr4:8436140-8493531,57391
31377164,31390590,chr20,DEFB119,chr20:31377164-31390590,13426
44668547,44737681,chr22,PRR5,chr22:44668547-44737681,69134
51333068,51365557,chr14,LINC00640,chr14:51333068-51365557,32489
59958423,60034011,chr20,CDH26,chr20:59958423-60034011,75588
39209116,39603528,chr13,LHFPL6,chr13:39209116-39603528,394412
73242651,73245979,chr14,PAPLN-AS1,chr14:73242651-73245979,3328
71044375,71044640,chr14,GTF3AP2,chr14:71044375-71044640,265
43300263,43300595,chr14,HNRNPUP1,chr14:43300263-43300595,332
81777016,81777613,chr14,RPL9P6,chr14:81777016-81777613,597
69484692,69531551,chr14,PLEKHD1,chr14:69484692-69531551,46859
31063306,31115699,chr13,WDR95P,chr13:31063306-31115699,52393
6909242,7033118,chr4,TBC1D14,chr4:6909242-7033118,123876
59071462,59071803,chr13,POLR3KP1,chr13:59071462-59071803,341
66012830,66013789,chr14,YBX1P1,chr14:66012830-66013789,959
62323657,62328833,chr13,LINC00459,chr13:62323657-62328833,5176
74498183,74612378,chr14,LTBP2,chr14:74498183-74612378,114195
57314739,57315909,chr13,SLC25A5P4,chr13:57314739-57315909,1170
60618991,61176758,chr13,LINC00378,chr13:60618991-61176758,557767
52511252,52511568,chr20,MRPS33P4,chr20:52511252-52511568,316
34546854,34560345,chr20,MAP1LC3A,chr20:34546854-34560345,13491
76834429,76834888,chr18,RPL26P35,chr18:76834429-76834888,459
69831158,69961803,chr18,CD226,chr18:69831158-69961803,130645
24252749,24254439,chr13,SPATA13-AS1,chr13:24252749-24254439,1690
27162855,27169135,chr13,USP12-AS1,chr13:27162855-27169135,6280
75156388,75304885,chrX,UPRT,chrX:75156388-75304885,148497
8097824,8099774,chr20,PHKBP1,chr20:8097824-8099774,1950
30403123,30403384,chr20,MLLT10P1,chr20:30403123-30403384,261
38617419,38617940,chr13,PRDX3P3,chr13:38617419-38617940,521
57173453,57173632,chr13,PRR20FP,chr13:57173453-57173632,179
25195693,25228075,chr20,ENTPD6,chr20:25195693-25228075,32382
67266845,67267706,chr13,RPSAP53,chr13:67266845-67267706,861
58751047,58752233,chr13,DNAJA1P1,chr13:58751047-58752233,1186
53099397,53151914,chr13,LINC01065,chr13:53099397-53151914,52517
32018825,32073219,chr18,RNF125,chr18:32018825-32073219,54394
9583942,9584131,chr4,SNRPCP13,chr4:9583942-9584131,189
94319038,94320025,chrX,TUBB4BP8,chrX:94319038-94320025,987
60012734,60044357,chr13,DIAPH3-AS1,chr13:60012734-60044357,31623
9781634,9784009,chr4,DRD5,chr4:9781634-9784009,2375
84755136,84756003,chrX,SETP4,chrX:84755136-84756003,867
76703444,76704254,chr18,ARL2BPP1,chr18:76703444-76704254,810
68289679,68291280,chr13,ELL2P3,chr13:68289679-68291280,1601
10006482,10009725,chr4,SLC2A9-AS1,chr4:10006482-10009725,3243
51095836,51224432,chrX,LINC01284,chrX:51095836-51224432,128596
65787932,65788764,chr13,HNRNPA3P5,chr13:65787932-65788764,832
42950928,42951014,chr21,MIR5692B,chr21:42950928-42951014,86
67790407,67790794,chr13,BCRP9,chr13:67790407-67790794,387
42974510,43033931,chr21,PKNOX1,chr21:42974510-43033931,59421
6026199,6200591,chr4,JAKMIP1,chr4:6026199-6200591,174392
49876724,49879241,chrX,USP27X-DT,chrX:49876724-49879241,2517
42272152,42323261,chr13,AKAP11,chr13:42272152-42323261,51109
62843697,62844306,chrX,MTND2P25,chrX:62843697-62844306,609
31753867,31908033,chr22,DEPDC5,chr22:31753867-31908033,154166
84317874,84502479,chrX,HDX,chrX:84317874-84502479,184605
61905255,62187118,chr18,PIGN,chr18:61905255-62187118,281863
44143150,44161257,chr13,SMIM2,chr13:44143150-44161257,18107
100149783,100151340,chrX,CTDSPL2P1,chrX:100149783-100151340,1557
95499604,95500036,chrX,CALM1P1,chrX:95499604-95500036,432
72708367,72727629,chr13,MZT1,chr13:72708367-72727629,19262
79369364,79370165,chrX,CORO1CP1,chrX:79369364-79370165,801
82875649,82875885,chrX,EIF3MP1,chrX:82875649-82875885,236
78554412,78554751,chrX,UBE2V1P7,chrX:78554412-78554751,339
69485343,69485652,chrX,CYCSP43,chrX:69485343-69485652,309
51498490,51511005,chrX,LINC01496,chrX:51498490-51511005,12515
73126037,73128080,chrX,NAP1L6P,chrX:73126037-73128080,2043
74493756,74497106,chr14,ISCA2,chr14:74493756-74497106,3350
90289536,90289903,chrX,UBE2V1P9,chrX:90289536-90289903,367
91434595,91438584,chrX,PABPC5,chrX:91434595-91438584,3989
25168969,25190643,chr13,LINC01053,chr13:25168969-25190643,21674
43053191,43076943,chr21,CBS,chr21:43053191-43076943,23752
73077276,73079512,chrX,PABPC1L2A,chrX:73077276-73079512,2236
89367435,89367600,chrX,SRIP2,chrX:89367435-89367600,165
100969708,100990831,chrX,ARL13A,chrX:100969708-100990831,21123
62672285,62796714,chr13,LINC00448,chr13:62672285-62796714,124429
75427716,75474111,chr14,JDP2,chr14:75427716-75474111,46395
98389512,98390919,chrX,EEF1A1P15,chrX:98389512-98390919,1407
71675067,71675469,chr13,H3P36,chr13:71675067-71675469,402
80669503,80809877,chrX,BRWD3,chrX:80669503-80809877,140374
58211697,58233117,chr13,LINC00374,chr13:58211697-58233117,21420
61409685,61415522,chr13,PCDH20,chr13:61409685-61415522,5837
39009865,39038089,chr13,PROSER1,chr13:39009865-39038089,28224
88384924,88470350,chr14,SPATA7,chr14:88384924-88470350,85426
48539714,48562609,chrX,TBC1D25,chrX:48539714-48562609,22895
2793071,2841098,chr4,SH3BP2,chr4:2793071-2841098,48027
86798598,86799226,chrX,COPS8P1,chrX:86798598-86799226,628
87703343,87704203,chrX,RPSAP15,chrX:87703343-87704203,860
92113246,92114461,chrX,EIF4A1P10,chrX:92113246-92114461,1215
64432401,64434145,chrX,SHC1P1,chrX:64432401-64434145,1744
69616067,70039472,chrX,EDA,chrX:69616067-70039472,423405
68331338,68331613,chr13,RPL37P21,chr13:68331338-68331613,275
48583093,48583339,chrX,MRPL32P1,chrX:48583093-48583339,246
85861180,86047561,chrX,CHM,chrX:85861180-86047561,186381
49187479,49187670,chr13,COX7CP1,chr13:49187479-49187670,191
45534522,45615739,chr13,ERICH6B,chr13:45534522-45615739,81217
90039213,90039834,chrX,STAU2P1,chrX:90039213-90039834,621
72181353,72302926,chrX,PIN4,chrX:72181353-72302926,121573
37534940,37551536,chr13,LINC00547,chr13:37534940-37551536,16596
54440704,54441315,chr13,RPL13AP25,chr13:54440704-54441315,611
33016423,33066143,chr13,KL,chr13:33016423-33066143,49720
74473017,74473953,chrX,HNRNPA1P25,chrX:74473017-74473953,936
43115334,43115709,chr21,MRPL51P2,chr21:43115334-43115709,375
43140523,43141092,chr21,FRGCA,chr21:43140523-43141092,569
78699384,78699891,chrX,PPATP2,chrX:78699384-78699891,507
75740831,75746911,chrX,TTC3P1,chrX:75740831-75746911,6080
95610578,95610957,chrX,HNRNPDLP3,chrX:95610578-95610957,379
86481532,86481813,chrX,FCF1P9,chrX:86481532-86481813,281
43169008,43172805,chr21,CRYAA,chr21:43169008-43172805,3797
96195477,96195617,chrX,RPS29P28,chrX:96195477-96195617,140
76656866,77014532,chrX,MIR325HG,chrX:76656866-77014532,357666
63667681,63738018,chr13,LINC00395,chr13:63667681-63738018,70337
99656997,99657381,chrX,TEX101P1,chrX:99656997-99657381,384
86084716,86086339,chrX,STIP1P3,chrX:86084716-86086339,1623
43092956,43107570,chr21,U2AF1,chr21:43092956-43107570,14614
95973328,95974315,chrX,KAT7P1,chrX:95973328-95974315,987
84058346,84188199,chrX,RPS6KA6,chrX:84058346-84188199,129853
73407768,73408352,chr13,MARK2P12,chr13:73407768-73408352,584
24742677,24746184,chr13,IRX1P1,chr13:24742677-24746184,3507
40812309,40921749,chr13,TPTE2P5,chr13:40812309-40921749,109440
36070427,36165288,chr14,LINC00609,chr14:36070427-36165288,94861
76633714,76634028,chr14,CYCSP1,chr14:76633714-76634028,314
10074339,10116949,chr4,WDR1,chr4:10074339-10116949,42610
44962190,45074431,chr14,TOGARAM1,chr14:44962190-45074431,112241
52842889,52848641,chr13,PCDH8,chr13:52842889-52848641,5752
99886740,99887691,chrX,B3GNT2P1,chrX:99886740-99887691,951
23583645,23586510,chr20,CST9LP2,chr20:23583645-23586510,2865
85277396,85379717,chrX,POF1B,chrX:85277396-85379717,102321
62410237,62427539,chr20,RBBP8NL,chr20:62410237-62427539,17302
71845981,71846317,chr13,RPL35AP31,chr13:71845981-71846317,336
72782133,73016461,chr13,PIBF1,chr13:72782133-73016461,234328
11800463,11878429,chr20,LINC00687,chr20:11800463-11878429,77966
87517409,87670050,chrX,KLHL4,chrX:87517409-87670050,152641
23626706,23638473,chr20,CST3,chr20:23626706-23638473,11767
36034541,36079389,chr21,SETD4,chr21:36034541-36079389,44848
55074644,55075140,chr20,RPL12P4,chr20:55074644-55075140,496
58218495,58228653,chr20,ANKRD60,chr20:58218495-58228653,10158
91580696,91780707,chr14,CATSPERB,chr14:91580696-91780707,200011
55408898,55684915,chr20,LINC01440,chr20:55408898-55684915,276017
72727977,72728821,chrX,CAPZA1P3,chrX:72727977-72728821,844
80929500,80930347,chrX,VDAC1P1,chrX:80929500-80930347,847
98251679,98252543,chrX,RPL6P29,chrX:98251679-98252543,864
80560146,80562054,chrX,WBP11P3,chrX:80560146-80562054,1908
74173890,74174066,chrX,ATP5MKP1,chrX:74173890-74174066,176
100887636,100888590,chrX,HNRNPA1P27,chrX:100887636-100888590,954
3758748,3763390,chr4,LINC02600,chr4:3758748-3763390,4642
72301638,72307187,chrX,CITED1,chrX:72301638-72307187,5549
16501541,16898678,chr4,LDB2,chr4:16501541-16898678,397137
30377372,30399257,chr20,FRG1BP,chr20:30377372-30399257,21885
62938147,62948475,chr20,GID8,chr20:62938147-62948475,10328
23772785,23776169,chr20,CSTP2,chr20:23772785-23776169,3384
70148582,70149654,chrX,IGBP1-AS2,chrX:70148582-70149654,1072
57268924,57298742,chr14,AP5M1,chr14:57268924-57298742,29818
100843324,100874359,chrX,NOX1,chrX:100843324-100874359,31035
30323367,30362276,chr20,FAM242A,chr20:30323367-30362276,38909
33217310,33227806,chr20,BPIFA3,chr20:33217310-33227806,10496
73100575,73100985,chr13,FABP5P1,chr13:73100575-73100985,410
65467807,65468341,chr14,RPL21P8,chr14:65467807-65468341,534
77116568,77259495,chr14,TMEM63C,chr14:77116568-77259495,142927
72727749,72756198,chr13,BORA,chr13:72727749-72756198,28449
57648392,57711536,chr20,PMEPA1,chr20:57648392-57711536,63144
33403413,33479348,chr21,IFNGR2,chr21:33403413-33479348,75935
51332231,51337525,chrX,NUDT10,chrX:51332231-51337525,5294
93776911,93777384,chrX,USP37P1,chrX:93776911-93777384,473
74409518,74410100,chrX,RPS7P14,chrX:74409518-74410100,582
75888700,75888888,chrX,FOXN3P2,chrX:75888700-75888888,188
74376125,74376885,chrX,RPS6P26,chrX:74376125-74376885,760
76427710,76431342,chrX,MAGEE1,chrX:76427710-76431342,3632
73474563,73474830,chrX,MORF4L1P6,chrX:73474563-73474830,267
82998699,82999236,chrX,ATG4AP1,chrX:82998699-82999236,537
103356489,103358462,chrX,TCEAL9,chrX:103356489-103358462,1973
784957,826129,chr4,CPLX1,chr4:784957-826129,41172
75201491,75201790,chrX,BUD31P2,chrX:75201491-75201790,299
94636663,94639570,chrX,PAICSP7,chrX:94636663-94639570,2907
100155885,100156773,chrX,RPSAP8,chrX:100155885-100156773,888
76173040,76178314,chrX,PBDC1,chrX:76173040-76178314,5274
57563920,57982194,chr14,SLC35F4,chr14:57563920-57982194,418274
33485530,33491716,chr21,DNAJC28,chr21:33485530-33491716,6186
12639086,12641009,chr4,ECM1P2,chr4:12639086-12641009,1923
2658395,2664219,chr20,IDH3B,chr20:2658395-2664219,5824
45376191,45376382,chr21,MTCO1P3,chr21:45376191-45376382,191
45407386,45410065,chr21,COL18A1-AS2,chr21:45407386-45410065,2679
2462220,2625320,chr4,RNF4,chr4:2462220-2625320,163100
45419716,45425070,chr21,COL18A1-AS1,chr21:45419716-45425070,5354
87807549,87809883,chrX,MRPS22P1,chrX:87807549-87809883,2334
97431286,97642589,chrX,DIAPH2-AS1,chrX:97431286-97642589,211303
45478266,45478326,chr21,MIR6815,chr21:45478266-45478326,60
90209796,90210420,chrX,RNF19BPX,chrX:90209796-90210420,624
78656068,78659328,chrX,RTL3,chrX:78656068-78659328,3260
56310880,56427032,chr14,LINC02284,chr14:56310880-56427032,116152
45493572,45573365,chr21,SLC19A1,chr21:45493572-45573365,79793
83559896,83560312,chrX,POMPP1,chrX:83559896-83560312,416
75582676,75585506,chrX,BRAFP1,chrX:75582676-75585506,2830
103007461,103008072,chrX,NUDT19P2,chrX:103007461-103008072,611
86905778,86922755,chr14,LINC01148,chr14:86905778-86922755,16977
80335504,80445311,chrX,TENT5D,chrX:80335504-80445311,109807
53949736,53958761,chr14,BMP4,chr14:53949736-53958761,9025
91560436,91561597,chrX,SERBP1P4,chrX:91560436-91561597,1161
90112650,90113706,chrX,USP12PX,chrX:90112650-90113706,1056
81600072,81601306,chrX,PDK1P2,chrX:81600072-81601306,1234
80014753,80031774,chrX,TBX22,chrX:80014753-80031774,17021
37595847,38041442,chr14,TTC6,chr14:37595847-38041442,445595
89921908,89922883,chrX,TGIF2LX,chrX:89921908-89922883,975
45405165,45513720,chr21,COL18A1,chr21:45405165-45513720,108555
93287733,93288759,chrX,ST13P18,chrX:93287733-93288759,1026
68771322,68772578,chrX,ACTR3P2,chrX:68771322-68772578,1256
92459670,92460952,chrX,KRT18P11,chrX:92459670-92460952,1282
56729241,56819179,chrX,NBDY,chrX:56729241-56819179,89938
97975878,97978641,chrX,KPNB1P1,chrX:97975878-97978641,2763
93042490,93042942,chrX,DLGAP5P2,chrX:93042490-93042942,452
79323446,79325217,chrX,KIF4CP,chrX:79323446-79325217,1771
39791580,39791904,chrX,OOEPP1,chrX:39791580-39791904,324
98422138,98422809,chrX,HMGB1P32,chrX:98422138-98422809,671
59624904,59628295,chr20,PHACTR3-AS1,chr20:59624904-59628295,3391
81202102,81298547,chrX,SH3BGRL,chrX:81202102-81298547,96445
64958097,64959396,chr13,LGMNP1,chr13:64958097-64959396,1299
57328546,57328696,chr20,RPL39P39,chr20:57328546-57328696,150
63737511,63742804,chr13,OR7E156P,chr13:63737511-63742804,5293
73413473,73661891,chr13,LINC00393,chr13:73413473-73661891,248418
31311303,31311962,chr20,RPL31P3,chr20:31311303-31311962,659
107032248,107032820,chrX,EEF1A1P40,chrX:107032248-107032820,572
95584303,95584942,chrX,GTF3C6P1,chrX:95584303-95584942,639
58389229,58451101,chr20,VAPB,chr20:58389229-58451101,61872
76655498,76656559,chrX,TRAPPC13P1,chrX:76655498-76656559,1061
100956593,100957538,chrX,CSGALNACT2P1,chrX:100956593-100957538,945
80571871,80574607,chrX,HK2P1,chrX:80571871-80574607,2736
49028726,49043410,chrX,TFE3,chrX:49028726-49043410,14684
69700594,70108493,chr13,KLHL1,chr13:69700594-70108493,407899
3935447,3942519,chr4,ALG1L7P,chr4:3935447-3942519,7072
5897373,6200555,chr4,C4orf50,chr4:5897373-6200555,303182
87353070,87573022,chr14,LINC02296,chr14:87353070-87573022,219952
42098754,42099173,chrX,ATP5MC2P4,chrX:42098754-42099173,419
65900932,65901451,chr14,FTH1P13,chr14:65900932-65901451,519
57351223,57379211,chr20,RAE1,chr20:57351223-57379211,27988
101009346,101052116,chrX,TRMT2B,chrX:101009346-101052116,42770
65279267,65281166,chr14,PTBP1P,chr14:65279267-65281166,1899
24658072,24658375,chr4,ATP5MGP3,chr4:24658072-24658375,303
40786110,40786710,chr4,ARL4AP2,chr4:40786110-40786710,600
45135930,45200890,chr14,FANCM,chr14:45135930-45200890,64960
8846076,8871839,chr4,HMX1,chr4:8846076-8871839,25763
20392154,20394856,chr4,SLIT2-IT1,chr4:20392154-20394856,2702
21843341,21853188,chr4,KCNIP4-IT1,chr4:21843341-21853188,9847
13333414,13338657,chr4,HSP90AB2P,chr4:13333414-13338657,5243
14909961,15002045,chr4,CPEB2-DT,chr4:14909961-15002045,92084
22345071,22516066,chr4,ADGRA3,chr4:22345071-22516066,170995
100910712,100911489,chrX,NSA2P3,chrX:100910712-100911489,777
100855288,100856379,chrX,HNRNPA1P26,chrX:100855288-100856379,1091
96337236,96337912,chrX,BRDTP1,chrX:96337236-96337912,676
73237647,73238709,chrX,LRRFIP2P1,chrX:73237647-73238709,1062
86066227,86066468,chrX,NDUFA5P7,chrX:86066227-86066468,241
27424619,27435823,chr13,GTF3A,chr13:27424619-27435823,11204
107980864,107982370,chrX,TEX13B,chrX:107980864-107982370,1506
95638375,95638924,chrX,HNRNPDLP1,chrX:95638375-95638924,549
102006883,102007294,chrX,C3orf49P1,chrX:102006883-102007294,411
91982655,91983505,chrX,VDAC1P3,chrX:91982655-91983505,850
99719364,99721158,chrX,XRCC6P5,chrX:99719364-99721158,1794
56737242,56737577,chrX,UQCRBP1,chrX:56737242-56737577,335
100913445,100929433,chrX,XKRX,chrX:100913445-100929433,15988
119222564,119223245,chrX,NUDT19P6,chrX:119222564-119223245,681
75782987,75785254,chrX,MAGEE2,chrX:75782987-75785254,2267
83748825,83749939,chrX,TERF1P4,chrX:83748825-83749939,1114
47232866,47248328,chrX,USP11,chrX:47232866-47248328,15462
29214253,29291869,chr4,LINC02472,chr4:29214253-29291869,77616
9677308,9677934,chr4,ENPP7P11,chr4:9677308-9677934,626
8558725,8619761,chr4,GPR78,chr4:8558725-8619761,61036
73136418,73223691,chr14,PSEN1,chr14:73136418-73223691,87273
52972358,53495330,chr20,TSHZ2,chr20:52972358-53495330,522972
68783472,68785066,chrX,SERBP1P1,chrX:68783472-68785066,1594
94776739,94777567,chrX,CCNB1IP1P3,chrX:94776739-94777567,828
40834485,40836005,chrX,MKRN4P,chrX:40834485-40836005,1520
93388075,93389497,chrX,NT5DC1P1,chrX:93388075-93389497,1422
41304212,41357727,chr21,FAM3B,chr21:41304212-41357727,53515
30541643,30542897,chr13,MFAP1P1,chr13:30541643-30542897,1254
116436606,116461458,chrX,SLC6A14,chrX:116436606-116461458,24852
63038011,63053863,chr20,LINC01056,chr20:63038011-63053863,15852
38533343,38545299,chr13,LINC00437,chr13:38533343-38545299,11956
23514940,23515284,chr4,RFPL4AP3,chr4:23514940-23515284,344
52703264,52739820,chr13,CNMD,chr13:52703264-52739820,36556
31421436,31429180,chr20,DEFB122,chr20:31421436-31429180,7744
9468974,9469983,chr4,OR7E84P,chr4:9468974-9469983,1009
57329803,57343994,chr20,SPO11,chr20:57329803-57343994,14191
37685791,37732130,chrX,XK,chrX:37685791-37732130,46339
38772238,38782990,chr4,TLR10,chr4:38772238-38782990,10752
40735400,40738701,chrX,MED14OS,chrX:40735400-40738701,3301
106562774,106563404,chrX,SERPINA7P1,chrX:106562774-106563404,630
103206010,103206899,chrX,RPSAP59,chrX:103206010-103206899,889
87806433,87806769,chrX,RPL34P36,chrX:87806433-87806769,336
25645722,25646327,chrX,RANBP1P1,chrX:25645722-25646327,605
51406948,51408843,chrX,EZHIP,chrX:51406948-51408843,1895
57677067,57680260,chrX,NLRP2B,chrX:57677067-57680260,3193
93222220,93225015,chrX,AP2B1P1,chrX:93222220-93225015,2795
11117651,11665920,chrX,ARHGAP6,chrX:11117651-11665920,548269
9459255,9460244,chr4,OR7E86P,chr4:9459255-9460244,989
2234251,2234499,chr4,COX6B1P5,chr4:2234251-2234499,248
37453925,37623495,chr4,C4orf19,chr4:37453925-37623495,169570
26835755,26845409,chr21,ADAMTS1,chr21:26835755-26845409,9654
55853648,55905086,chr4,EXOC1,chr4:55853648-55905086,51438
31199975,31332276,chr13,B3GLCT,chr13:31199975-31332276,132301
51831797,51862912,chr20,LINC01429,chr20:51831797-51862912,31115
37903111,37945350,chr20,VSTM2L,chr20:37903111-37945350,42239
31404845,31412838,chr20,DEFB121,chr20:31404845-31412838,7993
29427400,29427883,chr20,RARRES2P11,chr20:29427400-29427883,483
58003904,58004648,chr20,LINC01742,chr20:58003904-58004648,744
34088309,34112243,chr20,EIF2S2,chr20:34088309-34112243,23934
62327988,62328384,chr13,RPL32P28,chr13:62327988-62328384,396
60916981,60945955,chr13,LINC01442,chr13:60916981-60945955,28974
32268228,32279049,chr21,MIS18A,chr21:32268228-32279049,10821
47763460,47764606,chr13,NAP1L4P3,chr13:47763460-47764606,1146
55999200,56000448,chr13,HNF4GP1,chr13:55999200-56000448,1248
57933837,57934803,chrX,MYCLP2,chrX:57933837-57934803,966
44283916,44286246,chrX,TATDN2P1,chrX:44283916-44286246,2330
32277863,32280988,chr21,MIS18A-AS1,chr21:32277863-32280988,3125
32306464,32308737,chr21,MRAP-AS1,chr21:32306464-32308737,2273
111624210,111624726,chrX,RPL18AP15,chrX:111624210-111624726,516
32291813,32314784,chr21,MRAP,chr21:32291813-32314784,22971
64047582,64049639,chr20,SOX18,chr20:64047582-64049639,2057
103075810,103093143,chrX,NXF3,chrX:103075810-103093143,17333
68654572,68655050,chr13,RPL12P34,chr13:68654572-68655050,478
66990886,67002007,chr13,PCDH9-AS4,chr13:66990886-67002007,11121
42777819,42779994,chr21,LINC01668,chr21:42777819-42779994,2175
25006230,25058980,chr20,ACSS1,chr20:25006230-25058980,52750
42843094,42879568,chr21,WDR4,chr21:42843094-42879568,36474
52219344,52334277,chr13,TPTE2P2,chr13:52219344-52334277,114933
26576437,26756223,chr4,TBC1D19,chr4:26576437-26756223,179786
36187497,36272157,chr18,MOCOS,chr18:36187497-36272157,84660
70177483,70205704,chrX,DGAT2L6,chrX:70177483-70205704,28221
71732615,71788128,chr18,LINC01899,chr18:71732615-71788128,55513
90366697,90367179,chr14,RPL21P11,chr14:90366697-90367179,482
108091668,108154671,chrX,ATG4A,chrX:108091668-108154671,63003
73490933,73493394,chr14,RIOX1,chr14:73490933-73493394,2461
73151241,73264480,chr18,LINC02864,chr18:73151241-73264480,113239
51771789,51772086,chr14,OR7E159P,chr14:51771789-51772086,297
44763153,44782829,chr14,LINC02302,chr14:44763153-44782829,19676
46996454,46997174,chr14,RPA2P1,chr14:46996454-46997174,720
59010332,59010604,chr13,HMGN2P39,chr13:59010332-59010604,272
81916231,81917888,chr14,EIF3LP1,chr14:81916231-81917888,1657
67326177,67379994,chr13,LINC00364,chr13:67326177-67379994,53817
44077534,44077884,chr14,EIF4BP1,chr14:44077534-44077884,350
38902387,38902650,chr13,PLA2G12AP2,chr13:38902387-38902650,263
54475593,54651169,chr20,DOK5,chr20:54475593-54651169,175576
49643555,49688422,chr14,POLE2,chr14:49643555-49688422,44867
72742314,72868146,chr18,NETO1,chr18:72742314-72868146,125832
68985058,68986064,chr13,ZDHHC20P4,chr13:68985058-68986064,1006
68861284,68885325,chr13,LINC00550,chr13:68861284-68885325,24041
79477364,79481231,chr13,NDFIP2-AS1,chr13:79477364-79481231,3867
42879644,42913304,chr21,NDUFV3,chr21:42879644-42913304,33660
66825169,66915031,chr13,PCDH9-AS2,chr13:66825169-66915031,89862
40931924,41061440,chr13,ELF1,chr13:40931924-41061440,129516
25734570,25772460,chr21,GABPA,chr21:25734570-25772460,37890
58515379,58619888,chr20,APCDD1L-DT,chr20:58515379-58619888,104509
42159283,42691422,chr18,LINC00907,chr18:42159283-42691422,532139
34833575,34834462,chr20,HMGB3P1,chr20:34833575-34834462,887
5507875,5510002,chr20,LINC01729,chr20:5507875-5510002,2127
49632945,49713878,chr20,B4GALT5,chr20:49632945-49713878,80933
34668994,34718227,chr21,CLIC6,chr21:34668994-34718227,49233
70040542,70049938,chrX,AWAT2,chrX:70040542-70049938,9396
35878476,35878733,chr20,HIGD1AP16,chr20:35878476-35878733,257
20253303,20253838,chr20,RPL17P1,chr20:20253303-20253838,535
37062846,37073170,chr21,PIGP,chr21:37062846-37073170,10324
33273480,33309871,chr20,BPIFB1,chr20:33273480-33309871,36391
108084207,108091549,chrX,PSMD10,chrX:108084207-108091549,7342
41220074,41256727,chr4,UCHL1-DT,chr4:41220074-41256727,36653
31171013,31211678,chr4,LINC02497,chr4:31171013-31211678,40665
74495816,74523454,chr18,CNDP2,chr18:74495816-74523454,27638
38366914,38385759,chr4,LINC02513,chr4:38366914-38385759,18845
30884443,30885182,chr4,MTCYBP43,chr4:30884443-30885182,739
2741648,2756342,chr4,TNIP2,chr4:2741648-2756342,14694
39385404,39387102,chr14,COILP1,chr14:39385404-39387102,1698
52051663,52204308,chr20,ZFP64,chr20:52051663-52204308,152645
22488593,22488652,chr14,TRAJ50,chr14:22488593-22488652,59
77535674,77645263,chr13,SCEL,chr13:77535674-77645263,109589
34364006,34371381,chr21,KCNE2,chr21:34364006-34371381,7375
30348399,30348606,chr21,KRTAP23-1,chr21:30348399-30348606,207
92770855,92772091,chrX,TUSC2P2,chrX:92770855-92772091,1236
48489883,48490434,chr14,RPL18P1,chr14:48489883-48490434,551
41742639,41742963,chr14,FKBP1BP1,chr14:41742639-41742963,324
105822539,105958610,chrX,NRK,chrX:105822539-105958610,136071
10521553,10606140,chr21,TPTE,chr21:10521553-10606140,84587
43457527,43492543,chr4,LINC02383,chr4:43457527-43492543,35016
69726900,69772005,chr14,SRSF5,chr14:69726900-69772005,45105
23755041,23904089,chr4,PPARGC1A,chr4:23755041-23904089,149048
115110616,115234096,chrX,LRCH2,chrX:115110616-115234096,123480
104803915,104804440,chrX,RPL18AP14,chrX:104803915-104804440,525
115424064,115425600,chrX,TUBAP6,chrX:115424064-115425600,1536
44523639,44542859,chrX,FUNDC1,chrX:44523639-44542859,19220
43176994,43226598,chrX,PINCR,chrX:43176994-43226598,49604
50202713,50351914,chrX,CCNB3,chrX:50202713-50351914,149201
63939829,63956416,chr20,UCKL1,chr20:63939829-63956416,16587
128127090,128128212,chrX,ACTRT1P1,chrX:128127090-128128212,1122
107974078,107985008,chrX,NLRP3P1,chrX:107974078-107985008,10930
102937272,102938300,chrX,RAB40AL,chrX:102937272-102938300,1028
83508290,83512127,chrX,POU3F4,chrX:83508290-83512127,3837
82497669,82497924,chrX,EIF3JP1,chrX:82497669-82497924,255
32628759,32728040,chr21,SYNJ1,chr21:32628759-32728040,99281
92515323,92515497,chrX,SNX3P1X,chrX:92515323-92515497,174
72912615,72913401,chrX,FAM236C,chrX:72912615-72913401,786
78945332,78963727,chrX,P2RY10,chrX:78945332-78963727,18395
37492472,37527931,chr20,BLCAP,chr20:37492472-37527931,35459
89290205,89291594,chr14,CAP2P1,chr14:89290205-89291594,1389
121863698,121864196,chrX,TPT1P13,chrX:121863698-121864196,498
57984686,57986133,chrX,KRT8P17,chrX:57984686-57986133,1447
46447292,46497422,chrX,KRBOX4,chrX:46447292-46497422,50130
25720516,25721056,chr4,MTCO3P44,chr4:25720516-25721056,540
49620799,49623481,chr14,MGAT2,chr14:49620799-49623481,2682
12223445,12251286,chr4,LINC02270,chr4:12223445-12251286,27841
65410592,65744121,chr14,FUT8,chr14:65410592-65744121,333529
3766348,3768526,chr4,ADRA2C,chr4:3766348-3768526,2178
1166932,1208962,chr4,SPON2,chr4:1166932-1208962,42030
70380140,70384591,chr18,LINC01910,chr18:70380140-70384591,4451
1756756,1758940,chr20,CKAP2LP1,chr20:1756756-1758940,2184
68829021,68842160,chrX,EFNB1,chrX:68829021-68842160,13139
51782331,51802521,chr20,SALL4,chr20:51782331-51802521,20190
72255679,72277248,chrX,RPS4X,chrX:72255679-72277248,21569
70412055,70412391,chr18,LARP7P3,chr18:70412055-70412391,336
63871692,63903888,chr18,SERPINB2,chr18:63871692-63903888,32196
37521206,37523690,chr20,NNAT,chr20:37521206-37523690,2484
45983365,45984364,chrX,KRT18P68,chrX:45983365-45984364,999
57766320,57767292,chrX,MDH1P1,chrX:57766320-57767292,972
70120353,70121474,chrX,MTCYBP31,chrX:70120353-70121474,1121
48676596,48691427,chrX,WAS,chrX:48676596-48691427,14831
57168753,57266641,chr20,BMP7,chr20:57168753-57266641,97888
20251905,20620561,chr4,SLIT2,chr4:20251905-20620561,368656
72998388,73002856,chrX,PABPC1L2B-AS1,chrX:72998388-73002856,4468
103273691,103276750,chrX,TCEAL5,chrX:103273691-103276750,3059
42777366,42778163,chrX,PPP1R2C,chrX:42777366-42778163,797
104647216,104647999,chrX,PHBP10,chrX:104647216-104647999,783
70444835,70505490,chrX,DLG3,chrX:70444835-70505490,60655
37983007,38033461,chr20,TTI1,chr20:37983007-38033461,50454
13968489,13968595,chr21,RNU6-954P,chr21:13968489-13968595,106
40066286,40099233,chr18,LINC01477,chr18:40066286-40099233,32947
14000927,14005279,chr21,NF1P3,chr21:14000927-14005279,4352
14007134,14014880,chr21,PPP6R2P1,chr21:14007134-14014880,7746
37672689,37673176,chr18,RPL12P40,chr18:37672689-37673176,487
14019060,14020725,chr21,FRG2MP,chr21:14019060-14020725,1665
14064325,14069087,chr21,ANKRD20A18P,chr21:14064325-14069087,4762
14070871,14070986,chr21,RNA5SP488,chr21:14070871-14070986,115
14143581,14144158,chr21,ERLEC1P1,chr21:14143581-14144158,577
14216130,14228372,chr21,RBM11,chr21:14216130-14228372,12242
74534500,74587212,chr18,CNDP1,chr18:74534500-74587212,52712
14371115,14383484,chr21,HSPA13,chr21:14371115-14383484,12369
39171130,39172106,chr21,PCBP2P1,chr21:39171130-39172106,976
39174769,39183488,chr21,PSMG1,chr21:39174769-39183488,8719
39750127,39751293,chr22,MTFR2P2,chr22:39750127-39751293,1166
45604432,45605621,chr22,LINC01589,chr22:45604432-45605621,1189
58150902,58161150,chr20,C20orf85,chr20:58150902-58161150,10248
48866770,48898386,chr22,LINC01310,chr22:48866770-48898386,31616
49960768,49964072,chr22,PIM3,chr22:49960768-49964072,3304
18813783,18814378,chr20,SCP2D1,chr20:18813783-18814378,595
63005927,63007035,chr20,BHLHE23,chr20:63005927-63007035,1108
51130788,51131667,chr20,RPSAP1,chr20:51130788-51131667,879
63009383,63085071,chr20,LINC01749,chr20:63009383-63085071,75688
61252261,61940617,chr20,CDH4,chr20:61252261-61940617,688356
45163925,45188017,chr22,NUP50,chr22:45163925-45188017,24092
45671845,45672391,chr13,COX4I1P2,chr13:45671845-45672391,546
44860316,44866247,chr14,DOCK11P1,chr14:44860316-44866247,5931
34568689,34569129,chr14,RPS19P3,chr14:34568689-34569129,440
40143926,40144504,chr18,RPL17P45,chr18:40143926-40144504,578
21825487,21831539,chr18,MIR133A1HG,chr18:21825487-21831539,6052
26905362,26905861,chr13,FGFR1OP2P1,chr13:26905362-26905861,499
39184176,39321559,chr21,BRWD1,chr21:39184176-39321559,137383
28067587,28068334,chr13,KATNBL1P1,chr13:28067587-28068334,747
89892128,89892443,chr14,RAB42P1,chr14:89892128-89892443,315
44432143,44577147,chr13,TSC22D1,chr13:44432143-44577147,145004
35251058,35290245,chr18,ZSCAN30,chr18:35251058-35290245,39187
57229034,57229415,chrX,PPP1R11P2,chrX:57229034-57229415,381
83861126,83886699,chrX,CYLC1,chrX:83861126-83886699,25573
52639915,52695900,chr14,ERO1A,chr14:52639915-52695900,55985
46454097,46457199,chrX,VEZTP1,chrX:46454097-46457199,3102
106900063,106903341,chrX,RIPPLY1,chrX:106900063-106903341,3278
70124972,70129071,chrX,MTND4P31,chrX:70124972-70129071,4099
54671985,54672638,chrX,PGAM4P1,chrX:54671985-54672638,653
44476027,44477422,chrX,FDPSP5,chrX:44476027-44477422,1395
40758483,40759050,chrX,DPRXP6,chrX:40758483-40759050,567
102008524,102009046,chrX,MTND6P13,chrX:102008524-102009046,522
37700005,37700277,chrX,H2AL1MP,chrX:37700005-37700277,272
120210461,120212680,chrX,EEF1A1P30,chrX:120210461-120212680,2219
119399336,119454478,chrX,SLC25A43,chrX:119399336-119454478,55142
65423958,65448167,chr18,LINC01916,chr18:65423958-65448167,24209
9334767,9402420,chr18,TWSG1,chr18:9334767-9402420,67653
40626921,40647561,chrX,CXorf38,chrX:40626921-40647561,20640
46295143,46296660,chr22,GTSE1-DT,chr22:46295143-46296660,1517
50309030,50327012,chr22,DENND6B,chr22:50309030-50327012,17982
67831876,67832827,chr13,NPM1P22,chr13:67831876-67832827,951
76794732,76822295,chr18,ZNF236-DT,chr18:76794732-76822295,27563
115198432,115198749,chrX,RPL36P18,chrX:115198432-115198749,317
79090783,79094119,chr13,NIPA2P5,chr13:79090783-79094119,3336
74409415,74413209,chr18,LINC01922,chr18:74409415-74413209,3794
86160264,86161359,chrX,EEF1A1P29,chrX:86160264-86161359,1095
80654755,80657027,chr13,PWWP2AP1,chr13:80654755-80657027,2272
69400888,69849087,chr18,DOK6,chr18:69400888-69849087,448199
120202061,120202748,chrX,SFR1P1,chrX:120202061-120202748,687
57391171,57391518,chr13,RPL31P53,chr13:57391171-57391518,347
72460132,72460329,chr13,RPL18AP17,chr13:72460132-72460329,197
19533977,19887600,chrX,SH3KBP1,chrX:19533977-19887600,353623
36651766,36746090,chr20,NDRG3,chr20:36651766-36746090,94324
56214373,56216942,chr13,SPATA2P1,chr13:56214373-56216942,2569
78849231,78851208,chr13,HSPD1P8,chr13:78849231-78851208,1977
36829106,37232172,chr18,KIAA1328,chr18:36829106-37232172,403066
78761175,78761651,chr13,RPL21P111,chr13:78761175-78761651,476
56117814,56301524,chr14,PELI2,chr14:56117814-56301524,183710
70923664,70924455,chr13,MTCL1P1,chr13:70923664-70924455,791
38687077,38887131,chr13,FREM2,chr13:38687077-38887131,200054
45671798,45845307,chr22,ATXN10,chr22:45671798-45845307,173509
75292131,75292495,chr14,DPPA5P4,chr14:75292131-75292495,364
51763056,51764076,chr14,OR7E106P,chr14:51763056-51764076,1020
82692704,82693055,chr14,ENSAP2,chr14:82692704-82693055,351
58141279,58141660,chr14,UBA52P3,chr14:58141279-58141660,381
26208036,26208424,chr14,CYB5AP5,chr14:26208036-26208424,388
57390544,57415906,chr14,NAA30,chr14:57390544-57415906,25362
37896060,37902372,chr14,LINC00517,chr14:37896060-37902372,6312
38254000,38256093,chr14,CLEC14A,chr14:38254000-38256093,2093
45308968,45341955,chr22,FAM118A,chr22:45308968-45341955,32987
71932429,72566530,chr14,RGS6,chr14:71932429-72566530,634101
71704181,71704655,chr13,RPL21P109,chr13:71704181-71704655,474
78786272,78840051,chr13,LINC00331,chr13:78786272-78840051,53779
75195113,75209139,chr18,ZADH2,chr18:75195113-75209139,14026
63828840,63844125,chr13,OR7E104P,chr13:63828840-63844125,15285
23598926,23662911,chr18,ANKRD29,chr18:23598926-23662911,63985
66268997,66270458,chr13,TRIM60P19,chr13:66268997-66270458,1461
39216624,39217506,chr21,TIMM9P2,chr21:39216624-39217506,882
75237944,75240296,chr13,CTAGE11P,chr13:75237944-75240296,2352
39217093,39219805,chr21,BRWD1-IT1,chr21:39217093-39219805,2712
41229510,41240931,chr22,CHADL,chr22:41229510-41240931,11421
39235386,39236020,chr21,METTL21AP1,chr21:39235386-39236020,634
39313935,39314962,chr21,BRWD1-AS2,chr21:39313935-39314962,1027
39315707,39323218,chr21,BRWD1-AS1,chr21:39315707-39323218,7511
39342315,39349647,chr21,HMGN1,chr21:39342315-39349647,7332
57147488,57150509,chr13,PRR20B,chr13:57147488-57150509,3021
56700837,56701514,chr20,PTMAP6,chr20:56700837-56701514,677
56577563,56598621,chr20,LINC01716,chr20:56577563-56598621,21058
55420336,55427197,chr20,LINC01441,chr20:55420336-55427197,6861
64181314,64260055,chr18,LINC01538,chr18:64181314-64260055,78741
62387103,62388520,chr20,RPS21,chr20:62387103-62388520,1417
45344063,45413619,chr22,SMC1B,chr22:45344063-45413619,69556
68301605,68303302,chr13,HNRNPA1P18,chr13:68301605-68303302,1697
63970029,64019779,chr18,SERPINB8,chr18:63970029-64019779,49750
20728606,21948772,chr4,KCNIP4,chr4:20728606-21948772,1220166
77919689,78617328,chr13,OBI1-AS1,chr13:77919689-78617328,697639
57710156,57712780,chr20,NKILA,chr20:57710156-57712780,2624
60414396,60414872,chr20,MTCO2P1,chr20:60414396-60414872,476
34450930,34454552,chr20,ITCH-IT1,chr20:34450930-34454552,3622
63843436,63843915,chr20,C20orf181,chr20:63843436-63843915,479
34122470,34123290,chr20,RPS2P1,chr20:34122470-34123290,820
63895126,63936031,chr20,DNAJC5,chr20:63895126-63936031,40905
103330229,103332326,chrX,TCEAL7,chrX:103330229-103332326,2097
69174124,69174717,chrX,HMGN1P35,chrX:69174124-69174717,593
76029895,76030330,chrX,ARL5AP5,chrX:76029895-76030330,435
107939263,107939642,chrX,TMEM230P1,chrX:107939263-107939642,379
88061590,88062844,chrX,TMEM184CP1,chrX:88061590-88062844,1254
49729591,49729842,chr20,SNRPFP1,chr20:49729591-49729842,251
103062651,103064171,chrX,BEX1,chrX:103062651-103064171,1520
61079049,61083750,chr20,LINC01718,chr20:61079049-61083750,4701
37490362,37519542,chr22,CARD10,chr22:37490362-37519542,29180
56629306,56639283,chr20,TFAP2C,chr20:56629306-56639283,9977
128313281,128314048,chrX,RPL7AP72,chrX:128313281-128314048,767
131492279,131492886,chrX,NLRP7P1,chrX:131492279-131492886,607
65772741,65773632,chrX,NANOGP9,chrX:65772741-65773632,891
43278125,43279658,chrX,IMPDH1P4,chrX:43278125-43279658,1533
119978713,120025138,chrX,RHOXF1P1,chrX:119978713-120025138,46425
119468422,119471396,chrX,SLC25A5,chrX:119468422-119471396,2974
27977992,27981449,chrX,DCAF8L1,chrX:27977992-27981449,3457
75283503,75482169,chr13,TBC1D4,chr13:75283503-75482169,198666
82506434,82506812,chrX,RPL22P22,chrX:82506434-82506812,378
33161768,33181412,chr20,BPIFA2,chr20:33161768-33181412,19644
50905438,50905866,chrX,H3P44,chrX:50905438-50905866,428
68600099,68600473,chrX,RPL31P63,chrX:68600099-68600473,374
63347228,63351332,chrX,SPIN4,chrX:63347228-63351332,4104
24932771,24987919,chr18,LINC01894,chr18:24932771-24987919,55148
44309314,44310476,chrX,RRM2P3,chrX:44309314-44310476,1162
46058751,46059528,chrX,PCNAP3,chrX:46058751-46059528,777
93573834,93574579,chrX,RPL7P55,chrX:93573834-93574579,745
126471705,126472403,chrX,MTCO1P53,chrX:126471705-126472403,698
116748530,116748877,chrX,PRPF4BP1,chrX:116748530-116748877,347
126163499,126166289,chrX,DCAF12L2,chrX:126163499-126166289,2790
59430939,59697662,chr18,CCBE1,chr18:59430939-59697662,266723
118769796,118770857,chrX,TMEM30BP1,chrX:118769796-118770857,1061
68645326,68645527,chrX,COX6CP12,chrX:68645326-68645527,201
97906644,97908090,chrX,NCKAP1P1,chrX:97906644-97908090,1446
119236245,119244466,chrX,PGRMC1,chrX:119236245-119244466,8221
10737558,10749586,chr4,LINC02498,chr4:10737558-10749586,12028
39973444,39974338,chr4,PABPC1P1,chr4:39973444-39974338,894
117897813,118117340,chrX,KLHL13,chrX:117897813-118117340,219527
22668480,22685344,chr20,LINC01747,chr20:22668480-22685344,16864
64606418,64606613,chr4,MTCO3P27,chr4:64606418-64606613,195
71519962,71578956,chr18,LINC01541,chr18:71519962-71578956,58994
29962644,29963758,chr4,RPS3AP17,chr4:29962644-29963758,1114
62143769,62182514,chr20,SS18L1,chr20:62143769-62182514,38745
40335333,40355217,chr4,CHRNA9,chr4:40335333-40355217,19884
60009994,60011143,chr18,ENTR1P1,chr18:60009994-60011143,1149
14137710,14139272,chr18,FRG2LP,chr18:14137710-14139272,1562
23672253,23672748,chr18,RPS10P27,chr18:23672253-23672748,495
57214872,57215866,chr20,BMP7-AS1,chr20:57214872-57215866,994
64290385,64313132,chr20,LINC00266-1,chr20:64290385-64313132,22747
7134931,7135819,chr18,SLC25A51P2,chr18:7134931-7135819,888
59969438,59971396,chr18,NFE2L3P1,chr18:59969438-59971396,1958
56647988,56681899,chr4,HOPX,chr4:56647988-56681899,33911
1323794,1324085,chr18,RN7SKP72,chr18:1323794-1324085,291
6454962,6455068,chr18,RNU6-349P,chr18:6454962-6455068,106
6601540,6601836,chr18,RN7SL282P,chr18:6601540-6601836,296
5840695,5840833,chr18,MIR3976,chr18:5840695-5840833,138
8471831,8472128,chr18,RN7SL50P,chr18:8471831-8472128,297
6017723,6017839,chr18,RNU5F-3P,chr18:6017723-6017839,116
6374361,6374425,chr18,MIR4317,chr18:6374361-6374425,64
3571215,3571511,chr18,RN7SL39P,chr18:3571215-3571511,296
3885353,3885432,chr18,MIR6718,chr18:3885353-3885432,79
2652593,2658393,chr20,NOP56,chr20:2652593-2658393,5800
3894699,3894805,chr18,RNU6-831P,chr18:3894699-3894805,106
6936912,6937020,chr18,RNU6-916P,chr18:6936912-6937020,108
9518119,9518260,chr18,RNU2-27P,chr18:9518119-9518260,141
39373763,39377066,chr21,RNF6P1,chr21:39373763-39377066,3303
9617964,9618072,chr18,RNU6-903P,chr18:9617964-9618072,108
11654885,11654941,chr18,MIR7153,chr18:11654885-11654941,56
21928985,21929094,chr18,RNA5SP451,chr18:21928985-21929094,109
22130603,22130729,chr18,RNU6ATAC20P,chr18:22130603-22130729,126
39377698,39428528,chr21,GET1,chr21:39377698-39428528,50830
22647582,22647688,chr18,RNU6-1032P,chr18:22647582-22647688,106
21879801,21879904,chr18,RNU6-1038P,chr18:21879801-21879904,103
21793883,21794159,chr18,RN7SL233P,chr18:21793883-21794159,276
21817624,21817828,chr18,SNORA73,chr18:21817624-21817828,204
21825698,21825785,chr18,MIR133A1,chr18:21825698-21825785,87
21829004,21829088,chr18,MIR1-2,chr18:21829004-21829088,84
23004564,23004862,chr18,RN7SL745P,chr18:23004564-23004862,298
22933349,22933438,chr18,MIR4741,chr18:22933349-22933438,89
103252995,103255192,chrX,TCEAL8,chrX:103252995-103255192,2197
22180112,22180218,chr18,RNU6-702P,chr18:22180112-22180218,106
15320840,15320944,chr18,RNU6-721P,chr18:15320840-15320944,104
34756676,35002862,chr22,LINC02885,chr22:34756676-35002862,246186
25818234,25818532,chr18,RN7SL97P,chr18:25818234-25818532,298
26366301,26366406,chr18,RNU6-1289P,chr18:26366301-26366406,105
30298910,30298960,chr18,MIR302F,chr18:30298910-30298960,50
46684410,46738252,chr22,CERK,chr22:46684410-46738252,53842
26591467,26591535,chr18,MIR8057,chr18:26591467-26591535,68
29048620,29048719,chr18,RNU6-408P,chr18:29048620-29048719,99
24124170,24124285,chr18,RNU5A-6P,chr18:24124170-24124285,115
2907073,3053408,chr9,CARM1P1,chr9:2907073-3053408,146335
24170505,24170623,chr18,RNA5SP452,chr18:24170505-24170623,118
24179038,24179295,chr18,Metazoa_SRP,chr18:24179038-24179295,257
24218300,24218404,chr18,RNU6-435P,chr18:24218300-24218404,104
24321686,24321735,chr18,MIR320C2,chr18:24321686-24321735,49
14190700,14190806,chr18,RNU6-316P,chr18:14190700-14190806,106
31937533,31937639,chr18,RNU6-1050P,chr18:31937533-31937639,106
35591737,35591806,chr18,MIR3975,chr18:35591737-35591806,69
35934088,35934142,chr18,MIR3929,chr18:35934088-35934142,54
37657135,37657215,chr18,MIR4318,chr18:37657135-37657215,80
39622123,39622175,chr18,MIR924,chr18:39622123-39622175,52
39676719,39676777,chr18,MIR5583-2,chr18:39676719-39676777,58
39676721,39676779,chr18,MIR5583-1,chr18:39676721-39676779,58
70062457,70064179,chrX,OTUD6A,chrX:70062457-70064179,1722
39678520,39678622,chr18,RNU6-1242P,chr18:39678520-39678622,102
39016047,39016344,chr18,RN7SKP182,chr18:39016047-39016344,297
42270589,42270715,chr18,RNA5SP454,chr18:42270589-42270715,126
143711955,143721423,chrX,SPANXN2,chrX:143711955-143721423,9468
44071583,44071701,chr18,RNA5SP455,chr18:44071583-44071701,118
45989653,45989945,chr18,RN7SKP26,chr18:45989653-45989945,292
35904818,35904926,chr18,MIR187,chr18:35904818-35904926,108
46121615,46121721,chr18,RNU6-1278P,chr18:46121615-46121721,106
48670600,48670668,chr18,MIR4743,chr18:48670600-48670668,68
122010976,122011612,chrX,UBE2V1P16,chrX:122010976-122011612,636
47380496,47380565,chr18,MIR4527,chr18:47380496-47380565,69
39034007,39034110,chr18,RNU6-706P,chr18:39034007-39034110,103
46077004,46077099,chr18,RNY4P37,chr18:46077004-46077099,95
48169784,48169890,chr18,RNU6-708P,chr18:48169784-48169890,106
50319002,50319120,chr18,RNA5SP458,chr18:50319002-50319120,118
1045625,1048641,chr9,LINC01230,chr9:1045625-1048641,3016
53237101,53237190,chr18,MIR4528,chr18:53237101-53237190,89
50206998,50207278,chr18,RN7SL310P,chr18:50206998-50207278,280
123600561,123733056,chrX,THOC2,chrX:123600561-123733056,132495
57284602,57284708,chr18,RNU6-737P,chr18:57284602-57284708,106
1011085,1011799,chr9,H3P29,chr9:1011085-1011799,714
49946266,49946389,chr18,RNA5SP457,chr18:49946266-49946389,123
50126499,50126563,chr18,MIR4320,chr18:50126499-50126563,64
4709556,4742043,chr9,AK3,chr9:4709556-4742043,32487
49814133,49814276,chr18,SCARNA17,chr18:49814133-49814276,143
61391595,61391703,chr18,RNU6-116P,chr18:61391595-61391703,108
59972914,59973207,chr18,RN7SL342P,chr18:59972914-59973207,293
48475487,48475600,chr18,RNA5SP456,chr18:48475487-48475600,113
60163567,60163707,chr18,RNU4-17P,chr18:60163567-60163707,140
60018625,60018731,chr18,RNU6-567P,chr18:60018625-60018731,106
34082429,34083310,chr13,VDAC1P12,chr13:34082429-34083310,881
67081584,67081686,chr18,MIR5011,chr18:67081584-67081686,102
62731226,62731332,chr18,RNU6-142P,chr18:62731226-62731332,106
66946116,66946222,chr18,RNU6-1037P,chr18:66946116-66946222,106
25747433,25863760,chr4,SEL1L3,chr4:25747433-25863760,116327
62650308,62650601,chr18,RN7SL705P,chr18:62650308-62650601,293
70512727,70513008,chr18,RN7SL795P,chr18:70512727-70513008,281
72751952,72752051,chr18,RNA5SP460,chr18:72751952-72752051,99
74377163,74377951,chr13,RPL21P108,chr13:74377163-74377951,788
72853321,72853382,chr18,MIR548AV,chr18:72853321-72853382,61
73744935,73745232,chr18,RN7SL401P,chr18:73744935-73745232,297
68634190,68634486,chr13,RPS3AP52,chr13:68634190-68634486,296
68858934,68859040,chr18,RNU6-39P,chr18:68858934-68859040,106
58528615,58531026,chr13,CTAGE16P,chr13:58528615-58531026,2411
78036739,78036845,chr18,RNU6-655P,chr18:78036739-78036845,106
61805150,61805676,chr13,RAC1P8,chr13:61805150-61805676,526
77863464,77863567,chr18,RNA5SP461,chr18:77863464-77863567,103
76800664,76800774,chr18,RNU6-346P,chr18:76800664-76800774,110
87219004,87219269,chr13,UBBP5,chr13:87219004-87219269,265
3347696,3383532,chr18,LINC01895,chr18:3347696-3383532,35836
84562364,84563236,chr13,LINC00333,chr13:84562364-84563236,872
50343304,50445090,chr22,PPP6R2,chr22:50343304-50445090,101786
57160632,57163653,chr13,PRR20D,chr13:57160632-57163653,3021
39380332,39515506,chr21,GET1-SH3BGR,chr21:39380332-39515506,135174
39447010,39447069,chr21,MIR6508,chr21:39447010-39447069,59
39488327,39488760,chr21,MYL6P2,chr21:39488327-39488760,433
39491544,39491898,chr21,RPS26P4,chr21:39491544-39491898,354
3377916,3378247,chr18,RPL31P59,chr18:3377916-3378247,331
39525583,39529855,chr21,JCADP1,chr21:39525583-39529855,4272
39597147,39612910,chr21,B3GALT5-AS1,chr21:39597147-39612910,15763
3394889,3395312,chr18,IGLJCOR18,chr18:3394889-3395312,423
3406342,3406818,chr18,RPL21P127,chr18:3406342-3406818,476
80335976,80341126,chr13,SPRY2,chr13:80335976-80341126,5150
3415145,3415580,chr18,BOD1P1,chr18:3415145-3415580,435
4792944,4885917,chr9,RCL1,chr9:4792944-4885917,92973
3466250,3478978,chr18,GAPLINC,chr18:3466250-3478978,12728
39867438,39929397,chr21,PCP4,chr21:39867438-39929397,61959
57167197,57170218,chr13,PRR20E,chr13:57167197-57170218,3021
46803218,46920160,chr18,PIAS2,chr18:46803218-46920160,116942
30553670,30554693,chr13,PTPN2P2,chr13:30553670-30554693,1023
40010999,40847158,chr21,DSCAM,chr21:40010999-40847158,836159
38349849,38363619,chr13,UFM1,chr13:38349849-38363619,13770
1009936,1026898,chr4,FGFRL1,chr4:1009936-1026898,16962
56818298,56995827,chrX,SPIN3,chrX:56818298-56995827,177529
56601701,56602113,chr20,RPS4XP3,chr20:56601701-56602113,412
63034217,63037028,chr20,LINC00029,chr20:63034217-63037028,2811
5334930,5339876,chr9,RLN1,chr9:5334930-5339876,4946
274190,689668,chr10,DIP2C,chr10:274190-689668,415478
51386957,51562831,chr20,NFATC2,chr20:51386957-51562831,175874
5357971,5437925,chr9,PLGRKT,chr9:5357971-5437925,79954
40212352,40212431,chr21,MIR4760,chr21:40212352-40212431,79
40383083,40385358,chr21,DSCAM-AS1,chr21:40383083-40385358,2275
6639139,6639604,chr9,RPL23AP57,chr9:6639139-6639604,465
40615378,40630767,chr21,DSCAM-IT1,chr21:40615378-40630767,15389
5084999,5086112,chr9,PDSS1P1,chr9:5084999-5086112,1113
10439880,10457426,chr4,ZNF518B,chr4:10439880-10457426,17546
5094139,5095014,chr9,MTND1P11,chr9:5094139-5095014,875
7597823,7598377,chr9,PPIAP33,chr9:7597823-7598377,554
5098341,5099325,chr9,MTCO2P11,chr9:5098341-5099325,984
40863994,40864473,chr21,YRDCP3,chr21:40863994-40864473,479
6195934,6197248,chr9,GTF3AP1,chr9:6195934-6197248,1314
4944670,4945902,chr9,HNRNPA1P41,chr9:4944670-4945902,1232
41141493,41148198,chr21,LINC00323,chr21:41141493-41148198,6705
4679559,4708399,chr9,CDC37L1,chr9:4679559-4708399,28840
47107408,47150500,chr18,HDHD2,chr18:47107408-47150500,43092
41167557,41167629,chr21,MIR3197,chr21:41167557-41167629,72
41167801,41282530,chr21,BACE2,chr21:41167801-41282530,114729
1249300,1288291,chr4,CTBP1-DT,chr4:1249300-1288291,38991
270675,305474,chr4,ZNF732,chr4:270675-305474,34799
63811014,63811608,chr13,PPP1R2P10,chr13:63811014-63811608,594
6734598,6735076,chr9,PRELID3BP11,chr9:6734598-6735076,478
63183096,63328129,chr13,LINC00376,chr13:63183096-63328129,145033
25718082,25719745,chr4,MTND4P9,chr4:25718082-25719745,1663
61424689,61427946,chr13,LINC02339,chr13:61424689-61427946,3257
39932454,39933561,chr4,ELOCP33,chr4:39932454-39933561,1107
5100236,5101009,chr9,MTCO3P11,chr9:5100236-5101009,773
67910986,67911951,chr13,OR7E33P,chr13:67910986-67911951,965
425815,499156,chr4,ZNF721,chr4:425815-499156,73341
2305083,2315075,chr10,LINC00701,chr10:2305083-2315075,9992
15163622,15307360,chr9,TTC39B,chr9:15163622-15307360,143738
1989076,2015005,chr10,LINC00700,chr10:1989076-2015005,25929
63851197,64076044,chr13,LINC00355,chr13:63851197-64076044,224847
84520103,84521568,chr13,MTND4P1,chr13:84520103-84521568,1465
57204379,57204799,chr13,MTCO2P3,chr13:57204379-57204799,420
5035354,5107686,chr10,AKR1C3,chr10:5035354-5107686,72332
13540830,13544508,chr4,NKX3-2,chr4:13540830-13544508,3678
71437966,71867204,chr13,DACH1,chr13:71437966-71867204,429238
54086926,54087783,chr4,MORF4L2P1,chr4:54086926-54087783,857
47450787,47463702,chr4,COMMD8,chr4:47450787-47463702,12915
119220782,119221742,chrX,HNRNPA1P28,chrX:119220782-119221742,960
41175231,41186788,chr21,PLAC4,chr21:41175231-41186788,11557
120117642,120119700,chrX,LINC01402,chrX:120117642-120119700,2058
127390342,127392526,chrX,PNPLA10P,chrX:127390342-127392526,2184
41180097,41180626,chr21,BACE2-IT1,chr21:41180097-41180626,529
73524275,73563085,chrX,MAP2K4P1,chrX:73524275-73563085,38810
41580475,41582887,chr21,PCSEAT,chr21:41580475-41582887,2412
77374212,77381319,chrX,SPRYD7P1,chrX:77374212-77381319,7107
47152834,47176364,chr18,IER3IP1,chr18:47152834-47176364,23530
41679181,41697336,chr21,LINC00111,chr21:41679181-41697336,18155
123765301,123765686,chrX,MEMO1P4,chrX:123765301-123765686,385
41711520,41715775,chr21,LINC00479,chr21:41711520-41715775,4255
86304367,86305086,chrX,GEMIN8P3,chrX:86304367-86305086,719
79360384,79367667,chrX,ITM2A,chrX:79360384-79367667,7283
38867677,38945739,chr4,FAM114A1,chr4:38867677-38945739,78062
41715806,41717975,chr21,LINC00112,chr21:41715806-41717975,2169
47234442,47234548,chr18,RNU6-1131P,chr18:47234442-47234548,106
47206169,47251660,chr18,SKOR2,chr18:47206169-47251660,45491
41739369,41767089,chr21,RIPK4,chr21:41739369-41767089,27720
88096393,88097225,chrX,CAPZA1P1,chrX:88096393-88097225,832
95679130,95679627,chrX,RPS7P13,chrX:95679130-95679627,497
119465986,119469128,chrX,SLC25A5-AS1,chrX:119465986-119469128,3142
121024964,121026563,chrX,CBLL1P1,chrX:121024964-121026563,1599
88465778,88555007,chr14,PTPN21,chr14:88465778-88555007,89229
125320120,125325214,chrX,TEX13C,chrX:125320120-125325214,5094
4655427,4682722,chr10,LINC00705,chr10:4655427-4682722,27295
37994252,37994918,chrX,H2AL3,chrX:37994252-37994918,666
3411608,3459978,chr18,TGIF1,chr18:3411608-3459978,48370
115289715,115307563,chrX,LUZP4,chrX:115289715-115307563,17848
3673593,3677855,chr4,LINC02171,chr4:3673593-3677855,4262
41746772,41746841,chr21,MIR6814,chr21:41746772-41746841,69
141002594,141003706,chrX,SPANXB1,chrX:141002594-141003706,1112
4542131,4787359,chr4,STX18-AS1,chr4:4542131-4787359,245228
42199689,42297244,chr21,ABCG1,chr21:42199689-42297244,97555
5207169,5207742,chr10,ARL4AP3,chr10:5207169-5207742,573
5393101,5404828,chr10,TUBAL3,chr10:5393101-5404828,11727
134990991,134992473,chrX,SMIM10,chrX:134990991-134992473,1482
105405647,105407039,chrX,KCTD9P2,chrX:105405647-105407039,1392
121203182,121205014,chrX,HSPA8P1,chrX:121203182-121205014,1832
31676256,31750140,chr22,PRR14L,chr22:31676256-31750140,73884
124688504,124688838,chrX,RPS26P57,chrX:124688504-124688838,334
92676519,92676954,chrX,RPL26P36,chrX:92676519-92676954,435
45951762,45952333,chrX,MED28P4,chrX:45951762-45952333,571
70361486,70362374,chrX,TRAPPC2LP1,chrX:70361486-70362374,888
17096301,17096446,chr9,RPS29P33,chr9:17096301-17096446,145
119998087,120000088,chrX,RHOXF1P2,chrX:119998087-120000088,2001
5040945,5041940,chr9,CSNK1G2P1,chr9:5040945-5041940,995
12287320,12288238,chr9,JKAMPP1,chr9:12287320-12288238,918
17589161,17591318,chr9,PABPC1P11,chr9:17589161-17591318,2157
103376395,103378164,chrX,BEX3,chrX:103376395-103378164,1769
4803788,4804972,chr9,KLF4P1,chr9:4803788-4804972,1184
1177313,1737525,chr10,ADARB2,chr10:1177313-1737525,560212
22002903,22009305,chr9,CDKN2B,chr9:22002903-22009305,6402
59863564,59933655,chr20,SYCP2,chr20:59863564-59933655,70091
9483718,9484702,chr4,OR7E85P,chr4:9483718-9484702,984
36496128,36641939,chr4,LINC02505,chr4:36496128-36641939,145811
5123880,5185647,chr9,INSL6,chr9:5123880-5185647,61767
44492583,44498233,chr22,RTL6,chr22:44492583-44498233,5650
142202342,142205290,chrX,MAGEC2,chrX:142202342-142205290,2948
46053705,46057210,chr22,PRR34-AS1,chr22:46053705-46057210,3505
49096,50124,chr4,BNIP3P41,chr4:49096-50124,1028
5311444,5311716,chr9,HMGN2P31,chr9:5311444-5311716,272
48341529,48426201,chr4,SLAIN2,chr4:48341529-48426201,84672
5881596,6008482,chr9,KIAA2026,chr9:5881596-6008482,126886
27863893,27864349,chrX,VKORC1P1,chrX:27863893-27864349,456
6779549,6879450,chr10,LINC00707,chr10:6779549-6879450,99901
115718942,115719229,chrX,SUMO2P21,chrX:115718942-115719229,287
149817170,149817644,chrX,DUTP4,chrX:149817170-149817644,474
143622790,143636101,chrX,SLITRK4,chrX:143622790-143636101,13311
39994954,40043534,chr22,FAM83F,chr22:39994954-40043534,48580
19026001,19032626,chr13,GTF2IP3,chr13:19026001-19032626,6625
73212299,73214851,chrX,NAP1L2,chrX:73212299-73214851,2552
74405894,74426210,chr14,SYNDIG1L,chr14:74405894-74426210,20316
67902208,67903221,chr13,OR7E111P,chr13:67902208-67903221,1013
123603139,123603931,chrX,FERP1,chrX:123603139-123603931,792
115659713,115660022,chrX,PHF5FP,chrX:115659713-115660022,309
136497079,136512346,chrX,HTATSF1,chrX:136497079-136512346,15267
4786629,4848062,chr10,AKR1E2,chr10:4786629-4848062,61433
75932395,75935132,chr13,LINC00561,chr13:75932395-75935132,2737
91272081,91272577,chr13,PPIAP23,chr13:91272081-91272577,496
52334295,52341896,chr13,LINC02333,chr13:52334295-52341896,7601
41189727,41190188,chr22,LRRC37A14P,chr22:41189727-41190188,461
53036745,53153323,chr14,DDHD1,chr14:53036745-53153323,116578
1164414,1164867,chr9,RPS27AP14,chr9:1164414-1164867,453
337814,384868,chr4,ZNF141,chr4:337814-384868,47054
5096666,5098193,chr9,MTCO1P11,chr9:5096666-5098193,1527
23632106,23632360,chr9,SUMO2P2,chr9:23632106-23632360,254
36800684,36819479,chr22,PVALB,chr22:36800684-36819479,18795
4490468,4587469,chr9,SLC1A1,chr9:4490468-4587469,97001
73054976,73077541,chr13,KLF5,chr13:73054976-73077541,22565
106032435,106038727,chrX,SERPINA7,chrX:106032435-106038727,6292
13568738,13627725,chr4,BOD1L1,chr4:13568738-13627725,58987
26226445,26391685,chr18,TAF4B,chr18:26226445-26391685,165240
131204068,131205010,chrX,OR11Q1P,chrX:131204068-131205010,942
128122734,128123496,chrX,BTG3P1,chrX:128122734-128123496,762
145176582,145176894,chrX,CYCSP44,chrX:145176582-145176894,312
49900229,49918438,chr22,ALG12,chr22:49900229-49918438,18209
101989481,101989872,chrX,H2BP8,chrX:101989481-101989872,391
133216662,133218354,chrX,TFDP3,chrX:133216662-133218354,1692
139362040,139362382,chrX,SNURFL,chrX:139362040-139362382,342
73535503,73536241,chrX,RPL7P53,chrX:73535503-73536241,738
126472728,126472884,chrX,MTND4LP1,chrX:126472728-126472884,156
131398072,131398957,chrX,OR5BH1P,chrX:131398072-131398957,885
123785009,123785451,chrX,CHCHD2P1,chrX:123785009-123785451,442
5099560,5100229,chr9,MTATP6P11,chr9:5099560-5100229,669
115069237,115069846,chrX,YAP1P2,chrX:115069237-115069846,609
70133447,70166324,chrX,IGBP1,chrX:70133447-70166324,32877
5113549,5114804,chr9,IGHEP2,chr9:5113549-5114804,1255
4662294,4665258,chr9,PLPP6,chr9:4662294-4665258,2964
42221173,42221286,chr21,RNA5SP492,chr21:42221173-42221286,113
5091093,5091604,chr9,MTND6P5,chr9:5091093-5091604,511
42346357,42350997,chr21,TFF2,chr21:42346357-42350997,4640
5107937,5109290,chr9,MTND4P14,chr9:5107937-5109290,1353
5510531,5571282,chr9,PDCD1LG2,chr9:5510531-5571282,60751
103499130,103519489,chrX,RAB40A,chrX:103499130-103519489,20359
19674752,19783019,chr13,PSPC1,chr13:19674752-19783019,108267
42362282,42366535,chr21,TFF1,chr21:42362282-42366535,4253
143508735,143517475,chrX,SPANXN3,chrX:143508735-143517475,8740
138558996,138559298,chrX,H2AQ1P,chrX:138558996-138559298,302
17134982,17503923,chr9,CNTLN,chr9:17134982-17503923,368941
42371887,42396091,chr21,TMPRSS3,chr21:42371887-42396091,24204
131688779,131830862,chrX,FIRRE,chrX:131688779-131830862,142083
8259331,8268342,chr10,LINC00708,chr10:8259331-8268342,9011
3941760,3955432,chr4,FAM86EP,chr4:3941760-3955432,13672
39349925,39385575,chr22,SYNGR1,chr22:39349925-39385575,35650
79406293,79427317,chr13,RBM26-AS1,chr13:79406293-79427317,21024
10058722,10063502,chr10,LINC02670,chr10:10058722-10063502,4780
70234655,70240659,chrX,AWAT1,chrX:70234655-70240659,6004
9275833,9287057,chr10,LINC00709,chr10:9275833-9287057,11224
4201141,4243912,chr10,LINC00702,chr10:4201141-4243912,42771
59899996,59904305,chr18,PMAIP1,chr18:59899996-59904305,4309
138711452,138716617,chrX,FGF13-AS1,chrX:138711452-138716617,5165
78422823,78423192,chr13,RPL31P54,chr13:78422823-78423192,369
14057457,14132490,chr18,ZNF519,chr18:14057457-14132490,75033
120930250,120932301,chrX,CT47A12,chrX:120930250-120932301,2051
11011748,11013096,chr9,AKAP8P1,chr9:11011748-11013096,1348
128714506,128715790,chrX,KRT18P44,chrX:128714506-128715790,1284
15527133,15527683,chr9,FTH1P12,chr9:15527133-15527683,550
39304956,39327362,chrX,LINC01281,chrX:39304956-39327362,22406
3833950,3834728,chr10,LINC02639,chr10:3833950-3834728,778
45702320,45714559,chr13,CBY2,chr13:45702320-45714559,12239
10257169,10257466,chr10,CUX2P1,chr10:10257169-10257466,297
5418373,5418976,chr9,RNF152P1,chr9:5418373-5418976,603
8161260,8162192,chr10,PRPF38AP1,chr10:8161260-8162192,932
21190654,21191244,chr9,IFNWP9,chr9:21190654-21191244,590
28598668,28599292,chr9,KCTD10P1,chr9:28598668-28599292,624
149825708,149879799,chrX,LINC00850,chrX:149825708-149879799,54091
32783540,32789201,chr9,TMEM215,chr9:32783540-32789201,5661
125326897,125328021,chrX,FBLIM1P1,chrX:125326897-125328021,1124
120158613,120165630,chrX,RHOXF2,chrX:120158613-120165630,7017
6011025,6015625,chr9,RANBP6,chr9:6011025-6015625,4600
11742366,11764070,chr10,ECHDC3,chr10:11742366-11764070,21704
40810027,41216714,chr4,APBB2,chr4:40810027-41216714,406687
148198014,148198878,chrX,HAX1P1,chrX:148198014-148198878,864
31482875,31488039,chr14,GPR33,chr14:31482875-31488039,5164
69937166,69938017,chrX,CNOT7P1,chrX:69937166-69938017,851
26169462,26383597,chr22,SEZ6L,chr22:26169462-26383597,214135
131596121,131596987,chrX,OR7L1P,chrX:131596121-131596987,866
6278667,6279153,chr9,SELENOTP1,chr9:6278667-6279153,486
123561642,123562966,chrX,TUBB4AP1,chrX:123561642-123562966,1324
21216373,21217311,chr9,IFNA16,chr9:21216373-21217311,938
27893348,27894059,chrX,ORC1P1,chrX:27893348-27894059,711
15361393,15362134,chr9,RPL7P33,chr9:15361393-15362134,741
32484098,32484800,chr14,MTCO1P2,chr14:32484098-32484800,702
21384255,21385398,chr9,IFNA2,chr9:21384255-21385398,1143
96620654,96621903,chrX,SKP2P1,chrX:96620654-96621903,1249
51240162,51257655,chr14,TMX1,chr14:51240162-51257655,17493
135583651,135585160,chrX,ETS2P1,chrX:135583651-135585160,1509
62307955,62367312,chr20,LAMA5,chr20:62307955-62367312,59357
21329665,21335404,chr9,KLHL9,chr9:21329665-21335404,5739
31376777,31414912,chr18,DSG4,chr18:31376777-31414912,38135
118346073,118449961,chrX,WDR44,chrX:118346073-118449961,103888
18905419,18935554,chr13,LINC00408,chr13:18905419-18935554,30135
22446824,22455740,chr9,DMRTA1,chr9:22446824-22455740,8916
6350316,6352762,chr10,LINC02656,chr10:6350316-6352762,2446
19053141,19102904,chr9,HAUS6,chr9:19053141-19102904,49763
12195965,12250589,chr10,CDC123,chr10:12195965-12250589,54624
76634775,76635661,chr14,RPSAP3,chr14:76634775-76635661,886
45084107,45116282,chr14,PRPF39,chr14:45084107-45116282,32175
84020327,84020762,chr13,UBE2D3P4,chr13:84020327-84020762,435
26606544,26641793,chr13,WASF3-AS1,chr13:26606544-26641793,35249
81018176,81044691,chr13,LINC00377,chr13:81018176-81044691,26515
42403447,42447684,chr21,UBASH3A,chr21:42403447-42447684,44237
18734080,18734896,chr13,ZNF965P,chr13:18734080-18734896,816
94574054,94596242,chr13,TGDS,chr13:94574054-94596242,22188
31447741,31478702,chr18,DSG3,chr18:31447741-31478702,30961
6748703,6748981,chr9,SNRPEP2,chr9:6748703-6748981,278
106168305,106208956,chrX,PWWP3B,chrX:106168305-106208956,40651
33041765,33076674,chr9,SMU1,chr9:33041765-33076674,34909
136295690,136300298,chrX,STK24P1,chrX:136295690-136300298,4608
70282093,70285002,chrX,RAB41,chrX:70282093-70285002,2909
13308145,13308447,chr10,RBISP1,chr10:13308145-13308447,302
6618716,6625346,chr10,LINC02648,chr10:6618716-6625346,6630
31542146,31556948,chr18,DSG2-AS1,chr18:31542146-31556948,14802
5122087,5135226,chr10,AKR1C5P,chr10:5122087-5135226,13139
13156684,13158136,chr10,BTBD7P1,chr10:13156684-13158136,1452
5364966,5374692,chr10,UCN3,chr10:5364966-5374692,9726
31718893,31719208,chr18,RN7SKP44,chr18:31718893-31719208,315
13317428,13348298,chr10,SEPHS1,chr10:13317428-13348298,30870
31557009,31598833,chr18,TTR,chr18:31557009-31598833,41824
55781132,55796731,chr14,LINC00520,chr14:55781132-55796731,15599
39367285,39391807,chrX,LINC01282,chrX:39367285-39391807,24522
139446891,139447676,chrX,SRD5A1P1,chrX:139446891-139447676,785
106070481,106073202,chrX,CTDSPL2P2,chrX:106070481-106073202,2721
31505946,31506615,chr9,MTCO3P30,chr9:31505946-31506615,669
136665547,136780932,chrX,ARHGEF6,chrX:136665547-136780932,115385
5450503,5470566,chr9,CD274,chr9:5450503-5470566,20063
71913704,71914178,chr13,RPS10P21,chr13:71913704-71914178,474
79166119,79166885,chr13,BCAS2P3,chr13:79166119-79166885,766
18630318,18633634,chr14,LINC02297,chr14:18630318-18633634,3316
27932879,28177946,chr18,CDH2,chr18:27932879-28177946,245067
71296210,71297235,chr13,RABEPKP1,chr13:71296210-71297235,1025
84176419,84177088,chr14,MTCYBP27,chr14:84176419-84177088,669
62122461,62135374,chr20,LSM14B,chr20:62122461-62135374,12913
81661428,81662874,chr14,EEF1A1P2,chr14:81661428-81662874,1446
28300346,28495145,chr13,FLT1,chr13:28300346-28495145,194799
45706250,45715952,chr14,LINC02303,chr14:45706250-45715952,9702
77098126,77117287,chr14,CIPC,chr14:77098126-77117287,19161
13099449,13138308,chr10,OPTN,chr10:13099449-13138308,38859
112381392,112382220,chrX,CCDC121P1,chrX:112381392-112382220,828
115518182,115562731,chrX,PLS3-AS1,chrX:115518182-115562731,44549
30388935,30575012,chr9,LINC01242,chr9:30388935-30575012,186077
21966929,21967751,chr9,CDKN2A-DT,chr9:21966929-21967751,822
14040716,14041861,chr9,RPL3P11,chr9:14040716-14041861,1145
21802636,21937651,chr9,MTAP,chr9:21802636-21937651,135015
111665811,111760649,chrX,ALG13,chrX:111665811-111760649,94838
16223750,16224535,chr20,PPIAP17,chr20:16223750-16224535,785
59577509,59847711,chr20,PHACTR3,chr20:59577509-59847711,270202
65197254,65222443,chr14,LINC02324,chr14:65197254-65222443,25189
91603173,91603433,chr14,POLR3GP1,chr14:91603173-91603433,260
42417497,42417593,chr21,RNU6-1149P,chr21:42417497-42417593,96
42807378,42808112,chr14,YWHAQP1,chr14:42807378-42808112,734
42472486,42496246,chr21,RSPH1,chr21:42472486-42496246,23760
93237550,93333092,chr14,BTBD7,chr14:93237550-93333092,95542
42496008,42581440,chr21,SLC37A1,chr21:42496008-42581440,85432
44876874,44897077,chr14,RRAGAP1-AS1,chr14:44876874-44897077,20203
47200575,47201104,chr14,RPL13AP2,chr14:47200575-47201104,529
21349835,21351378,chr9,IFNA6,chr9:21349835-21351378,1543
21929457,21931073,chr9,ERVFRD-3,chr9:21929457-21931073,1616
51989514,52010694,chr14,RTRAF,chr14:51989514-52010694,21180
4768617,4769895,chr9,ECM1P1,chr9:4768617-4769895,1278
42599280,42615058,chr21,LINC01671,chr21:42599280-42615058,15778
22747700,22748234,chr9,CLIC4P1,chr9:22747700-22748234,534
14921013,15146401,chr9,CLCN3P1,chr9:14921013-15146401,225388
42653621,42775509,chr21,PDE9A,chr21:42653621-42775509,121888
33019682,33020165,chr9,LAGE3P1,chr9:33019682-33020165,483
27948078,28670286,chr9,LINGO2,chr9:27948078-28670286,722208
3775996,3785281,chr10,KLF6,chr10:3775996-3785281,9285
49049687,49049768,chr18,MIR4744,chr18:49049687-49049768,81
25937912,25938434,chr9,FAM71BP1,chr9:25937912-25938434,522
17447145,17448543,chr9,SAMM50P1,chr9:17447145-17448543,1398
49469803,49470223,chr18,PRR13P4,chr18:49469803-49470223,420
35449748,35450352,chr9,ZFAND6P1,chr9:35449748-35450352,604
49481681,49492479,chr18,RPL17-C18orf32,chr18:49481681-49492479,10798
6675284,6675614,chr9,RPL35AP20,chr9:6675284-6675614,330
6834456,6835577,chr9,ACTG1P14,chr9:6834456-6835577,1121
15464066,15510995,chr9,PSIP1,chr9:15464066-15510995,46929
64080082,64100643,chr20,OPRL1,chr20:64080082-64100643,20561
36758202,36776256,chr22,IFT27,chr22:36758202-36776256,18054
4871901,4891975,chr10,AKR1C6P,chr10:4871901-4891975,20074
48885019,48906937,chr4,OCIAD2,chr4:48885019-48906937,21918
6010689,6062370,chr10,IL2RA,chr10:6010689-6062370,51681
97632647,97686658,chr14,LINC02291,chr14:97632647-97686658,54011
45203190,45253540,chr14,MIS18BP1,chr14:45203190-45253540,50350
49487373,49487422,chr18,MIR1539,chr18:49487373-49487422,49
49489245,49489308,chr18,SNORD58C,chr18:49489245-49489308,63
49491283,49491347,chr18,SNORD58A,chr18:49491283-49491347,64
49491664,49491729,chr18,SNORD58B,chr18:49491664-49491729,65
49495147,49496896,chr18,SRP72P1,chr18:49495147-49496896,1749
49499390,49501860,chr18,LINC02837,chr18:49499390-49501860,2470
49560699,49599185,chr18,LIPG,chr18:49560699-49599185,38486
64073181,64079988,chr20,RGS19,chr20:64073181-64079988,6807
6071514,6071918,chr10,RPL32P23,chr10:6071514-6071918,404
7788147,7807815,chr10,ATP5F1C,chr10:7788147-7807815,19668
33407957,33443763,chr20,SNTA1,chr20:33407957-33443763,35806
49548918,49549435,chr4,MTCO3P42,chr4:49548918-49549435,517
44290997,44291718,chr14,YWHAZP1,chr14:44290997-44291718,721
89417354,89419793,chr14,FOXN3-AS1,chr14:89417354-89419793,2439
40423267,40630875,chr4,RBM47,chr4:40423267-40630875,207608
39223359,39244982,chr22,PDGFB,chr22:39223359-39244982,21623
64255695,64287821,chr20,PCMTD2,chr20:64255695-64287821,32126
32329298,32837684,chr14,AKAP6,chr14:32329298-32837684,508386
49036387,49461347,chr18,DYM,chr18:49036387-49461347,424960
29415264,29416911,chr20,FRG2EP,chr20:29415264-29416911,1647
64290187,64292998,chr20,CICP4,chr20:64290187-64292998,2811
64049836,64072347,chr20,TCEA2,chr20:64049836-64072347,22511
32886601,33025130,chr9,APTX,chr9:32886601-33025130,138529
43411196,43507848,chr22,MPPED1,chr22:43411196-43507848,96652
8619933,8620608,chr10,CHCHD3P1,chr10:8619933-8620608,675
9721963,9724416,chr10,HSP90AB7P,chr10:9721963-9724416,2453
4384246,4410614,chr10,LINC00703,chr10:4384246-4410614,26368
136648158,136660390,chrX,CD40LG,chrX:136648158-136660390,12232
12129637,12169961,chr10,SEC61A2,chr10:12129637-12169961,40324
51158282,51159383,chr18,SRSF10P1,chr18:51158282-51159383,1101
51283733,51283896,chr18,RNU1-46P,chr18:51283733-51283896,163
51174550,51218333,chr18,MEX3C,chr18:51174550-51218333,43783
7430285,7434930,chr4,PSAPL1,chr4:7430285-7434930,4645
137441258,137441836,chrX,RAC1P4,chrX:137441258-137441836,578
149878836,149881070,chrX,MAGEA8-AS1,chrX:149878836-149881070,2234
55105904,55124306,chr18,LINC01929,chr18:55105904-55124306,18402
28772674,28789301,chr22,CCDC117,chr22:28772674-28789301,16627
136487947,136493780,chrX,BRS3,chrX:136487947-136493780,5833
55146546,55146645,chr18,RNA5SP459,chr18:55146546-55146645,99
37590800,37686376,chr4,RELL1,chr4:37590800-37686376,95576
64224194,64230607,chrX,ASB12,chrX:64224194-64230607,6413
118632375,118634218,chrX,RBBP8P1,chrX:118632375-118634218,1843
120933840,120937158,chrX,CT47A11,chrX:120933840-120937158,3318
83903437,83915377,chr14,LINC02305,chr14:83903437-83915377,11940
145768095,145768342,chrX,UFM1P1,chrX:145768095-145768342,247
38207904,38213067,chr14,SSTR1,chr14:38207904-38213067,5163
138614727,139222777,chrX,FGF13,chrX:138614727-139222777,608050
64610980,64611308,chr4,MTND3P24,chr4:64610980-64611308,328
25678850,25679020,chr4,RPS29P11,chr4:25678850-25679020,170
100291116,100306547,chr14,SLC25A29,chr14:100291116-100306547,15431
48135783,48269838,chr4,TEC,chr4:48135783-48269838,134055
55222185,55664787,chr18,TCF4,chr18:55222185-55664787,442602
44172956,44219533,chr22,PARVG,chr22:44172956-44219533,46577
66977432,66985776,chr13,PCDH9-AS3,chr13:66977432-66985776,8344
120868611,120869807,chrX,PA2G4P1,chrX:120868611-120869807,1196
64185117,64205708,chrX,AMER1,chrX:64185117-64205708,20591
143025918,143034702,chrX,SPANXN4,chrX:143025918-143034702,8784
99200774,99386504,chr13,UBAC2,chr13:99200774-99386504,185730
96223108,96223347,chr14,CKS1BP1,chr14:96223108-96223347,239
137566127,137577691,chrX,ZIC3,chrX:137566127-137577691,11564
84172841,84173606,chr14,MTND4P33,chr14:84172841-84173606,765
128838441,128838834,chrX,RPL32P35,chrX:128838441-128838834,393
138806374,138807091,chrX,TPM2P1,chrX:138806374-138807091,717
122538253,122539460,chrX,RPL3P12,chrX:122538253-122539460,1207
151023607,151023722,chrX,RPL12P50,chrX:151023607-151023722,115
39182504,39285810,chr4,WDR19,chr4:39182504-39285810,103306
119379712,119380104,chrX,MRPS17P9,chrX:119379712-119380104,392
141241463,141242517,chrX,SPANXC,chrX:141241463-141242517,1054
2368561,2502200,chr10,LINC02645,chr10:2368561-2502200,133639
80476983,80959517,chr14,CEP128,chr14:80476983-80959517,482534
104566199,105767829,chrX,IL1RAPL2,chrX:104566199-105767829,1201630
62463497,62475995,chr20,GATA5,chr20:62463497-62475995,12498
6709530,6740532,chr10,LINP1,chr10:6709530-6740532,31002
148464708,148465428,chrX,RPL7L1P11,chrX:148464708-148465428,720
4963253,4983283,chr10,AKR1C1,chr10:4963253-4983283,20030
145247503,145256208,chrX,SPANXN1,chrX:145247503-145256208,8705
63956704,63969930,chr20,ZNF512B,chr20:63956704-63969930,13226
153075769,153076968,chrX,PNMA6B,chrX:153075769-153076968,1199
141838316,141897832,chrX,MAGEC3,chrX:141838316-141897832,59516
38346482,38377013,chr20,LBP,chr20:38346482-38377013,30531
43957027,43957348,chr22,RPL35AP36,chr22:43957027-43957348,321
46049478,46054144,chr22,PRR34,chr22:46049478-46054144,4666
149768897,149771368,chrX,TMEM185AP1,chrX:149768897-149771368,2471
33818069,33966558,chr13,RFC3,chr13:33818069-33966558,148489
135673591,135686151,chrX,SAGE2P,chrX:135673591-135686151,12560
145630218,145632375,chrX,TRMT1P1,chrX:145630218-145632375,2157
38219291,38273010,chr22,TMEM184B,chr22:38219291-38273010,53719
126472885,126473281,chrX,MTND4P24,chrX:126472885-126473281,396
135598927,135615431,chrX,SAGE4P,chrX:135598927-135615431,16504
132217053,132432862,chrX,RAP2C-AS1,chrX:132217053-132432862,215809
135730733,135732197,chrX,MGAT2P1,chrX:135730733-135732197,1464
131324391,131325313,chrX,OR11N1P,chrX:131324391-131325313,922
143884071,143885255,chrX,UBE2NL,chrX:143884071-143885255,1184
59933764,59948680,chr20,FAM217B,chr20:59933764-59948680,14916
149774068,149776867,chrX,HSFX1,chrX:149774068-149776867,2799
155061622,155071136,chrX,CMC4,chrX:155061622-155071136,9514
148546878,148547397,chrX,AFF2-IT1,chrX:148546878-148547397,519
2169140,2189512,chr10,LINC02662,chr10:2169140-2189512,20372
36996349,37095997,chr20,RBL1,chr20:36996349-37095997,99648
110636841,110637672,chrX,M6PRP1,chrX:110636841-110637672,831
120109051,120115913,chrX,RHOXF1,chrX:120109051-120115913,6862
114774828,114776775,chrX,HSPA8P7,chrX:114774828-114776775,1947
143343976,143344585,chrX,PGBD4P6,chrX:143343976-143344585,609
13159477,13159777,chr10,RPL36AP36,chr10:13159477-13159777,300
131619013,131619951,chrX,OR2AF1P,chrX:131619013-131619951,938
141583674,141585011,chrX,SPANXA1,chrX:141583674-141585011,1337
14959388,14988050,chr10,MEIG1,chr10:14959388-14988050,28662
56978409,56979621,chr14,RPL3P3,chr14:56978409-56979621,1212
137660519,137662242,chrX,ZFYVE9P1,chrX:137660519-137662242,1723
149881141,149885835,chrX,MAGEA8,chrX:149881141-149885835,4694
73058532,73123899,chr14,RBM25,chr14:73058532-73123899,65367
8897989,8914596,chr10,LINC02676,chr10:8897989-8914596,16607
10174230,10174577,chr10,ELOCP3,chr10:10174230-10174577,347
112454500,112457112,chrX,RTL4,chrX:112454500-112457112,2612
115664895,115666133,chrX,ASS1P5,chrX:115664895-115666133,1238
43110750,43129712,chr22,BIK,chr22:43110750-43129712,18962
149476988,149521096,chrX,IDS,chrX:149476988-149521096,44108
58524515,58536328,chr4,LINC02494,chr4:58524515-58536328,11813
11393150,11429564,chr4,HS3ST1,chr4:11393150-11429564,36414
7703316,7749520,chr10,ITIH2,chr10:7703316-7749520,46204
124501,202303,chr4,ZNF718,chr4:124501-202303,77802
40043068,40044530,chr22,TNRC6B-DT,chr22:40043068-40044530,1462
43039516,43089419,chr22,TTLL1,chr22:43039516-43089419,49903
38823715,38856817,chr4,TLR6,chr4:38823715-38856817,33102
38922727,38936199,chr13,ANKRD26P2,chr13:38922727-38936199,13472
38564003,38572022,chr4,LINC02278,chr4:38564003-38572022,8019
94436811,94479682,chr13,DCT,chr13:94436811-94479682,42871
28996498,29017256,chr4,LINC02364,chr4:28996498-29017256,20758
29430723,29432913,chr20,AGGF1P10,chr20:29430723-29432913,2190
58309715,58367507,chr20,RAB22A,chr20:58309715-58367507,57792
62510469,62510771,chr4,HMGN1P11,chr4:62510469-62510771,302
40020240,40021517,chr4,KRT18P25,chr4:40020240-40021517,1277
41256413,41268455,chr4,UCHL1,chr4:41256413-41268455,12042
153271618,153277803,chrX,PWWP4,chrX:153271618-153277803,6185
151175192,151177836,chrX,GPR50-AS1,chrX:151175192-151177836,2644
63953384,63956985,chr20,UCKL1-AS1,chr20:63953384-63956985,3601
3489529,3491005,chr20,SF3A3P1,chr20:3489529-3491005,1476
120953282,120956600,chrX,CT47A7,chrX:120953282-120956600,3318
59300443,59325992,chr20,EDN3,chr20:59300443-59325992,25549
143677153,143678362,chrX,HNRNPH1P2,chrX:143677153-143678362,1209
141111605,141177129,chrX,LDOC1,chrX:141111605-141177129,65524
155064034,155147937,chrX,MTCP1,chrX:155064034-155147937,83903
15553043,16061663,chr9,CCDC171,chr9:15553043-16061663,508620
143433042,143433958,chrX,MTND1P33,chrX:143433042-143433958,916
45413693,45432509,chr22,RIBC2,chr22:45413693-45432509,18816
152166234,152451315,chrX,GABRA3,chrX:152166234-152451315,285081
9758783,9878060,chr10,LINC02663,chr10:9758783-9878060,119277
4650158,4678185,chr10,MANCR,chr10:4650158-4678185,28027
78598362,78603552,chr13,POU4F1,chr13:78598362-78603552,5190
99446311,99564048,chr13,TM9SF2,chr13:99446311-99564048,117737
6144934,6254644,chr10,PFKFB3,chr10:6144934-6254644,109710
141261119,141264213,chrX,RBMX2P2,chrX:141261119-141264213,3094
37608725,37633564,chr22,GGA1,chr22:37608725-37633564,24839
149688228,149717268,chrX,MAGEA11,chrX:149688228-149717268,29040
62572671,62573384,chr20,RPL7P3,chr20:62572671-62573384,713
59460619,59460837,chr20,PIEZO1P1,chr20:59460619-59460837,218
135637623,135642756,chrX,SAGE3P,chrX:135637623-135642756,5133
151176584,151181465,chrX,GPR50,chrX:151176584-151181465,4881
38033725,38127780,chr20,RPRD1B,chr20:38033725-38127780,94055
72777608,72779097,chrX,FAM226B,chrX:72777608-72779097,1489
33166948,33182865,chr9,B4GALT1-AS1,chr9:33166948-33182865,15917
138482745,138483695,chrX,MAGEA13P,chrX:138482745-138483695,950
124375903,124963817,chrX,TENM1,chrX:124375903-124963817,587914
6413151,6507054,chr9,UHRF2,chr9:6413151-6507054,93903
64102394,64242253,chr20,MYT1,chr20:64102394-64242253,139859
25357764,25358689,chr14,OR7K1P,chr14:25357764-25358689,925
104223584,104288069,chr14,LINC02691,chr14:104223584-104288069,64485
101442076,101444315,chr14,LINC02314,chr14:101442076-101444315,2239
93333219,93707876,chr14,UNC79,chr14:93333219-93707876,374657
77697687,77764242,chr13,SLAIN1,chr13:77697687-77764242,66555
151563675,151676739,chrX,PASD1,chrX:151563675-151676739,113064
34120090,34335351,chr4,LINC02484,chr4:34120090-34335351,215261
16226685,16320140,chr4,TAPT1-AS1,chr4:16226685-16320140,93455
31644576,31645160,chr9,HMGB3P23,chr9:31644576-31645160,584
6662424,6663792,chr9,RPS3AP54,chr9:6662424-6663792,1368
48490252,48494389,chr4,ZAR1,chr4:48490252-48494389,4137
131273506,131578899,chrX,IGSF1,chrX:131273506-131578899,305393
25624045,25689032,chr20,ZNF337-AS1,chr20:25624045-25689032,64987
21638285,21638676,chr9,H3P30,chr9:21638285-21638676,391
21695176,21696943,chr9,KHSRPP1,chr9:21695176-21696943,1767
17579066,17797124,chr9,SH3GL2,chr9:17579066-17797124,218058
62302093,62308862,chr20,ADRM1,chr20:62302093-62308862,6769
51843000,51916837,chr4,DCUN1D4,chr4:51843000-51916837,73837
14068932,14069417,chr9,ATP5PDP3,chr9:14068932-14069417,485
21367424,21368962,chr9,IFNA13,chr9:21367424-21368962,1538
23681894,23682662,chr9,NOP56P2,chr9:23681894-23682662,768
21201469,21202205,chr9,IFNA7,chr9:21201469-21202205,736
35962195,36014623,chr9,OR2S1P,chr9:35962195-36014623,52428
30831878,30832225,chr9,RPS26P2,chr9:30831878-30832225,347
37434177,37434586,chr9,CHCHD4P3,chr9:37434177-37434586,409
12775020,12823060,chr9,LURAP1L,chr9:12775020-12823060,48040
37383178,37384434,chr9,LINC01627,chr9:37383178-37384434,1256
37073531,37075792,chr9,LINC01400,chr9:37073531-37075792,2261
21227243,21228222,chr9,IFNA17,chr9:21227243-21228222,979
22012155,22012536,chr9,UBA52P6,chr9:22012155-22012536,381
15588355,15588615,chr9,HMGN2P16,chr9:15588355-15588615,260
6704270,6707780,chr9,LINC02851,chr9:6704270-6707780,3510
21231266,21231853,chr9,IFNWP5,chr9:21231266-21231853,587
27608382,27610745,chr9,CTAGE12P,chr9:27608382-27610745,2363
21420234,21420813,chr9,IFNWP2,chr9:21420234-21420813,579
21398614,21399139,chr9,IFNA11P,chr9:21398614-21399139,525
35771974,35950370,chr20,PHF20,chr20:35771974-35950370,178396
29824742,29826711,chr9,ME2P1,chr9:29824742-29826711,1969
21455484,21456049,chr9,IFNWP19,chr9:21455484-21456049,565
6668999,6670008,chr9,RNF2P1,chr9:6668999-6670008,1009
32926051,32926450,chr9,BOLA3P4,chr9:32926051-32926450,399
32945996,32947222,chr9,ASS1P12,chr9:32945996-32947222,1226
30558880,30559481,chr9,SLC4A1APP1,chr9:30558880-30559481,601
37477149,37478317,chr9,KCTD9P3,chr9:37477149-37478317,1168
42497704,42499134,chr9,RBPJP6,chr9:42497704-42499134,1430
57999735,58298139,chr14,ARMH4,chr14:57999735-58298139,298404
36336396,36487548,chr9,RNF38,chr9:36336396-36487548,151152
91418266,91421176,chr14,CCDC88C-DT,chr14:91418266-91421176,2910
57200507,57268905,chr14,EXOC5,chr14:57200507-57268905,68398
19747172,19747435,chr10,MTND1P37,chr10:19747172-19747435,263
6293100,6294684,chr10,SDCBPP1,chr10:6293100-6294684,1584
13277796,13302412,chr10,PHYH,chr10:13277796-13302412,24616
73036401,73036848,chr13,PSMD10P3,chr13:73036401-73036848,447
131795657,131796167,chrX,MCRIP2P1,chrX:131795657-131796167,510
126729104,126730226,chrX,MTCYBP38,chrX:126729104-126730226,1122
27307777,27318501,chr22,LINC02554,chr22:27307777-27318501,10724
23979805,24307074,chr13,SPATA13,chr13:23979805-24307074,327269
149808214,149809155,chrX,MAGEA7P,chrX:149808214-149809155,941
153317680,153321767,chrX,PNMA6F,chrX:153317680-153321767,4087
134961711,134962305,chrX,HMGB3P31,chrX:134961711-134962305,594
37675636,37679802,chr22,LGALS1,chr22:37675636-37679802,4166
149929527,149938700,chrX,EOLA2,chrX:149929527-149938700,9173
35850674,35850915,chr20,COX7BP2,chr20:35850674-35850915,241
33290512,33371157,chr9,NFX1,chr9:33290512-33371157,80645
6089034,6117457,chr10,RBM17,chr10:6089034-6117457,28423
20721187,20721879,chr20,LLPHP1,chr20:20721187-20721879,692
20854121,20854642,chr20,MRPS11P1,chr20:20854121-20854642,521
34844720,34872856,chr20,GGT7,chr20:34844720-34872856,28136
41074180,41075239,chr22,ACTBP15,chr22:41074180-41075239,1059
1210120,1218591,chr4,CTBP1-AS,chr4:1210120-1218591,8471
46255663,46263343,chr22,PKDREJ,chr22:46255663-46263343,7680
54332892,54355954,chr4,LINC02283,chr4:54332892-54355954,23062
23326616,23328493,chr22,LINC02556,chr22:23326616-23328493,1877
393534,393658,chr4,ZNF519P4,chr4:393534-393658,124
93347182,93348356,chr14,COX8C,chr14:93347182-93348356,1174
37830855,37849327,chr22,ANKRD54,chr22:37830855-37849327,18472
155025980,155060304,chrX,FUNDC2,chrX:155025980-155060304,34324
100238298,100282788,chr14,YY1,chr14:100238298-100282788,44490
61143656,61153962,chr4,LINC02271,chr4:61143656-61153962,10306
705748,770640,chr4,PCGF3,chr4:705748-770640,64892
13104574,13104793,chr10,SNRPGP5,chr10:13104574-13104793,219
12165330,12196144,chr10,NUDT5,chr10:12165330-12196144,30814
141380823,141381107,chrX,NDUFB3P5,chrX:141380823-141381107,284
149527591,149540959,chrX,LINC00893,chrX:149527591-149540959,13368
45290036,45290386,chr14,DNAJC19P9,chr14:45290036-45290386,350
63974116,63980008,chr20,SAMD10,chr20:63974116-63980008,5892
47444106,47444494,chr14,RPS15AP3,chr14:47444106-47444494,388
80211419,80455469,chr14,DIO2-AS1,chr14:80211419-80455469,244050
141138478,141139174,chrX,RPL36AP52,chrX:141138478-141139174,696
90267860,90331969,chr14,NRDE2,chr14:90267860-90331969,64109
42733594,42741758,chr21,PDE9A-AS1,chr21:42733594-42741758,8164
43322417,43332039,chr21,LINC00322,chr21:43322417-43332039,9622
149540355,149550510,chrX,EOLA1,chrX:149540355-149550510,10155
52110344,52111049,chr20,ERP29P1,chr20:52110344-52111049,705
43414483,43427131,chr21,SIK1,chr21:43414483-43427131,12648
2652777,2652842,chr20,MIR1292,chr20:2652777-2652842,65
2654212,2654286,chr20,SNORD110,chr20:2654212-2654286,74
2655067,2655198,chr20,SNORA51,chr20:2655067-2655198,131
2656097,2656182,chr20,SNORD86,chr20:2656097-2656182,85
2656624,2656694,chr20,SNORD56,chr20:2656624-2656694,70
2656939,2657010,chr20,SNORD57,chr20:2656939-2657010,71
5890055,5890212,chr20,RNU1-55P,chr20:5890055-5890212,157
6001733,6002030,chr20,RN7SL498P,chr20:6001733-6002030,297
7371608,7371692,chr20,MIR8062,chr20:7371608-7371692,84
13973316,13973424,chr20,RNU6-278P,chr20:13973316-13973424,108
14223041,14223325,chr20,RN7SL864P,chr20:14223041-14223325,284
14352320,14352425,chr20,RNU6-228P,chr20:14352320-14352425,105
15021553,15021659,chr20,RNU6-1159P,chr20:15021553-15021659,106
15022852,15022958,chr20,RNU6-115P,chr20:15022852-15022958,106
15280764,15280873,chr20,RNA5SP475,chr20:15280764-15280873,109
62559839,62569907,chr9,CNTNAP3P5,chr9:62559839-62569907,10068
17576206,17576510,chr20,RN7SKP69,chr20:17576206-17576510,304
17187510,17187616,chr20,RNU6-27P,chr20:17187510-17187616,106
7633562,7633851,chr20,RN7SL547P,chr20:7633562-7633851,289
18592330,18592619,chr20,RN7SL638P,chr20:18592330-18592619,289
43446601,43453902,chr21,LINC00319,chr21:43446601-43453902,7301
18611047,18611167,chr20,RNU6ATAC34P,chr20:18611047-18611167,120
18433842,18433944,chr20,RNA5SP476,chr20:18433842-18433944,102
62452451,62522018,chr9,LINC01189,chr9:62452451-62522018,69567
20738433,20738731,chr20,RN7SL607P,chr20:20738433-20738731,298
17209060,17209220,chr20,RNU1-131P,chr20:17209060-17209220,160
5098387,5098476,chr20,RNA5SP474,chr20:5098387-5098476,89
66082350,66083187,chr9,SNX18P4,chr9:66082350-66083187,837
11818821,11819091,chr20,RN7SKP111,chr20:11818821-11819091,270
24974171,24974280,chr20,RNU6-1257P,chr20:24974171-24974280,109
43461960,43479534,chr21,LINC00313,chr21:43461960-43479534,17574
30935485,30935977,chr9,FTLP4,chr9:30935485-30935977,492
1666360,1666640,chr20,RN7SL561P,chr20:1666360-1666640,280
8831186,8831393,chr20,RNU105B,chr20:8831186-8831393,207
20316755,20316994,chr20,RN7SL690P,chr20:20316755-20316994,239
21424758,21425041,chr20,RN7SKP140,chr20:21424758-21425041,283
12896625,13099652,chr10,CCDC3,chr10:12896625-13099652,203027
25611153,25611223,chr20,RNU6ATAC17P,chr20:25611153-25611223,70
23160857,23160971,chr20,RNA5SP478,chr20:23160857-23160971,114
24237255,24237398,chr20,RNU1-23P,chr20:24237255-24237398,143
43529186,43659488,chr21,HSF2BP,chr21:43529186-43659488,130302
30816156,30816274,chr20,RNA5SP528,chr20:30816156-30816274,118
18470615,18470691,chr20,MIR3192,chr20:18470615-18470691,76
31356870,31356978,chr20,RNA5SP480,chr20:31356870-31356978,108
39155525,39155945,chr22,FUNDC2P4,chr22:39155525-39155945,420
25654595,25654881,chr20,RN7SL594P,chr20:25654595-25654881,286
10649636,10649695,chr20,MIR6870,chr20:10649636-10649695,59
34049119,34049190,chr20,MIR4755,chr20:34049119-34049190,71
38442036,38442169,chr20,SNORA71,chr20:38442036-38442169,133
35887659,35887801,chr20,RNU4-40P,chr20:35887659-35887801,142
43151547,43163242,chr22,TSPO,chr22:43151547-43163242,11695
35928570,35928675,chr20,RNU6-937P,chr20:35928570-35928675,105
26647986,26653454,chr10,FAM238B,chr10:26647986-26653454,5468
43796437,43796543,chr20,RNU6-639P,chr20:43796437-43796543,106
29874059,29874177,chr20,RNA5SP532,chr20:29874059-29874177,118
38872770,38873074,chr20,RN7SL116P,chr20:38872770-38873074,304
34466325,34466418,chr20,MIR644A,chr20:34466325-34466418,93
38098414,38098700,chr20,RN7SL237P,chr20:38098414-38098700,286
39349094,39349392,chr20,RN7SL680P,chr20:39349094-39349392,298
26208186,26208278,chr20,MIR663A,chr20:26208186-26208278,92
99500190,99604207,chr14,CCDC85C,chr14:99500190-99604207,104017
47166967,47167058,chr20,MIR3616,chr20:47166967-47167058,91
19489101,19489400,chr10,HMGN1P20,chr10:19489101-19489400,299
48494234,48494309,chr20,RNU7-144P,chr20:48494234-48494309,75
49794811,49794914,chr20,RNU6-919P,chr20:49794811-49794914,103
51902291,51902395,chr20,RNU6-347P,chr20:51902291-51902395,104
13221766,13234374,chr10,UCMA,chr10:13221766-13234374,12608
51904969,51905030,chr20,RNU7-6P,chr20:51904969-51905030,61
9493736,9498066,chr4,UNC93B7,chr4:9493736-9498066,4330
1980290,2193624,chr9,SMARCA2,chr9:1980290-2193624,213334
38427309,38427442,chr20,SNORA71A,chr20:38427309-38427442,133
37001772,37023499,chr4,LINC02616,chr4:37001772-37023499,21727
38429670,38429803,chr20,SNORA71C,chr20:38429670-38429803,133
38433865,38433998,chr20,SNORA71D,chr20:38433865-38433998,133
43551229,43551600,chr21,RPL31P1,chr21:43551229-43551600,371
49972106,49972212,chr20,RNU6-147P,chr20:49972106-49972212,106
43565182,43565648,chr21,H2BS1,chr21:43565182-43565648,466
47484278,47484381,chr20,RNU6-497P,chr20:47484278-47484381,103
56205052,56205173,chr20,RNA5SP487,chr20:56205052-56205173,121
56667430,56667531,chr20,RNU6-1146P,chr20:56667430-56667531,101
43609887,43609989,chr21,MIR6070,chr21:43609887-43609989,102
51452905,51452977,chr20,MIR3194,chr20:51452905-51452977,72
25719755,25720030,chr4,MTND4LP22,chr4:25719755-25720030,275
56785981,56786087,chr20,RNU6-929P,chr20:56785981-56786087,106
53668697,53668758,chr20,RNU7-14P,chr20:53668697-53668758,61
54859688,54859812,chr20,RNU4ATAC7P,chr20:54859688-54859812,124
57321502,57321591,chr20,MIR4325,chr20:57321502-57321591,89
7750962,7787993,chr10,KIN,chr10:7750962-7787993,37031
53097652,53097984,chr20,RN7SKP184,chr20:53097652-53097984,332
44133610,44210114,chr21,GATD3A,chr21:44133610-44210114,76504
49721949,49722247,chr20,RN7SL197P,chr20:49721949-49722247,298
59852667,59852728,chr20,RNU7-141P,chr20:59852667-59852728,61
37975156,37975481,chr20,RN7SKP185,chr20:37975156-37975481,325
60308474,60308567,chr20,MIR646,chr20:60308474-60308567,93
60478111,60478181,chr20,MIR4533,chr20:60478111-60478181,70
60564562,60564625,chr20,MIR548AG2,chr20:60564562-60564625,63
43063326,43063609,chr20,RN7SKP100,chr20:43063326-43063609,283
62554306,62554376,chr20,MIR1-1,chr20:62554306-62554376,70
62564912,62565013,chr20,MIR133A2,chr20:62564912-62565013,101
46859333,46859672,chr20,RN7SKP33,chr20:46859333-46859672,339
46723830,46724408,chr4,RAC1P2,chr4:46723830-46724408,578
63942631,63942726,chr20,MIR647,chr20:63942631-63942726,95
56688401,56688695,chr20,RN7SL170P,chr20:56688401-56688695,294
49213911,49214247,chr22,RPL35P8,chr22:49213911-49214247,336
63941465,63941544,chr20,MIR1914,chr20:63941465-63941544,79
153179284,153183880,chrX,MAGEA1,chrX:153179284-153183880,4596
64076955,64077010,chr20,MIR6813,chr20:64076955-64077010,55
46993723,47426447,chr4,GABRB1,chr4:46993723-47426447,432724
22588155,22588688,chr22,IGLV2-33,chr22:22588155-22588688,533
62332487,62332557,chr20,MIR4758,chr20:62332487-62332557,70
47492978,47493085,chr20,RNU6-563P,chr20:47492978-47493085,107
63908955,63909119,chr20,RNU1-134P,chr20:63908955-63909119,164
63919756,63919827,chr20,MIR941-4,chr20:63919756-63919827,71
63919868,63919939,chr20,MIR941-5,chr20:63919868-63919939,71
63919449,63919520,chr20,MIR941-1,chr20:63919449-63919520,71
141697411,141698739,chrX,SPANXD,chrX:141697411-141698739,1328
63919505,63919576,chr20,MIR941-2,chr20:63919505-63919576,71
63919561,63919632,chr20,MIR941-3,chr20:63919561-63919632,71
45306840,45317824,chr20,RBPJL,chr20:45306840-45317824,10984
143434517,143435280,chrX,MTND2P39,chrX:143434517-143435280,763
144309132,144309693,chrX,RRM2P4,chrX:144309132-144309693,561
106693794,106797016,chrX,RNF128,chrX:106693794-106797016,103222
56813183,57152177,chr14,OTX2-AS1,chr14:56813183-57152177,338994
31122731,31134697,chr22,INPP5J,chr22:31122731-31134697,11966
37960398,37961128,chr4,PTTG2,chr4:37960398-37961128,730
9754898,9755778,chr4,OR7E35P,chr4:9754898-9755778,880
8513687,8515106,chr10,KRT8P37,chr10:8513687-8515106,1419
152479577,152481024,chrX,KRT8P8,chrX:152479577-152481024,1447
47593999,47838106,chr4,CORIN,chr4:47593999-47838106,244107
102224500,102305190,chr14,MOK,chr14:102224500-102305190,80690
138487665,138488871,chrX,KRT8P6,chrX:138487665-138488871,1206
146553728,146555765,chrX,ELL2P4,chrX:146553728-146555765,2037
5861616,5889906,chr10,ANKRD16,chr10:5861616-5889906,28290
136532215,136556807,chrX,VGLL1,chrX:136532215-136556807,24592
146619597,146620584,chrX,ANKRD11P2,chrX:146619597-146620584,987
153395639,153401392,chrX,PNMA6E,chrX:153395639-153401392,5753
149525001,149526043,chrX,IDSP1,chrX:149525001-149526043,1042
141903894,141909374,chrX,MAGEC1,chrX:141903894-141909374,5480
45325288,45348424,chr20,SDC4,chr20:45325288-45348424,23136
112630648,112680054,chrX,LHFPL1,chrX:112630648-112680054,49406
154835788,155026940,chrX,F8,chrX:154835788-155026940,191152
45361937,45376798,chr20,SYS1,chr20:45361937-45376798,14861
11920022,12043170,chr10,UPF2,chr10:11920022-12043170,123148
44217014,44240966,chr21,ICOSLG,chr21:44217014-44240966,23952
45363200,45410610,chr20,SYS1-DBNDD2,chr20:45363200-45410610,47410
151226229,151227715,chrX,NAB1P1,chrX:151226229-151227715,1486
144840777,144841660,chrX,HNRNPCP10,chrX:144840777-144841660,883
45372557,45407889,chr20,TP53TG5,chr20:45372557-45407889,35332
131646639,131646890,chrX,HDGFP1,chrX:131646639-131646890,251
44246339,44262216,chr21,DNMT3L,chr21:44246339-44262216,15877
126819729,126821786,chrX,PRR32,chrX:126819729-126821786,2057
117399452,117400081,chrX,TCERG1P1,chrX:117399452-117400081,629
146809771,146810411,chrX,CXorf51B,chrX:146809771-146810411,640
45388347,45388705,chr20,NDUFB4P10,chr20:45388347-45388705,358
45425510,45425573,chr20,MIR6812,chr20:45425510-45425573,63
148500617,149000663,chrX,AFF2,chrX:148500617-149000663,500046
58634772,58635738,chr20,LINC01711,chr20:58634772-58635738,966
58651253,58679526,chr20,STX16,chr20:58651253-58679526,28273
5943639,5978187,chr10,IL15RA,chr10:5943639-5978187,34548
44250813,44251520,chr21,DNMT3L-AS1,chr21:44250813-44251520,707
44285838,44298648,chr21,AIRE,chr21:44285838-44298648,12810
49210422,49212294,chr13,OGFOD1P1,chr13:49210422-49212294,1872
73564244,73588070,chr13,LINC00392,chr13:73564244-73588070,23826
39038306,39050109,chr13,NHLRC3,chr13:39038306-39050109,11803
44300051,44327376,chr21,PFKL,chr21:44300051-44327376,27325
103215108,103217246,chrX,BEX4,chrX:103215108-103217246,2138
39822863,39977956,chr4,PDS5A,chr4:39822863-39977956,155093
58165827,58209483,chr13,LINC02338,chr13:58165827-58209483,43656
81113699,81201913,chrX,HMGN5,chrX:81113699-81201913,88214
94960041,94961319,chr13,LINC00557,chr13:94960041-94961319,1278
53028813,53052057,chr13,OLFM4,chr13:53028813-53052057,23244
100756551,100757059,chr13,ARF4P3,chr13:100756551-100757059,508
87379472,87380258,chr13,LIN28AP2,chr13:87379472-87380258,786
65309855,65310953,chr13,STARP1,chr13:65309855-65310953,1098
78908919,78910542,chr13,CCT5P2,chr13:78908919-78910542,1623
24566843,24570728,chr13,PSPC1P2,chr13:24566843-24570728,3885
57140918,57143939,chr13,PRR20A,chr13:57140918-57143939,3021
75250480,75252012,chr13,LINC01078,chr13:75250480-75252012,1532
97953658,98024296,chr13,IPO5,chr13:97953658-98024296,70638
43038585,43052366,chr22,TTLL1-AS1,chr22:43038585-43052366,13781
43212674,43213661,chr22,SCUBE1-AS2,chr22:43212674-43213661,987
112689915,112690520,chrX,HMGB3P30,chrX:112689915-112690520,605
22758700,22759218,chr22,IGLV2-14,chr22:22758700-22759218,518
136213220,136256482,chrX,MAP7D3,chrX:136213220-136256482,43262
44569295,44572453,chr22,LINC00207,chr22:44569295-44572453,3158
95686426,95692628,chr14,TCL1B,chr14:95686426-95692628,6202
38290691,38318084,chr22,CSNK1E,chr22:38290691-38318084,27393
102362941,102502477,chr14,TECPR2,chr14:102362941-102502477,139536
96883908,96885467,chrX,RPA4,chrX:96883908-96885467,1559
126549383,126552814,chrX,DCAF12L1,chrX:126549383-126552814,3431
116963049,116963676,chrX,SETP8,chrX:116963049-116963676,627
63299247,63299673,chrX,CBX1P1,chrX:63299247-63299673,426
131424301,131425239,chrX,OR1AA1P,chrX:131424301-131425239,938
121047610,121050094,chrX,GLUD2,chrX:121047610-121050094,2484
134887632,134915257,chrX,MOSPD1,chrX:134887632-134915257,27625
44328944,44339402,chr21,CFAP410,chr21:44328944-44339402,10458
64607703,64608831,chr4,MTCYBP16,chr4:64607703-64608831,1128
129041536,129043183,chrX,TJAP1P1,chrX:129041536-129043183,1647
115702811,115704120,chrX,EEF1GP5,chrX:115702811-115704120,1309
141177284,141649927,chrX,SPANXA2-OT1,chrX:141177284-141649927,472643
55427903,55546909,chr4,CLOCK,chr4:55427903-55546909,119006
111706649,111711101,chrX,ALG13-AS1,chrX:111706649-111711101,4452
106802673,106876150,chrX,TBC1D8B,chrX:106802673-106876150,73477
14878820,14904315,chr10,SUV39H2,chr10:14878820-14904315,25495
95573520,95582305,chr14,LINC02318,chr14:95573520-95582305,8785
44414588,44425272,chr21,TRPM2-AS,chr21:44414588-44425272,10684
44450986,44455284,chr21,LRRC3-DT,chr21:44450986-44455284,4298
58651434,58715410,chr20,STX16-NPEPL1,chr20:58651434-58715410,63976
44455510,44462196,chr21,LRRC3,chr21:44455510-44462196,6686
44469929,44472516,chr21,MTCYBP21,chr21:44469929-44472516,2587
44472895,44473739,chr21,MTND6P21,chr21:44472895-44473739,844
44473723,44475097,chr21,MTND5P1,chr21:44473723-44475097,1374
44497893,44711572,chr21,TSPEAR,chr21:44497893-44711572,213679
58689131,58719238,chr20,NPEPL1,chr20:58689131-58719238,30107
51436038,51436963,chr14,SETP2,chr14:51436038-51436963,925
90256527,90275429,chr14,PSMC1,chr14:90256527-90275429,18902
128440929,128441785,chrX,RUVBL2P1,chrX:128440929-128441785,856
96953630,96954195,chrX,NDUFB5P2,chrX:96953630-96954195,565
106813871,107000212,chrX,MORC4,chrX:106813871-107000212,186341
13057902,13058676,chr10,RPL5P25,chr10:13057902-13058676,774
25113058,25161236,chr10,LINC01516,chr10:25113058-25161236,48178
15075475,15088776,chr10,ACBD7,chr10:15075475-15088776,13301
44506807,44516575,chr21,TSPEAR-AS1,chr21:44506807-44516575,9768
19747823,19748621,chr10,MTND2P16,chr10:19747823-19748621,798
24157835,24158781,chr10,NUP35P1,chr10:24157835-24158781,946
102002125,102003310,chr13,LIPT1P1,chr13:102002125-102003310,1185
69101832,69102056,chr13,SNRPFP3,chr13:69101832-69102056,224
44517216,44525952,chr21,TSPEAR-AS2,chr21:44517216-44525952,8736
15097180,15139818,chr10,RPP38,chr10:15097180-15139818,42638
44538981,44540195,chr21,KRTAP10-1,chr21:44538981-44540195,1214
44550357,44551505,chr21,KRTAP10-2,chr21:44550357-44551505,1148
44557790,44558795,chr21,KRTAP10-3,chr21:44557790-44558795,1005
44579455,44580604,chr21,KRTAP10-5,chr21:44579455-44580604,1149
44591268,44592505,chr21,KRTAP10-6,chr21:44591268-44592505,1237
59665583,60163928,chr13,DIAPH3,chr13:59665583-60163928,498345
44600597,44602174,chr21,KRTAP10-7,chr21:44600597-44602174,1577
44612079,44612954,chr21,KRTAP10-8,chr21:44612079-44612954,875
41092592,41180077,chr22,EP300,chr22:41092592-41180077,87485
44637356,44638455,chr21,KRTAP10-10,chr21:44637356-44638455,1099
106327534,106327824,chrX,CSGALNACT2P2,chrX:106327534-106327824,290
7559270,7666998,chr10,ITIH5,chr10:7559270-7666998,107728
44646414,44647650,chr21,KRTAP10-11,chr21:44646414-44647650,1236
52314305,52328598,chr14,PTGER2,chr14:52314305-52328598,14293
44654213,44654659,chr21,KRTAP12-4,chr21:44654213-44654659,446
44657932,44658341,chr21,KRTAP12-3,chr21:44657932-44658341,409
44666189,44666927,chr21,KRTAP12-2,chr21:44666189-44666927,738
155197007,155239841,chrX,VBP1,chrX:155197007-155239841,42834
44675868,44678086,chr21,IMMTP1,chr21:44675868-44678086,2218
44681576,44682163,chr21,KRTAP12-1,chr21:44681576-44682163,587
44686358,44686629,chr21,KRTAP12-6P,chr21:44686358-44686629,271
44697172,44698044,chr21,KRTAP10-12,chr21:44697172-44698044,872
58740532,58783821,chr20,PIEZO1P2,chr20:58740532-58783821,43289
44702221,44702791,chr21,KRTAP10-13P,chr21:44702221-44702791,570
44768580,44801826,chr21,UBE2G2,chr21:44768580-44801826,33246
58817615,58817694,chr20,MIR296,chr20:58817615-58817694,79
58818226,58818313,chr20,MIR298,chr20:58818226-58818313,87
134949549,134953382,chrX,LINC02243,chrX:134949549-134953382,3833
115003975,115019977,chrX,IL13RA2,chrX:115003975-115019977,16002
58981208,58995133,chr20,NELFCD,chr20:58981208-58995133,13925
49618530,49620626,chr14,RPL36AL,chr14:49618530-49620626,2096
51649516,51651744,chr14,FRMD6-AS1,chr14:51649516-51651744,2228
102932380,103057549,chr14,CDC42BPB,chr14:102932380-103057549,125169
8366282,8440723,chr4,ACOX3,chr4:8366282-8440723,74441
5154140,5185187,chr10,AKR1C8P,chr10:5154140-5185187,31047
44885953,44931989,chr21,ITGB2,chr21:44885953-44931989,46036
72578814,72714319,chrX,PHKA1,chrX:72578814-72714319,135505
13643706,14462142,chr10,FRMD4A,chr10:13643706-14462142,818436
31346777,31348719,chr22,LINC01521,chr22:31346777-31348719,1942
40859549,40862113,chr22,DNAJB7,chr22:40859549-40862113,2564
22762294,22762516,chr22,IGLV3-13,chr22:22762294-22762516,222
40798039,40798285,chr22,JTBP1,chr22:40798039-40798285,246
41207592,41228500,chr22,L3MBTL2-AS1,chr22:41207592-41228500,20908
40951347,40973309,chr22,RBX1,chr22:40951347-40973309,21962
22697789,22698407,chr22,IGLV2-23,chr22:22697789-22698407,618
22918132,22918201,chr22,IGLJ6,chr22:22918132-22918201,69
25647261,25649232,chr22,YES1P1,chr22:25647261-25649232,1971
38468078,38483447,chr22,KDELR3,chr22:38468078-38483447,15369
31134807,31140508,chr22,PLA2G3,chr22:31134807-31140508,5701
17809348,17911164,chr10,MRC1,chr10:17809348-17911164,101816
100323339,100330421,chr14,SLC25A47,chr14:100323339-100330421,7082
39901084,39973721,chr22,GRAP2,chr22:39901084-39973721,72637
86006893,86062981,chr14,LINC02316,chr14:86006893-86062981,56088
84173791,84175510,chr14,MTND5P35,chr14:84173791-84175510,1719
75368427,75523502,chrX,ZDHHC15,chrX:75368427-75523502,155075
59019429,59026654,chr20,TUBB1,chr20:59019429-59026654,7225
42561457,42562425,chr4,CCNL2P1,chr4:42561457-42562425,968
89736965,89738391,chr14,CHORDC2P,chr14:89736965-89738391,1426
31506422,31558831,chr4,LINC02501,chr4:31506422-31558831,52409
28587446,29956718,chrX,IL1RAPL1,chrX:28587446-29956718,1369272
54221126,54221472,chr4,RPL22P13,chr4:54221126-54221472,346
59025475,59032345,chr20,ATP5F1E,chr20:59025475-59032345,6870
99169287,99272197,chr14,BCL11B,chr14:99169287-99272197,102910
29697935,29698174,chr10,CKS1BP2,chr10:29697935-29698174,239
31325804,31346346,chr22,PATZ1,chr22:31325804-31346346,20542
17386919,17445758,chr10,ST8SIA6-AS1,chr10:17386919-17445758,58839
67468762,67545503,chr4,CENPC,chr4:67468762-67545503,76741
114389135,114389954,chrX,TNPO3P1,chrX:114389135-114389954,819
118128748,118129018,chrX,TUBB4BP3,chrX:118128748-118129018,270
72044545,72044892,chrX,RPS26P11,chrX:72044545-72044892,347
120250752,120258398,chrX,ZBTB33,chrX:120250752-120258398,7646
26664206,26697295,chr10,SELENOOLP,chr10:26664206-26697295,33089
40618738,40621348,chr13,RLIMP1,chr13:40618738-40621348,2610
18659431,18681639,chr10,ARL5B,chr10:18659431-18681639,22208
28107431,28107877,chr13,CHCHD2P8,chr13:28107431-28107877,446
59033145,59042809,chr20,PRELID3B,chr20:59033145-59042809,9664
69408216,69408735,chr13,SRSF1P1,chr13:69408216-69408735,519
65866070,65922731,chr13,LINC01052,chr13:65866070-65922731,56661
100539901,100540248,chr13,RPS26P47,chr13:100539901-100540248,347
119249346,119257667,chrX,AKAP17BP,chrX:119249346-119257667,8321
94757451,94759272,chr13,BRD7P5,chr13:94757451-94759272,1821
90890954,90926597,chr13,LINC00410,chr13:90890954-90926597,35643
72127110,72131901,chrX,RTL5,chrX:72127110-72131901,4791
57631744,57729311,chr13,PCDH17,chr13:57631744-57729311,97567
14986942,14987515,chr10,OR7E110P,chr10:14986942-14987515,573
16823966,17129811,chr10,CUBN,chr10:16823966-17129811,305845
118146063,118146561,chrX,RPL12P43,chrX:118146063-118146561,498
28659065,28659469,chrX,H3P43,chrX:28659065-28659469,404
155212921,155213638,chrX,CD84P1,chrX:155212921-155213638,717
72660470,72660719,chrX,MATR3P1,chrX:72660470-72660719,249
114390674,114391256,chrX,SSU72P1,chrX:114390674-114391256,582
62212577,62249947,chr13,LINC01075,chr13:62212577-62249947,37370
89361160,89363224,chr13,SP3P,chr13:89361160-89363224,2064
72703693,72704138,chr13,RPL21P110,chr13:72703693-72704138,445
136300963,136416890,chrX,ADGRG4,chrX:136300963-136416890,115927
77895481,77975529,chr13,EDNRB,chr13:77895481-77975529,80048
59113224,59113631,chr20,MRPS16P2,chr20:59113224-59113631,407
35433029,35435450,chr20,GDF5-AS1,chr20:35433029-35435450,2421
22919535,22919851,chr22,IGLC6,chr22:22919535-22919851,316
35433347,35454746,chr20,GDF5,chr20:35433347-35454746,21399
46039907,46044853,chr22,LINC00899,chr22:46039907-46044853,4946
43516107,43560063,chr22,EFCAB6-AS1,chr22:43516107-43560063,43956
96456576,96457041,chr14,RPL23AP10,chr14:96456576-96457041,465
96279195,96363341,chr14,ATG2B,chr14:96279195-96363341,84146
35453954,35454097,chr20,MIR1289-1,chr20:35453954-35454097,143
44243665,44312951,chr22,SHISAL1,chr22:44243665-44312951,69286
35455164,35519280,chr20,CEP250,chr20:35455164-35519280,64116
43275955,43283830,chr22,SCUBE1-AS1,chr22:43275955-43283830,7875
22914237,22914308,chr22,IGLJ5,chr22:22914237-22914308,71
44443327,44444788,chr22,LINC01656,chr22:44443327-44444788,1461
66497748,66499424,chrX,PKMP2,chrX:66497748-66499424,1676
44849585,44873903,chr21,PTTG1IP,chr21:44849585-44873903,24318
40857077,40932815,chr22,XPNPEP3,chr22:40857077-40932815,75738
112319952,112320417,chrX,DPRXP7,chrX:112319952-112320417,465
153052150,153052413,chrX,HMGN2P48,chrX:153052150-153052413,263
75384346,75384828,chrX,RPL21P134,chrX:75384346-75384828,482
30017160,30017881,chrX,PIGFP3,chrX:30017160-30017881,721
106466542,106467440,chrX,NAP1L4P2,chrX:106466542-106467440,898
155258235,155264491,chrX,RAB39B,chrX:155258235-155264491,6256
135520083,135520674,chrX,INTS6L-AS1,chrX:135520083-135520674,591
114589620,114589935,chrX,RPL36AP53,chrX:114589620-114589935,315
147801005,147801302,chrX,SLIRPP1,chrX:147801005-147801302,297
49233289,49233965,chr4,SNX18P23,chr4:49233289-49233965,676
93670930,93673578,chrX,NAP1L3,chrX:93670930-93673578,2648
150993501,150994091,chrX,RPL19P21,chrX:150993501-150994091,590
89181324,89280240,chr13,LINC00440,chr13:89181324-89280240,98916
44940012,44976989,chr21,SLX9,chr21:44940012-44976989,36977
150980509,150990771,chrX,HMGB3,chrX:150980509-150990771,10262
37220860,37221246,chr13,RPS12P24,chr13:37220860-37221246,386
42810366,42814897,chr13,LINC01050,chr13:42810366-42814897,4531
32351038,32353220,chr4,LINC02353,chr4:32351038-32353220,2182
27066156,27171811,chr13,USP12,chr13:27066156-27171811,105655
64611374,64611888,chr4,MTCO3P28,chr4:64611374-64611888,514
22915635,22915927,chr22,IGLC5,chr22:22915635-22915927,292
41935129,41960803,chr4,TMEM33,chr4:41935129-41960803,25674
106170749,106171052,chr14,IGHVIII-16-1,chr14:106170749-106171052,303
51454512,51599952,chr14,FRMD6-AS2,chr14:51454512-51599952,145440
28883572,29057488,chr22,ZNRF3,chr22:28883572-29057488,173916
81272891,81273170,chr13,HIGD1AP2,chr13:81272891-81273170,279
106268606,106269140,chr14,IGHV3-23,chr14:106268606-106269140,534
25158072,25176276,chr10,GPR158-AS1,chr10:25158072-25176276,18204
91414878,91434999,chrX,PABPC5-AS1,chrX:91414878-91434999,20121
44989864,44994086,chr21,LINC00163,chr21:44989864-44994086,4222
75620434,75859870,chr13,LMO7,chr13:75620434-75859870,239436
118727133,118794535,chrX,IL13RA1,chrX:118727133-118794535,67402
90847861,91060641,chr14,RPS6KA5,chr14:90847861-91060641,212780
17137336,17202054,chr10,TRDMT1,chr10:17137336-17202054,64718
44994362,44995185,chr21,LINC00165,chr21:44994362-44995185,823
44999208,45004727,chr21,PICSAR,chr21:44999208-45004727,5519
45070952,45074165,chr21,SSR4P1,chr21:45070952-45074165,3213
45234308,45264548,chr21,LINC00334,chr21:45234308-45264548,30240
45263928,45287898,chr21,POFUT2,chr21:45263928-45287898,23970
42835412,43015149,chr22,PACSIN2,chr22:42835412-43015149,179737
64275257,64409468,chr4,TECRL,chr4:64275257-64409468,134211
116688870,116690185,chrX,SLC6A14P2,chrX:116688870-116690185,1315
116669810,116680303,chrX,SLC6A14P1,chrX:116669810-116680303,10493
46288016,46289128,chrX,ACTBP1,chrX:46288016-46289128,1112
114584078,114910061,chrX,HTR2C,chrX:114584078-114910061,325983
35523186,35529652,chr20,C20orf173,chr20:35523186-35529652,6466
131341570,131342425,chrX,OR5AW1P,chrX:131341570-131342425,855
106264688,106264715,chr14,IGHVIII-22-2,chr14:106264688-106264715,27
106611930,106679439,chrX,RADX,chrX:106611930-106679439,67509
102501767,102509799,chr14,ANKRD9,chr14:102501767-102509799,8032
75354076,75362566,chr4,LINC02483,chr4:75354076-75362566,8490
49561479,49562149,chr4,SNX18P24,chr4:49561479-49562149,670
35544430,35544747,chr20,RPL36P4,chr20:35544430-35544747,317
16513734,16521879,chr10,C1QL3,chr10:16513734-16521879,8145
69004862,69020414,chr4,UGT2B27P,chr4:69004862-69020414,15552
35558737,35607562,chr20,FER1L4,chr20:35558737-35607562,48825
45300245,45305257,chr21,LINC00315,chr21:45300245-45305257,5012
45338590,45341990,chr21,LINC00316,chr21:45338590-45341990,3400
15778170,15860507,chr10,MINDY3,chr10:15778170-15860507,82337
45827961,45837987,chr21,PCBP3-AS1,chr21:45827961-45837987,10026
106373663,106374145,chr14,IGHV4-34,chr14:106373663-106374145,482
51392128,51397135,chr14,LINC02310,chr14:51392128-51397135,5007
53986587,53987058,chr4,RPL21P44,chr4:53986587-53987058,471
87634379,87655294,chr14,LINC02330,chr14:87634379-87655294,20915
62816826,62818794,chr4,EXOC5P1,chr4:62816826-62818794,1968
11740948,11769468,chr4,LINC02360,chr4:11740948-11769468,28520
45643694,45942454,chr21,PCBP3,chr21:45643694-45942454,298760
4894182,4895173,chr4,LDHAP1,chr4:4894182-4895173,991
95533503,95544724,chr14,GLRX5,chr14:95533503-95544724,11221
58103147,58103434,chr4,SRIP1,chr4:58103147-58103434,287
45323253,45326028,chr4,THAP12P9,chr4:45323253-45326028,2775
116461686,116462976,chrX,CT83,chrX:116461686-116462976,1290
13546075,13547801,chr4,LINC01096,chr4:13546075-13547801,1726
131562729,131563846,chrX,OR13K1P,chrX:131562729-131563846,1117
141589708,141590762,chrX,SPANXA2,chrX:141589708-141590762,1054
88018181,88036319,chr14,LINC01147,chr14:88018181-88036319,18138
40316485,40330419,chr4,LINC02265,chr4:40316485-40330419,13934
69408828,69423164,chr4,UGT2B24P,chr4:69408828-69423164,14336
101405984,101408258,chr14,LINC00524,chr14:101405984-101408258,2274
3572857,3572961,chrX,RNU6-114P,chrX:3572857-3572961,104
8126965,8127061,chrX,MIR651,chrX:8126965-8127061,96
3532117,3532251,chrX,SNORA48B,chrX:3532117-3532251,134
96392128,96489427,chr14,AK7,chr14:96392128-96489427,97299
66431092,66431521,chr4,RPS23P3,chr4:66431092-66431521,429
6383906,6383963,chrX,MIR4770,chrX:6383906-6383963,57
11318614,11318686,chrX,MIR548AX,chrX:11318614-11318686,72
3607258,3607365,chrX,RNU6-146P,chrX:3607258-3607365,107
16539137,16539439,chrX,RN7SL658P,chrX:16539137-16539439,302
53377641,53460862,chr4,FIP1L1,chr4:53377641-53460862,83221
16627012,16627085,chrX,MIR548AM,chrX:16627012-16627085,73
9133828,9133946,chrX,RNA5SP499,chrX:9133828-9133946,118
1293918,1293992,chrX,MIR3690,chrX:1293918-1293992,74
1300256,1300375,chrX,RNA5SP498,chrX:1300256-1300375,119
20452108,20452431,chrX,RN7SKP183,chrX:20452108-20452431,323
16875146,16875267,chrX,RNU4-6P,chrX:16875146-16875267,121
21214637,21214743,chrX,RNU6-133P,chrX:21214637-21214743,106
28982852,28982970,chrX,RNA5SP500,chrX:28982852-28982970,118
37794276,37796109,chr10,ZNF33BP1,chr10:37794276-37796109,1833
29574278,29574358,chrX,MIR4666B,chrX:29574278-29574358,80
16767844,16767905,chrX,RNU7-56P,chrX:16767844-16767905,61
28495555,28495663,chrX,MIR6134,chrX:28495555-28495663,108
36021939,36022045,chrX,RNU6-641P,chrX:36021939-36022045,106
39081180,39081285,chrX,RNU6-591P,chrX:39081180-39081285,105
37870109,37870215,chrX,RNU6-49P,chrX:37870109-37870215,106
22928024,23038523,chr10,ARMC3,chr10:22928024-23038523,110499
38023895,38023986,chrX,MIR548AJ2,chrX:38023895-38023986,91
38608215,38608276,chrX,RNU7-7P,chrX:38608215-38608276,61
35594173,35594273,chrX,RNU6-1087P,chrX:35594173-35594273,100
39786524,39786823,chrX,RN7SL732P,chrX:39786524-39786823,299
39661216,39661321,chrX,MIR3937,chrX:39661216-39661321,105
40535502,40535563,chrX,RNU7-164P,chrX:40535502-40535563,61
42174279,42174385,chrX,RNU6-1124P,chrX:42174279-42174385,106
42139425,42139530,chrX,RNU6-630P,chrX:42139425-42139530,105
45746157,45746266,chrX,MIR221,chrX:45746157-45746266,109
46517766,46517868,chrX,RNU6-50P,chrX:46517766-46517868,102
45747015,45747124,chrX,MIR222,chrX:45747015-45747124,109
54814370,54814497,chrX,SNORA11,chrX:54814370-54814497,127
49945336,49945442,chrX,RNU6-421P,chrX:49945336-49945442,106
50003148,50003238,chrX,MIR532,chrX:50003148-50003238,90
50003503,50003588,chrX,MIR188,chrX:50003503-50003588,85
50008431,50008514,chrX,MIR500A,chrX:50008431-50008514,83
50008964,50009028,chrX,MIR362,chrX:50008964-50009028,64
50009722,50009805,chrX,MIR501,chrX:50009722-50009805,83
50010672,50010750,chrX,MIR500B,chrX:50010672-50010750,78
50013241,50013337,chrX,MIR660,chrX:50013241-50013337,96
90453571,90490763,chr14,LINC00642,chr14:90453571-90490763,37192
50014598,50014683,chrX,MIR502,chrX:50014598-50014683,85
54343546,54343652,chrX,RNU6-434P,chrX:54343546-54343652,106
64210691,64210988,chrX,RN7SL799P,chrX:64210691-64210988,297
66018870,66018979,chrX,MIR223,chrX:66018870-66018979,109
70222006,70222314,chrX,RN7SL581P,chrX:70222006-70222314,308
70396279,70396375,chrX,RNY4P23,chrX:70396279-70396375,96
70846080,70846295,chrX,SNORD3E,chrX:70846080-70846295,215
52336557,52336642,chrX,MIR8088,chrX:52336557-52336642,85
55451495,55451582,chrX,MIR4536-2,chrX:55451495-55451582,87
70022857,70022923,chrX,MIR676,chrX:70022857-70022923,66
71965972,71966074,chrX,RNU6-1078P,chrX:71965972-71966074,102
75202703,75202809,chrX,RNU6-562P,chrX:75202703-75202809,106
70450879,70451022,chrX,RNU4-81P,chrX:70450879-70451022,143
55451495,55451582,chrX,MIR4536-1,chrX:55451495-55451582,87
77066709,77066827,chrX,RNA5SP509,chrX:77066709-77066827,118
69672479,69672597,chrX,5S_rRNA,chrX:69672479-69672597,118
73397531,73397637,chrX,RNU6-1044P,chrX:73397531-73397637,106
78901194,78901249,chrX,MIR4328,chrX:78901194-78901249,55
72198712,72199050,chrX,RN7SL388P,chrX:72198712-72199050,338
70253042,70253162,chrX,RNA5SP507,chrX:70253042-70253162,120
72376979,72377169,chrX,RNU2-68P,chrX:72376979-72377169,190
74390692,74390989,chrX,RN7SL790P,chrX:74390692-74390989,297
85835780,85835858,chrX,MIR1321,chrX:85835780-85835858,78
84225752,84225828,chrX,MIR548I4,chrX:84225752-84225828,76
76244968,76245074,chrX,RNU6-867P,chrX:76244968-76245074,106
91798093,91798283,chrX,RNU2-26P,chrX:91798093-91798283,190
94003815,94003922,chrX,RNU6-332P,chrX:94003815-94003922,107
95582064,95582162,chrX,RNA5SP510,chrX:95582064-95582162,98
95063141,95063226,chrX,MIR548M,chrX:95063141-95063226,85
76919273,76919360,chrX,MIR384,chrX:76919273-76919360,87
77005404,77005501,chrX,MIR325,chrX:77005404-77005501,97
72740706,72740869,chrX,RNU1-112P,chrX:72740706-72740869,163
76655009,76655127,chrX,RNA5SP508,chrX:76655009-76655127,118
85903636,85903707,chrX,MIR361,chrX:85903636-85903707,71
21383374,21389478,chr22,RIMBP3B,chr22:21383374-21389478,6104
82001220,82001327,chrX,RNU6-974P,chrX:82001220-82001327,107
80936434,80936540,chrX,RNU6-995P,chrX:80936434-80936540,106
101915589,101915695,chrX,RNU6-345P,chrX:101915589-101915695,106
80900757,80900864,chrX,RNU6-493P,chrX:80900757-80900864,107
66676258,66676364,chrX,RNU6-394P,chrX:66676258-66676364,106
103733195,103847575,chr14,PPP1R13B,chr14:103733195-103847575,114380
36950529,36953723,chr22,CSF2RBP1,chr22:36950529-36953723,3194
96410432,96410782,chrX,RN7SKP194,chrX:96410432-96410782,350
108826764,108826869,chrX,RNU6-309P,chrX:108826764-108826869,105
74218549,74218618,chrX,MIR374C,chrX:74218549-74218618,69
74242608,74242908,chrX,RN7SL648P,chrX:74242608-74242908,300
46914092,46916042,chr22,TBC1D22A-AS1,chr22:46914092-46916042,1950
115032427,115032533,chrX,RNU6-648P,chrX:115032427-115032533,106
97341046,97341344,chrX,RN7SL74P,chrX:97341046-97341344,298
21417371,21451463,chr22,HIC2,chr22:21417371-21451463,34092
74287104,74287209,chrX,MIR545,chrX:74287104-74287209,105
111669829,111669948,chrX,RNA5SP512,chrX:111669829-111669948,119
115126316,115126444,chrX,SNORA35B,chrX:115126316-115126444,128
74287286,74287357,chrX,MIR374A,chrX:74287286-74287357,71
114630797,114630924,chrX,SNORA35,chrX:114630797-114630924,127
74218377,74218461,chrX,MIR421,chrX:74218377-74218461,84
114639435,114639519,chrX,MIR764,chrX:114639435-114639519,84
114651544,114651623,chrX,MIR1912,chrX:114651544-114651623,79
74218547,74218618,chrX,MIR374B,chrX:74218547-74218618,71
114652655,114652723,chrX,MIR1264,chrX:114652655-114652723,68
114715233,114715344,chrX,MIR1298,chrX:114715233-114715344,111
114763184,114763263,chrX,MIR1911,chrX:114763184-114763263,79
114823454,114823564,chrX,MIR448,chrX:114823454-114823564,110
90597235,90597340,chrX,RNU6-555P,chrX:90597235-90597340,105
96023360,96023652,chrX,RN7SL379P,chrX:96023360-96023652,292
119456558,119456658,chrX,RNY3P16,chrX:119456558-119456658,100
116850839,116850945,chrX,RNU6-1323P,chrX:116850839-116850945,106
106639814,106639896,chrX,MIR548AN,chrX:106639814-106639896,82
116400848,116400953,chrX,RNU6-154P,chrX:116400848-116400953,105
105676071,105676177,chrX,RNU6-207P,chrX:105676071-105676177,106
121370972,121371053,chrX,MIR3672,chrX:121370972-121371053,81
112919132,112919230,chrX,RNU6-1015P,chrX:112919132-112919230,98
119423742,119423905,chrX,RNU1-67P,chrX:119423742-119423905,163
119434519,119434820,chrX,RN7SL118P,chrX:119434519-119434820,301
123772078,123772139,chrX,RNU7-69P,chrX:123772078-123772139,61
134918310,134918416,chrX,RNU6-616P,chrX:134918310-134918416,106
118386394,118386471,chrX,MIR1277,chrX:118386394-118386471,77
138397351,138397628,chrX,RN7SKP31,chrX:138397351-138397628,277
138667711,138667793,chrX,MIR504,chrX:138667711-138667793,82
136550878,136550960,chrX,MIR934,chrX:136550878-136550960,82
141118030,141118136,chrX,RNU6-3P,chrX:141118030-141118136,106
143197248,143197591,chrX,RN7SKP149,chrX:143197248-143197591,343
146427456,146427572,chrX,RNA5SP517,chrX:146427456-146427572,116
142411053,142411171,chrX,RNA5SP516,chrX:142411053-142411171,118
147281943,147282030,chrX,MIR514A2,chrX:147281943-147282030,87
147279247,147279344,chrX,MIR514A1,chrX:147279247-147279344,97
143090347,143090677,chrX,RN7SKP81,chrX:143090347-143090677,330
123811331,123811587,chrX,RN7SL190P,chrX:123811331-123811587,256
140926172,140926219,chrX,MIR320D2,chrX:140926172-140926219,47
137595265,137595547,chrX,RN7SL325P,chrX:137595265-137595547,282
145992750,145992826,chrX,MIR892C,chrX:145992750-145992826,76
136583240,136583345,chrX,RNU6-320P,chrX:136583240-136583345,105
147284641,147284728,chrX,MIR514A3,chrX:147284641-147284728,87
145994275,145994351,chrX,MIR890,chrX:145994275-145994351,76
137687891,137687994,chrX,RNU6-985P,chrX:137687891-137687994,103
145994784,145994860,chrX,MIR888,chrX:145994784-145994860,76
145996669,145996743,chrX,MIR892A,chrX:145996669-145996743,74
145997198,145997274,chrX,MIR892B,chrX:145997198-145997274,76
146001053,146001131,chrX,MIR891B,chrX:146001053-146001131,78
133238657,133238816,chrX,RNU1-115P,chrX:133238657-133238816,159
147272335,147272408,chrX,MIR510,chrX:147272335-147272408,73
150955494,150955587,chrX,RNU6-383P,chrX:150955494-150955587,93
146027794,146027872,chrX,MIR891A,chrX:146027794-146027872,78
41464300,41531116,chr21,TMPRSS2,chr21:41464300-41531116,66816
151168222,151168326,chrX,MIR4330,chrX:151168222-151168326,104
148822164,148822448,chrX,RN7SKP267,chrX:148822164-148822448,284
145057108,145057437,chrX,RN7SKP189,chrX:145057108-145057437,329
151026295,151026406,chrX,RNA5SP525,chrX:151026295-151026406,111
152250572,152250676,chrX,RNU6-764P,chrX:152250572-152250676,104
147189704,147189787,chrX,MIR513C,chrX:147189704-147189787,83
147199044,147199127,chrX,MIR513B,chrX:147199044-147199127,83
152392219,152392299,chrX,MIR105-1,chrX:152392219-152392299,80
147213463,147213591,chrX,MIR513A1,chrX:147213463-147213591,128
152393421,152393529,chrX,MIR767,chrX:152393421-152393529,108
147225826,147225952,chrX,MIR513A2,chrX:147225826-147225952,126
152394412,152394492,chrX,MIR105-2,chrX:152394412-152394492,80
147230720,147230843,chrX,MIR506,chrX:147230720-147230843,123
147230984,147231077,chrX,MIR507,chrX:147230984-147231077,93
147236913,147237027,chrX,MIR508,chrX:147236913-147237027,114
147250151,147250230,chrX,MIR514B,chrX:147250151-147250230,79
147258760,147258850,chrX,MIR509-2,chrX:147258760-147258850,90
147259652,147259726,chrX,MIR509-3,chrX:147259652-147259726,74
147260532,147260625,chrX,MIR509-1,chrX:147260532-147260625,93
147827279,147827384,chrX,RNU6-382P,chrX:147827279-147827384,105
47273366,47274390,chrX,NICN2P,chrX:47273366-47274390,1024
47280811,47281063,chrX,RN7SL785P,chrX:47280811-47281063,252
47388649,47388777,chrX,SNORA11C,chrX:47388649-47388777,128
47438736,47439774,chrX,NPM1P49,chrX:47438736-47439774,1038
47483571,47484823,chrX,LINC01560,chrX:47483571-47484823,1252
65770955,65771434,chr9,IGKV1OR-3,chr9:65770955-65771434,479
47512602,47513483,chrX,NUS1P1,chrX:47512602-47513483,881
42410830,42412150,chr9,ATP5F1AP1,chr9:42410830-42412150,1320
60929774,60936746,chr9,FAM74A6,chr9:60929774-60936746,6972
47571901,47619857,chrX,SYN1,chrX:47571901-47619857,47956
35588324,35588607,chr20,RPL37P1,chr20:35588324-35588607,283
23690104,23826337,chr9,ELAVL2,chr9:23690104-23826337,136233
35643143,35643462,chr20,RN7SKP271,chr20:35643143-35643462,319
35647328,35647430,chr20,RNU6-759P,chr20:35647328-35647430,102
35648925,35664956,chr20,RBM12,chr20:35648925-35664956,16031
11611305,11612227,chr10,USP6NL-AS1,chr10:11611305-11612227,922
41359607,41700044,chr4,LIMCH1,chr4:41359607-41700044,340437
15095385,15097319,chr10,RPP38-DT,chr10:15095385-15097319,1934
42279734,42281819,chr10,PABPC1P8,chr10:42279734-42281819,2085
32446140,32882874,chr10,CCDC7,chr10:32446140-32882874,436734
106122420,106122709,chr14,IGHV1-12,chr14:106122420-106122709,289
92794305,92839947,chr14,GOLGA5,chr14:92794305-92839947,45642
44302840,44311202,chr20,FITM2,chr20:44302840-44311202,8362
86725500,86726053,chr13,TXNL1P1,chr13:86725500-86726053,553
44372746,44395706,chr20,HNF4A-AS1,chr20:44372746-44395706,22960
25206049,25206506,chr13,RPL23AP69,chr13:25206049-25206506,457
75871038,75883811,chr13,LMO7DN,chr13:75871038-75883811,12773
44436172,44465349,chr20,LINC01620,chr20:44436172-44465349,29177
80619098,80620067,chr13,HNRNPA1P31,chr13:80619098-80620067,969
47587429,47587505,chrX,MIR4769,chrX:47587429-47587505,76
47635521,47650604,chrX,ELK1,chrX:47635521-47650604,15083
62838824,62844276,chr9,PTGER4P2,chr9:62838824-62844276,5452
77997909,78053604,chr13,LINC00446,chr13:77997909-78053604,55695
68541036,68644442,chr9,TMEM252-DT,chr9:68541036-68644442,103406
44466564,44466842,chr20,RPL37AP1,chr20:44466564-44466842,278
44475874,44494603,chr20,TTPAL,chr20:44475874-44494603,18729
67211663,67213067,chr9,RBM17P2,chr9:67211663-67213067,1404
52167709,52194465,chr13,MRPS31P5,chr13:52167709-52194465,26756
63775892,63776143,chr9,PTGER4P3,chr9:63775892-63776143,251
88005135,88014811,chr14,GPR65,chr14:88005135-88014811,9676
61205258,61212373,chr9,FAM74A4,chr9:61205258-61212373,7115
37422666,37436990,chr9,GRHPR,chr9:37422666-37436990,14324
56488354,56650606,chr14,TMEM260,chr14:56488354-56650606,162252
41061509,41084006,chr13,WBP4,chr13:41061509-41084006,22497
47651796,47659180,chrX,UXT,chrX:47651796-47659180,7384
44496221,44522085,chr20,SERINC3,chr20:44496221-44522085,25864
22922594,22923034,chr22,IGLC7,chr22:22922594-22923034,440
22921390,22921435,chr22,IGLJ7,chr22:22921390-22921435,45
41205282,41231271,chr22,L3MBTL2,chr22:41205282-41231271,25989
47658833,47692326,chrX,UXT-AS1,chrX:47658833-47692326,33493
68878380,68893573,chr13,LINC02342,chr13:68878380-68893573,15193
47707191,47753456,chrX,CXXC1P1,chrX:47707191-47753456,46265
88626853,88630397,chr13,LINC00560,chr13:88626853-88630397,3544
36674020,36697839,chr13,SERTM1,chr13:36674020-36697839,23819
47718002,47719099,chrX,SMSP1,chrX:47718002-47719099,1097
26254104,26405238,chr13,CDK8,chr13:26254104-26405238,151134
47803296,47804789,chrX,WASF4P,chrX:47803296-47804789,1493
47840963,47841702,chrX,RPL7P57,chrX:47840963-47841702,739
47582408,47586789,chrX,TIMP1,chrX:47582408-47586789,4381
41420020,41470071,chr21,MX1,chr21:41420020-41470071,50051
44531785,44624247,chr20,PKIG,chr20:44531785-44624247,92462
21321300,21321827,chr9,IFNA20P,chr9:21321300-21321827,527
67059560,67293468,chr9,CNTNAP3P2,chr9:67059560-67293468,233908
71239624,71255146,chrX,ZMYM3,chrX:71239624-71255146,15522
74722495,74888094,chr9,TRPM6,chr9:74722495-74888094,165599
38696424,38697902,chr10,ACTR3BP5,chr10:38696424-38697902,1478
78488182,78488513,chr13,ELOCP23,chr13:78488182-78488513,331
86332376,86401285,chr14,LINC02309,chr14:86332376-86401285,68909
38635908,38638082,chr10,PABPC1P12,chr10:38635908-38638082,2174
32231849,32232245,chr10,RPS24P13,chr10:32231849-32232245,396
84521725,84523915,chr13,MTND5P3,chr13:84521725-84523915,2190
62406058,62406916,chr13,SQSTM1P1,chr13:62406058-62406916,858
18545561,18659285,chr10,NSUN6,chr10:18545561-18659285,113724
94709622,94712545,chr13,SOX21,chr13:94709622-94712545,2923
87837820,87993665,chr14,GALC,chr14:87837820-87993665,155845
29509414,29595688,chr13,SLC7A1,chr13:29509414-29595688,86274
21125660,21128063,chr22,POM121L7P,chr22:21125660-21128063,2403
21141624,21142371,chr22,E2F6P2,chr22:21141624-21142371,747
37469063,37486393,chr22,MFNG,chr22:37469063-37486393,17330
42747544,42748687,chr10,DUXAP3,chr10:42747544-42748687,1143
15007861,15008884,chr10,OR7E115P,chr10:15007861-15008884,1023
37883594,37884109,chr10,ZNF37CP,chr10:37883594-37884109,515
36870099,36870402,chr20,RN7SL156P,chr20:36870099-36870402,303
36876121,36894235,chr20,TLDC2,chr20:36876121-36894235,18114
22534854,22714578,chr10,PIP4K2A,chr10:22534854-22714578,179724
98683801,98752672,chr13,SLC15A1,chr13:98683801-98752672,68871
37021743,37021984,chr20,RPS3AP3,chr20:37021743-37021984,241
37049254,37049707,chr20,RPS27AP3,chr20:37049254-37049707,453
44007248,44007537,chr20,RN7SL443P,chr20:44007248-44007537,289
44195939,44210771,chr20,OSER1,chr20:44195939-44210771,14832
41361999,41409393,chr21,MX2,chr21:41361999-41409393,47394
44106590,44187188,chr20,JPH2,chr20:44106590-44187188,80598
15701459,15701565,chr22,RNU6-816P,chr22:15701459-15701565,106
22886267,22886379,chr22,MIR5571,chr22:22886267-22886379,112
18605802,18606102,chr22,RN7SKP131,chr22:18605802-18606102,300
10736171,10736283,chr22,U2,chr22:10736171-10736283,112
16486985,16488322,chr22,ACTR3BP6,chr22:16486985-16488322,1337
26390667,26390776,chr22,RNA5SP495,chr22:26390667-26390776,109
25715041,25715169,chr22,RNA5SP494,chr22:25715041-25715169,128
22822776,22822871,chr22,MIR650,chr22:22822776-22822871,95
31160062,31160119,chr22,MIR3928,chr22:31160062-31160119,57
27035887,27035991,chr22,RNU6-1066P,chr22:27035887-27035991,104
31388733,31388837,chr22,RNU6-338P,chr22:31388733-31388837,104
25963983,25964273,chr22,RN7SKP169,chr22:25963983-25964273,290
31222745,31222853,chr22,RNU6-1128P,chr22:31222745-31222853,108
31757202,31757498,chr22,RN7SL20P,chr22:31757202-31757498,296
43405473,43405578,chr20,RNU6-743P,chr20:43405473-43405578,105
27920525,27920612,chr22,MIR3199-1,chr22:27920525-27920612,87
43423196,43423538,chr20,EIF4EBP2P1,chr20:43423196-43423538,342
31305404,31305512,chr22,RNA5SP496,chr22:31305404-31305512,108
27920526,27920611,chr22,MIR3199-2,chr22:27920526-27920611,85
31837238,31837298,chr22,RNU6-201P,chr22:31837238-31837298,60
43457893,43466046,chr20,SRSF6,chr20:43457893-43466046,8153
28056153,28056453,chr22,RN7SL757P,chr22:28056153-28056453,300
28232756,28232823,chr22,SNORD42,chr22:28232756-28232823,67
38231720,38231993,chr22,RN7SL704P,chr22:38231720-38231993,273
39874255,39874515,chr22,RN7SKP210,chr22:39874255-39874515,260
31479383,31479489,chr22,RNU6-28P,chr22:31479383-31479489,106
28459869,28459948,chr22,MIR5739,chr22:28459869-28459948,79
46091044,46091126,chr22,MIR3619,chr22:46091044-46091126,82
39405728,39445805,chr21,LCA5L,chr21:39405728-39445805,40077
29899587,29899693,chr22,RNU6-331P,chr22:29899587-29899693,106
23202696,23344845,chr10,C10orf67,chr10:23202696-23344845,142149
30007049,30007113,chr22,MIR6818,chr22:30007049-30007113,64
31621467,31621531,chr22,MIR7109,chr22:31621467-31621531,64
39315213,39315307,chr22,SNORD83A,chr22:39315213-39315307,94
49962866,49962939,chr22,MIR6821,chr22:49962866-49962939,73
39313819,39313911,chr22,SNORD83B,chr22:39313819-39313911,92
39319050,39319113,chr22,SNORD43,chr22:39319050-39319113,63
45200954,45201019,chr22,MIR1249,chr22:45200954-45201019,65
49738677,49739003,chr22,RN7SKP252,chr22:49738677-49739003,326
45624531,45624632,chr22,RNU6-1161P,chr22:45624531-45624632,101
48780295,48780353,chr22,MIR4535,chr22:48780295-48780353,58
48274364,48274415,chr22,MIR3201,chr22:48274364-48274415,51
49543393,49543466,chr22,MIR3667,chr22:49543393-49543466,73
45760524,45760598,chr22,MIR4762,chr22:45760524-45760598,74
37669464,37669739,chr22,RN7SL385P,chr22:37669464-37669739,275
32635102,32635198,chr22,RNA5SP497,chr22:32635102-32635198,96
40813883,40813958,chr22,MIR4766,chr22:40813883-40813958,75
43473013,43473119,chr20,RNU6-1251P,chr20:43473013-43473119,106
40917743,40917846,chr22,RNU6-379P,chr22:40917743-40917846,103
41168217,41168316,chr22,RNU6-375P,chr22:41168217-41168316,99
41252992,41253050,chr22,MIR6889,chr22:41252992-41253050,58
31059989,31060285,chr22,RN7SL633P,chr22:31059989-31060285,296
21389191,21389491,chr22,RN7SKP63,chr22:21389191-21389491,300
17352881,17353177,chr22,RN7SL843P,chr22:17352881-17353177,296
41092513,41092566,chr22,MIR1281,chr22:41092513-41092566,53
37055033,37055347,chr22,RN7SKP214,chr22:37055033-37055347,314
32102522,32103293,chr10,RPS4XP11,chr10:32102522-32103293,771
43590937,43647299,chr20,IFT52,chr20:43590937-43647299,56362
5195462,5218949,chr10,AKR1C4,chr10:5195462-5218949,23487
32199919,32200234,chr22,IGLCOR22-1,chr22:32199919-32200234,315
32205115,32278382,chr22,SLC5A4-AS1,chr22:32205115-32278382,73267
32269381,32273110,chr22,CPSF1P1,chr22:32269381-32273110,3729
32354885,32361161,chr22,RFPL3,chr22:32354885-32361161,6276
43652523,43653291,chr20,RPL27AP,chr20:43652523-43653291,768
43667019,43716495,chr20,MYBL2,chr20:43667019-43716495,49476
32356676,32356988,chr22,IGLCOR22-2,chr22:32356676-32356988,312
18741730,18742718,chr13,CYP4F34P,chr13:18741730-18742718,988
32359886,32382106,chr22,RFPL3S,chr22:32359886-32382106,22220
71301750,71305371,chrX,ITGB1BP2,chrX:71301750-71305371,3621
100464440,100481205,chr13,PCCA-AS1,chr13:100464440-100481205,16765
66721158,66722760,chr9,ATP5F1AP10,chr9:66721158-66722760,1602
62474948,62476333,chr9,FGF7P7,chr9:62474948-62476333,1385
91347820,91354579,chr13,MIR17HG,chr13:91347820-91354579,6759
21994139,22128103,chr9,CDKN2B-AS1,chr9:21994139-22128103,133964
102263046,102263202,chr13,RPL39P29,chr13:102263046-102263202,156
83907301,83907781,chr13,VENTXP2,chr13:83907301-83907781,480
30316360,30319903,chr13,LINC00427,chr13:30316360-30319903,3543
27953526,27955370,chr13,LINC00543,chr13:27953526-27955370,1844
19561328,19588603,chr13,LINC00350,chr13:19561328-19588603,27275
32376682,32377135,chr22,IGLVIVOR22-2,chr22:32376682-32377135,453
19048801,19790401,chr10,MALRD1,chr10:19048801-19790401,741600
18609132,18609702,chr13,LONRF2P2,chr13:18609132-18609702,570
103444620,103444968,chr13,ATP6V1G1P7,chr13:103444620-103444968,348
42339188,42485956,chr13,LINC02341,chr13:42339188-42485956,146768
43726164,43727002,chr20,GTSF1L,chr20:43726164-43727002,838
32387582,32412248,chr22,RTCB,chr22:32387582-32412248,24666
71314912,71315879,chrX,ZCRB1P1,chrX:71314912-71315879,967
76013023,76014501,chr13,LINC01034,chr13:76013023-76014501,1478
71352418,71352988,chrX,RHOG2P,chrX:71352418-71352988,570
106342680,106342980,chr14,IGHVII-30-1,chr14:106342680-106342980,300
40555667,40666641,chr13,FOXO1,chr13:40555667-40666641,110974
23602410,23605917,chr20,CST9,chr20:23602410-23605917,3507
106163583,106163802,chr14,IGHVII-15-1,chr14:106163583-106163802,219
102545254,102555826,chr14,LINC02323,chr14:102545254-102555826,10572
71420083,71420514,chrX,PABPN1P1,chrX:71420083-71420514,431
71491682,71492928,chrX,INGX,chrX:71491682-71492928,1246
18567347,18569563,chr20,SMIM26,chr20:18567347-18569563,2216
71527814,71530225,chrX,SOCS6P1,chrX:71527814-71530225,2411
96256210,96268967,chr14,BDKRB1,chr14:96256210-96268967,12757
71533104,71575892,chrX,OGT,chrX:71533104-71575892,42788
80888348,80888867,chr13,ARF4P4,chr13:80888348-80888867,519
98577244,98578830,chr13,STK24-AS1,chr13:98577244-98578830,1586
74419158,74444735,chr13,LINC00381,chr13:74419158-74444735,25577
1561385,1620061,chr20,SIRPB1,chr20:1561385-1620061,58676
25716503,25735673,chr21,ATP5PF,chr21:25716503-25735673,19170
105664633,105669843,chr14,IGHGP,chr14:105664633-105669843,5210
45464898,45536701,chr13,COG3,chr13:45464898-45536701,71803
28743506,28941910,chr10,LINC01517,chr10:28743506-28941910,198404
93718298,93788485,chr14,PRIMA1,chr14:93718298-93788485,70187
106410493,106411021,chr14,IGHV3-38,chr14:106410493-106411021,528
106257762,106258223,chr14,IGHV3-22,chr14:106257762-106258223,461
62601226,62602672,chr9,RBPJP7,chr9:62601226-62602672,1446
34875210,34875422,chr10,SS18L2P1,chr10:34875210-34875422,212
62710036,62711398,chr9,FKBP4P7,chr9:62710036-62711398,1362
21440439,21441316,chr9,IFNA1,chr9:21440439-21441316,877
101843394,101844122,chr14,NPM1P20,chr14:101843394-101844122,728
17315421,17454595,chr10,ST8SIA6,chr10:17315421-17454595,139174
7477045,7478320,chr9,RPL4P5,chr9:7477045-7478320,1275
105009573,105021083,chr14,CDCA4,chr14:105009573-105021083,11510
36833269,37034268,chr9,PAX5,chr9:36833269-37034268,200999
106396676,106397114,chr14,IGHV3-37,chr14:106396676-106397114,438
34488583,34488878,chr10,ELOBP4,chr10:34488583-34488878,295
1623806,2245605,chr6,GMDS,chr6:1623806-2245605,621799
16748358,16770062,chr20,OTOR,chr20:16748358-16770062,21704
26216665,26304558,chr10,GAD2,chr10:26216665-26304558,87893
31944522,31957603,chr22,YWHAH,chr22:31944522-31957603,13081
103420825,103428298,chr13,LINC01309,chr13:103420825-103428298,7473
100333790,100376805,chr14,WARS1,chr14:100333790-100376805,43015
78285838,78286288,chr13,SRGNP1,chr13:78285838-78286288,450
36740041,36740863,chr13,GAPDHP34,chr13:36740041-36740863,822
95693983,95694495,chr13,MTND6P18,chr13:95693983-95694495,512
646615,653200,chr20,SRXN1,chr20:646615-653200,6585
46553168,46753040,chr13,LRCH1,chr13:46553168-46753040,199872
31981147,31981427,chr22,RN7SL305P,chr22:31981147-31981427,280
18587942,18766644,chr20,DTD1,chr20:18587942-18766644,178702
31925519,31945518,chr22,YWHAH-AS1,chr22:31925519-31945518,19999
46151614,46152647,chr21,FTCD-AS1,chr21:46151614-46152647,1033
46161148,46184476,chr21,SPATC1L,chr21:46161148-46184476,23328
26429260,26445015,chr22,ASPHD2,chr22:26429260-26445015,15755
46188141,46228824,chr21,LSS,chr21:46188141-46228824,40683
26483877,26494658,chr22,SRRD,chr22:26483877-26494658,10781
62231922,62296213,chr20,OSBPL2,chr20:62231922-62296213,64291
485154,693139,chr6,EXOC2,chr6:485154-693139,207985
71615916,71618511,chrX,CXCR3,chrX:71615916-71618511,2595
26491225,26512505,chr22,TFIP11,chr22:26491225-26512505,21280
155276211,155334657,chrX,CLIC2,chrX:155276211-155334657,58446
42842414,42842887,chr13,LINC00428,chr13:42842414-42842887,473
93032972,93057926,chr13,LINC00363,chr13:93032972-93057926,24954
155290360,155291353,chrX,TWF1P2,chrX:155290360-155291353,993
94601857,94634661,chr13,GPR180,chr13:94601857-94634661,32804
155292169,155293432,chrX,PHF10P1,chrX:155292169-155293432,1263
155310247,155310490,chrX,SRD5A2P1,chrX:155310247-155310490,243
155383100,155383198,chrX,MIR1184-2,chrX:155383100-155383198,98
155457517,155457615,chrX,MIR1184-3,chrX:155457517-155457615,98
155459415,155460005,chrX,H2AB3,chrX:155459415-155460005,590
81689911,81691072,chr13,PTMAP5,chr13:81689911-81691072,1161
155466540,155611616,chrX,TMLHE-AS1,chrX:155466540-155611616,145076
90230384,90231682,chr13,KRT18P27,chr13:90230384-90231682,1298
94760553,94761015,chr13,RPL21P112,chr13:94760553-94761015,462
37481467,37484769,chr13,LINC01048,chr13:37481467-37484769,3302
77599755,77606551,chr13,SCEL-AS1,chr13:77599755-77606551,6796
155489011,155719098,chrX,TMLHE,chrX:155489011-155719098,230087
100623875,100624429,chr13,COX5BP6,chr13:100623875-100624429,554
27672874,27746060,chr10,MKX,chr10:27672874-27746060,73186
25301556,25349800,chr13,NUP58,chr13:25301556-25349800,48244
155612572,155782459,chrX,SPRY3,chrX:155612572-155782459,169887
155828585,155829576,chrX,AMD1P2,chrX:155828585-155829576,991
155875636,155875885,chrX,DPH3P2,chrX:155875636-155875885,249
155881345,155943769,chrX,VAMP7,chrX:155881345-155943769,62424
1321698,1324022,chr6,LINC01394,chr6:1321698-1324022,2324
1383790,1385066,chr6,FOXF2-DT,chr6:1383790-1385066,1276
42475480,42495337,chr10,LINC00839,chr10:42475480-42495337,19857
2341450,2341711,chr6,HMGN2P28,chr6:2341450-2341711,261
47322454,47327588,chr10,GDF2,chr10:47322454-47327588,5134
391752,411443,chr6,IRF4,chr6:391752-411443,19691
32511336,32511737,chr10,C1DP1,chr10:32511336-32511737,401
38356380,38378505,chr10,HSD17B7P2,chr10:38356380-38378505,22125
26521996,26596717,chr22,TPST2,chr22:26521996-26596717,74721
155978992,155979325,chrX,ELOCP24,chrX:155978992-155979325,333
155985370,155986249,chrX,TRPC6P,chrX:155985370-155986249,879
156014623,156016837,chrX,WASIR1,chrX:156014623-156016837,2214
99190579,99190991,chr13,GAPDHP22,chr13:99190579-99190991,412
156025664,156027877,chrX,DDX11L16,chrX:156025664-156027877,2213
79804418,79805685,chr13,LINC01038,chr13:79804418-79805685,1267
39169636,39169951,chr13,NXT1P1,chr13:39169636-39169951,315
154144243,154159032,chrX,OPN1LW,chrX:154144243-154159032,14789
62321305,62322398,chr13,LINC01074,chr13:62321305-62322398,1093
97986950,97987216,chr13,FTLP8,chr13:97986950-97987216,266
49247925,49293485,chr13,CDADC1,chr13:49247925-49293485,45560
46229196,46259390,chr21,MCM3AP-AS1,chr21:46229196-46259390,30194
27775186,27999079,chr10,ODAD2,chr10:27775186-27999079,223893
154159357,154176349,chrX,TEX28P2,chrX:154159357-154176349,16992
3849373,3851320,chr6,FAM50B,chr6:3849373-3851320,1947
154182596,154196861,chrX,OPN1MW,chrX:154182596-154196861,14265
26555212,26555323,chr22,MIR548J,chr22:26555212-26555323,111
26560526,26561088,chr22,HMGB1P10,chr22:26560526-26561088,562
26599278,26618027,chr22,CRYBB1,chr22:26599278-26618027,18749
8073360,8102559,chr6,EEF1E1,chr6:8073360-8102559,29199
42933858,42934892,chr13,ZDHHC4P1,chr13:42933858-42934892,1034
86909586,86937108,chr13,LINC00430,chr13:86909586-86937108,27522
154196471,154213487,chrX,TEX28P1,chrX:154196471-154213487,17016
80011077,80028283,chr13,LINC01080,chr13:80011077-80028283,17206
46136160,46155579,chr21,FTCD,chr21:46136160-46155579,19419
86275493,86277262,chr13,DDX6P2,chr13:86275493-86277262,1769
154257538,154271805,chrX,OPN1MW3,chrX:154257538-154271805,14267
26621963,26630669,chr22,CRYBA4,chr22:26621963-26630669,8706
95019835,95301475,chr13,ABCC4,chr13:95019835-95301475,281640
154271265,154295853,chrX,TEX28,chrX:154271265-154295853,24588
154295795,154330350,chrX,TKTL1,chrX:154295795-154330350,34555
131910,145083,chr6,CICP18,chr6:131910-145083,13173
37125843,37175054,chr22,IL2RB,chr22:37125843-37175054,49211
8013567,8064396,chr6,BLOC1S5,chr6:8013567-8064396,50829
14280127,14285454,chr6,LINC01108,chr6:14280127-14285454,5327
55452533,55482940,chr18,TCF4-AS1,chr18:55452533-55482940,30407
55479221,55479298,chr18,MIR4529,chr18:55479221-55479298,77
55492175,55496392,chr18,TCF4-AS2,chr18:55492175-55496392,4217
19348181,19349076,chr6,RPL5P20,chr6:19348181-19349076,895
55635833,55636310,chr18,RPL21P126,chr18:55635833-55636310,477
55776727,55781722,chr18,LINC01415,chr18:55776727-55781722,4995
15934782,15935315,chr6,ARPC3P5,chr6:15934782-15935315,533
38713195,38719229,chr10,CHEK2P5,chr10:38713195-38719229,6034
9596110,10211608,chr6,OFCC1,chr6:9596110-10211608,615498
15513954,15719922,chr10,ITGA8,chr10:15513954-15719922,205968
36748626,36990236,chr21,HLCS,chr21:36748626-36990236,241610
26687621,26703638,chr18,PCAT18,chr18:26687621-26703638,16017
37180166,37199385,chr22,C1QTNF6,chr22:37180166-37199385,19219
26852043,26865771,chr18,AQP4,chr18:26852043-26865771,13728
154411524,154421726,chrX,TAFAZZIN,chrX:154411524-154421726,10202
45073853,45226560,chr21,ADARB1,chr21:45073853-45226560,152707
37204237,37212477,chr22,SSTR3,chr22:37204237-37212477,8240
95650498,95679833,chr14,TCL6,chr14:95650498-95679833,29335
42555440,42555724,chr10,FXYD6P1,chr10:42555440-42555724,284
30723251,30723740,chr10,LINC02644,chr10:30723251-30723740,489
38452987,38455365,chr10,CICP9,chr10:38452987-38455365,2378
37225270,37244448,chr22,RAC2,chr22:37225270-37244448,19178
21624592,21626286,chr10,HNRNPRP1,chr10:21624592-21626286,1694
43777562,43778825,chr10,LINC02658,chr10:43777562-43778825,1263
38640971,38689068,chr10,SLC9B1P3,chr10:38640971-38689068,48097
17951839,18043292,chr10,SLC39A12,chr10:17951839-18043292,91453
44337043,44351238,chr20,R3HDML,chr20:44337043-44351238,14195
106324254,106324760,chr14,IGHV4-28,chr14:106324254-106324760,506
31514410,31577923,chr20,HM13,chr20:31514410-31577923,63513
101634454,101731108,chr14,LINC02320,chr14:101634454-101731108,96654
106377300,106377733,chr14,IGHV7-34-1,chr14:106377300-106377733,433
106120207,106120473,chr14,IGHVIII-11-1,chr14:106120207-106120473,266
106235064,106235594,chr14,IGHV3-21,chr14:106235064-106235594,530
106314651,106314975,chr14,IGHVII-26-2,chr14:106314651-106314975,324
106088122,106088573,chr14,IGHV3-64D,chr14:106088122-106088573,451
46968695,46969912,chr18,ELOA3CP,chr18:46968695-46969912,1217
106354448,106354704,chr14,IGHVII-30-21,chr14:106354448-106354704,256
25023247,25024483,chr6,ASS1P1,chr6:25023247-25024483,1236
11537749,11583524,chr6,TMEM170B,chr6:11537749-11583524,45775
102592649,102730561,chr14,RCOR1,chr14:102592649-102730561,137912
57435374,57491298,chr18,ONECUT2,chr18:57435374-57491298,55924
22133205,22147193,chr6,NBAT1,chr6:22133205-22147193,13988
43778946,43901004,chr10,LINC00840,chr10:43778946-43901004,122058
37065436,37109713,chr22,TMPRSS6,chr22:37065436-37109713,44277
76419934,76420631,chr9,H3P32,chr9:76419934-76420631,697
63299453,63385117,chr9,BMS1P10,chr9:63299453-63385117,85664
57600656,57622213,chr18,NARS1,chr18:57600656-57622213,21557
19323428,19839080,chr6,LNC-LBCS,chr6:19323428-19839080,515652
37046835,37047237,chr9,RPL32P21,chr9:37046835-37047237,402
65287914,65323015,chr9,CBWD4P,chr9:65287914-65323015,35101
64369394,64413142,chr9,ANKRD20A4P,chr9:64369394-64413142,43748
42694371,42714575,chr10,CUBNP1,chr10:42694371-42714575,20204
106174342,106174760,chr14,IGHV1-17,chr14:106174342-106174760,418
5266033,5271236,chr10,LINC02561,chr10:5266033-5271236,5203
96423700,96424209,chr14,PEBP1P1,chr14:96423700-96424209,509
104137150,104137898,chr14,KIF26A-DT,chr14:104137150-104137898,748
106389392,106389858,chr14,IGHV3-35,chr14:106389392-106389858,466
20350049,20351100,chr10,AMD1P1,chr10:20350049-20351100,1051
87952527,87955203,chr14,SHLD2P2,chr14:87952527-87955203,2676
103940426,103942561,chr14,RD3L,chr14:103940426-103942561,2135
106153624,106154163,chr14,IGHV3-15,chr14:106153624-106154163,539
4702463,4703779,chr6,PSMC1P11,chr6:4702463-4703779,1316
102777449,102911500,chr14,TRAF3,chr14:102777449-102911500,134051
21485896,21521414,chr6,LINC00581,chr6:21485896-21521414,35518
45615500,45672780,chr10,ZFAND4,chr10:45615500-45672780,57280
15243923,15245000,chr6,JARID2-DT,chr6:15243923-15245000,1077
8015726,8102530,chr6,EEF1E1-BLOC1S5,chr6:8015726-8102530,86804
2617144,2640001,chr6,LINC02521,chr6:2617144-2640001,22857
42492663,42493570,chr9,RAB28P3,chr9:42492663-42493570,907
76970322,76971028,chr9,LYPLA2P3,chr9:76970322-76971028,706
32979560,32980403,chr9,TCEA1P4,chr9:32979560-32980403,843
24976419,24976982,chr6,PPIAP29,chr6:24976419-24976982,563
72752169,72782096,chr13,DIS3,chr13:72752169-72782096,29927
16171606,16172031,chr6,MRPL42P2,chr6:16171606-16172031,425
27535640,27573866,chr9,C9orf72,chr9:27535640-27573866,38226
10429255,10435015,chr6,LINC00518,chr6:10429255-10435015,5760
18155329,18223854,chr6,KDM1B,chr6:18155329-18223854,68525
57646426,57803315,chr18,ATP8B1,chr18:57646426-57803315,156889
47588681,47619480,chr10,LINC02675,chr10:47588681-47619480,30799
105672308,105673314,chr14,ELK2AP,chr14:105672308-105673314,1006
106317823,106318236,chr14,IGHV7-27,chr14:106317823-106318236,413
28898996,28899484,chr10,RPL21P93,chr10:28898996-28899484,488
104085686,104115582,chr14,ASPG,chr14:104085686-104115582,29896
25934229,26212532,chr10,MYO3A,chr10:25934229-26212532,278303
26596953,26600739,chr6,ABT1,chr6:26596953-26600739,3786
30560875,30561314,chr21,KRTAP19-7,chr21:30560875-30561314,439
7881522,8064364,chr6,BLOC1S5-TXNDC5,chr6:7881522-8064364,182842
77716097,78031811,chr9,GNAQ,chr9:77716097-78031811,315714
34446688,34512214,chr21,KCNE1,chr21:34446688-34512214,65526
23856698,23856818,chr6,SPTLC1P2,chr6:23856698-23856818,120
7986537,7988192,chr6,PIP5K1P1,chr6:7986537-7988192,1655
7726099,7881728,chr6,BMP6,chr6:7726099-7881728,155629
57755394,57755500,chr18,RNU6-742P,chr18:57755394-57755500,106
57838476,57838966,chr18,RSL24D1P11,chr18:57838476-57838966,490
57961231,57964434,chr18,LINC01897,chr18:57961231-57964434,3203
58018794,58019061,chr18,HMGN1P30,chr18:58018794-58019061,267
58451074,58451158,chr18,MIR122,chr18:58451074-58451158,84
58451080,58451152,chr18,MIR3591,chr18:58451080-58451152,72
45981770,46005050,chr21,COL6A1,chr21:45981770-46005050,23280
58481247,58629091,chr18,ALPK2,chr18:58481247-58629091,147844
72900671,73080442,chr9,ALDH1A1,chr9:72900671-73080442,179771
7881517,7910788,chr6,TXNDC5,chr6:7881517-7910788,29271
24248074,24249466,chr22,GGTLC4P,chr22:24248074-24249466,1392
44751808,44810546,chr20,RIMS4,chr20:44751808-44810546,58738
106392774,106393231,chr14,IGHV3-36,chr14:106392774-106393231,457
24251828,24265525,chr22,POM121L9P,chr22:24251828-24265525,13697
92180715,92180885,chr13,FABP5P4,chr13:92180715-92180885,170
85363601,85544570,chr13,LINC00351,chr13:85363601-85544570,180969
99684298,99727301,chr14,CYP46A1,chr14:99684298-99727301,43003
89402398,89818453,chr13,LINC02336,chr13:89402398-89818453,416055
154436913,154443467,chrX,GDI1,chrX:154436913-154443467,6554
91023732,91023954,chr13,BRK1P2,chr13:91023732-91023954,222
24259929,24263764,chr22,BCRP1,chr22:24259929-24263764,3835
39655627,39791665,chr13,COG6,chr13:39655627-39791665,136038
58600631,58600698,chr18,SNORA108,chr18:58600631-58600698,67
58631259,58632120,chr18,RPL9P31,chr18:58631259-58632120,861
58670009,58671877,chr18,MALT1-AS1,chr18:58670009-58671877,1868
63090806,63102631,chr20,HAR1B,chr20:63090806-63102631,11825
58671465,58754477,chr18,MALT1,chr18:58671465-58754477,83012
63102205,63104386,chr20,HAR1A,chr20:63102205-63104386,2181
26634383,26659752,chr6,ZNF322,chr6:26634383-26659752,25369
24270817,24417739,chr22,SPECC1L,chr22:24270817-24417739,146922
63178500,63178586,chr20,MIR124-3,chr20:63178500-63178586,86
63195429,63216139,chr20,YTHDF1,chr20:63195429-63216139,20710
42667506,42668887,chr9,FGF7P4,chr9:42667506-42668887,1381
74804473,74804773,chr9,RPSAP75,chr9:74804473-74804773,300
63235883,63240495,chr20,BIRC7,chr20:63235883-63240495,4612
30988085,30990572,chr9,HSPA8P17,chr9:30988085-30990572,2487
74952968,74996293,chr9,CARNMT1-AS1,chr9:74952968-74996293,43325
33025935,33029196,chr21,OLIG2,chr21:33025935-33029196,3261
71911510,71986054,chr9,C9orf85,chr9:71911510-71986054,74544
24797335,24798917,chr6,ARMH2,chr6:24797335-24798917,1582
91604402,91605319,chr14,NANOGP7,chr14:91604402-91605319,917
106289029,106289479,chr14,IGHV3-25,chr14:106289029-106289479,450
33057829,33064983,chr21,LINC00945,chr21:33057829-33064983,7154
27060365,27061249,chr6,VN1R13P,chr6:27060365-27061249,884
22569566,22571666,chr6,HDGFL1,chr6:22569566-22571666,2100
33070141,33072413,chr21,OLIG1,chr21:33070141-33072413,2272
10434316,10456781,chr6,MIR5689HG,chr6:10434316-10456781,22465
92703807,92748679,chr14,LGMN,chr14:92703807-92748679,44872
25678769,25679164,chr6,PRELID1P2,chr6:25678769-25679164,395
44806443,44808223,chr10,EIF2AP4,chr10:44806443-44808223,1780
1312098,1314758,chr6,FOXQ1,chr6:1312098-1314758,2660
44997698,45000888,chr10,ZNF22-AS1,chr10:44997698-45000888,3190
13924446,13980310,chr6,RNF182,chr6:13924446-13980310,55864
40641841,40642117,chr9,IGKV1OR9-2,chr9:40641841-40642117,276
33164809,33170649,chr21,LINC01548,chr21:33164809-33170649,5840
154444141,154450654,chrX,FAM50A,chrX:154444141-154450654,6513
40729128,40771190,chr13,MRPS31,chr13:40729128-40771190,42062
16071416,16071809,chr10,FTLP19,chr10:16071416-16071809,393
37523011,37544701,chr10,TACC1P1,chr10:37523011-37544701,21690
37894637,37896666,chr10,ZNF33CP,chr10:37894637-37896666,2029
23095579,23122013,chr10,MSRB2,chr10:23095579-23122013,26434
33205282,33265675,chr21,IFNAR2,chr21:33205282-33265675,60393
42384805,42386136,chr9,FKBP4P6,chr9:42384805-42386136,1331
63238779,63238842,chr20,MIR3196,chr20:63238779-63238842,63
84275457,84340758,chr9,SLC28A3,chr9:84275457-84340758,65301
63240784,63272694,chr20,NKAIN4,chr20:63240784-63272694,31910
69221866,69322190,chr13,LINC00383,chr13:69221866-69322190,100324
92701389,92721614,chr13,GPC5-AS1,chr13:92701389-92721614,20225
30906271,30925572,chr13,MEDAG,chr13:30906271-30925572,19301
45302298,45315608,chr10,OR13A1,chr10:45302298-45315608,13310
4994717,5004063,chr6,RPP40,chr6:4994717-5004063,9346
14999050,15000055,chr10,OR7E26P,chr10:14999050-15000055,1005
26589865,26594330,chr10,FAM238A,chr10:26589865-26594330,4465
89214847,89236890,chr13,LINC01047,chr13:89214847-89236890,22043
34675635,34676041,chr10,RPS12P16,chr10:34675635-34676041,406
42408168,42475349,chr10,CCNYL2,chr10:42408168-42475349,67181
110305812,110513209,chr13,COL4A2,chr13:110305812-110513209,207397
76549282,76549771,chr9,PPIAP87,chr9:76549282-76549771,489
77019655,77020953,chr9,FOXB2,chr9:77019655-77020953,1298
154450320,154450386,chrX,MIR6858,chrX:154450320-154450386,66
154458281,154477779,chrX,PLXNA3,chrX:154458281-154477779,19498
68328308,68531061,chr9,PGM5,chr9:68328308-68531061,202753
63253978,63261615,chr20,FLJ16779,chr20:63253978-63261615,7637
58690356,58692153,chr18,MRPL37P1,chr18:58690356-58692153,1797
63272785,63289790,chr20,ARFGAP1,chr20:63272785-63289790,17005
23192312,23194245,chr10,PTF1A,chr10:23192312-23194245,1933
58805268,58805374,chr18,RNU6-219P,chr18:58805268-58805374,106
58808468,58834364,chr18,LINC01926,chr18:58808468-58834364,25896
58818883,58819016,chr18,U8,chr18:58818883-58819016,133
58926197,58926296,chr18,RNU2-69P,chr18:58926197-58926296,99
58996734,59069338,chr18,OACYLP,chr18:58996734-59069338,72604
24848614,24952606,chr10,PRTFDC1,chr10:24848614-24952606,103992
24270898,24442356,chr22,SPECC1L-ADORA2A,chr22:24270898-24442356,171458
12698554,12814377,chr9,LURAP1L-AS1,chr9:12698554-12814377,115823
78297125,78330093,chr9,PSAT1,chr9:78297125-78330093,32968
24417879,24442357,chr22,ADORA2A,chr22:24417879-24442357,24478
3941282,3941801,chr6,TDGF1P4,chr6:3941282-3941801,519
15994944,15999797,chr6,LINC02543,chr6:15994944-15999797,4853
35452230,35497979,chr18,INO80C,chr18:35452230-35497979,45749
18223860,18264548,chr6,DEK,chr6:18223860-18264548,40688
25648011,25678748,chr4,SLC34A2,chr4:25648011-25678748,30737
154483717,154486615,chrX,UBL4A,chrX:154483717-154486615,2898
14897359,14954432,chr10,DCLRE1C,chr10:14897359-14954432,57073
24429206,24495074,chr22,ADORA2A-AS1,chr22:24429206-24495074,65868
154487306,154490690,chrX,SLC10A3,chrX:154487306-154490690,3384
61615835,61627683,chr9,FAM242D,chr9:61615835-61627683,11848
42408526,42409006,chr9,SDR42E1P2,chr9:42408526-42409006,480
89548691,89553804,chr13,LINC00353,chr13:89548691-89553804,5113
79872586,79918042,chr13,LINC00382,chr13:79872586-79918042,45456
154495815,154496113,chrX,RN7SL697P,chrX:154495815-154496113,298
83623049,83644130,chr9,IDNK,chr9:83623049-83644130,21081
24494107,24528390,chr22,UPB1,chr22:24494107-24528390,34283
154531391,154547572,chrX,G6PD,chrX:154531391-154547572,16181
27373348,27374366,chr13,LINC01079,chr13:27373348-27374366,1018
7566782,8406861,chr18,PTPRM,chr18:7566782-8406861,840079
89991831,89992878,chr13,PEX12P1,chr13:89991831-89992878,1047
63975451,63976422,chr13,NFYAP1,chr13:63975451-63976422,971
57140918,57157082,chr13,PRR20C,chr13:57140918-57157082,16164
33103137,33350630,chr13,STARD13,chr13:33103137-33350630,247493
40505399,40566281,chr9,BMS1P14,chr9:40505399-40566281,60882
63127359,63143401,chr9,AQP7P4,chr9:63127359-63143401,16042
33266367,33310187,chr21,IL10RB,chr21:33266367-33310187,43820
103847721,103858049,chr14,PPP1R13B-DT,chr14:103847721-103858049,10328
99481169,99535044,chr14,CCNK,chr14:99481169-99535044,53875
24555958,24582052,chr22,SNRPD3,chr22:24555958-24582052,26094
28823244,28824211,chr4,MESTP3,chr4:28823244-28824211,967
57352999,57353329,chr4,RPS26P24,chr4:57352999-57353329,330
82979590,83063177,chr9,RASEF,chr9:82979590-83063177,83587
26956932,27059749,chr6,LINC00240,chr6:26956932-27059749,102817
212610,255985,chr4,ZNF876P,chr4:212610-255985,43375
33324429,33359864,chr21,IFNAR1,chr21:33324429-33359864,35435
68376323,68376505,chr4,MT2P1,chr4:68376323-68376505,182
68815994,68832023,chr4,UGT2B10,chr4:68815994-68832023,16029
28648286,28649066,chr6,LINC00533,chr6:28648286-28649066,780
25652201,25701783,chr6,SCGN,chr6:25652201-25701783,49582
62606797,62607748,chr9,RAB28P2,chr9:62606797-62607748,951
75060573,75088217,chr9,NMRK1,chr9:75060573-75088217,27644
24585620,24593208,chr22,LRRC75B,chr22:24585620-24593208,7588
104985775,105010482,chr14,CLBA1,chr14:104985775-105010482,24707
18522735,18674001,chr6,MIR548A1HG,chr6:18522735-18674001,151266
154571248,154571960,chrX,FAM223A,chrX:154571248-154571960,712
958323,1101400,chr6,LINC01622,chr6:958323-1101400,143077
154580926,154581998,chrX,ATF4P2,chrX:154580926-154581998,1072
26496936,26505603,chrX,FMN2P1,chrX:26496936-26505603,8667
33334571,33335096,chr21,USF1P1,chr21:33334571-33335096,525
26686026,26687955,chrX,RPL7P58,chrX:26686026-26687955,1929
26748029,26749090,chrX,HMGA1P1,chrX:26748029-26749090,1061
42311667,42315409,chr21,TFF3,chr21:42311667-42315409,3742
26790142,26790286,chrX,RNU1-142P,chrX:26790142-26790286,144
64914281,65024485,chr4,LINC02232,chr4:64914281-65024485,110204
24594811,24629005,chr22,GGT1,chr22:24594811-24629005,34194
25279078,25620530,chr6,CARMIL1,chr6:25279078-25620530,341452
39445855,39515506,chr21,SH3BGR,chr21:39445855-39515506,69651
85243991,85273362,chrX,ZNF711,chrX:85243991-85273362,29371
96573659,96574499,chr13,AMMECR1LP1,chr13:96573659-96574499,840
37485948,37503697,chr9,POLR1E,chr9:37485948-37503697,17749
88494789,88607814,chr13,LINC00433,chr13:88494789-88607814,113025
99397748,99480889,chr14,SETD3,chr14:99397748-99480889,83141
57424495,57478341,chr4,LINC02380,chr4:57424495-57478341,53846
114154691,114223084,chr13,CFAP97D2,chr13:114154691-114223084,68393
36741878,36742465,chr13,TCEAL4P1,chr13:36741878-36742465,587
67791955,67792895,chrX,BMI1P1,chrX:67791955-67792895,940
96941281,96984172,chr13,TULP3P1,chr13:96941281-96984172,42891
103822327,103832257,chrX,RAB9B,chrX:103822327-103832257,9930
42029209,42030123,chr4,ATP1B1P1,chr4:42029209-42030123,914
39770081,39771371,chr4,ZBTB12BP,chr4:39770081-39771371,1290
29306778,29307785,chr13,GAPDHP69,chr13:29306778-29307785,1007
103850797,103850911,chrX,RNA5SP511,chrX:103850797-103850911,114
103904322,103904754,chrX,H2BP9,chrX:103904322-103904754,432
103910305,103911352,chrX,ELF2P1,chrX:103910305-103911352,1047
38790677,38856817,chr4,TLR1,chr4:38790677-38856817,66140
103918896,103966712,chrX,TMSB15B,chrX:103918896-103966712,47816
92484606,92510094,chr13,GPC5-IT1,chr13:92484606-92510094,25488
18610298,18611675,chr13,LINC00388,chr13:18610298-18611675,1377
19411231,19416188,chr13,SLC25A15P2,chr13:19411231-19416188,4957
98610292,98610876,chr13,NUS1P4,chr13:98610292-98610876,584
85792790,85806683,chr13,SLITRK6,chr13:85792790-85806683,13893
13609777,13645823,chr21,POTED,chr21:13609777-13645823,36046
92339794,92379536,chr13,GPC5-AS2,chr13:92339794-92379536,39742
45680184,45701184,chr13,LINC01055,chr13:45680184-45701184,21000
87890172,87892472,chr13,TET1P1,chr13:87890172-87892472,2300
103928099,103929017,chrX,SLC25A53P1,chrX:103928099-103929017,918
47766640,47767085,chr13,RPL27AP8,chr13:47766640-47767085,445
103961811,103962279,chrX,DPPA3P1,chrX:103961811-103962279,468
104062542,104063037,chrX,H2BW3P,chrX:104062542-104063037,495
102292327,102394519,chr13,FGF14-IT1,chr13:102292327-102394519,102192
11704123,11705590,chrX,LIMK2P1,chrX:11704123-11705590,1467
69721167,69787961,chr4,SULT1B1,chr4:69721167-69787961,66794
66302834,67230445,chr13,PCDH9,chr13:66302834-67230445,927611
89005771,89178818,chr9,SHC3,chr9:89005771-89178818,173047
42062959,42143453,chr21,UMODL1,chr21:42062959-42143453,80494
29026680,29027607,chr6,OR2AD1P,chr6:29026680-29027607,927
17102050,17131378,chr6,STMND1,chr6:17102050-17131378,29328
11758159,11775772,chrX,MSL3,chrX:11758159-11775772,17613
28732017,28732904,chr6,RPSAP2,chr6:28732017-28732904,887
11514192,11516466,chr6,THAP12P5,chr6:11514192-11516466,2274
82427350,82428025,chr9,MTCO3P40,chr9:82427350-82428025,675
48852008,48860203,chr4,OCIAD1-AS1,chr4:48852008-48860203,8195
88410529,88411463,chr9,HNRNPA1P14,chr9:88410529-88411463,934
26871484,26956554,chr6,GUSBP2,chr6:26871484-26956554,85070
42397488,42402487,chr4,SHISA3,chr4:42397488-42402487,4999
64465463,64466498,chr9,CYP4F25P,chr9:64465463-64466498,1035
105702699,105797539,chr13,LINC00343,chr13:105702699-105797539,94840
86026146,86100173,chr9,GOLM1,chr9:86026146-86100173,74027
39546336,39638902,chr4,SMIM14,chr4:39546336-39638902,92566
5954706,6415237,chr18,L3MBTL4,chr18:5954706-6415237,460531
28861416,28862047,chr6,RPL13P,chr6:28861416-28862047,631
4774526,4775408,chr6,CDYL-AS1,chr6:4774526-4775408,882
5003774,5045666,chr6,LYRM4-AS1,chr6:5003774-5045666,41892
106145891,106146131,chr14,IGHV1-14,chr14:106145891-106146131,240
106210936,106211453,chr14,IGHV3-20,chr14:106210936-106211453,517
73259209,73317953,chr4,ANKRD17-DT,chr4:73259209-73317953,58744
24789912,24800842,chr4,SOD3,chr4:24789912-24800842,10930
90452063,90455127,chr14,LINC02317,chr14:90452063-90455127,3064
99964529,99965378,chr14,VDAC3P1,chr14:99964529-99965378,849
26457904,26476621,chr6,BTN2A1,chr6:26457904-26476621,18717
106369107,106369546,chr14,IGHV3-33-2,chr14:106369107-106369546,439
90107675,90107995,chr14,GLRXP2,chr14:90107675-90107995,320
104937244,104978374,chr14,AHNAK2,chr14:104937244-104978374,41130
49588772,49589529,chr4,SNX18P25,chr4:49588772-49589529,757
41981756,41986465,chr4,DCAF4L1,chr4:41981756-41986465,4709
42657496,42657928,chr4,ATP8A1-DT,chr4:42657496-42657928,432
73042745,73056528,chr9,CYP1D1P,chr9:73042745-73056528,13783
102341102,102362916,chr14,CINP,chr14:102341102-102362916,21814
44173903,44448809,chr4,KCTD8,chr4:44173903-44448809,274906
76691980,76863307,chr9,PCA3,chr9:76691980-76863307,171327
77963940,77964511,chr4,HMGB1P44,chr4:77963940-77964511,571
25720099,25720431,chr4,MTND3P5,chr4:25720099-25720431,332
63286808,63286866,chr20,MIR4326,chr20:63286808-63286866,58
63337339,63337449,chr20,RNU6-994P,chr20:63337339-63337449,110
64608905,64609424,chr4,MTND6P16,chr4:64608905-64609424,519
72807267,72808192,chr4,HNRNPA1P67,chr4:72807267-72808192,925
63343223,63378401,chr20,CHRNA4,chr20:63343223-63378401,35178
27217479,27282225,chr4,LINC02261,chr4:27217479-27282225,64746
75940950,75990962,chr4,SDAD1,chr4:75940950-75990962,50012
72007881,72008136,chr9,HSPB1P1,chr9:72007881-72008136,255
77040416,77040673,chr9,ATP5MFP3,chr9:77040416-77040673,257
22169589,22202528,chr18,GATA6,chr18:22169589-22202528,32939
66106815,66179474,chr9,ANKRD20A3P,chr9:66106815-66179474,72659
106293568,106293808,chr14,IGHVIII-25-1,chr14:106293568-106293808,240
106276548,106277043,chr14,IGHV1-24,chr14:106276548-106277043,495
106359793,106360324,chr14,IGHV3-33,chr14:106359793-106360324,531
28455648,28456141,chr6,OR2E1P,chr6:28455648-28456141,493
90524564,90816479,chr14,TTC7B,chr14:90524564-90816479,291915
25732497,25732827,chr6,H2AC2P,chr6:25732497-25732827,330
46667821,46759257,chr18,ST8SIA5,chr18:46667821-46759257,91436
12008762,12164999,chr6,HIVEP1,chr6:12008762-12164999,156237
91087254,91089593,chr13,LINC00380,chr13:91087254-91089593,2339
95677139,95794988,chr13,DNAJC3,chr13:95677139-95794988,117849
7816675,7829926,chr21,KCNE1B,chr21:7816675-7829926,13251
98629686,98629989,chr13,CYCSP35,chr13:98629686-98629989,303
113953705,113974076,chr13,C13orf46,chr13:113953705-113974076,20371
24632915,24650012,chr22,BCRP3,chr22:24632915-24650012,17097
34513142,34615113,chr21,RCAN1,chr21:34513142-34615113,101971
63448051,63449329,chr20,KCNQ2-AS1,chr20:63448051-63449329,1278
24328211,24329072,chr13,NUS1P3,chr13:24328211-24329072,861
77659413,77659664,chr13,SPTLC1P5,chr13:77659413-77659664,251
11823339,11872277,chr10,PROSER2,chr10:11823339-11872277,48938
10334419,10334698,chr20,HIGD1AP15,chr20:10334419-10334698,279
43908669,44030461,chr13,NRAD1,chr13:43908669-44030461,121792
10349157,10349628,chr20,RPL23AP6,chr20:10349157-10349628,471
10385779,10387806,chr20,SDAD1P2,chr20:10385779-10387806,2027
10401009,10434222,chr20,MKKS,chr20:10401009-10434222,33213
6729716,6915716,chr18,ARHGAP28,chr18:6729716-6915716,186000
25248263,25248779,chr6,KATNBL1P5,chr6:25248263-25248779,516
27033435,27034310,chr6,VN1R12P,chr6:27033435-27034310,875
24657481,24658765,chr22,POM121L10P,chr22:24657481-24658765,1284
28349947,28369172,chr6,ZKSCAN3,chr6:28349947-28369172,19225
24686168,24686679,chr22,ARL5AP4,chr22:24686168-24686679,511
98949719,98950447,chr13,RPL7L1P12,chr13:98949719-98950447,728
86287733,86354454,chr9,TUT7,chr9:86287733-86354454,66721
19563589,19564900,chr13,GOLM2P1,chr13:19563589-19564900,1311
27904209,27905162,chr10,RPL36AP55,chr10:27904209-27905162,953
90493287,90535080,chr13,LINC01049,chr13:90493287-90535080,41793
18195297,18232024,chr13,FAM230C,chr13:18195297-18232024,36727
25691537,25692323,chr10,HIRAP1,chr10:25691537-25692323,786
5275173,5288470,chr10,AKR1C7P,chr10:5275173-5288470,13297
24712292,24712520,chr22,CRIP1P4,chr22:24712292-24712520,228
48489553,48850912,chr22,TAFA5,chr22:48489553-48850912,361359
36222008,36297840,chr13,CCDC169,chr13:36222008-36297840,75832
28969130,28970460,chr6,KRT18P1,chr6:28969130-28970460,1330
29934101,29934286,chr6,HLA-U,chr6:29934101-29934286,185
23694746,24547848,chr10,KIAA1217,chr10:23694746-24547848,853102
28783633,28784004,chr6,NOP56P1,chr6:28783633-28784004,371
25731782,25732091,chr6,H2BC2P,chr6:25731782-25732091,309
63488013,63499239,chr20,EEF1A2,chr20:63488013-63499239,11226
13357830,13487662,chr6,GFOD1,chr6:13357830-13487662,129832
21759657,21867680,chr22,MAPK1,chr22:21759657-21867680,108023
29926459,29929232,chr6,HLA-K,chr6:29926459-29929232,2773
24126186,24154900,chr6,NRSN1,chr6:24126186-24154900,28714
106418018,106418299,chr14,IGHVIII-38-1,chr14:106418018-106418299,281
98972879,98973301,chr14,RPL3P4,chr14:98972879-98973301,422
55766177,55767717,chr14,RPL13AP3,chr14:55766177-55767717,1540
101561351,101563452,chr14,DIO3,chr14:101561351-101563452,2101
106335082,106335613,chr14,IGHV3-30,chr14:106335082-106335613,531
15729982,15880064,chr21,USP25,chr21:15729982-15880064,150082
63520765,63522206,chr20,PPDPF,chr20:63520765-63522206,1441
91232532,91253925,chr14,GPR68,chr14:91232532-91253925,21393
29268462,29269421,chr6,OR2U2P,chr6:29268462-29269421,959
28859625,28864630,chr6,LINC01623,chr6:28859625-28864630,5005
15246069,15522042,chr6,JARID2,chr6:15246069-15522042,275973
63528001,63537376,chr20,PTK6,chr20:63528001-63537376,9375
105703995,105708665,chr14,IGHA1,chr14:105703995-105708665,4670
23786931,23838009,chr22,SMARCB1,chr22:23786931-23838009,51078
51756996,51757988,chr14,OR7E105P,chr14:51756996-51757988,992
106179554,106180519,chr14,SLC20A1P2,chr14:106179554-106180519,965
106107972,106108464,chr14,IGHV5-10-1,chr14:106107972-106108464,492
63547891,63556695,chr20,FNDC11,chr20:63547891-63556695,8804
73481745,73504001,chr4,AFM,chr4:73481745-73504001,22256
101730437,101732522,chr14,LINC00239,chr14:101730437-101732522,2085
97749264,97763989,chr14,LINC02312,chr14:97749264-97763989,14725
10980759,11044305,chr6,ELOVL2,chr6:10980759-11044305,63546
100143957,100159645,chr14,DEGS2,chr14:100143957-100159645,15688
63558086,63574239,chr20,HELZ2,chr20:63558086-63574239,16153
90061994,90185853,chr14,KCNK13,chr14:90061994-90185853,123859
33333679,33335277,chr13,LINC02344,chr13:33333679-33335277,1598
13949095,13949666,chr6,MRPL35P1,chr6:13949095-13949666,571
19823482,19863649,chr13,ZMYM5,chr13:19823482-19863649,40167
24947880,24948344,chr6,MTCO2P33,chr6:24947880-24948344,464
92893698,92894505,chr9,SNX18P2,chr9:92893698-92894505,807
106331106,106331563,chr14,IGHV3-32,chr14:106331106-106331563,457
29181510,29182445,chr6,OR2J4P,chr6:29181510-29182445,935
106367385,106367664,chr14,IGHVII-33-1,chr14:106367385-106367664,279
26896952,26898777,chr6,POM121L6P,chr6:26896952-26898777,1825
35487812,35489750,chr4,SEC63P2,chr4:35487812-35489750,1938
69427532,69672371,chr9,APBA1,chr9:69427532-69672371,244839
70992538,71030914,chr4,DCK,chr4:70992538-71030914,38376
102662240,102662708,chr14,RPL23AP11,chr14:102662240-102662708,468
28903002,28923988,chr6,TRIM27,chr6:28903002-28923988,20986
106301396,106301862,chr14,IGHV2-26,chr14:106301396-106301862,466
107788342,107835451,chr13,NALF1-IT1,chr13:107788342-107835451,47109
88142867,88236082,chr13,LINC00373,chr13:88142867-88236082,93215
94698725,94708475,chr13,LINC00391,chr13:94698725-94708475,9750
19126399,19139611,chr13,CENPIP1,chr13:19126399-19139611,13212
89954939,90044764,chr14,TDP1,chr14:89954939-90044764,89825
62187255,62310249,chr18,RELCH,chr18:62187255-62310249,122994
19422877,19536762,chr13,TPTE2,chr13:19422877-19536762,113885
81410279,81410630,chr9,RPS20P25,chr9:81410279-81410630,351
12685439,12710285,chr9,TYRP1,chr9:12685439-12710285,24846
6346465,6622771,chr6,LY86-AS1,chr6:6346465-6622771,276306
42795392,42800672,chr9,ADGRF5P2,chr9:42795392-42800672,5280
77423079,77648322,chr9,GNA14,chr9:77423079-77648322,225243
70334981,70337116,chr4,CABS1,chr4:70334981-70337116,2135
75876886,75881127,chr13,LMO7DN-IT1,chr13:75876886-75881127,4241
112067149,112071706,chr13,SOX1,chr13:112067149-112071706,4557
51865050,51865535,chr4,DUTP7,chr4:51865050-51865535,485
68226653,68245694,chr4,TMPRSS11B,chr4:68226653-68245694,19041
30932656,30975500,chr13,TEX26,chr13:30932656-30975500,42844
72351413,72365235,chr9,ZFAND5,chr9:72351413-72365235,13822
5609227,5610195,chr6,HNRNPA1P37,chr6:5609227-5610195,968
29925983,29926973,chr6,HCG4B,chr6:29925983-29926973,990
5950652,5998977,chr20,MCM8,chr20:5950652-5998977,48325
100708325,101059286,chr13,NALCN-AS1,chr13:100708325-101059286,350961
30802242,30802427,chr21,KRTAP8-2P,chr21:30802242-30802427,185
30806932,30807119,chr21,KRTAP8-3P,chr21:30806932-30807119,187
30812697,30813274,chr21,KRTAP8-1,chr21:30812697-30813274,577
28888832,28889906,chr6,ZNF90P2,chr6:28888832-28889906,1074
29071824,29072599,chr6,OR2P1P,chr6:29071824-29072599,775
67716375,67717388,chr4,ST3GAL1P1,chr4:67716375-67717388,1013
61997136,62029572,chr13,LINC00358,chr13:61997136-62029572,32436
30829039,30829759,chr21,KRTAP7-1,chr21:30829039-30829759,720
17171757,17186079,chr4,LINC02493,chr4:17171757-17186079,14322
29907783,29908645,chr6,MCCD1P1,chr6:29907783-29908645,862
98640814,98641239,chr13,CALM2P4,chr13:98640814-98641239,425
30880644,30881580,chr21,KRTAP11-1,chr21:30880644-30881580,936
28570535,28616212,chr6,ZBED9,chr6:28570535-28616212,45677
958887,986895,chr4,DGKQ,chr4:958887-986895,28008
31118416,31559977,chr21,TIAM1,chr21:31118416-31559977,441561
108596152,109208005,chr13,MYO16,chr13:108596152-109208005,611853
21549447,21624034,chr22,UBE2L3,chr22:21549447-21624034,74587
12290361,12297194,chr6,EDN1,chr6:12290361-12297194,6833
28525881,28534955,chr6,GPX5,chr6:28525881-28534955,9074
29883169,30030868,chr22,MTMR3,chr22:29883169-30030868,147699
29076573,29077168,chr6,SAR1AP1,chr6:29076573-29077168,595
20437821,20440178,chr6,E2F3-IT1,chr6:20437821-20440178,2357
11093834,11138733,chr6,SMIM13,chr6:11093834-11138733,44899
68353614,68357893,chr9,PGM5-AS1,chr9:68353614-68357893,4279
29086208,29087313,chr6,OR2B3,chr6:29086208-29087313,1105
29975112,29978410,chr6,HCG9,chr6:29975112-29978410,3298
74980790,75028423,chr9,CARNMT1,chr9:74980790-75028423,47633
10459906,10460541,chr6,MRPL48P1,chr6:10459906-10460541,635
17281361,17293871,chr6,RBM24,chr6:17281361-17293871,12510
70370093,70390244,chr4,SMR3B,chr4:70370093-70390244,20151
66303871,66323561,chr13,PCDH9-AS1,chr13:66303871-66323561,19690
106425773,106426122,chr13,RPL35P9,chr13:106425773-106426122,349
33218365,33248567,chr9,SPINK4,chr9:33218365-33248567,30202
58862600,58986480,chr18,ZNF532,chr18:58862600-58986480,123880
110148963,110307157,chr13,COL4A1,chr13:110148963-110307157,158194
25686202,25686458,chr4,SLIRPP2,chr4:25686202-25686458,256
37438102,37465450,chr9,ZBTB5,chr9:37438102-37465450,27348
31901254,31901426,chr20,RNU1-94P,chr20:31901254-31901426,172
39698109,39782792,chr4,UBE2K,chr4:39698109-39782792,84683
31944337,31952046,chr20,PDRG1,chr20:31944337-31952046,7709
19612755,19614036,chr6,KRT18P38,chr6:19612755-19614036,1281
29970801,29972464,chr6,MICD,chr6:29970801-29972464,1663
18363417,18365423,chr6,DDX18P3,chr6:18363417-18365423,2006
31968151,32003387,chr20,XKR7,chr20:31968151-32003387,35236
31038159,31038476,chr21,KRTAP19-8,chr21:31038159-31038476,317
85941146,86025462,chr9,NAA35,chr9:85941146-86025462,84316
31060600,31063168,chr21,UBE3AP2,chr21:31060600-31063168,2568
7268306,7347446,chr6,SSR1,chr6:7268306-7347446,79140
31627127,31628600,chr21,FBXW11P1,chr21:31627127-31628600,1473
31659666,31668931,chr21,SOD1,chr21:31659666-31668931,9265
32008351,32008472,chr20,RNA5SP481,chr20:32008351-32008472,121
32010438,32032180,chr20,CCM2L,chr20:32010438-32032180,21742
106142287,106142577,chr14,IGHVIII-13-1,chr14:106142287-106142577,290
12373167,12375133,chrX,FRMPD4-AS1,chrX:12373167-12375133,1966
106184901,106185394,chr14,IGHV1-18,chr14:106184901-106185394,493
12395757,12396167,chrX,RPL17P49,chrX:12395757-12396167,410
47581211,47582321,chr10,CTSLP2,chr10:47581211-47582321,1110
106286811,106287657,chr14,HOMER2P2,chr14:106286811-106287657,846
12614003,12614197,chrX,RN7SKP290,chrX:12614003-12614197,194
46734827,46909245,chr4,COX7B2,chr4:46734827-46909245,174418
12825840,12826833,chrX,PSMA6P2,chrX:12825840-12826833,993
12844865,12845430,chrX,MRPL35P4,chrX:12844865-12845430,565
42566677,42567483,chr10,EIF3LP2,chr10:42566677-42567483,806
12867072,12890361,chrX,TLR7,chrX:12867072-12890361,23289
31706555,31706864,chr21,HMGN1P2,chr21:31706555-31706864,309
99971449,100144236,chr14,EVL,chr14:99971449-100144236,172787
36156782,36294274,chr21,DOP1B,chr21:36156782-36294274,137492
12902817,12908333,chrX,TLR8-AS1,chrX:12902817-12908333,5516
32050588,32050705,chr20,RNA5SP482,chr20:32050588-32050705,117
68302867,68305084,chr9,FOXD4L3,chr9:68302867-68305084,2217
43909244,43981102,chr10,LINC00841,chr10:43909244-43981102,71858
32109714,32167258,chr20,TM9SF4,chr20:32109714-32167258,57544
52485046,52485912,chrX,RBM22P6,chrX:52485046-52485912,866
52495808,52500812,chrX,XAGE1A,chrX:52495808-52500812,5004
69199951,69214748,chr4,UGT2B11,chr4:69199951-69214748,14797
58212541,58213036,chr10,TPT1P10,chr10:58212541-58213036,495
15015370,15021863,chr10,DCLRE1CP1,chr10:15015370-15021863,6493
13870797,13871175,chr10,NUTF2P5,chr10:13870797-13871175,378
93096217,93113283,chr9,CARD19,chr9:93096217-93113283,17066
34965069,34966259,chr10,PRDX2P2,chr10:34965069-34966259,1190
76435229,76783253,chr4,SHROOM3,chr4:76435229-76783253,348024
52972612,53030024,chr10,LINC02672,chr10:52972612-53030024,57412
52509903,52510182,chrX,RBM22P7,chrX:52509903-52510182,279
52598494,52603289,chrX,SSXP4,chrX:52598494-52603289,4795
30611779,30629762,chr10,LYZL2,chr10:30611779-30629762,17983
52606535,52611758,chrX,SSXP1,chrX:52606535-52611758,5223
52644061,52654900,chrX,SSX7,chrX:52644061-52654900,10839
93576584,93679587,chr9,PHF2,chr9:93576584-93679587,103003
27744786,27767794,chr10,MKX-AS1,chr10:27744786-27767794,23008
52665231,52665347,chrX,RNA5SP504,chrX:52665231-52665347,116
52672718,52677051,chrX,SSXP5,chrX:52672718-52677051,4333
52687363,52687633,chrX,S100A11P10,chrX:52687363-52687633,270
45678692,45700532,chr10,AGAP10P,chr10:45678692-45700532,21840
33864313,33864723,chr10,RPL23P11,chr10:33864313-33864723,410
33759713,33772702,chr10,LINC00838,chr10:33759713-33772702,12989
52770809,52771080,chrX,S100A11P8,chrX:52770809-52771080,271
52796144,52797427,chrX,SPANXN5,chrX:52796144-52797427,1283
26714622,26715832,chr10,HSPA8P3,chr10:26714622-26715832,1210
52832704,52833899,chrX,EIF4A2P4,chrX:52832704-52833899,1195
24981979,25062279,chr10,ENKUR,chr10:24981979-25062279,80300
52622935,52633948,chrX,SSX8P,chrX:52622935-52633948,11013
113522482,113522989,chrX,PPIHP2,chrX:113522482-113522989,507
113882590,113883667,chrX,QTRT1P1,chrX:113882590-113883667,1077
113949917,113950082,chrX,RNU1-57P,chrX:113949917-113950082,165
113976341,113976633,chrX,RN7SL93P,chrX:113976341-113976633,292
114017033,114017102,chrX,SNORD30,chrX:114017033-114017102,69
113616300,114059289,chrX,XACT,chrX:113616300-114059289,442989
119574536,119591083,chrX,UBE2A,chrX:119574536-119591083,16547
1389576,1395603,chr6,FOXF2,chr6:1389576-1395603,6027
46721002,46751738,chr10,FAM245B,chr10:46721002-46751738,30736
49477243,49487252,chr18,C18orf32,chr18:49477243-49487252,10009
32170390,32170790,chr20,RSL24D1P6,chr20:32170390-32170790,400
58269162,58289586,chr10,CISD1,chr10:58269162-58289586,20424
32186477,32190527,chr20,TSPY26P,chr20:32186477-32190527,4050
28587378,28591747,chr6,ZBED9-AS1,chr6:28587378-28591747,4369
82629539,82798796,chr4,SCD5,chr4:82629539-82798796,169257
32192504,32207743,chr20,PLAGL2,chr20:32192504-32207743,15239
36295173,36295702,chr21,SRSF9P1,chr21:36295173-36295702,529
75210755,75289950,chr18,TSHZ1,chr18:75210755-75289950,79195
19638040,19638808,chr6,UQCRFS1P3,chr6:19638040-19638808,768
29993209,29993605,chr6,DDX39BP2,chr6:29993209-29993605,396
62686912,62688190,chr9,ATP5F1AP7,chr9:62686912-62688190,1278
42916803,42925630,chr21,ERVH48-1,chr21:42916803-42925630,8827
21593751,21598619,chr6,SOX4,chr6:21593751-21598619,4868
72107818,72108312,chr9,BTF3P4,chr9:72107818-72108312,494
42972386,42973289,chr9,CNN2P4,chr9:42972386-42973289,903
32207880,32238658,chr20,POFUT1,chr20:32207880-32238658,30778
4488798,4495769,chr6,LINC02533,chr6:4488798-4495769,6971
14108813,14210955,chr21,LIPI,chr21:14108813-14210955,102142
68499532,68499968,chr10,RPL26P27,chr10:68499532-68499968,436
44016700,44022063,chr4,LINC02475,chr4:44016700-44022063,5363
10454635,10489949,chr18,APCDD1,chr18:10454635-10489949,35314
29229227,29230157,chr6,OR2G1P,chr6:29229227-29230157,930
62856999,62898095,chr9,LERFS,chr9:62856999-62898095,41096
21756548,22003769,chr10,DNAJC1,chr10:21756548-22003769,247221
38664197,38701517,chr4,KLF3,chr4:38664197-38701517,37320
20534457,21232404,chr6,CDKAL1,chr6:20534457-21232404,697947
44627093,44628378,chr21,KRTAP10-9,chr21:44627093-44628378,1285
46635595,46665124,chr21,PRMT2,chr21:46635595-46665124,29529
10474500,10478502,chr6,LINC02522,chr6:10474500-10478502,4002
48497357,48780322,chr4,FRYL,chr4:48497357-48780322,282965
10525905,10552764,chr18,NAPG,chr18:10525905-10552764,26859
24171755,24358059,chr6,DCDC2,chr6:24171755-24358059,186304
32237795,32237847,chr20,MIR1825,chr20:32237795-32237847,52
32564992,32608893,chr20,NOL4L-DT,chr20:32564992-32608893,43901
59551404,59551878,chr10,MRPL50P4,chr10:59551404-59551878,474
43789249,43790387,chr10,HNRNPA3P1,chr10:43789249-43790387,1138
42625436,42626813,chr9,FGF7P5,chr9:42625436-42626813,1377
34663859,34664101,chr10,RPL37P18,chr10:34663859-34664101,242
32631625,32673941,chr20,C20orf203,chr20:32631625-32673941,42316
43732334,43732584,chr10,UQCRHP3,chr10:43732334-43732584,250
25647570,25648104,chr10,GPN3P1,chr10:25647570-25648104,534
49014236,49115522,chr10,VSTM4,chr10:49014236-49115522,101286
42199000,42204988,chr9,FAM74A7,chr9:42199000-42204988,5988
19837370,19842197,chr6,ID4,chr6:19837370-19842197,4827
41974362,41975768,chr9,RBM17P3,chr9:41974362-41975768,1406
32690180,32690815,chr20,BAK1P1,chr20:32690180-32690815,635
62844818,62845184,chr9,CDK2AP2P2,chr9:62844818-62845184,366
98435405,98435840,chr13,FARP1-AS1,chr13:98435405-98435840,435
77456295,77526697,chr9,GNA14-AS1,chr9:77456295-77526697,70402
51966742,51967149,chr13,FABP5P2,chr13:51966742-51967149,407
32762385,32809356,chr20,DNMT3B,chr20:32762385-32809356,46971
51584455,51767709,chr13,WDFY2,chr13:51584455-51767709,183254
119646738,119646848,chrX,MIR766,chrX:119646738-119646848,110
75088514,75147265,chr9,OSTF1,chr9:75088514-75147265,58751
17282637,17283093,chrX,CBX1P4,chrX:17282637-17283093,456
17425881,17425954,chrX,MIR4768,chrX:17425881-17425954,73
50705380,50708906,chr10,CTSLP4,chr10:50705380-50708906,3526
45127318,45148914,chr10,CUBNP3,chr10:45127318-45148914,21596
17552349,17557387,chrX,NHS-AS1,chrX:17552349-17557387,5038
17705339,17705691,chrX,CHP1P3,chrX:17705339-17705691,352
68477998,68527523,chr10,SLC25A16,chr10:68477998-68527523,49525
17737449,17754988,chrX,SCML1,chrX:17737449-17754988,17539
29941260,29945884,chr6,HLA-A,chr6:29941260-29945884,4624
25742144,26031045,chr22,MYO18B,chr22:25742144-26031045,288901
92913156,92921560,chr9,ALOX15P2,chr9:92913156-92921560,8404
62860873,62864957,chr9,ADGRF5P1,chr9:62860873-62864957,4084
57982285,57982993,chr10,MRPS35P3,chr10:57982285-57982993,708
11849608,11894700,chr10,PROSER2-AS1,chr10:11849608-11894700,45092
112056845,112108015,chr13,SOX1-OT,chr13:112056845-112108015,51170
76931261,76932066,chr9,DNAJB5P1,chr9:76931261-76932066,805
70217195,70217668,chr9,RPL24P8,chr9:70217195-70217668,473
19051455,19052170,chr10,UBE2V2P1,chr10:19051455-19052170,715
61190003,61196280,chr9,SPATA31A7,chr9:61190003-61196280,6277
65169438,65169869,chr10,MYL6P3,chr10:65169438-65169869,431
88236547,88236969,chr13,RPL29P29,chr13:88236547-88236969,422
59176643,59247774,chr10,PHYHIPL,chr10:59176643-59247774,71131
95692538,95693972,chr13,MTND5P2,chr13:95692538-95693972,1434
97901653,97902288,chr13,RPL7AP61,chr13:97901653-97902288,635
10612304,10626353,chr18,LINC01887,chr18:10612304-10626353,14049
96883842,96885821,chr13,HSP90AB6P,chr13:96883842-96885821,1979
81114866,81115295,chr13,DPPA3P3,chr13:81114866-81115295,429
10623876,10624305,chr18,MIX23P1,chr18:10623876-10624305,429
44575893,44580432,chr13,TSC22D1-AS1,chr13:44575893-44580432,4539
45687548,45688469,chr13,AKR1B1P4,chr13:45687548-45688469,921
101801878,101802488,chr13,HMGB3P7,chr13:101801878-101802488,610
91127613,91131407,chr13,LINC00379,chr13:91127613-91131407,3794
10636670,10637399,chr18,PMM2P1,chr18:10636670-10637399,729
109752695,109786583,chr13,IRS2,chr13:109752695-109786583,33888
106196700,106196990,chr14,IGHV3-19,chr14:106196700-106196990,290
17769005,17769398,chrX,FAM136GP,chrX:17769005-17769398,393
106349283,106349792,chr14,IGHV4-31,chr14:106349283-106349792,509
74552503,74565445,chr13,LINC00347,chr13:74552503-74565445,12942
46651010,46651781,chr14,RPL10L,chr14:46651010-46651781,771
50623466,50641451,chr10,SGMS1-AS1,chr10:50623466-50641451,17985
10724619,10728539,chr18,KIAA0895LP1,chr18:10724619-10728539,3920
10759584,10759649,chr18,MIR6788,chr18:10759584-10759649,65
38269163,38327544,chrX,RPGR,chrX:38269163-38327544,58381
106287674,106288828,chr14,LINC00226,chr14:106287674-106288828,1154
79566678,79571445,chr13,LINC01068,chr13:79566678-79571445,4767
42660728,42661776,chr10,VN1R54P,chr10:42660728-42661776,1048
36521721,36524234,chr10,NAMPTP1,chr10:36521721-36524234,2513
109310135,109311773,chr13,LINC01067,chr13:109310135-109311773,1638
45151445,45151915,chr10,ANKRD54P1,chr10:45151445-45151915,470
110809676,110813084,chr13,LINC00567,chr13:110809676-110813084,3408
80563571,80564630,chr9,MTCO1P51,chr9:80563571-80564630,1059
70289045,70330199,chr18,SOCS6,chr18:70289045-70330199,41154
58200080,58235636,chr14,ACTR10,chr14:58200080-58235636,35556
90020654,90041499,chr9,MIR4290HG,chr9:90020654-90041499,20845
114234887,114272723,chr13,CDC16,chr13:114234887-114272723,37836
70335929,70337310,chr18,LIVAR,chr18:70335929-70337310,1381
91159573,91166272,chr9,LINC00484,chr9:91159573-91166272,6699
72096032,72217134,chr10,ASCC1,chr10:72096032-72217134,121102
21120404,21120506,chr18,RNU6-120P,chr18:21120404-21120506,102
21182503,21183499,chr18,EXOGP1,chr18:21182503-21183499,996
21240675,21241371,chr18,GREB1L-DT,chr18:21240675-21241371,696
63317067,63333091,chr9,AQP7P1,chr9:63317067-63333091,16024
21529284,21600884,chr18,ESCO1,chr18:21529284-21600884,71600
82744067,82744792,chr9,RPS6P12,chr9:82744067-82744792,725
83242990,83538546,chr9,FRMD3,chr9:83242990-83538546,295556
21612314,21633524,chr18,SNRPD1,chr18:21612314-21633524,21210
21650901,21704780,chr18,ABHD3,chr18:21650901-21704780,53879
97698922,97700734,chr9,KRT18P13,chr9:97698922-97700734,1812
71683366,71816690,chr9,CEMIP2,chr9:71683366-71816690,133324
106356145,106356591,chr14,IGHV3-29,chr14:106356145-106356591,446
96363452,96387288,chr14,GSKIP,chr14:96363452-96387288,23836
21683510,21683597,chr18,MIR320C1,chr18:21683510-21683597,87
63327726,63367228,chr18,KDSR,chr18:63327726-63367228,39502
38380027,38661780,chr21,ERG,chr21:38380027-38661780,281753
71741696,71804041,chr4,GC,chr4:71741696-71804041,62345
105721794,105722527,chr14,IGHEP1,chr14:105721794-105722527,733
89576216,89577477,chr14,FOXN3-AS2,chr14:89576216-89577477,1261
106129540,106130072,chr14,IGHV3-13,chr14:106129540-106130072,532
106344385,106344833,chr14,IGHV3-30-2,chr14:106344385-106344833,448
81727780,81743749,chr14,LINC02311,chr14:81727780-81743749,15969
106263362,106263626,chr14,IGHVII-22-1,chr14:106263362-106263626,264
43728217,43728728,chr10,SPRING1P1,chr10:43728217-43728728,511
106309417,106309666,chr14,IGHVIII-26-1,chr14:106309417-106309666,249
5304431,5304865,chr10,RPL26P28,chr10:5304431-5304865,434
47348363,47357881,chr10,RBP3,chr10:47348363-47357881,9518
31805398,31928876,chr10,ARHGAP12,chr10:31805398-31928876,123478
55559072,55701526,chr14,KTN1,chr14:55559072-55701526,142454
155456914,155458620,chrX,F8A3,chrX:155456914-155458620,1706
37008366,37011664,chrX,FAM47C,chrX:37008366-37011664,3298
73002939,73006106,chrX,PABPC1L2B,chrX:73002939-73006106,3167
120072264,120077690,chrX,RHOXF2B,chrX:120072264-120077690,5426
63389190,63422483,chr18,VPS4B,chr18:63389190-63422483,33293
115189410,115192868,chrX,RBMXL3,chrX:115189410-115192868,3458
52751132,52790305,chrX,SSX2B,chrX:52751132-52790305,39173
79225694,79326061,chr4,NAA11,chr4:79225694-79326061,100367
23762990,23765863,chr22,C22orf15,chr22:23762990-23765863,2873
5542772,5709548,chr4,EVC2,chr4:5542772-5709548,166776
44573729,44575371,chr21,KRTAP10-4,chr21:44573729-44575371,1642
44350163,44443081,chr21,TRPM2,chr21:44350163-44443081,92918
37571569,37684463,chrX,LANCL3,chrX:37571569-37684463,112894
94030794,94109856,chr9,PTPDC1,chr9:94030794-94109856,79062
23765834,23767972,chr22,CHCHD10,chr22:23765834-23767972,2138
72938163,72938958,chrX,FAM236A,chrX:72938163-72938958,795
149929573,149931287,chrX,HSFX4,chrX:149929573-149931287,1714
153334147,153360110,chrX,ZNF275,chrX:153334147-153360110,25963
40106325,40107066,chr22,RPL7P52,chr22:40106325-40107066,741
40370591,40410289,chr22,SGSM3,chr22:40370591-40410289,39698
16839283,16870362,chrX,RBBP7,chrX:16839283-16870362,31079
63476958,63505085,chr18,SERPINB5,chr18:63476958-63505085,28127
32819954,32850405,chr20,MAPRE1,chr20:32819954-32850405,30451
35172072,35216240,chr20,PROCR,chr20:35172072-35216240,44168
63496989,63497400,chr18,ATP5MC1P6,chr18:63496989-63497400,411
35195306,35195423,chr20,RNA5SP483,chr20:35195306-35195423,117
35201745,35278131,chr20,MMP24OS,chr20:35201745-35278131,76386
63123346,63320128,chr18,BCL2,chr18:63123346-63320128,196782
64705734,64709311,chr9,BMS1P11,chr9:64705734-64709311,3577
89605012,89606555,chr9,GADD45G,chr9:89605012-89606555,1543
21602128,21602383,chr6,BOLA2P3,chr6:21602128-21602383,255
63719864,63720441,chr9,CDRT15P7,chr9:63719864-63720441,577
64439346,64440180,chr9,SNX18P9,chr9:64439346-64440180,834
17759183,17987635,chr6,KIF13A,chr6:17759183-17987635,228452
12093843,12129764,chr18,ANKRD62,chr18:12093843-12129764,35921
35218009,35218185,chr20,MT1P3,chr20:35218009-35218185,176
74946583,74952912,chr9,C9orf40,chr9:74946583-74952912,6329
35226690,35276998,chr20,MMP24,chr20:35226690-35276998,50308
47370578,47414498,chrX,ZNF157,chrX:47370578-47414498,43920
51803007,51902354,chrX,MAGED1,chrX:51803007-51902354,99347
96450169,96491336,chr9,HABP4,chr9:96450169-96491336,41167
12098427,12098532,chr18,RNU6-324P,chr18:12098427-12098532,105
12101997,12102470,chr18,SDHDP1,chr18:12101997-12102470,473
12192203,12192934,chr18,PMM2P2,chr18:12192203-12192934,731
35285251,35285756,chr20,FAM83C-AS1,chr20:35285251-35285756,505
35285731,35292425,chr20,FAM83C,chr20:35285731-35292425,6694
112376355,112434689,chr13,SPACA7,chr13:112376355-112434689,58334
82352498,82374503,chr4,HNRNPD,chr4:82352498-82374503,22005
839447,839977,chr20,RPS10P5,chr20:839447-839977,530
88970887,88971341,chr9,PCNPP2,chr9:88970887-88971341,454
37101226,37179588,chr20,MROH8,chr20:37101226-37179588,78362
12211378,12211807,chr18,MIX23P3,chr18:12211378-12211807,429
12246589,12247055,chr18,PPIAP56,chr18:12246589-12247055,466
12254361,12277595,chr18,CIDEA,chr18:12254361-12277595,23234
86669349,86708307,chr9,LINC02834,chr9:86669349-86708307,38958
97501180,97601743,chr9,TMOD1,chr9:97501180-97601743,100563
40372664,40388290,chr22,SGSM3-AS1,chr22:40372664-40388290,15626
37178410,37241619,chr20,RPN2,chr20:37178410-37241619,63209
40521800,40526707,chr22,MRTFA-AS1,chr22:40521800-40526707,4907
40569286,40569895,chr22,COX6B1P3,chr22:40569286-40569895,609
40586700,40588003,chr22,RPL4P6,chr22:40586700-40588003,1303
40673484,40674451,chr22,GAPDHP37,chr22:40673484-40674451,967
30731557,30731641,chr22,MIR3200,chr22:30731557-30731641,84
30902219,30902781,chr22,EIF4HP2,chr22:30902219-30902781,562
95433604,95579759,chr13,CLDN10,chr13:95433604-95579759,146155
30922308,30932449,chr22,MORC2-AS1,chr22:30922308-30932449,10141
12304091,12304194,chr18,RNU6-170P,chr18:12304091-12304194,103
12307669,12344320,chr18,TUBB6,chr18:12307669-12344320,36651
30925130,30968774,chr22,MORC2,chr22:30925130-30968774,43644
99222064,99230615,chr9,SEC61B,chr9:99222064-99230615,8551
63222155,63223045,chr10,TATDN1P1,chr10:63222155-63223045,890
47538377,47551954,chr10,BMS1P2,chr10:47538377-47551954,13577
90609832,90642862,chr9,DIRAS2,chr9:90609832-90642862,33030
53038285,53038544,chr10,SNRPEP8,chr10:53038285-53038544,259
58334979,58370751,chr10,UBE2D1,chr10:58334979-58370751,35772
97926791,97944856,chr9,HEMGN,chr9:97926791-97944856,18065
113648804,113658198,chr13,ATP4B,chr13:113648804-113658198,9394
39745183,39802081,chr21,IGSF5,chr21:39745183-39802081,56898
23136924,23137661,chr10,YWHAZP3,chr10:23136924-23137661,737
42696012,42706453,chr10,LINC02632,chr10:42696012-42706453,10441
66724584,66725064,chr9,SDR42E1P4,chr9:66724584-66725064,480
78178263,78179512,chr9,ASS1P3,chr9:78178263-78179512,1249
96313444,96383711,chr9,SLC35D2,chr9:96313444-96383711,70267
29536933,29940033,chr21,GRIK1,chr21:29536933-29940033,403100
47300197,47313577,chr10,GDF10,chr10:47300197-47313577,13380
82823131,82824136,chr13,GYG1P2,chr13:82823131-82824136,1005
106863816,106864286,chr13,PPIAP24,chr13:106863816-106864286,470
114314482,114337626,chr13,CHAMP1,chr13:114314482-114337626,23144
52230398,52314507,chr10,PRKG1-AS1,chr10:52230398-52314507,84109
42574185,42638570,chr10,ZNF33B,chr10:42574185-42638570,64385
82909973,83012926,chr4,LIN54,chr4:82909973-83012926,102953
1894167,1940592,chr20,SIRPA,chr20:1894167-1940592,46425
89449558,89450754,chr9,PA2G4P6,chr9:89449558-89450754,1196
74828553,74830080,chr13,RIOK3P1,chr13:74828553-74830080,1527
90216039,90216924,chr9,OR7E31P,chr9:90216039-90216924,885
62857208,62858484,chr9,MYO5BP2,chr9:62857208-62858484,1276
113748511,113751089,chr13,LINC00552,chr13:113748511-113751089,2578
83659968,83707958,chr9,UBQLN1,chr9:83659968-83707958,47990
45002222,45076066,chr10,CEP164P1,chr10:45002222-45076066,73844
30969245,30979395,chr22,TUG1,chr22:30969245-30979395,10150
6667865,7148158,chrX,PUDP,chrX:6667865-7148158,480293
71015042,71168417,chr13,LINC00348,chr13:71015042-71168417,153375
35778302,35800920,chr10,PCAT5,chr10:35778302-35800920,22618
34815767,34816386,chr10,PARD3-AS1,chr10:34815767-34816386,619
44522366,44523074,chr18,MLECP1,chr18:44522366-44523074,708
44676927,44679717,chr18,SETBP1-DT,chr18:44676927-44679717,2790
44970082,44970166,chr18,MIR4319,chr18:44970082-44970166,84
69504326,69532508,chrX,NALF2,chrX:69504326-69532508,28182
33177492,33336262,chr10,NRP1,chr10:33177492-33336262,158770
119538149,119565409,chrX,STEEP1,chrX:119538149-119565409,27260
36751791,36773818,chr20,DSN1,chr20:36751791-36773818,22027
6484623,6499261,chr21,U2AF1L5,chr21:6484623-6499261,14638
13239543,13242076,chr18,C18orf15,chr18:13239543-13242076,2533
13419421,13427480,chr18,LDLRAD4-AS1,chr18:13419421-13427480,8059
1274371,1309654,chr11,TOLLIP,chr11:1274371-1309654,35283
13459947,13460026,chr18,MIR5190,chr18:13459947-13460026,79
105218929,105220694,chrX,TEX13A,chrX:105218929-105220694,1765
62690033,62690534,chr9,SDR42E1P3,chr9:62690033-62690534,501
153072454,153075019,chrX,PNMA6A,chrX:153072454-153075019,2565
13611114,13611200,chr18,MIR4526,chr18:13611114-13611200,86
99173593,99174490,chr13,RPS6P23,chr13:99173593-99174490,897
26443423,26483837,chr22,HPS4,chr22:26443423-26483837,40414
108439838,108697545,chrX,COL4A5,chrX:108439838-108697545,257707
13663347,13726663,chr18,FAM210A,chr18:13663347-13726663,63316
96246462,96250393,chr9,HSD17B3-AS1,chr9:96246462-96250393,3931
81988772,81995253,chr9,SPATA31D1,chr9:81988772-81995253,6481
112197350,112201000,chr13,LINC01070,chr13:112197350-112201000,3650
42923277,42924144,chr9,SNX18P5,chr9:42923277-42924144,867
38965925,38990859,chr13,STOML3,chr13:38965925-38990859,24934
6499203,6564489,chr21,CRYAA2,chr21:6499203-6564489,65286
101793454,101793756,chr9,MTND3P4,chr9:101793454-101793756,302
13715102,13715368,chr18,RN7SL362P,chr18:13715102-13715368,266
4338660,4339244,chr11,SSU72P7,chr11:4338660-4339244,584
99216425,99221942,chr9,ALG2,chr9:99216425-99221942,5517
2608328,2699994,chr11,KCNQ1OT1,chr11:2608328-2699994,91666
13726660,13764556,chr18,RNMT,chr18:13726660-13764556,37896
4329865,4330449,chr11,SSU72P3,chr11:4329865-4330449,584
1309769,1310707,chr11,TOLLIP-DT,chr11:1309769-1310707,938
2132538,2161209,chr11,INS-IGF2,chr11:2132538-2161209,28671
114281601,114305817,chr13,UPF3A,chr13:114281601-114305817,24216
71434405,71437924,chr4,LDHAL6EP,chr4:71434405-71437924,3519
4233288,4233872,chr11,SSU72P5,chr11:4233288-4233872,584
41744082,41748725,chr4,PHOX2B,chr4:41744082-41748725,4643
96235306,96302176,chr9,HSD17B3,chr9:96235306-96302176,66870
2129112,2141238,chr11,IGF2,chr11:2129112-2141238,12126
6444869,6468040,chr21,CBSL,chr21:6444869-6468040,23171
82900684,82919969,chr4,THAP9,chr4:82900684-82919969,19285
53459301,53701405,chr4,LNX1,chr4:53459301-53701405,242104
1223066,1262172,chr11,MUC5B,chr11:1223066-1262172,39106
13927971,13945610,chr9,LINC00583,chr9:13927971-13945610,17639
90081297,90082569,chr9,IL6RP1,chr9:90081297-90082569,1272
62888535,62889921,chr9,FGF7P8,chr9:62888535-62889921,1386
66635754,66637197,chr9,RBPJP2,chr9:66635754-66637197,1443
100302077,100352942,chr9,TEX10,chr9:100302077-100352942,50865
68304343,68304939,chr4,APOOP4,chr4:68304343-68304939,596
63743668,63832038,chr20,ZBTB46,chr20:63743668-63832038,88370
63350114,63351472,chr4,LARP1BP1,chr4:63350114-63351472,1358
79406361,79408228,chr4,GK2,chr4:79406361-79408228,1867
2847006,2916003,chr18,EMILIN2,chr18:2847006-2916003,68997
87422573,87459455,chr4,NUDT9,chr4:87422573-87459455,36882
49812713,49892242,chr20,SLC9A8,chr20:49812713-49892242,79529
95694569,95695705,chr13,MTCYBP3,chr13:95694569-95695705,1136
2916994,3013144,chr18,LPIN2,chr18:2916994-3013144,96150
12906620,12923169,chrX,TLR8,chrX:12906620-12923169,16549
112313467,112321758,chr13,LINC01043,chr13:112313467-112321758,8291
113128155,113128880,chr13,F10-AS1,chr13:113128155-113128880,725
130171962,130184870,chrX,RAB33A,chrX:130171962-130184870,12908
1389899,1462689,chr11,BRSK2,chr11:1389899-1462689,72790
110878540,110915069,chr13,ANKRD10,chr13:110878540-110915069,36529
130202707,130268899,chrX,ZNF280C,chrX:130202707-130268899,66192
34363241,34540748,chr20,ITCH,chr20:34363241-34540748,177507
75724222,75724575,chr9,OTX2P1,chr9:75724222-75724575,353
18715815,18719341,chr22,PPP1R26P4,chr22:18715815-18719341,3526
97983341,98015943,chr9,ANP32B,chr9:97983341-98015943,32602
18733914,18757906,chr22,FAM230E,chr22:18733914-18757906,23992
18773665,18843399,chr22,GGT3P,chr22:18773665-18843399,69734
66253424,66254464,chr9,CDRT15P12,chr9:66253424-66254464,1040
39556442,39673137,chr21,B3GALT5,chr21:39556442-39673137,116695
101569352,101738647,chr9,GRIN3A,chr9:101569352-101738647,169295
18833694,18834438,chr22,E2F6P1,chr22:18833694-18834438,744
2945550,2946890,chr18,CHORDC1P4,chr18:2945550-2946890,1340
18855621,18858640,chr22,BCRP7,chr22:18855621-18858640,3019
2990652,2991078,chr18,SNRPCP4,chr18:2990652-2991078,426
18873543,18894407,chr22,FAM230F,chr22:18873543-18894407,20864
7744951,7777853,chr21,SMIM11B,chr21:7744951-7777853,32902
3093568,3093629,chr18,RNU7-25P,chr18:3093568-3093629,61
130124666,130165879,chrX,AIFM1,chrX:130124666-130165879,41213
18906028,18914238,chr22,DGCR6,chr22:18906028-18914238,8210
3247481,3256236,chr18,MYL12A,chr18:3247481-3256236,8755
19816239,20289856,chr10,PLXDC2,chr10:19816239-20289856,473617
90462899,90583821,chr9,LINC01501,chr9:90462899-90583821,120922
82610974,82621610,chr4,LINC00575,chr4:82610974-82621610,10636
109281973,109297690,chr13,LINC00370,chr13:109281973-109297690,15717
80183879,80204329,chr4,PRDM8,chr4:80183879-80204329,20450
53199981,53202753,chr13,PCDH8P1,chr13:53199981-53202753,2772
7769588,7770548,chr21,FAM243B,chr21:7769588-7770548,960
28986203,28987484,chr6,HCG15,chr6:28986203-28987484,1281
114306646,114307066,chr13,CLCP2,chr13:114306646-114307066,420
30440275,30440869,chr21,KRTAP15-1,chr21:30440275-30440869,594
15247815,15248634,chr6,JARID2-AS1,chr6:15247815-15248634,819
19458398,19458718,chr13,CYCSP32,chr13:19458398-19458718,320
10404502,10407928,chr6,TFAP2A-AS2,chr6:10404502-10407928,3426
33915534,33977703,chr21,LINC00649,chr21:33915534-33977703,62169
99087819,99088625,chr13,DOCK9-DT,chr13:99087819-99088625,806
63055641,63059217,chr9,BMS1P9,chr9:63055641-63059217,3576
102995311,103018488,chr9,CYLC2,chr9:102995311-103018488,23177
10886831,10979320,chr6,SYCP2L,chr6:10886831-10979320,92489
81225865,81226983,chr13,LINC00564,chr13:81225865-81226983,1118
36005137,36007838,chr21,LINC01436,chr21:36005137-36007838,2701
18970439,19031242,chr22,DGCR5,chr22:18970439-19031242,60803
109400696,109401641,chr13,LINC00399,chr13:109400696-109401641,945
94038030,94038345,chr9,CYCSP24,chr9:94038030-94038345,315
24331450,24337121,chr13,LINC00566,chr13:24331450-24337121,5671
91409045,91423832,chr9,NFIL3,chr9:91409045-91423832,14787
112322567,112331225,chr13,LINC01044,chr13:112322567-112331225,8658
90232185,90233141,chr9,OR7E116P,chr9:90232185-90233141,956
41389115,41389593,chr4,RPL12P20,chr4:41389115-41389593,478
95479444,95533910,chr13,CLDN10-AS1,chr13:95479444-95533910,54466
98943179,99070792,chr9,COL15A1,chr9:98943179-99070792,127613
33263873,33266264,chr21,IL10RB-DT,chr21:33263873-33266264,2391
53496400,53549578,chr4,LNX1-AS1,chr4:53496400-53549578,53178
44932814,44939941,chr21,LINC01547,chr21:44932814-44939941,7127
3255436,3261850,chr18,MYL12-AS1,chr18:3255436-3261850,6414
49121839,49151547,chr10,FAM170B-AS1,chr10:49121839-49151547,29708
111865136,111901264,chr13,LINC00354,chr13:111865136-111901264,36128
19029524,19031242,chr22,FAM246C,chr22:19029524-19031242,1718
49246601,49246915,chr4,MTND3P22,chr4:49246601-49246915,314
19031564,19034564,chr22,CA15P1,chr22:19031564-19034564,3000
3261479,3278461,chr18,MYL12B,chr18:3261479-3278461,16982
19046162,19048375,chr22,DGCR11,chr22:19046162-19048375,2213
43358147,43362349,chr21,LINC01679,chr21:43358147-43362349,4202
70360760,70367158,chr4,SMR3A,chr4:70360760-70367158,6398
16590611,16817463,chr10,RSU1,chr10:16590611-16817463,226852
18366736,18368644,chr6,IMPDH1P9,chr6:18366736-18368644,1908
42085526,42090884,chr22,NDUFA6,chr22:42085526-42090884,5358
67558727,67607337,chr4,STAP1,chr4:67558727-67607337,48610
18128311,18155077,chr6,TPMT,chr6:18128311-18155077,26766
42090931,42137742,chr22,NDUFA6-DT,chr22:42090931-42137742,46811
75136154,75136940,chr13,SSR1P2,chr13:75136154-75136940,786
45590771,45603088,chr21,LINC01694,chr21:45590771-45603088,12317
89833157,89833941,chr13,RPL7L1P1,chr13:89833157-89833941,784
37995494,37996203,chr4,PSME2P4,chr4:37995494-37996203,709
114329559,114333948,chr13,LINC01054,chr13:114329559-114333948,4389
17611708,17633199,chr21,BTG3-AS1,chr21:17611708-17633199,21491
98909537,98909848,chr4,TBCAP3,chr4:98909537-98909848,311
107163510,107867496,chr13,NALF1,chr13:107163510-107867496,703986
30984106,30984215,chr18,RNU6-857P,chr18:30984106-30984215,109
25385388,25431701,chr21,LINC00158,chr21:25385388-25431701,46313
47485275,47593486,chr4,ATP10D,chr4:47485275-47593486,108211
30989365,31042815,chr18,DSC3,chr18:30989365-31042815,53450
104814327,104815069,chr13,RPL7P45,chr13:104814327-104815069,742
16107622,16108593,chr6,MDH1P2,chr6:16107622-16108593,971
113158648,113172386,chr13,PROZ,chr13:113158648-113172386,13738
11043482,11079154,chr6,ELOVL2-AS1,chr6:11043482-11079154,35672
6074845,6123030,chr20,FERMT1,chr20:6074845-6123030,48185
42107765,42108953,chr22,OLA1P1,chr22:42107765-42108953,1188
24001824,24002433,chr6,HNRNPA1P58,chr6:24001824-24002433,609
42149886,42155001,chr22,CYP2D8P,chr22:42149886-42155001,5115
68544489,68544833,chr10,TMEM14DP,chr10:68544489-68544833,344
52389112,52389488,chr10,RPL31P44,chr10:52389112-52389488,376
36131767,36175815,chr21,CBR3-AS1,chr21:36131767-36175815,44048
42269703,42279534,chr22,OGFRP1,chr22:42269703-42279534,9831
105694541,105776629,chr9,TMEM38B,chr9:105694541-105776629,82088
7326656,7389742,chr6,CAGE1,chr6:7326656-7389742,63086
59736692,59756041,chr10,MRLN,chr10:59736692-59756041,19349
42380407,42432403,chr22,NFAM1,chr22:42380407-42432403,51996
101761798,101927989,chr14,PPP2R5C,chr14:101761798-101927989,166191
99305176,99306611,chr9,KRT8P11,chr9:99305176-99306611,1435
65878766,65894790,chr9,AQP7P3,chr9:65878766-65894790,16024
31129236,31162856,chr18,DSC1,chr18:31129236-31162856,33620
50726947,50727969,chr10,PGGT1BP1,chr10:50726947-50727969,1022
75276376,75276646,chr10,HMGA1P5,chr10:75276376-75276646,270
9068325,9129773,chr21,TEKT4P2,chr21:9068325-9129773,61448
43741437,43742350,chr10,ELOCP30,chr10:43741437-43742350,913
68674356,68675100,chr10,RPS3AP37,chr10:68674356-68675100,744
42508344,42519796,chr22,RRP7A,chr22:42508344-42519796,11452
77953495,77953876,chr10,H2AZP5,chr10:77953495-77953876,381
35507564,35507873,chr9,RPL36AP33,chr9:35507564-35507873,309
61330717,61453030,chr9,CNTNAP3C,chr9:61330717-61453030,122313
65054460,65055003,chr10,NEK4P3,chr10:65054460-65055003,543
28004702,28004932,chr10,MRPS21P5,chr10:28004702-28004932,230
78068623,78069538,chr10,GNAI2P2,chr10:78068623-78069538,915
93951627,93955355,chr9,BARX1,chr9:93951627-93955355,3728
63427297,63427939,chr10,PRELID1P3,chr10:63427297-63427939,642
30012803,30115494,chr10,JCAD,chr10:30012803-30115494,102691
44944015,44944961,chr4,PRDX4P1,chr4:44944015-44944961,946
73508803,73534128,chr4,LINC02499,chr4:73508803-73534128,25325
44247099,44280947,chr20,GDAP1L1,chr20:44247099-44280947,33848
25561810,25575168,chr21,MIR155HG,chr21:25561810-25575168,13358
82010665,82013095,chr4,NPM1P41,chr4:82010665-82013095,2430
38426327,38455199,chr22,KCNJ4,chr22:38426327-38455199,28872
2400488,2403878,chr11,TSSC4,chr11:2400488-2403878,3390
5109496,5110762,chr9,MTND5P14,chr9:5109496-5110762,1266
74371535,74372416,chr10,RPSAP6,chr10:74371535-74372416,881
90300885,90433566,chr9,LINC01508,chr9:90300885-90433566,132681
18735745,18738631,chr10,AIFM1P1,chr10:18735745-18738631,2886
113759226,113816995,chr13,TMEM255B,chr13:113759226-113816995,57769
38778508,38794198,chr22,DNAL4,chr22:38778508-38794198,15690
75397830,75401764,chr10,ZNF503,chr10:75397830-75401764,3934
73847866,73848829,chr4,PPBPP1,chr4:73847866-73848829,963
20651450,20803816,chr21,LINC00320,chr21:20651450-20803816,152366
31318160,31359246,chr18,DSG1,chr18:31318160-31359246,41086
30720415,31146805,chr4,PCDH7,chr4:30720415-31146805,426390
81913437,81919926,chr9,SPATA31D5P,chr9:81913437-81919926,6489
45706431,45727231,chr10,FAM21FP,chr10:45706431-45727231,20800
38818452,38844028,chr22,NPTXR,chr22:38818452-38844028,25576
22345445,22454224,chr10,SPAG6,chr10:22345445-22454224,108779
2140501,2148666,chr11,IGF2-AS,chr11:2140501-2148666,8165
92711363,92764833,chr9,BICD2,chr9:92711363-92764833,53470
38861422,38872249,chr22,CBX6,chr22:38861422-38872249,10827
67820876,67884002,chr4,TMPRSS11D,chr4:67820876-67884002,63126
4378282,4379209,chr11,OR52B3P,chr11:4378282-4379209,927
1242261,1249676,chr11,MUC5B-AS1,chr11:1242261-1249676,7415
2335135,2347685,chr11,RPL26P30,chr11:2335135-2347685,12550
4431323,4432277,chr11,OR52P2P,chr11:4431323-4432277,954
31345362,31345467,chr18,RNU6-167P,chr18:31345362-31345467,105
4367263,4368386,chr11,OR52B4,chr11:4367263-4368386,1123
107543151,107543616,chr9,PPIAP88,chr9:107543151-107543616,465
26133852,26193355,chr18,PSMA8,chr18:26133852-26193355,59503
110243810,110256507,chr9,TXN,chr9:110243810-110256507,12697
2444684,2849105,chr11,KCNQ1,chr11:2444684-2849105,404421
38952741,38992778,chr22,APOBEC3A,chr22:38952741-38992778,40037
16272104,16573448,chr20,KIF16B,chr20:16272104-16573448,301344
113177536,113208715,chr13,PCID2,chr13:113177536-113208715,31179
9692495,9702954,chr4,FAM86MP,chr4:9692495-9702954,10459
7040849,7043001,chr4,CCDC96,chr4:7040849-7043001,2152
109498325,110172512,chr9,PALM2AKAP2,chr9:109498325-110172512,674187
99304971,99352760,chr4,ADH1B,chr4:99304971-99352760,47789
2663629,2750922,chr6,MYLK4,chr6:2663629-2750922,87293
38982347,38992804,chr22,APOBEC3B,chr22:38982347-38992804,10457
9546791,9615240,chr18,PPP4R1,chr18:9546791-9615240,68449
33771202,33789130,chr6,LEMD2,chr6:33771202-33789130,17928
52411135,52413492,chr10,THAP12P3,chr10:52411135-52413492,2357
80215851,80216119,chr10,RPS12P2,chr10:80215851-80216119,268
45454585,45594906,chr10,MARCHF8,chr10:45454585-45594906,140321
4384897,4393702,chr11,TRIM21,chr11:4384897-4393702,8805
78179185,78551355,chr10,LINC00595,chr10:78179185-78551355,372170
63865228,63891545,chr20,TPD52L2,chr20:63865228-63891545,26317
4278705,4279192,chr11,SSU72P6,chr11:4278705-4279192,487
1350359,1364286,chr11,LINC02689,chr11:1350359-1364286,13927
11856490,11856859,chr11,H3P33,chr11:11856490-11856859,369
14236206,14362754,chr21,ABCC13,chr21:14236206-14362754,126548
38991559,38998209,chr22,APOBEC3B-AS1,chr22:38991559-38998209,6650
17515165,17527104,chr4,CLRN2,chr4:17515165-17527104,11939
39014257,39020352,chr22,APOBEC3C,chr22:39014257-39020352,6095
6926404,7001004,chr11,ZNF215,chr11:6926404-7001004,74600
6320578,6563600,chr4,PPP2R2C,chr4:6320578-6563600,243022
16276871,16295858,chr10,LINC02654,chr10:16276871-16295858,18987
39040604,39055972,chr22,APOBEC3F,chr22:39040604-39055972,15368
118740563,118745312,chr9,LINC02578,chr9:118740563-118745312,4749
94176492,94259545,chr9,LINC02603,chr9:94176492-94259545,83053
72917641,72918534,chr10,NPM1P24,chr10:72917641-72918534,893
41275739,41276778,chrX,LINC02601,chrX:41275739-41276778,1039
68560337,68694487,chr10,TET1,chr10:68560337-68694487,134150
1609915,1613897,chr6,FOXC1,chr6:1609915-1613897,3982
41292798,41292916,chrX,RNA5SP502,chrX:41292798-41292916,118
41322601,41323111,chrX,SHISA5P1,chrX:41322601-41323111,510
41345576,41345876,chrX,RN7SL15P,chrX:41345576-41345876,300
41472264,41472653,chrX,GEMIN7P1,chrX:41472264-41472653,389
88324454,88325339,chr9,RPSAP49,chr9:88324454-88325339,885
41520036,41522336,chrX,CASK-AS1,chrX:41520036-41522336,2300
41570923,41571029,chrX,RNU6-1321P,chrX:41570923-41571029,106
41675760,41676494,chrX,YWHAZP10,chrX:41675760-41676494,734
29994437,29995314,chr6,MCCD1P2,chr6:29994437-29995314,877
68705240,69009176,chr9,PIP5K1B,chr9:68705240-69009176,303936
41683168,41683462,chrX,RN7SL144P,chrX:41683168-41683462,294
6259806,6272127,chr11,CCKBR,chr11:6259806-6272127,12321
36854827,36874803,chr6,PPIL1,chr6:36854827-36874803,19976
41724181,41730130,chrX,GPR82,chrX:41724181-41730130,5949
39077067,39087743,chr22,APOBEC3G,chr22:39077067-39087743,10676
41748222,41748608,chrX,RPS15AP39,chrX:41748222-41748608,386
41919254,41919349,chrX,RNU6-202P,chrX:41919254-41919349,95
52314281,52318042,chr10,DKK1,chr10:52314281-52318042,3761
77727867,77728080,chrX,FABP5P15,chrX:77727867-77728080,213
10409340,10416446,chr6,TFAP2A-AS1,chr6:10409340-10416446,7106
77837289,77837395,chrX,RNU6-854P,chrX:77837289-77837395,106
77885377,77885634,chrX,RN7SL460P,chrX:77885377-77885634,257
77899440,77907376,chrX,COX7B,chrX:77899440-77907376,7936
11102489,11111725,chr6,ERVFRD-1,chr6:11102489-11111725,9236
18120440,18122677,chr6,NHLRC1,chr6:18120440-18122677,2237
44485486,44491141,chr21,LINC02575,chr21:44485486-44491141,5655
45288035,45297806,chr21,LINC00205,chr21:45288035-45297806,9771
35896874,35898963,chr10,LINC02630,chr10:35896874-35898963,2089
48296816,48306179,chrX,SSX9P,chrX:48296816-48306179,9363
4706159,4955551,chr6,CDYL,chr6:4706159-4955551,249392
32009015,32056425,chr10,KIF5B,chr10:32009015-32056425,47410
48322349,48326683,chrX,SSXP9,chrX:48322349-48326683,4334
15552855,15604169,chr11,LINC02751,chr11:15552855-15604169,51314
48336899,48337169,chrX,S100A11P9,chrX:48336899-48337169,270
48346427,48356707,chrX,SSX3,chrX:48346427-48356707,10280
15928296,16645467,chr21,MIR99AHG,chr21:15928296-16645467,717171
69280475,69295050,chr4,UGT2B28,chr4:69280475-69295050,14575
106165205,106165730,chr14,IGHV3-16,chr14:106165205-106165730,525
36136108,36176468,chr14,PTCSC3,chr14:36136108-36176468,40360
11270877,11622005,chr11,GALNT18,chr11:11270877-11622005,351128
39399778,39437060,chr22,TAB1,chr22:39399778-39437060,37282
89794669,89954777,chr14,EFCAB11,chr14:89794669-89954777,160108
48383516,48393347,chrX,SSX4,chrX:48383516-48393347,9831
92702345,92702659,chr4,MTND1P19,chr4:92702345-92702659,314
73098822,73099145,chr4,HMGA1P2,chr4:73098822-73099145,323
6205557,6211135,chr11,C11orf42,chr11:6205557-6211135,5578
79395856,79529325,chr18,NFATC1,chr18:79395856-79529325,133469
15910528,15930951,chr11,LINC02682,chr11:15910528-15930951,20423
20696282,20752907,chr4,PACRGL,chr4:20696282-20752907,56625
100975668,100976682,chr9,GAPDHP26,chr9:100975668-100976682,1014
80565032,80565962,chr9,MTND2P9,chr9:80565032-80565962,930
48476021,48486364,chrX,FTSJ1,chrX:48476021-48486364,10343
12319453,12319592,chr6,SUMO2P12,chr6:12319453-12319592,139
41657708,41699072,chr9,FAM242F,chr9:41657708-41699072,41364
39899578,39934551,chr6,MOCS1,chr6:39899578-39934551,34973
14904997,15082342,chr11,CALCB,chr11:14904997-15082342,177345
35406755,35483035,chr9,ATP8B5P,chr9:35406755-35483035,76280
39457012,39492194,chr22,MGAT3,chr22:39457012-39492194,35182
39475807,39476822,chr22,MGAT3-AS1,chr22:39475807-39476822,1015
39499432,39518132,chr22,MIEF1,chr22:39499432-39518132,18700
13492054,13496181,chr11,PTH,chr11:13492054-13496181,4127
13669327,13670149,chr11,FAR1-IT1,chr11:13669327-13670149,822
6151641,6152549,chr11,OR52B1P,chr11:6151641-6152549,908
4287499,4288083,chr11,SSU72P4,chr11:4287499-4288083,584
13986175,13987909,chr9,PES1P2,chr9:13986175-13987909,1734
8106056,8169055,chr11,RIC3,chr11:8106056-8169055,62999
98731329,98796965,chr9,ANKS6,chr9:98731329-98796965,65636
92513781,92688994,chr14,RIN3,chr14:92513781-92688994,175213
48521799,48528716,chrX,EBP,chrX:48521799-48528716,6917
13849247,13996443,chr20,SEL1L2,chr20:13849247-13996443,147196
10582817,10582919,chrX,RNU6-800P,chrX:10582817-10582919,102
15235288,15270467,chrX,ASB9,chrX:15235288-15270467,35179
14987671,14988694,chr11,OR7E41P,chr11:14987671-14988694,1023
28446973,28447807,chr6,COX11P1,chr6:28446973-28447807,834
118763867,118764345,chr9,TUBB4BP6,chr9:118763867-118764345,478
42950566,42951630,chr9,CYP4F60P,chr9:42950566-42951630,1064
2404515,2423045,chr11,TRPM5,chr11:2404515-2423045,18530
15102584,15168693,chr10,NMT2,chr10:15102584-15168693,66109
69709522,69760011,chr9,PTAR1,chr9:69709522-69760011,50489
41026895,41039221,chr6,UNC5CL,chr6:41026895-41039221,12326
39529093,39532761,chr22,RPS19BP1,chr22:39529093-39532761,3668
106116635,106117204,chr14,IGHV3-11,chr14:106116635-106117204,569
15281697,15315640,chrX,ASB11,chrX:15281697-15315640,33943
106329432,106329684,chr14,IGHVII-28-1,chr14:106329432-106329684,252
22493403,22493465,chr14,TRAJ46,chr14:22493403-22493465,62
52117602,52117995,chr14,COX5AP2,chr14:52117602-52117995,393
52775193,52791668,chr14,GNPNAT1,chr14:52775193-52791668,16475
41042467,41044337,chr6,TSPO2,chr6:41042467-41044337,1870
21811621,21812347,chr9,TUBB8P1,chr9:21811621-21812347,726
102055252,102055741,chr9,ARL2BPP7,chr9:102055252-102055741,489
97699625,97853080,chr9,PTCSC2,chr9:97699625-97853080,153455
17518676,17519029,chr22,DNAJA1P6,chr22:17518676-17519029,353
17563450,17590995,chr22,SLC25A18,chr22:17563450-17590995,27545
31253901,31254777,chr9,SLC25A6P2,chr9:31253901-31254777,876
63861498,63862988,chr20,ABHD16B,chr20:63861498-63862988,1490
23035312,23039237,chr20,SSTR4,chr20:23035312-23039237,3925
25070885,25082141,chr20,VSX1,chr20:25070885-25082141,11256
127087348,127122635,chr9,ANGPTL2,chr9:127087348-127122635,35287
34018643,34155622,chr6,GRM4,chr6:34018643-34155622,136979
15319452,15335554,chrX,PIGA,chrX:15319452-15335554,16102
18343038,18343144,chr14,RNU6-458P,chr14:18343038-18343144,106
18978847,18978953,chr14,RNU6-1239P,chr14:18978847-18978953,106
34546714,34546877,chr14,RNU1-27P,chr14:34546714-34546877,163
32442341,32442639,chr14,RN7SL660P,chr14:32442341-32442639,298
32203163,32203269,chr14,RNU6-8,chr14:32203163-32203269,106
37187219,37187314,chr14,RNU6-273P,chr14:37187219-37187314,95
31662039,31662143,chr14,RNU6-602P,chr14:31662039-31662143,104
47760995,47761104,chr14,MIR548Y,chr14:47760995-47761104,109
37434469,37434573,chr14,RNU6-886P,chr14:37434469-37434573,104
49154725,49188585,chr10,TMEM273,chr10:49154725-49188585,33860
31686692,31686798,chr14,RNU6-455P,chr14:31686692-31686798,106
37827798,37827904,chr14,RNU6-1277P,chr14:37827798-37827904,106
26908642,26908725,chr14,MIR4307,chr14:26908642-26908725,83
27633205,27633278,chr14,MIR3171,chr14:27633205-27633278,73
34675891,34675994,chr14,RNU6-1261P,chr14:34675891-34675994,103
49552633,49552748,chr14,RNA5SP384,chr14:49552633-49552748,115
51522864,51522967,chr14,RNU6-1291P,chr14:51522864-51522967,103
51692752,51692861,chr14,RNA5SP385,chr14:51692752-51692861,109
32202045,32202151,chr14,RNU6-7,chr14:32202045-32202151,106
51724103,51724209,chr14,RNU6-301P,chr14:51724103-51724209,106
45088243,45088308,chr14,SNORD58,chr14:45088243-45088308,65
45110883,45110968,chr14,SNORD127,chr14:45110883-45110968,85
60974327,60974435,chr14,RNU6-398P,chr14:60974327-60974435,108
36952309,36952391,chr14,MIR4503,chr14:36952309-36952391,82
53948427,53948484,chr14,MIR5580,chr14:53948427-53948484,57
36231555,36231774,chr14,RN7SKP21,chr14:36231555-36231774,219
65335117,65335183,chr14,MIR4708,chr14:65335117-65335183,66
58179771,58180064,chr14,RN7SL598P,chr14:58179771-58180064,293
57837354,57837660,chr14,RN7SKP99,chr14:57837354-57837660,306
59646962,59647020,chr14,MIR5586,chr14:59646962-59647020,58
65124352,65124542,chr14,RNU2-14P,chr14:65124352-65124542,190
17592136,17628749,chr22,ATP6V1E1,chr22:17592136-17628749,36613
48341226,48341332,chr14,RNU6-297P,chr14:48341226-48341332,106
71398337,71398407,chr14,SNORD56B,chr14:71398337-71398407,70
73040619,73040914,chr14,RN7SL586P,chr14:73040619-73040914,295
71448689,71448958,chr14,RN7SL683P,chr14:71448689-71448958,269
49586580,49586878,chr14,RN7SL1,chr14:49586580-49586878,298
64810865,64811429,chr9,BNIP3P4,chr9:64810865-64811429,564
34556226,34556389,chr14,RNU1-28P,chr14:34556226-34556389,163
90742526,90743380,chr9,OR7E109P,chr9:90742526-90743380,854
45274359,45274477,chr14,RNU6-552P,chr14:45274359-45274477,118
64488600,64489786,chr9,GXYLT1P6,chr9:64488600-64489786,1186
72871130,72874135,chr9,LINC01474,chr9:72871130-72874135,3005
3264032,3302452,chr7,SDK1-AS1,chr7:3264032-3302452,38420
65471102,65471186,chr14,MIR625,chr14:65471102-65471186,84
84739942,84740052,chr14,RNU6-976P,chr14:84739942-84740052,110
83750384,83750501,chr14,RNU6ATAC28P,chr14:83750384-83750501,117
74480133,74480204,chr14,MIR4709,chr14:74480133-74480204,71
73246818,73246880,chr14,RNU6-419P,chr14:73246818-73246880,62
36541497,36551447,chr20,MYL9,chr20:36541497-36551447,9950
91091077,91091138,chr14,RNU7-30P,chr14:91091077-91091138,61
1232872,1237326,chr7,UNCX,chr7:1232872-1237326,4454
91126425,91126553,chr14,SNORA11B,chr14:91126425-91126553,128
89621918,89622207,chr14,RN7SKP107,chr14:89621918-89622207,289
89712511,89712823,chr14,RN7SKP255,chr14:89712511-89712823,312
87996345,87996448,chr14,RNU6-835P,chr14:87996345-87996448,103
95533355,95533629,chr14,SCARNA13,chr14:95533355-95533629,274
64765054,64765535,chr9,IGKV1OR-2,chr9:64765054-64765535,481
93437400,93437510,chr14,RNU6-1258P,chr14:93437400-93437510,110
100319073,100319370,chr14,RN7SL523P,chr14:100319073-100319370,297
88990863,89005155,chr9,S1PR3,chr9:88990863-89005155,14292
100277357,100277417,chr14,MIR6764,chr14:100277357-100277417,60
15345596,15384413,chrX,VEGFD,chrX:15345596-15384413,38817
876554,896436,chr7,GET4,chr7:876554-896436,19882
102865856,102865963,chr14,RNU6-1316P,chr14:102865856-102865963,107
98351367,98351664,chr14,RN7SL714P,chr14:98351367-98351664,297
104400943,104401048,chr14,RNU6-684P,chr14:104400943-104401048,105
96384624,96384815,chr14,RNU2-33P,chr14:96384624-96384815,191
100307859,100307956,chr14,MIR345,chr14:100307859-100307956,97
99945315,99945477,chr14,RNU1-47P,chr14:99945315-99945477,162
102077180,102077472,chr14,RN7SL472P,chr14:102077180-102077472,292
101803227,101803331,chr14,RNU6-790P,chr14:101803227-101803331,104
104117405,104117514,chr14,MIR203A,chr14:104117405-104117514,109
102539644,102539726,chr14,MIR4309,chr14:102539644-102539726,82
99444306,99444412,chr14,RNU6-91P,chr14:99444306-99444412,106
68721012,68792377,chr10,CCAR1,chr10:68721012-68792377,71365
101560287,101560422,chr14,MIR1247,chr14:101560287-101560422,135
104117418,104117503,chr14,MIR203B,chr14:104117418-104117503,85
104013642,104013933,chr14,RN7SL634P,chr14:104013642-104013933,291
10156975,10237660,chrX,CLCN4,chrX:10156975-10237660,80685
100109419,100109514,chr14,MIR151B,chr14:100109419-100109514,95
100109655,100109753,chr14,MIR342,chr14:100109655-100109753,98
102582888,102583177,chr14,RN7SL546P,chr14:102582888-102583177,289
102501676,102501779,chr14,RNU6-244P,chr14:102501676-102501779,103
69820817,69906227,chr9,C9orf135,chr9:69820817-69906227,85410
83048579,83048640,chr14,RNU7-51P,chr14:83048579-83048640,61
22494821,22494883,chr14,TRAJ44,chr14:22494821-22494883,62
36573488,36593950,chr20,TGIF2,chr20:36573488-36593950,20462
22495913,22495966,chr14,TRAJ43,chr14:22495913-22495966,53
22496887,22496952,chr14,TRAJ42,chr14:22496887-22496952,65
22497657,22497718,chr14,TRAJ41,chr14:22497657-22497718,61
22499689,22499749,chr14,TRAJ40,chr14:22499689-22499749,60
22501601,22501663,chr14,TRAJ39,chr14:22501601-22501663,62
22503750,22503814,chr14,TRAJ37,chr14:22503750-22503814,64
22505110,22505167,chr14,TRAJ36,chr14:22505110-22505167,57
22506644,22506702,chr14,TRAJ35,chr14:22506644-22506702,58
22507666,22507723,chr14,TRAJ34,chr14:22507666-22507723,57
36574553,36612384,chr20,TGIF2-RAB5IF,chr20:36574553-36612384,37831
22508602,22508658,chr14,TRAJ33,chr14:22508602-22508658,56
22509341,22509406,chr14,TRAJ32,chr14:22509341-22509406,65
22510968,22511024,chr14,TRAJ31,chr14:22510968-22511024,56
4242056,4242640,chr11,SSU72P2,chr11:4242056-4242640,584
22445673,22492073,chr11,LINC01495,chr11:22445673-22492073,46400
22512852,22512908,chr14,TRAJ30,chr14:22512852-22512908,56
30773464,30774732,chr9,KRT18P66,chr9:30773464-30774732,1268
104270228,104286955,chr9,TOPORSLP,chr9:104270228-104286955,16727
22513939,22513998,chr14,TRAJ29,chr14:22513939-22513998,59
1470277,1504389,chr7,INTS1,chr7:1470277-1504389,34112
36612318,36646196,chr20,SLA2,chr20:36612318-36646196,33878
22515623,22515688,chr14,TRAJ28,chr14:22515623-22515688,65
19117099,19176422,chr11,ZDHHC13,chr11:19117099-19176422,59323
93121496,93134251,chr9,NINJ1,chr9:93121496-93134251,12755
22516273,22516331,chr14,TRAJ27,chr14:22516273-22516331,58
22518446,22518505,chr14,TRAJ26,chr14:22518446-22518505,59
22518812,22518871,chr14,TRAJ25,chr14:22518812-22518871,59
22519969,22520031,chr14,TRAJ24,chr14:22519969-22520031,62
22520416,22520478,chr14,TRAJ23,chr14:22520416-22520478,62
22522040,22522102,chr14,TRAJ22,chr14:22522040-22522102,62
22523600,22523654,chr14,TRAJ21,chr14:22523600-22523654,54
22524325,22524381,chr14,TRAJ20,chr14:22524325-22524381,56
22525263,22525322,chr14,TRAJ19,chr14:22525263-22525322,59
36620403,36621423,chr20,HNRNPA3P2,chr20:36620403-36621423,1020
22525650,22525715,chr14,TRAJ18,chr14:22525650-22525715,65
22526844,22526906,chr14,TRAJ17,chr14:22526844-22526906,62
3046052,3048250,chr20,MRPS26,chr20:3046052-3048250,2198
22528527,22528586,chr14,TRAJ16,chr14:22528527-22528586,59
22530327,22530378,chr14,TRAJ14,chr14:22530327-22530378,51
96385941,96418370,chr9,ZNF367,chr9:96385941-96418370,32429
22531076,22531138,chr14,TRAJ13,chr14:22531076-22531138,62
3071620,3072517,chr20,OXT,chr20:3071620-3072517,897
22531939,22531998,chr14,TRAJ12,chr14:22531939-22531998,59
22532502,22532561,chr14,TRAJ11,chr14:22532502-22532561,59
17628855,17730855,chr22,BCL2L13,chr22:17628855-17730855,102000
22533497,22533560,chr14,TRAJ10,chr14:22533497-22533560,63
44801883,44804717,chr21,LINC01424,chr21:44801883-44804717,2834
22535554,22535614,chr14,TRAJ9,chr14:22535554-22535614,60
3082556,3084724,chr20,AVP,chr20:3082556-3084724,2168
76286494,76288081,chr9,RBM22P5,chr9:76286494-76288081,1587
22536145,22536204,chr14,TRAJ8,chr14:22536145-22536204,59
112750760,112881671,chr9,SNX30,chr9:112750760-112881671,130911
20657638,20688408,chr15,NBEAP1,chr15:20657638-20688408,30770
22537622,22537680,chr14,TRAJ7,chr14:22537622-22537680,58
22539073,22539134,chr14,TRAJ6,chr14:22539073-22539134,61
22540247,22540306,chr14,TRAJ5,chr14:22540247-22540306,59
22542199,22542261,chr14,TRAJ4,chr14:22542199-22542261,62
3094171,3094509,chr20,RN7SL555P,chr20:3094171-3094509,338
22543179,22543240,chr14,TRAJ3,chr14:22543179-22543240,61
3106913,3150867,chr20,UBOX5-AS1,chr20:3106913-3150867,43954
85065087,85078920,chr13,LINC00375,chr13:85065087-85078920,13833
22544071,22544136,chr14,TRAJ2,chr14:22544071-22544136,65
22545037,22545098,chr14,TRAJ1,chr14:22545037-22545098,61
3107573,3160196,chr20,UBOX5,chr20:3107573-3160196,52623
22547506,22552156,chr14,TRAC,chr14:22547506-22552156,4650
53094145,53170914,chrX,KANTR,chrX:53094145-53170914,76769
93955597,93959140,chr9,BARX1-DT,chr9:93955597-93959140,3543
22556311,22557062,chr14,LINC02332,chr14:22556311-22557062,751
22564907,22589224,chr14,DAD1,chr14:22564907-22589224,24317
53142832,53143913,chrX,ACTG1P10,chrX:53142832-53143913,1081
21080812,21081447,chr15,BCAR1P2,chr15:21080812-21081447,635
100089015,100530437,chr13,PCCA,chr13:100089015-100530437,441422
53195411,53195488,chrX,MIR6895,chrX:53195411-53195488,77
32728094,32747065,chr21,PAXBP1-AS1,chr21:32728094-32747065,18971
20011153,20011169,chr15,IGHD1OR15-1A,chr15:20011153-20011169,16
53198889,53198945,chrX,MIR6894,chrX:53198889-53198945,56
53212408,53214679,chrX,KDM5C-IT1,chrX:53212408-53214679,2271
21019388,21020851,chr15,FAM30C,chr15:21019388-21020851,1463
53322990,53323822,chrX,RPSAP62,chrX:53322990-53323822,832
20099684,20212469,chr6,MBOAT1,chr6:20099684-20212469,112785
53340986,53341505,chrX,MPV17L2P1,chrX:53340986-53341505,519
21683038,21683962,chr15,OR4N3BP,chr15:21683038-21683962,924
53405673,53405765,chrX,MIR6857,chrX:53405673-53405765,92
20003840,20003862,chr15,IGHD5OR15-5A,chr15:20003840-20003862,22
53422690,53431120,chrX,RIBC1,chrX:53422690-53431120,8430
77177445,77421537,chr9,VPS13A,chr9:77177445-77421537,244092
4797055,4883716,chr7,RADIL,chr7:4797055-4883716,86661
19978699,19981337,chr11,NAV2-AS3,chr11:19978699-19981337,2638
3190350,3204685,chr20,DDRGK1,chr20:3190350-3204685,14335
6997085,7020346,chr11,ZNF214,chr11:6997085-7020346,23261
16129086,16148248,chr6,MYLIP,chr6:16129086-16148248,19162
22701476,22766562,chr14,OXA1L-DT,chr14:22701476-22766562,65086
21372793,21373881,chr15,CXADRP2,chr15:21372793-21373881,1088
20593494,20599195,chr15,SPATA31E2P,chr15:20593494-20599195,5701
21637909,21638992,chr15,OR4M2B,chr15:21637909-21638992,1083
22702143,22703065,chr14,OR6E1P,chr14:22702143-22703065,922
53456273,53457029,chrX,TIPINP1,chrX:53456273-53457029,756
25734757,25782017,chr11,LINC02699,chr11:25734757-25782017,47260
24101827,24823365,chr15,PWRN1,chr15:24101827-24823365,721538
53462209,53462310,chrX,VTRNA3-1P,chrX:53462209-53462310,101
140397062,140398311,chrX,EEDP1,chrX:140397062-140398311,1249
140451148,140451208,chrX,U7,chrX:140451148-140451208,60
140470866,140471274,chrX,RPS17P17,chrX:140470866-140471274,408
22766522,22773042,chr14,OXA1L,chr14:22766522-22773042,6520
140502985,140505069,chrX,SOX3,chrX:140502985-140505069,2084
153642492,153651326,chrX,DUSP9,chrX:153642492-153651326,8834
1157953,1201138,chr11,MUC5AC,chr11:1157953-1201138,43185
30184455,30213427,chr6,TRIM26,chr6:30184455-30213427,28972
44921051,44929680,chr21,ITGB2-AS1,chr21:44921051-44929680,8629
6022247,6059175,chr7,EIF2AK1,chr7:6022247-6059175,36928
153662162,153662692,chrX,RPL18AP16,chrX:153662162-153662692,530
153666226,153666510,chrX,RN7SL687P,chrX:153666226-153666510,284
3208868,3223870,chr20,ITPA,chr20:3208868-3223870,15002
153669733,153689010,chrX,PNCK,chrX:153669733-153689010,19277
16484084,16484671,chr11,AKR1B1P3,chr11:16484084-16484671,587
32829927,32858120,chr11,PRRG4,chr11:32829927-32858120,28193
69051363,69112987,chr4,UGT2B7,chr4:69051363-69112987,61624
25588475,25588795,chr11,RPL36AP40,chr11:25588475-25588795,320
13756027,13757560,chr11,CENPUP1,chr11:13756027-13757560,1533
7088998,7091148,chr11,RBMXL2,chr11:7088998-7091148,2150
4865432,4865804,chr7,RPL22P16,chr7:4865432-4865804,372
76822557,76972901,chr18,ZNF236,chr18:76822557-76972901,150344
17764180,17764259,chr22,MIR3198-1,chr22:17764180-17764259,79
17777322,17779481,chr22,LINC00528,chr22:17777322-17779481,2159
37819727,38154624,chr6,ZFAND3,chr6:37819727-38154624,334897
13685499,13685656,chr11,RPL39P26,chr11:13685499-13685656,157
1152071,1160759,chr7,ZFAND2A,chr7:1152071-1160759,8688
20574186,20575042,chr11,HMGB1P40,chr11:20574186-20575042,856
6234765,6244479,chr11,CNGA4,chr11:6234765-6244479,9714
17787649,18024561,chr22,MICAL3,chr22:17787649-18024561,236912
22871740,22881713,chr14,LRP10,chr14:22871740-22881713,9973
26188842,26663289,chr11,ANO3,chr11:26188842-26663289,474447
22009547,22010529,chr15,OR11H3P,chr15:22009547-22010529,982
21980277,21981245,chr15,OR11J6P,chr15:21980277-21981245,968
41990502,42090461,chr4,SLC30A9,chr4:41990502-42090461,99959
20008402,20008432,chr15,IGHD2OR15-2A,chr15:20008402-20008432,30
23083094,23121324,chr15,ELMO2P1,chr15:23083094-23121324,38230
29497475,29510558,chr6,LINC02829,chr6:29497475-29510558,13083
11861626,11862970,chr6,AMD1P4,chr6:11861626-11862970,1344
39553811,39554943,chr6,E2F4P1,chr6:39553811-39554943,1132
22160431,22160868,chr15,IGHV1OR15-1,chr15:22160431-22160868,437
5970925,6009106,chr7,PMS2,chr7:5970925-6009106,38181
32041153,32115334,chr6,TNXB,chr6:32041153-32115334,74181
22152276,22152897,chr15,RPS8P10,chr15:22152276-22152897,621
22883222,22887678,chr14,REM2,chr14:22883222-22887678,4456
3360036,3360142,chr20,RNU6-1019P,chr20:3360036-3360142,106
21552815,21557161,chr15,LINC02203,chr15:21552815-21557161,4346
3361880,3362324,chr20,UBE2V1P1,chr20:3361880-3362324,444
21651844,21652968,chr15,OR4N4C,chr15:21651844-21652968,1124
31547412,31548081,chr20,MCTS2P,chr20:31547412-31548081,669
31563166,31564076,chr20,HM13-IT1,chr20:31563166-31564076,910
31567707,31573263,chr20,HM13-AS1,chr20:31567707-31573263,5556
25902119,26053123,chr15,LINC02346,chr15:25902119-26053123,151004
31581089,31581192,chr20,RNU6-384P,chr20:31581089-31581192,103
31605283,31606515,chr20,ID1,chr20:31605283-31606515,1232
22893204,22919182,chr14,RBM23,chr14:22893204-22919182,25978
31607186,31607240,chr20,MIR3193,chr20:31607186-31607240,54
31637912,31645006,chr20,COX4I2,chr20:31637912-31645006,7094
20012741,20014208,chr15,FAM30B,chr15:20012741-20014208,1467
25456271,25578813,chr15,LINC02250,chr15:25456271-25578813,122542
31686216,31716825,chr20,BCL2L1-AS1,chr20:31686216-31716825,30609
31721507,31723409,chr20,ABALON,chr20:31721507-31723409,1902
31739271,31801805,chr20,TPX2,chr20:31739271-31801805,62534
22983192,23039572,chr15,TUBGCP5,chr15:22983192-23039572,56380
58939288,58988182,chr4,LINC02619,chr4:58939288-58988182,48894
54099523,54102498,chr4,GSX2,chr4:54099523-54102498,2975
31280672,31280987,chr11,CYCSP25,chr11:31280672-31280987,315
16613132,16758340,chr11,C11orf58,chr11:16613132-16758340,145208
90838903,90839037,chr4,TMSB4XP8,chr4:90838903-90839037,134
17061878,17062165,chr4,MTND5P4,chr4:17061878-17062165,287
49246021,49246538,chr4,MTCO3P39,chr4:49246021-49246538,517
99202638,99219537,chr4,ADH6,chr4:99202638-99219537,16899
153700492,153724565,chrX,BCAP31,chrX:153700492-153724565,24073
19182030,19210571,chr11,CSRP3,chr11:19182030-19210571,28541
31829197,31953136,chr18,TRAPPC8,chr18:31829197-31953136,123939
6855485,6859830,chr7,UNC93B2,chr7:6855485-6859830,4345
55556519,55592245,chr4,PDCL2,chr4:55556519-55592245,35726
6923804,6930835,chr7,ALG1L5P,chr7:6923804-6930835,7031
7566875,7608932,chr7,MIOS,chr7:7566875-7608932,42057
72280969,72569221,chr4,ADAMTS3,chr4:72280969-72569221,288252
74744386,74744707,chr10,FAM32CP,chr10:74744386-74744707,321
7238778,7469043,chr11,SYT9,chr11:7238778-7469043,230265
75401519,75408982,chr10,ZNF503-AS2,chr10:75401519-75408982,7463
6879627,6880626,chr7,OR7E59P,chr7:6879627-6880626,999
75269392,75269545,chr10,RPL39P25,chr10:75269392-75269545,153
80297720,80299655,chr10,ZNF519P1,chr10:80297720-80299655,1935
153724856,153744755,chrX,ABCD1,chrX:153724856-153744755,19899
19510890,19519896,chr11,NAV2-AS4,chr11:19510890-19519896,9006
80649797,80653732,chr10,LINC02655,chr10:80649797-80653732,3935
39934595,40000527,chr6,TUBBP9,chr6:39934595-40000527,65932
38618264,38646384,chr11,LINC02759,chr11:38618264-38646384,28120
56357227,56361273,chr10,ZWINT,chr10:56357227-56361273,4046
31819308,31834689,chr20,MYLK2,chr20:31819308-31834689,15381
41993381,42163851,chr11,LINC02745,chr11:41993381-42163851,170470
38715311,39030792,chr6,DNAH8,chr6:38715311-39030792,315481
153764196,153779346,chrX,PLXNB3,chrX:153764196-153779346,15150
11351942,11353250,chr11,CSNK2A3,chr11:11351942-11353250,1308
41518895,41714492,chr11,LINC02741,chr11:41518895-41714492,195597
9634270,9635703,chr7,PER3P1,chr7:9634270-9635703,1433
15611212,15686683,chr7,MEOX2,chr7:15611212-15686683,75471
22606022,22617854,chr15,GOLGA8IP,chr15:22606022-22617854,11832
103019868,103085829,chr4,SLC9B2,chr4:103019868-103085829,65961
13610363,13610771,chr11,HMGN2P36,chr11:13610363-13610771,408
99372173,99372686,chr13,HMGB3P4,chr13:99372173-99372686,513
22622533,22625823,chr11,FANCF,chr11:22622533-22625823,3290
10449820,10779944,chr7,MGC4859,chr7:10449820-10779944,330124
14262846,14273691,chr11,SPON1-AS1,chr11:14262846-14273691,10845
10451311,10453252,chr7,HSPA8P8,chr7:10451311-10453252,1941
109728282,109730007,chr13,LINC00676,chr13:109728282-109730007,1725
38211389,38212799,chr11,DNAAF11P1,chr11:38211389-38212799,1410
4598672,4608231,chr11,TRIM68,chr11:4598672-4608231,9559
192571,260772,chr7,FAM20C,chr7:192571-260772,68201
87801036,87803808,chr13,LINC00397,chr13:87801036-87803808,2772
112485011,112588205,chr13,TUBGCP3,chr13:112485011-112588205,103194
31844303,31845604,chr20,FOXS1,chr20:31844303-31845604,1301
21490354,21509404,chr15,NF1P9,chr15:21490354-21509404,19050
31664452,31723989,chr20,BCL2L1,chr20:31664452-31723989,59537
4682295,4771442,chr7,FOXK1,chr7:4682295-4771442,89147
85577731,85607213,chr10,GRID1-AS1,chr10:85577731-85607213,29482
21595684,21596526,chr15,OR11K1BP,chr15:21595684-21596526,842
87225448,87236908,chr10,NUTM2A,chr10:87225448-87236908,11460
37938601,37954663,chr11,LINC02760,chr11:37938601-37954663,16062
24235477,24262218,chr11,LINC02686,chr11:24235477-24262218,26741
23127066,23136822,chr15,GOLGA6L1,chr15:23127066-23136822,9756
996986,1138260,chr7,C7orf50,chr7:996986-1138260,141274
30323104,30338223,chr11,ARL14EP,chr11:30323104-30338223,15119
21704957,21870953,chr18,MIB1,chr18:21704957-21870953,165996
77927372,77929824,chr10,DLG5-AS1,chr10:77927372-77929824,2452
26115726,26134001,chr15,LINC00929,chr15:26115726-26134001,18275
19196775,19281426,chr11,CSRP3-AS1,chr11:19196775-19281426,84651
153776412,153785732,chrX,SRPK3,chrX:153776412-153785732,9320
75431624,76560168,chr10,LRMDA,chr10:75431624-76560168,1128544
21114723,21115197,chr20,RPL24P2,chr20:21114723-21115197,474
17788048,18013047,chr11,SERGEF,chr11:17788048-18013047,224999
21125983,21246622,chr20,KIZ,chr20:21125983-21246622,120639
64609454,64610532,chr4,MTND5P13,chr4:64609454-64610532,1078
68182292,68212470,chr4,FTLP10,chr4:68182292-68212470,30178
100778582,100791426,chr4,LINC01217,chr4:100778582-100791426,12844
7041899,7057952,chr4,TADA2B,chr4:7041899-7057952,16053
2631986,2664802,chr7,TTYH3,chr7:2631986-2664802,32816
63465229,63466563,chr10,JMJD1C-AS1,chr10:63465229-63466563,1334
85193421,85197958,chr10,LINC01519,chr10:85193421-85197958,4537
74423435,74424014,chr10,RAB5CP1,chr10:74423435-74424014,579
68715209,69055189,chr18,CCDC102B,chr18:68715209-69055189,339980
74641410,74641776,chr10,NDUFA8P1,chr10:74641410-74641776,366
26697701,26746798,chr10,PDSS1,chr10:26697701-26746798,49097
21010494,21010516,chr15,IGHD5OR15-5B,chr15:21010494-21010516,22
94369833,94370163,chr4,RPL35AP11,chr4:94369833-94370163,330
22125511,22126434,chr15,OR4N3P,chr15:22125511-22126434,923
24908932,24909825,chr15,RPL5P1,chr15:24908932-24909825,893
21971706,21972645,chr15,OR11J7P,chr15:21971706-21972645,939
92303966,93810157,chr4,GRID2,chr4:92303966-93810157,1506191
20940380,21058440,chr15,LINC01193,chr15:20940380-21058440,118060
45000923,45005326,chr10,ZNF22,chr10:45000923-45005326,4403
59955430,59960913,chr10,LINC01553,chr10:59955430-59960913,5483
3663063,3696194,chr17,P2RX5-TAX1BP3,chr17:3663063-3696194,33131
80150889,80205572,chr10,ANXA11,chr10:80150889-80205572,54683
17980868,17980961,chr22,MIR648,chr22:17980868-17980961,93
18019214,18020200,chr22,RHEBP3,chr22:18019214-18020200,986
24138987,24161600,chr18,CABYR,chr18:24138987-24161600,22613
2337498,2381058,chr17,SGSM2,chr17:2337498-2381058,43560
18102457,18103649,chr22,ARL2BPP10,chr22:18102457-18103649,1192
50691260,50691363,chr22,RNU6-409P,chr22:50691260-50691363,103
62801461,62813486,chr9,LINC01410,chr9:62801461-62813486,12025
50738196,50745339,chr22,ACR,chr22:50738196-50745339,7143
153793516,153798499,chrX,SSR4,chrX:153793516-153798499,4983
22178107,22178542,chr15,IGHV1OR15-3,chr15:22178107-22178542,435
98890590,98891937,chr9,NME2P3,chr9:98890590-98891937,1347
1160374,1165607,chr7,ZFAND2A-DT,chr7:1160374-1165607,5233
105532475,105532630,chr4,ATP5F1EP1,chr4:105532475-105532630,155
19987656,19988117,chr15,IGHV3OR15-7,chr15:19987656-19988117,461
62924911,62934964,chr9,CNTNAP3P1,chr9:62924911-62934964,10053
20639464,20639890,chr15,IGHV1OR15-6,chr15:20639464-20639890,426
74933095,75050115,chr4,PARM1,chr4:74933095-75050115,117020
4511959,4512033,chr7,CYP3A54P,chr7:4511959-4512033,74
22918947,22926900,chr14,PRMT5-AS1,chr14:22918947-22926900,7953
21138956,21139074,chr20,RNA5SP477,chr20:21138956-21139074,118
89311195,89316703,chr9,CKS2,chr9:89311195-89316703,5508
6009255,6023834,chr7,AIMP2,chr7:6009255-6023834,14579
33104330,33145861,chr22,LINC01640,chr22:33104330-33145861,41531
21154023,21218289,chr20,KIZ-AS1,chr20:21154023-21218289,64266
63774870,63775241,chr9,CDK2AP2P3,chr9:63774870-63775241,371
103586031,103719985,chr4,TACR3,chr4:103586031-103719985,133954
21383821,21384064,chr15,GRAMD4P6,chr15:21383821-21384064,243
99397024,99906605,chr9,STX17-DT,chr9:99397024-99906605,509581
33436582,33436669,chr22,MIR4764,chr22:33436582-33436669,87
33704786,33704920,chr22,SNORA50B,chr22:33704786-33704920,134
33723832,33724912,chr22,LARGE-IT1,chr22:33723832-33724912,1080
21015048,21015078,chr15,IGHD2OR15-2B,chr15:21015048-21015078,30
21166206,21166596,chr20,RPS15AP1,chr20:21166206-21166596,390
20813299,20814958,chr15,GRAMD4P5,chr15:20813299-20814958,1659
66744561,66745929,chr9,FKBP4P8,chr9:66744561-66745929,1368
33725007,33750843,chr22,LARGE-AS1,chr22:33725007-33750843,25836
21265854,21266465,chr20,ZNF877P,chr20:21265854-21266465,611
23157366,23170711,chr15,GOLGA8DP,chr15:23157366-23170711,13345
22920525,22929408,chr14,PRMT5,chr14:22920525-22929408,8883
17903762,17903861,chr20,RNU6-192P,chr20:17903762-17903861,99
70043848,70226972,chr9,MAMDC2,chr9:70043848-70226972,183124
105746245,105827172,chr4,GSTCD-AS1,chr4:105746245-105827172,80927
17956979,18059188,chr20,OVOL2,chr20:17956979-18059188,102209
41748293,41824119,chr4,PHOX2B-AS1,chr4:41748293-41824119,75826
16864267,16866308,chr7,RAD17P1,chr7:16864267-16866308,2041
34246381,34249108,chr6,SMIM29,chr6:34246381-34249108,2727
153841251,153841565,chrX,CYCSP45,chrX:153841251-153841565,314
81164922,81193395,chr4,PRKG2-AS1,chr4:81164922-81193395,28473
84583127,84651334,chr4,CDS1,chr4:84583127-84651334,68207
153861514,153886173,chrX,L1CAM,chrX:153861514-153886173,24659
17962710,17962946,chr20,SNORD17,chr20:17962710-17962946,236
17969018,17991122,chr20,MGME1,chr20:17969018-17991122,22104
34438934,34472060,chr11,CAT,chr11:34438934-34472060,33126
816615,896435,chr7,SUN1,chr7:816615-896435,79820
21209189,21209779,chr9,IFNWP18,chr9:21209189-21209779,590
107283137,107332192,chr9,RAD23B,chr9:107283137-107332192,49055
18011955,18012284,chr20,PTMAP3,chr20:18011955-18012284,329
46330875,46357340,chr22,TRMU,chr22:46330875-46357340,26465
18090116,18090715,chr20,RPL15P1,chr20:18090116-18090715,599
18095571,18095632,chr20,RNU7-137P,chr20:18095571-18095632,61
18220113,18220512,chr20,GGCTP2,chr20:18220113-18220512,399
18258554,18258851,chr20,RN7SL14P,chr20:18258554-18258851,297
18265690,18265879,chr20,RNU2-56P,chr20:18265690-18265879,189
38006784,38007105,chr4,MRPS33P2,chr4:38006784-38007105,321
20531856,20541800,chr15,GOLGA6L6,chr15:20531856-20541800,9944
18295143,18295451,chr20,RN7SKP74,chr20:18295143-18295451,308
102896725,102898237,chr4,PABPC1P7,chr4:102896725-102898237,1512
18313765,18315111,chr20,ZNF133-AS1,chr20:18313765-18315111,1346
18379049,18381484,chr20,LINC00851,chr20:18379049-18381484,2435
27340524,27340804,chr15,SERPINE4P,chr15:27340524-27340804,280
75382393,75382844,chr10,SPA17P1,chr10:75382393-75382844,451
18137863,18143169,chr20,PET117,chr20:18137863-18143169,5306
26866911,26949208,chr15,GABRA5,chr15:26866911-26949208,82297
9505180,9514998,chr20,LAMP5-AS1,chr20:9505180-9514998,9818
7389793,7418037,chr6,RIOK1,chr6:7389793-7418037,28244
101411286,102074812,chr4,BANK1,chr4:101411286-102074812,663526
98069275,98119222,chr9,TRIM14,chr9:98069275-98119222,49947
9514358,9530524,chr20,LAMP5,chr20:9514358-9530524,16166
60026298,60733490,chr10,ANK3,chr10:60026298-60733490,707192
23403805,23406103,chr11,WIZP1,chr11:23403805-23406103,2298
19380484,19385014,chr11,NAV2-IT1,chr11:19380484-19385014,4530
32583798,32606264,chr11,EIF3M,chr11:32583798-32606264,22466
4163821,4263995,chr17,ANKFY1,chr17:4163821-4263995,100174
66022661,66027719,chr9,GXYLT1P4,chr9:66022661-66027719,5058
1113240,1189415,chr20,PSMF1,chr20:1113240-1189415,76175
126805006,126838210,chr9,ZBTB43,chr9:126805006-126838210,33204
36740775,36839444,chr6,CPNE5,chr6:36740775-36839444,98669
105758164,105760755,chr9,DEPDC1P2,chr9:105758164-105760755,2591
125595669,125596628,chr9,HNRNPA1P15,chr9:125595669-125596628,959
64486164,64487069,chr9,CNN2P3,chr9:64486164-64487069,905
72655832,72656192,chr9,RPS20P24,chr9:72655832-72656192,360
68780065,68785566,chr9,PABIR1,chr9:68780065-68785566,5501
9460319,9528524,chr11,ZNF143,chr11:9460319-9528524,68205
1160584,1161697,chr20,ACTG1P3,chr20:1160584-1161697,1113
87148644,87159556,chr9,LINC02872,chr9:87148644-87159556,10912
1266280,1309328,chr20,SNPH,chr20:1266280-1309328,43048
66641314,66642277,chr9,RAB28P4,chr9:66641314-66642277,963
69818394,69820773,chr9,C9orf135-DT,chr9:69818394-69820773,2379
20775464,20775998,chr15,LONRF2P3,chr15:20775464-20775998,534
23689453,23956222,chr18,LAMA3,chr18:23689453-23956222,266769
85898903,85899716,chr9,PHBP7,chr9:85898903-85899716,813
5110913,5112849,chr9,TCF3P1,chr9:5110913-5112849,1936
126613928,126701032,chr9,LMX1B,chr9:126613928-126701032,87104
36948263,36964837,chr6,PI16,chr6:36948263-36964837,16574
24978583,25420336,chr15,SNHG14,chr15:24978583-25420336,441753
1309909,1329139,chr20,SDCBP2,chr20:1309909-1329139,19230
39048781,39091303,chr6,GLP1R,chr6:39048781-39091303,42522
4959226,4967817,chr17,SPAG7,chr17:4959226-4967817,8591
33620365,33696574,chr6,ITPR3,chr6:33620365-33696574,76209
67991684,68015768,chr4,TMPRSS11GP,chr4:67991684-68015768,24084
107834509,107834829,chr9,RPL36AP6,chr9:107834509-107834829,320
98056732,98083077,chr9,NANS,chr9:98056732-98083077,26345
89879532,89954629,chr4,MMRN1,chr4:89879532-89954629,75097
110762674,110763133,chr13,RPL21P107,chr13:110762674-110763133,459
1392900,1392961,chr20,MIR6869,chr20:1392900-1392961,61
1470741,1491587,chr20,SIRPB2,chr20:1470741-1491587,20846
81966564,81972130,chr9,SPATA31D2P,chr9:81966564-81972130,5566
4004445,4143030,chr17,ZZEF1,chr17:4004445-4143030,138585
62376161,62435199,chr9,FGF7P6,chr9:62376161-62435199,59038
95809310,95809607,chr13,HMGN1P24,chr13:95809310-95809607,297
45436121,45436660,chr13,PPIAP25,chr13:45436121-45436660,539
27585145,27586144,chr4,IGBP1P5,chr4:27585145-27586144,999
87497228,87708634,chr9,DAPK1,chr9:87497228-87708634,211406
113130416,113132054,chr13,KARS1P2,chr13:113130416-113132054,1638
46481329,46481760,chr22,FAM136EP,chr22:46481329-46481760,431
103572089,103574082,chr4,DDX3P3,chr4:103572089-103574082,1993
46576012,46679790,chr22,GRAMD4,chr22:46576012-46679790,103778
113667219,113737736,chr13,GRK1,chr13:113667219-113737736,70517
83535914,83605875,chr4,GPAT3,chr4:83535914-83605875,69961
1529056,1529159,chr20,RNU6-917P,chr20:1529056-1529159,103
153880672,153888990,chrX,LCA10,chrX:153880672-153888990,8318
1534251,1557705,chr20,SIRPD,chr20:1534251-1557705,23454
153907367,153934999,chrX,ARHGAP4,chrX:153907367-153934999,27632
45833799,45843276,chr20,SNX21,chr20:45833799-45843276,9477
77987860,77988813,chr4,HNRNPA1P56,chr4:77987860-77988813,953
98175785,98177269,chr13,RNF113B,chr13:98175785-98177269,1484
33922422,33922766,chr22,LARGE1-AS1,chr22:33922422-33922766,344
46360834,46537620,chr22,CELSR1,chr22:46360834-46537620,176786
75513946,75550473,chr4,THAP6,chr4:75513946-75550473,36527
109101261,109101919,chr13,MYO16-AS2,chr13:109101261-109101919,658
78614289,78659155,chr13,OBI1,chr13:78614289-78659155,44866
6590021,6608726,chr7,C7orf26,chr7:6590021-6608726,18705
111596009,111642079,chr13,LINC02337,chr13:111596009-111642079,46070
109163902,109201483,chr13,MYO16-AS1,chr13:109163902-109201483,37581
90060247,90119719,chr13,LINC00559,chr13:90060247-90119719,59472
45841721,45857405,chr20,ACOT8,chr20:45841721-45857405,15684
1420689,1463162,chr17,CRK,chr17:1420689-1463162,42473
11183298,11382348,chr6,NEDD9,chr6:11183298-11382348,199050
54009789,54064605,chr4,CHIC2,chr4:54009789-54064605,54816
2558972,2614733,chr7,IQCE,chr7:2558972-2614733,55761
31812307,32002405,chr11,PAUPAR,chr11:31812307-32002405,190098
2755705,3037741,chr17,RAP1GAP2,chr17:2755705-3037741,282036
77779723,77844145,chr13,EDNRB-AS1,chr13:77779723-77844145,64422
100660279,100675113,chr4,LINC01216,chr4:100660279-100675113,14834
102868974,102892807,chr4,CISD2,chr4:102868974-102892807,23833
29594326,29631515,chr11,LINC02546,chr11:29594326-29631515,37189
106663437,106663847,chr13,ATP5MC1P5,chr13:106663437-106663847,410
106653897,106672177,chr13,LINC00443,chr13:106653897-106672177,18280
2328749,2377992,chr11,CD81-AS1,chr11:2328749-2377992,49243
101972423,101972798,chr4,MTND5P5,chr4:101972423-101972798,375
27617626,27634627,chr11,LINC00678,chr11:27617626-27634627,17001
99948086,99950355,chr4,H2AZ1,chr4:99948086-99950355,2269
20156155,20160475,chr11,DBX1,chr11:20156155-20160475,4320
28598833,28600052,chr13,EIF4A1P7,chr13:28598833-28600052,1219
48001389,48002552,chr13,SUCLA2-AS1,chr13:48001389-48002552,1163
89248818,89250100,chr13,TRIM60P13,chr13:89248818-89250100,1282
33256672,33357023,chr11,HIPK3,chr11:33256672-33357023,100351
37634654,37656117,chr22,SH3BP1,chr22:37634654-37656117,21463
35832966,35921342,chr6,SRPK1,chr6:35832966-35921342,88376
113122799,113149529,chr13,F10,chr13:113122799-113149529,26730
9703754,9710812,chr4,ALG1L3P,chr4:9703754-9710812,7058
45857614,45879122,chr20,ZSWIM3,chr20:45857614-45879122,21508
77862830,77952785,chr4,MRPL1,chr4:77862830-77952785,89955
45898621,45912155,chr20,PLTP,chr20:45898621-45912155,13534
22929607,22956374,chr14,PRMT5-DT,chr14:22929607-22956374,26767
22971177,22982551,chr14,AJUBA,chr14:22971177-22982551,11374
106041599,106316683,chr4,TBCK,chr4:106041599-106316683,275084
5019214,5020093,chr17,KIF1C-AS1,chr17:5019214-5020093,879
5471254,5486811,chr17,DERL2,chr17:5471254-5486811,15557
22982698,22999078,chr14,AJUBA-DT,chr14:22982698-22999078,16380
45934683,45948023,chr20,PCIF1,chr20:45934683-45948023,13340
153929225,153935080,chrX,NAA10,chrX:153929225-153935080,5855
22985894,23010166,chr14,C14orf93,chr14:22985894-23010166,24272
41244779,41286187,chr22,RANGAP1,chr22:41244779-41286187,41408
27040725,27127809,chr11,BBOX1,chr11:27040725-27127809,87084
45948660,45972203,chr20,ZNF335,chr20:45948660-45972203,23543
90170866,90171799,chr13,FAR1P1,chr13:90170866-90171799,933
95394049,95394454,chr13,MEMO1P5,chr13:95394049-95394454,405
39817741,39818049,chr13,CDKN2AIPNLP3,chr13:39817741-39818049,308
91398621,92873682,chr13,GPC5,chr13:91398621-92873682,1475061
6789133,6831761,chr17,TEKT1,chr17:6789133-6831761,42628
33867506,33896914,chr6,LINC01016,chr6:33867506-33896914,29408
24496970,25082638,chr11,LUZP2,chr11:24496970-25082638,585668
45975249,45976075,chr20,FTLP1,chr20:45975249-45976075,826
46008908,46016561,chr20,MMP9,chr20:46008908-46016561,7653
80407829,80437115,chr10,PRXL2A,chr10:80407829-80437115,29286
43427366,43450427,chr6,ABCC10,chr6:43427366-43450427,23061
46013500,46022073,chr20,SLC12A5-AS1,chr20:46013500-46022073,8573
110303476,110337884,chr9,TXNDC8,chr9:110303476-110337884,34408
99404684,99417224,chr13,CCR12P,chr13:99404684-99417224,12540
1368977,1393164,chr20,FKBP1A,chr20:1368977-1393164,24187
36490078,36490441,chr13,H2ACP1,chr13:36490078-36490441,363
4940008,4945222,chr17,RNF167,chr17:4940008-4945222,5214
39856710,39857094,chr13,AZU1P1,chr13:39856710-39857094,384
16777297,17014414,chr11,PLEKHA7,chr11:16777297-17014414,237117
18491904,18492419,chr13,BNIP3P7,chr13:18491904-18492419,515
29764371,29850617,chr13,UBL3,chr13:29764371-29850617,86246
96407284,96407797,chr9,NSA2P7,chr9:96407284-96407797,513
129612225,129620776,chr9,C9orf50,chr9:129612225-129620776,8551
153935269,153944687,chrX,RENBP,chrX:153935269-153944687,9418
107458038,107458306,chr9,HMGN2P32,chr9:107458038-107458306,268
97600080,97633368,chr9,TSTD2,chr9:97600080-97633368,33288
85449592,85492001,chr10,LINC01520,chr10:85449592-85492001,42409
98832084,98834629,chr13,DOCK9-AS1,chr13:98832084-98834629,2545
50799409,50885675,chr10,A1CF,chr10:50799409-50885675,86266
112894378,113099742,chr13,MCF2L,chr13:112894378-113099742,205364
3227417,3239559,chr20,SLC4A11,chr20:3227417-3239559,12142
35943516,36024868,chr6,SLC26A8,chr6:35943516-36024868,81352
119153458,119369435,chr9,BRINP1,chr9:119153458-119369435,215977
23016543,23035230,chr14,PSMB5,chr14:23016543-23035230,18687
153947557,153971818,chrX,HCFC1,chrX:153947557-153971818,24261
7909300,7910449,chr7,CCNB2P1,chr7:7909300-7910449,1149
26285578,26331289,chr11,ANO3-AS1,chr11:26285578-26331289,45711
3662895,3668679,chr17,TAX1BP3,chr17:3662895-3668679,5784
34051731,34102610,chr11,CAPRIN1,chr11:34051731-34102610,50879
8113184,8262687,chr7,ICA1,chr7:8113184-8262687,149503
90751240,90752230,chr9,OR7E108P,chr9:90751240-90752230,990
17734138,17774770,chr22,BID,chr22:17734138-17774770,40632
23042212,23044060,chr14,PSMB11,chr14:23042212-23044060,1848
92809568,92838457,chr9,ANKRD19P,chr9:92809568-92838457,28889
105484698,105486080,chr4,EEF1A1P9,chr4:105484698-105486080,1382
6444441,6451469,chr17,PIMREG,chr17:6444441-6451469,7028
23095505,23100456,chr14,C14orf119,chr14:23095505-23100456,4951
107590276,107720234,chr4,PAPSS1,chr4:107590276-107720234,129958
23099062,23104989,chr14,LMLN2,chr14:23099062-23104989,5927
101028727,101325135,chr9,PLPPR1,chr9:101028727-101325135,296408
23272422,23299447,chr14,HOMEZ,chr14:23272422-23299447,27025
153969325,153970087,chrX,HCFC1-AS1,chrX:153969325-153970087,762
153972754,153983194,chrX,TMEM187,chrX:153972754-153983194,10440
23293852,23295798,chr14,H3P37,chr14:23293852-23295798,1946
153981097,153981177,chrX,MIR3202-1,chrX:153981097-153981177,80
23295652,23302859,chr14,PPP1R3E,chr14:23295652-23302859,7207
153981098,153981176,chrX,MIR3202-2,chrX:153981098-153981176,78
154010506,154019902,chrX,IRAK1,chrX:154010506-154019902,9396
107963703,107964045,chr9,RPS15AP27,chr9:107963703-107964045,342
97633668,97673748,chr9,NCBP1,chr9:97633668-97673748,40080
4988130,4997610,chr17,INCA1,chr17:4988130-4997610,9480
23356403,23365752,chr14,EFS,chr14:23356403-23365752,9349
95124,95454,chr6,WBP1LP12,chr6:95124-95454,330
100812255,100814280,chr4,LINC01218,chr4:100812255-100814280,2025
91885046,91885254,chr4,KRT19P6,chr4:91885046-91885254,208
34284887,34426071,chr6,RPS10-NUDT3,chr6:34284887-34426071,141184
92821986,92822918,chr4,RACK1P3,chr4:92821986-92822918,932
117834145,117869960,chr4,LINC02264,chr4:117834145-117869960,35815
23372809,23376403,chr14,IL25,chr14:23372809-23376403,3594
17137511,17165287,chr22,HDHD5,chr22:17137511-17165287,27776
33657087,33674463,chr20,NECAB3,chr20:33657087-33674463,17376
23376773,23379772,chr14,CMTM5,chr14:23376773-23379772,2999
5360963,5419676,chr17,NUP88,chr17:5360963-5419676,58713
69480165,69526014,chr4,UGT2B4,chr4:69480165-69526014,45849
39110321,39112952,chr6,ANKRD18EP,chr6:39110321-39112952,2631
50676743,50686326,chr10,NUTM2HP,chr10:50676743-50686326,9583
12514110,12514724,chr6,RPL15P3,chr6:12514110-12514724,614
87504875,87553461,chr10,MINPP1,chr10:87504875-87553461,48586
36697826,36733184,chr6,RAB44,chr6:36697826-36733184,35358
19710934,19712619,chr11,NAV2-AS6,chr11:19710934-19712619,1685
102519636,102657514,chr9,LINC00587,chr9:102519636-102657514,137878
36442767,36491143,chr6,KCTD20,chr6:36442767-36491143,48376
97238497,97377287,chr9,SUGT1P4-STRA6LP-CCDC180,chr9:97238497-97377287,138790
43311963,43344529,chr11,API5,chr11:43311963-43344529,32566
16753755,16784536,chr7,TSPAN13,chr7:16753755-16784536,30781
80776165,80778088,chr10,FARSBP1,chr10:80776165-80778088,1923
83034447,83075818,chr4,COPS4,chr4:83034447-83075818,41371
45156775,45176925,chr10,ANKRD30BP3,chr10:45156775-45176925,20150
58385345,58399220,chr10,TFAM,chr10:58385345-58399220,13875
154019920,154019989,chrX,MIR718,chrX:154019920-154019989,69
101325404,101325510,chrX,RNU6-934P,chrX:101325404-101325510,106
101337725,101338289,chrX,NANOGNBP3,chrX:101337725-101338289,564
6835420,6835794,chr7,OR7E39P,chr7:6835420-6835794,374
101339917,101340934,chrX,RPL21P132,chrX:101339917-101340934,1017
32801705,32863041,chr22,TIMP3,chr22:32801705-32863041,61336
7636518,7718607,chr7,RPA3,chr7:7636518-7718607,82089
101345661,101348742,chrX,TIMM8A,chrX:101345661-101348742,3081
11689264,11885685,chr18,GNAL,chr18:11689264-11885685,196421
101390824,101396155,chrX,RPL36A,chrX:101390824-101396155,5331
49918167,49927540,chr22,CRELD2,chr22:49918167-49927540,9373
23412740,23435660,chr14,MYH7,chr14:23412740-23435660,22920
38923029,38953099,chr6,DNAH8-AS1,chr6:38923029-38953099,30070
8433609,8752961,chr7,NXPH1,chr7:8433609-8752961,319352
142789,181650,chr17,DOC2B,chr17:142789-181650,38861
33794673,33804003,chr6,MLN,chr6:33794673-33804003,9330
20141916,20153531,chr7,MACC1-AS1,chr7:20141916-20153531,11615
11820317,11821294,chr7,THRAP3P3,chr7:11820317-11821294,977
21011451,21011469,chr15,IGHD4OR15-4B,chr15:21011451-21011469,18
87386685,87390203,chr10,CTSLP1,chr10:87386685-87390203,3518
7958183,7969903,chr7,GLCCI1-DT,chr7:7958183-7969903,11720
101391011,101412297,chrX,RPL36A-HNRNPH2,chrX:101391011-101412297,21286
21160305,21167357,chr15,BMS1P16,chr15:21160305-21167357,7052
91807179,91807439,chr10,SRP9P1,chr10:91807179-91807439,260
7552462,7566996,chr7,MIOS-DT,chr7:7552462-7566996,14534
71212570,71302864,chr10,UNC5B,chr10:71212570-71302864,90294
39588357,39588882,chr15,THBS1-AS1,chr15:39588357-39588882,525
6031376,6036552,chr7,ANKRD61,chr7:6031376-6036552,5176
101408222,101414133,chrX,HNRNPH2,chrX:101408222-101414133,5911
21927657,21946641,chr15,NF1P2,chr15:21927657-21946641,18984
4857738,4862030,chr7,PAPOLB,chr7:4857738-4862030,4292
101443707,101444103,chrX,PPIAP90,chrX:101443707-101444103,396
64610616,64610909,chr4,MTND4LP31,chr4:64610616-64610909,293
109303035,109316135,chr4,COL25A1-DT,chr4:109303035-109316135,13100
3860315,3894891,chr17,CAMKK1,chr17:3860315-3894891,34576
103961616,104037543,chr4,LINC02503,chr4:103961616-104037543,75927
153587925,153600045,chrX,CCNQ,chrX:153587925-153600045,12120
5925550,5970683,chr7,RSPH10B,chr7:5925550-5970683,45133
43307134,43369647,chr6,ZNF318,chr6:43307134-43369647,62513
100041841,100042104,chr4,DYNLL1P6,chr4:100041841-100042104,263
115764099,115764819,chr4,PGAM4P2,chr4:115764099-115764819,720
22727104,22744918,chr15,PDCD6IPP1,chr15:22727104-22744918,17814
76708853,76802426,chr4,SHROOM3-AS1,chr4:76708853-76802426,93573
84560443,84561263,chr10,RPS3AP5,chr10:84560443-84561263,820
50962993,50963358,chr10,MIX23P2,chr10:50962993-50963358,365
40569299,40574949,chr15,RPUSD2,chr15:40569299-40574949,5650
106921802,107283806,chr4,DKK2,chr4:106921802-107283806,362004
80247219,80247683,chr10,EIF5AP4,chr10:80247219-80247683,464
91628442,91633071,chr10,PPP1R3C,chr10:91628442-91633071,4629
15154802,15155320,chr10,PPIAP30,chr10:15154802-15155320,518
58715554,58716257,chr10,FAM133CP,chr10:58715554-58716257,703
72934762,72954806,chr10,PLA2G12B,chr10:72934762-72954806,20044
19964666,19965101,chr15,IGHV1OR15-9,chr15:19964666-19965101,435
17706257,17707344,chr6,NUP153-AS1,chr6:17706257-17707344,1087
33694293,33711727,chr6,UQCC2,chr6:33694293-33711727,17434
85599552,86366795,chr10,GRID1,chr10:85599552-86366795,767243
33075566,33076460,chr11,PIGCP1,chr11:33075566-33076460,894
22867052,22981063,chr15,CYFIP1,chr15:22867052-22981063,114011
41842154,41843950,chr4,HMGB1P28,chr4:41842154-41843950,1796
35618460,35620865,chr11,FJX1,chr11:35618460-35620865,2405
28896530,28897322,chr6,HCG14,chr6:28896530-28897322,792
30044053,30322988,chr11,ARL14EP-DT,chr11:30044053-30322988,278935
117406166,117691188,chr4,LINC01378,chr4:117406166-117691188,285022
153604497,153605348,chrX,KRT18P48,chrX:153604497-153605348,851
27806443,27806996,chr11,CBX3P1,chr11:27806443-27806996,553
153687926,153696588,chrX,SLC6A8,chrX:153687926-153696588,8662
14907518,14907986,chr11,CALCP,chr11:14907518-14907986,468
48526064,48526971,chr11,OR4A43P,chr11:48526064-48526971,907
45232026,45247361,chr10,CUBNP2,chr10:45232026-45247361,15335
39792298,39904877,chr6,DAAM2,chr6:39792298-39904877,112579
90402521,90628852,chr10,LINC02653,chr10:90402521-90628852,226331
49133653,49134800,chr11,UBTFL9,chr11:49133653-49134800,1147
49117010,49124570,chr11,TRIM77BP,chr11:49117010-49124570,7560
64901136,65017639,chr10,LINC02671,chr10:64901136-65017639,116503
49081907,49083097,chr11,UBTFL7,chr11:49081907-49083097,1190
73740541,73743716,chr4,CXCL8,chr4:73740541-73743716,3175
11006399,11006876,chr7,RPL23AP52,chr7:11006399-11006876,477
80207372,80219657,chr10,LINC00857,chr10:80207372-80219657,12285
49952391,49953419,chr11,OR4C13,chr11:49952391-49953419,1028
15701435,15701752,chr7,RPL36AP26,chr7:15701435-15701752,317
50100892,50102898,chr11,GTF2IP11,chr11:50100892-50102898,2006
6866658,6867672,chr7,OR7E136P,chr7:6866658-6867672,1014
78033760,78056813,chr10,RPS24,chr10:78033760-78056813,23053
7156934,7248616,chr7,C1GALT1,chr7:7156934-7248616,91682
27047186,27220113,chr11,BBOX1-AS1,chr11:27047186-27220113,172927
68184081,68218080,chr4,TMPRSS11BNL,chr4:68184081-68218080,33999
23469689,23509862,chr14,NGDN,chr14:23469689-23509862,40173
48496348,48497280,chr11,OR4A46P,chr11:48496348-48497280,932
43466392,43466871,chr11,PPIAP41,chr11:43466392-43466871,479
32091874,32131561,chr18,RNF138,chr18:32091874-32131561,39687
71016531,71016905,chrX,NUTF2P7,chrX:71016531-71016905,374
71020275,71020438,chrX,RNU1-56P,chrX:71020275-71020438,163
105552620,105708093,chr4,ARHGEF38,chr4:105552620-105708093,155473
3896592,3916476,chr17,P2RX1,chr17:3896592-3916476,19884
71043214,71045470,chrX,SOCS5P4,chrX:71043214-71045470,2256
32387775,32435564,chr11,WT1,chr11:32387775-32435564,47789
71056332,71073426,chrX,SNX12,chrX:71056332-71073426,17094
549197,727650,chr7,PRKAR1B,chr7:549197-727650,178453
33662327,33665619,chr20,C20orf144,chr20:33662327-33665619,3292
33675477,33686385,chr20,E2F1,chr20:33675477-33686385,10908
74365145,74388749,chr4,EREG,chr4:74365145-74388749,23604
71095851,71103532,chrX,FOXO4,chrX:71095851-71103532,7681
410325,431062,chr17,C17orf97,chr17:410325-431062,20737
43999211,44172939,chr22,PARVB,chr22:43999211-44172939,173728
32176050,32176168,chr18,RNA5SP453,chr18:32176050-32176168,118
32185069,32220404,chr18,MEP1B,chr18:32185069-32220404,35335
33702758,33720319,chr20,PXMP4,chr20:33702758-33720319,17561
74744759,74794523,chr4,BTC,chr4:74744759-74794523,49764
109300186,109301172,chr9,MTND2P11,chr9:109300186-109301172,986
71103889,71106788,chrX,CXorf65,chrX:71103889-71106788,2899
6451263,6556555,chr17,PITPNM3,chr17:6451263-6556555,105292
97307304,97378751,chr9,CCDC180,chr9:97307304-97378751,71447
45098021,45099260,chr6,RBM22P4,chr6:45098021-45099260,1239
44809317,45377953,chr6,SUPT3H,chr6:44809317-45377953,568636
103077592,103099870,chr4,BDH2,chr4:103077592-103099870,22278
23511760,23560778,chr14,ZFHX2-AS1,chr14:23511760-23560778,49018
87341685,87357882,chr10,LINC00863,chr10:87341685-87357882,16197
71107404,71112108,chrX,IL2RG,chrX:71107404-71112108,4704
33731657,33792269,chr20,ZNF341,chr20:33731657-33792269,60612
59788747,59906556,chr10,CCDC6,chr10:59788747-59906556,117809
32196026,32196966,chr18,CLUHP6,chr18:32196026-32196966,940
23555988,23560271,chr14,THTPA,chr14:23555988-23560271,4283
91544852,91545098,chr10,RPS27P1,chr10:91544852-91545098,246
80716483,80717068,chr10,RPS7P9,chr10:80716483-80717068,585
46476972,46657220,chr18,LOXHD1,chr18:46476972-46657220,180248
77790791,77926755,chr10,DLG5,chr10:77790791-77926755,135964
87008440,87042419,chr9,LINC02893,chr9:87008440-87042419,33979
23721311,23721782,chr7,PCMTD1P3,chr7:23721311-23721782,471
73151865,73170393,chr9,ANXA1,chr9:73151865-73170393,18528
49430360,49463253,chr6,MMUT,chr6:49430360-49463253,32893
6754109,6799365,chr7,RSPH10B2,chr7:6754109-6799365,45256
23559565,23568070,chr14,AP1G2,chr14:23559565-23568070,8505
71212811,71225516,chrX,GJB1,chrX:71212811-71225516,12705
26395037,26455217,chr15,LINC02248,chr15:26395037-26455217,60180
52497408,52577060,chr6,TRAM2,chr6:52497408-52577060,79652
34849137,34850395,chr15,TUBAP11,chr15:34849137-34850395,1258
30195809,30217552,chr15,LINC02249,chr15:30195809-30217552,21743
50018798,50019695,chr11,OR4C48P,chr11:50018798-50019695,897
50032874,50033794,chr11,OR4C45,chr11:50032874-50033794,920
20005905,20005935,chr15,IGHD3OR15-3A,chr15:20005905-20005935,30
103548745,103624534,chr4,TACR3-AS1,chr4:103548745-103624534,75789
13668668,13732346,chr11,FAR1,chr11:13668668-13732346,63678
65788417,65789287,chr6,SLC25A51P1,chr6:65788417-65789287,870
50912712,50913256,chr6,FTH1P5,chr6:50912712-50913256,544
27895704,27896582,chr15,RPL5P32,chr15:27895704-27896582,878
53556223,53556341,chrX,MIR98,chrX:53556223-53556341,118
53557192,53557274,chrX,MIRLET7F2,chrX:53557192-53557274,82
74582976,74614624,chrX,RLIM,chrX:74582976-74614624,31648
114598770,114678225,chr4,UGT8,chr4:114598770-114678225,79455
3714628,3801188,chr17,ITGAE,chr17:3714628-3801188,86560
40807086,40815084,chr15,ZFYVE19,chr15:40807086-40815084,7998
36493892,36547479,chr6,STK38,chr6:36493892-36547479,53587
74583088,74583546,chrX,PABPC1P3,chrX:74583088-74583546,458
74680053,74680159,chrX,RNU6-330P,chrX:74680053-74680159,106
74732856,74925472,chrX,NEXMIF,chrX:74732856-74925472,192616
99336497,99352746,chr4,ADH1C,chr4:99336497-99352746,16249
15489990,15492564,chr22,YME1L1P1,chr22:15489990-15492564,2574
44741087,44741964,chrX,RPSAP61,chrX:44741087-44741964,877
15550904,15553838,chr22,ARHGAP42P3,chr22:15550904-15553838,2934
44772773,44773061,chrX,RN7SL291P,chrX:44772773-44773061,288
44844021,44844888,chrX,DUSP21,chrX:44844021-44844888,867
45148373,45200901,chrX,DIPK2B,chrX:45148373-45200901,52528
37212178,37258155,chr6,TMEM217,chr6:37212178-37258155,45977
33752167,33752543,chr20,RPL31P2,chr20:33752167-33752543,376
33787373,33811109,chr20,ZNF341-AS1,chr20:33787373-33811109,23736
49558546,49810419,chr11,GRM5P1,chr11:49558546-49810419,251873
33811348,33854366,chr20,CHMP4B,chr20:33811348-33854366,43018
21473000,21517533,chr22,PI4KAP2,chr22:21473000-21517533,44533
79863019,79866875,chr9,NPAP1P6,chr9:79863019-79866875,3856
42183659,42189887,chr9,SPATA31A6,chr9:42183659-42189887,6228
28702607,29064322,chr11,LINC02742,chr11:28702607-29064322,361715
71697196,71706455,chrX,LINC00891,chrX:71697196-71706455,9259
103140523,103325034,chr9,LINC01492,chr9:103140523-103325034,184511
43222206,43222509,chr20,RN7SL666P,chr20:43222206-43222509,303
43230760,43231260,chr20,PPIAP21,chr20:43230760-43231260,500
116598161,116599611,chr4,ACTN4P1,chr4:116598161-116599611,1450
5190196,5233840,chr7,WIPI2,chr7:5190196-5233840,43644
119799089,119804554,chr4,LINC01365,chr4:119799089-119804554,5465
55537002,55537924,chr11,OR4C14P,chr11:55537002-55537924,922
109532830,109534332,chr9,YBX1P6,chr9:109532830-109534332,1502
49981473,49982535,chr11,OR4C12,chr11:49981473-49982535,1062
135942478,135947139,chrX,CT45A11P,chrX:135942478-135947139,4661
117685254,117685588,chr9,RPL35AP22,chr9:117685254-117685588,334
136077844,136078631,chrX,GAPDHP67,chrX:136077844-136078631,787
19502672,19507229,chr11,NAV2-AS5,chr11:19502672-19507229,4557
136097835,136098348,chrX,E2F6P4,chrX:136097835-136098348,513
76419850,76651203,chr9,GCNT1,chr9:76419850-76651203,231353
43489442,43550954,chr20,L3MBTL1,chr20:43489442-43550954,61512
107428630,107429461,chrX,KRT18P49,chrX:107428630-107429461,831
107512983,107545821,chrX,FRMPD3-AS1,chrX:107512983-107545821,32838
105708778,105847725,chr4,GSTCD,chr4:105708778-105847725,138947
38168451,38640148,chr6,BTBD9,chr6:38168451-38640148,471697
14277922,14364506,chr11,RRAS2,chr11:14277922-14364506,86584
107628428,107651993,chrX,PRPS1,chrX:107628428-107651993,23565
5208920,5234860,chr17,SCIMP,chr17:5208920-5234860,25940
42817105,42823213,chr9,MEP1AP4,chr9:42817105-42823213,6108
33025273,33039907,chr9,DNAJA1,chr9:33025273-33039907,14634
92836826,92837668,chr9,EEF1DP2,chr9:92836826-92837668,842
87553454,87554459,chr9,DAPK1-IT1,chr9:87553454-87554459,1005
87396561,87435035,chr10,FAM245A,chr10:87396561-87435035,38474
129827290,129835863,chr9,C9orf78,chr9:129827290-129835863,8573
51319826,51320660,chr10,RSU1P3,chr10:51319826-51320660,834
42644445,42691723,chr10,LINC01518,chr10:42644445-42691723,47278
5116032,5175034,chr17,USP6,chr17:5116032-5175034,59002
67544021,67730619,chrX,AR,chrX:67544021-67730619,186598
33540046,33589026,chr6,GGNBP1,chr6:33540046-33589026,48980
80940665,80941201,chr10,WARS2P1,chr10:80940665-80941201,536
89837612,89839334,chr10,MARK2P16,chr10:89837612-89839334,1722
89978717,89979070,chr10,SNRPD2P1,chr10:89978717-89979070,353
91152605,91153349,chr10,NUDT9P1,chr10:91152605-91153349,744
92668745,92669743,chr10,EIF2S2P3,chr10:92668745-92669743,998
87376896,87378481,chr10,NPAP1P3,chr10:87376896-87378481,1585
48975324,48983826,chr11,TRIM51GP,chr11:48975324-48983826,8502
93306429,93482334,chr10,MYOF,chr10:93306429-93482334,175905
72741152,72741617,chr9,RPS27AP15,chr9:72741152-72741617,465
24162754,24169948,chr15,PWRN2,chr15:24162754-24169948,7194
21545344,21545644,chr22,RN7SKP221,chr22:21545344-21545644,300
35023522,35023831,chr6,HSPE1P11,chr6:35023522-35023831,309
41301525,41360147,chr22,ZC3H7B,chr22:41301525-41360147,58622
23730588,23796970,chr11,LINC02726,chr11:23730588-23796970,66382
115142982,115143303,chr4,MRPS33P3,chr4:115142982-115143303,321
48579436,48580336,chr11,OR4A45P,chr11:48579436-48580336,900
23179869,23182049,chr15,ABCB10P1,chr15:23179869-23182049,2180
73836640,73849064,chr4,CXCL6,chr4:73836640-73849064,12424
49785660,49787285,chr6,PGK2,chr6:49785660-49787285,1625
75890644,76362975,chr9,PCSK5,chr9:75890644-76362975,472331
25865295,25877211,chr15,ATP10A-DT,chr15:25865295-25877211,11916
48610063,48611000,chr11,OR4A42P,chr11:48610063-48611000,937
70003031,70205726,chr18,RTTN,chr18:70003031-70205726,202695
20562375,20575696,chr15,GOLGA8CP,chr15:20562375-20575696,13321
65836930,65838039,chr6,ADH5P4,chr6:65836930-65838039,1109
60873360,60874642,chr6,RBBP4P3,chr6:60873360-60874642,1282
63480134,63481876,chr6,EEF1B2P5,chr6:63480134-63481876,1742
23478068,23480430,chr11,THAP12P4,chr11:23478068-23480430,2362
49915013,49915644,chr11,OR4A49P,chr11:49915013-49915644,631
48345351,48352447,chr11,OR4C4P,chr11:48345351-48352447,7096
14117256,14136918,chr6,CD83,chr6:14117256-14136918,19662
28986635,28987498,chr11,OR2BH1P,chr11:28986635-28987498,863
116378919,116379269,chr4,TRMT112P1,chr4:116378919-116379269,350
4775615,4794397,chr7,AP5Z1,chr7:4775615-4794397,18782
94154193,94187991,chr13,GPC6-AS1,chr13:94154193-94187991,33798
44629357,44629674,chr11,RPL34P22,chr11:44629357-44629674,317
30098826,30102093,chr15,DNM1P28,chr15:30098826-30102093,3267
109912883,110013766,chr4,EGF,chr4:109912883-110013766,100883
113977783,114132623,chr13,RASA3,chr13:113977783-114132623,154840
21017800,21017816,chr15,IGHD1OR15-1B,chr15:21017800-21017816,16
13962723,14268133,chr11,SPON1,chr11:13962723-14268133,305410
38628005,39180499,chr15,LINC02694,chr15:38628005-39180499,552494
35794982,35797344,chr6,CLPS,chr6:35794982-35797344,2362
41367333,41399326,chr22,TEF,chr22:41367333-41399326,31993
35181799,35238197,chr15,ANP32AP1,chr15:35181799-35238197,56398
53418452,53418737,chr6,NANOGP3,chr6:53418452-53418737,285
32085111,32085712,chr11,EIF4A2P5,chr11:32085111-32085712,601
70098390,70098676,chr6,RPL37P15,chr6:70098390-70098676,286
40087890,40108892,chr15,BMF,chr15:40087890-40108892,21002
48486363,48486825,chr11,OR4R1P,chr11:48486363-48486825,462
37257772,37332970,chr6,TBC1D22B,chr6:37257772-37332970,75198
100291644,100410273,chrX,PCDH19,chrX:100291644-100410273,118629
41377177,41377283,chr22,RNU6-495P,chr22:41377177-41377283,106
53267398,53349179,chr6,ELOVL5,chr6:53267398-53349179,81781
41433494,41446801,chr22,TOB2,chr22:41433494-41446801,13307
47269161,47330031,chr11,MADD,chr11:47269161-47330031,60870
41459717,41468692,chr22,PHF5A,chr22:41459717-41468692,8975
34978341,34988287,chr15,ZNF770,chr15:34978341-34988287,9946
85968999,85969533,chr13,MOB1AP1,chr13:85968999-85969533,534
38139595,38226897,chr15,LINC02895,chr15:38139595-38226897,87302
50910735,50916641,chrX,BMP15,chrX:50910735-50916641,5906
110053285,110054952,chr13,LINC00396,chr13:110053285-110054952,1667
41525799,41544606,chr22,POLR3H,chr22:41525799-41544606,18807
49341192,49345922,chrX,GAGE2E,chrX:49341192-49345922,4730
89477608,89500509,chr13,LINC01040,chr13:89477608-89500509,22901
39188971,39229475,chr6,KCNK5,chr6:39188971-39229475,40504
49628507,49633872,chr13,ARL11,chr13:49628507-49633872,5365
26964917,26970385,chr15,TVP23BP1,chr15:26964917-26970385,5468
72051376,72072721,chr9,C9orf57,chr9:72051376-72072721,21345
42313687,42314386,chr15,BNIP3P5,chr15:42313687-42314386,699
35919892,36049537,chr15,LINC02853,chr15:35919892-36049537,129645
19967414,19968352,chr15,SLC20A1P3,chr15:19967414-19968352,938
44278734,44297698,chr6,TCTE1,chr6:44278734-44297698,18964
49529869,49529985,chrX,GAGE12B,chrX:49529869-49529985,116
93226807,94408020,chr13,GPC6,chr13:93226807-94408020,1181213
49632500,49633349,chrX,VDAC1P2,chrX:49632500-49633349,849
49664844,49668680,chrX,SALL1P1,chrX:49664844-49668680,3836
20379495,20506180,chr15,HERC2P3,chr15:20379495-20506180,126685
49687447,49695984,chrX,PAGE1,chrX:49687447-49695984,8537
12922545,12922920,chr7,RBMX2P4,chr7:12922545-12922920,375
34236873,34246231,chr6,HMGA1,chr6:34236873-34246231,9358
10931943,10940153,chr7,NDUFA4,chr7:10931943-10940153,8210
35592786,35592951,chr9,RPS29P17,chr9:35592786-35592951,165
49829260,49834264,chrX,PAGE4,chrX:49829260-49834264,5004
70033921,70175888,chr9,MAMDC2-AS1,chr9:70033921-70175888,141967
35278907,35284985,chr20,EIF6,chr20:35278907-35284985,6078
42782795,42834937,chr10,BMS1,chr10:42782795-42834937,52142
150228004,150228083,chrX,MIR2114,chrX:150228004-150228083,79
150231075,150232896,chrX,XRCC6P2,chrX:150231075-150232896,1821
6651762,6693202,chr17,C17orf100,chr17:6651762-6693202,41440
12570577,12660182,chr7,SCIN,chr7:12570577-12660182,89605
136773999,136774105,chrX,RNU6-972P,chrX:136773999-136774105,106
136791064,136791780,chrX,RPL7P56,chrX:136791064-136791780,716
136807223,136807877,chrX,RANP4,chrX:136807223-136807877,654
102367539,102373666,chr13,FGF14-AS1,chr13:102367539-102373666,6127
136847384,136848034,chrX,RAB28P5,chrX:136847384-136848034,650
136848004,136880764,chrX,RBMX,chrX:136848004-136880764,32760
81583683,81689547,chr9,TLE1,chr9:81583683-81689547,105864
105526596,105527397,chr4,PIMREGP2,chr4:105526596-105527397,801
35989515,35991374,chr6,DPRXP2,chr6:35989515-35991374,1859
117083554,117085576,chr4,TRAM1L1,chr4:117083554-117085576,2022
113208193,113267108,chr13,CUL4A,chr13:113208193-113267108,58915
47368943,47369230,chr6,B3GNTL1P2,chr6:47368943-47369230,287
4948092,4957131,chr17,ENO3,chr17:4948092-4957131,9039
118400514,118400834,chr4,NDUFS5P5,chr4:118400514-118400834,320
73431138,73456174,chr4,AFP,chr4:73431138-73456174,25036
37353979,37394734,chr6,RNF8,chr6:37353979-37394734,40755
41561010,41577741,chr22,CSDC2,chr22:41561010-41577741,16731
23561097,23568073,chr14,AP1G2-AS1,chr14:23561097-23568073,6976
92689955,92695647,chr10,HHEX,chr10:92689955-92695647,5692
41576900,41589871,chr22,PMM1,chr22:41576900-41589871,12971
23749236,23751150,chr14,BRD7P1,chr14:23749236-23751150,1914
95999778,96000243,chr10,RPL21P90,chr10:95999778-96000243,465
23791930,23792236,chr14,RN7SKP205,chr14:23791930-23792236,306
47564256,47566016,chr10,DUSP8P1,chr10:47564256-47566016,1760
23922247,23934568,chr14,LINC00596,chr14:23922247-23934568,12321
1428465,1459470,chr7,MICALL2,chr7:1428465-1459470,31005
84328586,84518521,chr10,CCSER2,chr10:84328586-84518521,189935
5114953,5126626,chr20,PCNA,chr20:5114953-5126626,11673
23953734,23969279,chr14,DHRS4,chr14:23953734-23969279,15545
136879199,136879271,chrX,SNORD61,chrX:136879199-136879271,72
136947748,136948133,chrX,RPL22P23,chrX:136947748-136948133,385
136976417,136985705,chrX,SRRM1P3,chrX:136976417-136985705,9288
137023929,137033995,chrX,GPR101,chrX:137023929-137033995,10066
52688661,52688998,chr6,SREK1IP1P2,chr6:52688661-52688998,337
103626076,103626492,chrX,TCEAL3-AS1,chrX:103626076-103626492,416
29262703,29264079,chr6,OR2U1P,chr6:29262703-29264079,1376
103628704,103630953,chrX,TCEAL1,chrX:103628704-103630953,2249
44898711,44899295,chr6,NUDT19P4,chr6:44898711-44899295,584
49463370,49493107,chr6,CENPQ,chr6:49463370-49493107,29737
39581079,39599466,chr15,THBS1,chr15:39581079-39599466,18387
103651735,103652106,chrX,CNEP1R1P1,chrX:103651735-103652106,371
103675496,103688158,chrX,MORF4L2,chrX:103675496-103688158,12662
45328157,45664349,chr6,RUNX2,chr6:45328157-45664349,336192
118685392,118715433,chr4,METTL14,chr4:118685392-118715433,30041
41598028,41621043,chr22,DESI1,chr22:41598028-41621043,23015
63761546,63762824,chr9,MYO5BP3,chr9:63761546-63762824,1278
5126879,5197887,chr20,CDS2,chr20:5126879-5197887,71008
129634604,129642169,chr9,ASB6,chr9:129634604-129642169,7565
34851782,34969742,chr15,AQR,chr15:34851782-34969742,117960
11257681,11258535,chr7,NPM1P11,chr7:11257681-11258535,854
73474378,73476073,chr9,DPP3P2,chr9:73474378-73476073,1695
30670964,30671966,chr9,CDRT15P5,chr9:30670964-30671966,1002
86944362,86947506,chr9,GAS1,chr9:86944362-86947506,3144
41621163,41664048,chr22,XRCC6,chr22:41621163-41664048,42885
898778,975549,chr7,COX19,chr7:898778-975549,76771
102961956,102963327,chr4,ACTR3BP4,chr4:102961956-102963327,1371
103687284,103691772,chrX,MORF4L2-AS1,chrX:103687284-103691772,4488
63521401,63625128,chr10,REEP3,chr10:63521401-63625128,103727
103710909,103714032,chrX,TMEM31,chrX:103710909-103714032,3123
98120975,98192637,chr9,CORO2A,chr9:98120975-98192637,71662
104099214,104157009,chrX,SLC25A53,chrX:104099214-104157009,57795
49171898,49175235,chrX,PLP2,chrX:49171898-49175235,3337
109553243,109554094,chr4,SETP20,chr4:109553243-109554094,851
5292388,5292831,chr20,UBE2D3P1,chr20:5292388-5292831,443
118664087,118685343,chr4,METTL14-DT,chr4:118664087-118685343,21256
5299218,5316954,chr20,PROKR2,chr20:5299218-5316954,17736
5346006,5346160,chr20,RNA5-8SP7,chr20:5346006-5346160,154
88273864,88584530,chr10,RNLS,chr10:88273864-88584530,310666
49174802,49186528,chrX,PRICKLE3,chrX:49174802-49186528,11726
30799471,30800746,chr9,KRT18P36,chr9:30799471-30800746,1275
5426892,5471094,chr20,LINC00658,chr20:5426892-5471094,44202
92947523,93036236,chr9,FGD3,chr9:92947523-93036236,88713
97153045,97292637,chr10,ARHGAP19-SLIT1,chr10:97153045-97292637,139592
17033089,17033478,chr7,BRWD1P3,chr7:17033089-17033478,389
24284188,24291862,chr7,NPY,chr7:24284188-24291862,7674
37600796,37601368,chr10,MTND1P18,chr10:37600796-37601368,572
105369077,105474067,chr4,PPA2,chr4:105369077-105474067,104990
82228985,82232920,chr10,NRG3-AS1,chr10:82228985-82232920,3935
9614978,9615985,chr7,GAPDHP68,chr7:9614978-9615985,1007
33721662,33746905,chr6,IP6K3,chr6:33721662-33746905,25243
3672199,3696240,chr17,P2RX5,chr17:3672199-3696240,24041
30820207,31031937,chr10,ZNF438,chr10:30820207-31031937,211730
12686856,12690958,chr7,ARL4A,chr7:12686856-12690958,4102
49198966,49202454,chrX,SYP-AS1,chrX:49198966-49202454,3488
49205063,49233371,chrX,CACNA1F,chrX:49205063-49233371,28308
22502231,22502292,chr14,TRAJ38,chr14:22502231-22502292,61
95709947,95714196,chr14,TCL1A,chr14:95709947-95714196,4249
14985378,14986074,chr7,GTF3AP5,chr7:14985378-14986074,696
14190795,14192157,chr7,EEF1A1P26,chr7:14190795-14192157,1362
35776594,35779552,chr6,CLPSL2,chr6:35776594-35779552,2958
1044546,1059261,chr7,GPR146,chr7:1044546-1059261,14715
78867551,78946440,chr6,IRAK1BP1,chr6:78867551-78946440,78889
13891229,13991425,chr7,ETV1,chr7:13891229-13991425,100196
63586989,63604639,chr18,SERPINB13,chr18:63586989-63604639,17650
66093431,66094909,chr6,NUFIP1P1,chr6:66093431-66094909,1478
40217428,40277487,chr15,PAK6,chr15:40217428-40277487,60059
58119741,58121029,chr6,RBBP4P4,chr6:58119741-58121029,1288
34516414,34540958,chr20,DYNLRB1,chr20:34516414-34540958,24544
92118664,92119164,chr10,SDHCP2,chr10:92118664-92119164,500
96364608,96513926,chr10,TLL2,chr10:96364608-96513926,149318
92886352,92893508,chr14,LINC02833,chr14:92886352-92893508,7156
35118071,35148610,chr6,TCP11,chr6:35118071-35148610,30539
92905697,92907482,chr14,LINC02287,chr14:92905697-92907482,1785
63637259,63644256,chr18,SERPINB4,chr18:63637259-63644256,6997
92923150,92935285,chr14,CHGA,chr14:92923150-92935285,12135
97238449,97297314,chr9,SUGT1P4-STRA6LP,chr9:97238449-97297314,58865
17941597,17968980,chr20,SNX5,chr20:17941597-17968980,27383
76385526,76394517,chr9,RFK,chr9:76385526-76394517,8991
45255640,45263252,chr10,OR6D1P,chr10:45255640-45263252,7612
38601418,38605609,chr10,ABCD1P2,chr10:38601418-38605609,4191
83311628,83314475,chr10,MARK2P15,chr10:83311628-83314475,2847
65828120,65831696,chr9,BMS1P13,chr9:65828120-65831696,3576
7796500,7888380,chr9,DMAC1,chr9:7796500-7888380,91880
63133247,63155031,chr10,NRBF2,chr10:63133247-63155031,21784
100099243,100302175,chr9,INVS,chr9:100099243-100302175,202932
96560185,96560922,chr10,NPM1P26,chr10:96560185-96560922,737
92936914,93116320,chr14,ITPK1,chr14:92936914-93116320,179406
80336105,80356755,chr10,DYDC1,chr10:80336105-80356755,20650
280057,389320,chr12,KDM5A,chr12:280057-389320,109263
63647579,63726432,chr18,SERPINB11,chr18:63647579-63726432,78853
70478767,70568450,chr10,PALD1,chr10:70478767-70568450,89683
3668812,3669668,chr17,EMC6,chr17:3668812-3669668,856
5078467,5096374,chr17,ZFP3,chr17:5078467-5096374,17907
98955982,98956767,chr4,FAM177A1P1,chr4:98955982-98956767,785
94762681,94855547,chr10,CYP2C19,chr10:94762681-94855547,92866
6657034,6693577,chr17,ALOX15P1,chr17:6657034-6693577,36543
104468308,104494901,chr4,CXXC4,chr4:104468308-104494901,26593
118193405,118194751,chr4,FKBP4P1,chr4:118193405-118194751,1346
63655197,63661893,chr18,SERPINB3,chr18:63655197-63661893,6696
42830337,42950827,chr9,ANKRD20A7P,chr9:42830337-42950827,120490
121451541,121451967,chr4,TUBB4BP5,chr4:121451541-121451967,426
29865959,29866169,chr13,TIMM8BP1,chr13:29865959-29866169,210
84965534,85011277,chr4,WDFY3-AS2,chr4:84965534-85011277,45743
22580998,22585455,chr20,FOXA2,chr20:22580998-22585455,4457
102394630,102395703,chr13,FGF14-AS2,chr13:102394630-102395703,1073
4937130,4940053,chr17,SLC25A11,chr17:4937130-4940053,2923
80454166,80533124,chr10,TSPAN14,chr10:80454166-80533124,78958
21911559,21912590,chr15,ZNF519P3,chr15:21911559-21912590,1031
49233956,49234501,chrX,HSPB1P2,chrX:49233956-49234501,545
32702699,32743467,chr20,COMMD7,chr20:32702699-32743467,40768
49235470,49250520,chrX,CCDC22,chrX:49235470-49250520,15050
34751032,34754998,chr15,GJD2,chr15:34751032-34754998,3966
41673933,41690504,chr22,SNU13,chr22:41673933-41690504,16571
102611162,102612155,chr9,ZYG11AP1,chr9:102611162-102612155,993
49660674,49691486,chr13,EBPL,chr13:49660674-49691486,30812
104094260,104141419,chr9,SMC2,chr9:104094260-104141419,47159
36889204,37101299,chr15,MEIS2,chr15:36889204-37101299,212095
9537370,9839076,chr20,PAK5,chr20:9537370-9839076,301706
93067452,93072152,chr14,ITPK1-AS1,chr14:93067452-93072152,4700
41679711,41679817,chr22,RNU6-476P,chr22:41679711-41679817,106
49269793,49301461,chrX,PPP1R3F,chrX:49269793-49301461,31668
93138066,93138465,chr14,CYB5AP3,chr14:93138066-93138465,399
41688877,41698136,chr22,C22orf46,chr22:41688877-41698136,9259
116193997,116194751,chr4,TTC39CP1,chr4:116193997-116194751,754
93182199,93184923,chr14,MOAP1,chr14:93182199-93184923,2724
67612652,67701155,chr4,UBA6,chr4:67612652-67701155,88503
18026770,18027846,chr7,PRPS1L1,chr7:18026770-18027846,1076
49220338,49222377,chr13,MLNR,chr13:49220338-49222377,2039
36602,38133,chr12,FAM138D,chr12:36602-38133,1531
11239759,11240280,chr11,MTND5P21,chr11:11239759-11240280,521
49406190,49406714,chr11,CBX3P8,chr11:49406190-49406714,524
93184951,93188463,chr14,TMEM251,chr14:93184951-93188463,3512
41709225,41709489,chr22,HMGN2P10,chr22:41709225-41709489,264
55062945,55161490,chr13,LINC02335,chr13:55062945-55161490,98545
49874945,49876638,chr11,TRIM51DP,chr11:49874945-49876638,1693
26637871,26647305,chr7,LINC02860,chr7:26637871-26647305,9434
41722043,41722131,chr22,RNU6ATAC22P,chr22:41722043-41722131,88
55506635,55511169,chr11,OR4C1P,chr11:55506635-55511169,4534
6749718,6750188,chr17,RPL23AP73,chr17:6749718-6750188,470
28642979,28643270,chr22,RN7SL162P,chr22:28642979-28643270,291
32591793,32592771,chr11,HNRNPA3P9,chr11:32591793-32592771,978
12310,13501,chr12,DDX11L8,chr12:12310-13501,1191
47974851,48003989,chrX,ZNF182,chrX:47974851-48003989,29138
28742039,28757515,chr22,HSCB,chr22:28742039-28757515,15476
28003274,28100592,chr13,FLT3,chr13:28003274-28100592,97318
3043622,3045747,chr20,GNRH2,chr20:3043622-3045747,2125
25224570,25228486,chr7,NPVF,chr7:25224570-25228486,3916
55786964,55787905,chr11,OR5D15P,chr11:55786964-55787905,941
33552123,33578187,chr18,ASXL3-DT,chr18:33552123-33578187,26064
16546954,16569204,chr17,ZNF287,chr17:16546954-16569204,22250
42183292,42253721,chr11,LINC02740,chr11:42183292-42253721,70429
93202894,93207065,chr14,GON7,chr14:93202894-93207065,4171
33578219,33751195,chr18,ASXL3,chr18:33578219-33751195,172976
47983356,48071658,chrX,ZNF630,chrX:47983356-48071658,88302
28995235,29195451,chr7,CPVL,chr7:28995235-29195451,200216
93207241,93229215,chr14,UBR7,chr14:93207241-93229215,21974
66767,178455,chr12,IQSEC3,chr12:66767-178455,111688
17693672,17735871,chr20,BANF2,chr20:17693672-17735871,42199
27506830,27698231,chr11,BDNF-AS,chr11:27506830-27698231,191401
91798426,91865475,chr10,TNKS2,chr10:91798426-91865475,67049
5499427,5619424,chr17,NLRP1,chr17:5499427-5619424,119997
58985686,59008238,chr20,CTSZ,chr20:58985686-59008238,22552
28687743,28742422,chr22,CHEK2,chr22:28687743-28742422,54679
4487735,4538508,chr12,C12orf4,chr12:4487735-4538508,50773
108788745,108789779,chr4,RCC2P8,chr4:108788745-108789779,1034
117413462,117414279,chr4,RPSAP35,chr4:117413462-117414279,817
109346326,109347459,chr4,RBMXP4,chr4:109346326-109347459,1133
121035613,121073021,chr4,NDNF,chr4:121035613-121073021,37408
48056310,48066583,chrX,ZNF630-AS1,chrX:48056310-48066583,10273
48107992,48120210,chrX,SSX6P,chrX:48107992-48120210,12218
122723990,122724925,chr9,OR1L4,chr9:122723990-122724925,935
64621560,64637586,chr9,AQP7P2,chr9:64621560-64637586,16026
33578931,33600040,chr10,LINC02628,chr10:33578931-33600040,21109
77652827,77653055,chr14,COX6CP11,chr14:77652827-77653055,228
124968294,124968840,chr9,FXNP2,chr9:124968294-124968840,546
91666780,91667782,chr10,GAPDHP28,chr10:91666780-91667782,1002
48153980,48154074,chrX,RNU6-707P,chrX:48153980-48154074,94
100442271,100577636,chr9,MSANTD3-TMEFF1,chr9:100442271-100577636,135365
77672404,77708023,chr14,ALKBH1,chr14:77672404-77708023,35619
48156367,48166350,chrX,SSXP3,chrX:48156367-48166350,9983
36944111,36944738,chr10,MKNK2P1,chr10:36944111-36944738,627
48177731,48178023,chrX,S100A11P5,chrX:48177731-48178023,292
60684505,60685209,chr10,ARL4AP1,chr10:60684505-60685209,704
97184093,98143476,chr4,STPG2,chr4:97184093-98143476,959383
48206258,48206374,chrX,RNA5SP503,chrX:48206258-48206374,116
92136875,92138370,chr10,EIF4A1P8,chr10:92136875-92138370,1495
30919012,30921235,chr10,DDX10P1,chr10:30919012-30921235,2223
48228833,48228959,chrX,S100A11P7,chrX:48228833-48228959,126
48274904,48275047,chrX,S100A11P6,chrX:48274904-48275047,143
123859724,123913976,chrX,XIAP,chrX:123859724-123913976,54252
54587757,54599493,chr18,DYNAP,chr18:54587757-54599493,11736
97865000,98030828,chr10,CRTAC1,chr10:97865000-98030828,165828
120091046,120092282,chr4,LTV1P1,chr4:120091046-120092282,1236
115920707,115921978,chr4,KRT18P21,chr4:115920707-115921978,1271
77683202,77683989,chr14,RPL21P10,chr14:77683202-77683989,787
77696591,77697377,chr14,ZMYND19P1,chr14:77696591-77697377,786
93058688,93085133,chr9,SUSD3,chr9:93058688-93085133,26445
104490849,104734546,chr4,CXXC4-AS1,chr4:104490849-104734546,243697
77708071,77761104,chr14,SLIRP,chr14:77708071-77761104,53033
13217498,13652755,chr18,LDLRAD4,chr18:13217498-13652755,435257
74955974,74970362,chr4,PARM1-AS1,chr4:74955974-74970362,14388
117574512,117576174,chr4,NT5C3AP1,chr4:117574512-117576174,1662
4809176,4813412,chr12,KCNA6,chr12:4809176-4813412,4236
105561591,105570238,chr4,ARHGEF38-IT1,chr4:105561591-105570238,8647
67766480,67773854,chr4,TMPRSS11CP,chr4:67766480-67773854,7374
2695765,2812902,chr12,ITFG2-AS1,chr12:2695765-2812902,117137
66094142,66094526,chr4,IFITM3P1,chr4:66094142-66094526,384
100820359,100841520,chrX,CSTF2,chrX:100820359-100841520,21161
118635970,118638782,chr4,CICP16,chr4:118635970-118638782,2812
108742048,108763054,chr4,ETNPPL,chr4:108742048-108763054,21006
897900,955407,chr7,ADAP1,chr7:897900-955407,57507
106541673,106568137,chr13,ARGLU1,chr13:106541673-106568137,26464
126860665,126885878,chr9,ZBTB34,chr9:126860665-126885878,25213
77800109,77935014,chr14,ADCK1,chr14:77800109-77935014,134905
135932969,135961373,chr9,UBAC1,chr9:135932969-135961373,28404
2794970,2805423,chr12,FKBP4,chr12:2794970-2805423,10453
12068954,12123221,chr10,DHTKD1,chr10:12068954-12123221,54267
41228339,41238882,chr6,TREML4,chr6:41228339-41238882,10543
85092284,85243911,chrX,SATL1,chrX:85092284-85243911,151627
98142562,98455176,chr13,FARP1,chr13:98142562-98455176,312614
96490241,96619843,chr9,CDC14B,chr9:96490241-96619843,129602
41024205,41024394,chr20,RNU2-52P,chr20:41024205-41024394,189
41028822,41124487,chr20,TOP1,chr20:41028822-41124487,95665
56563627,56567868,chrX,UBQLN2,chrX:56563627-56567868,4241
145817829,145829856,chrX,SLITRK2,chrX:145817829-145829856,12027
70856679,70957060,chr6,B3GAT2,chr6:70856679-70957060,100381
183824,191587,chr17,LINC02091,chr17:183824-191587,7763
98711613,98717761,chr14,LINC02914,chr14:98711613-98717761,6148
203642,205094,chr12,SLC6A12-AS1,chr12:203642-205094,1452
103309346,103311007,chrX,BEX2,chrX:103309346-103311007,1661
4945652,4949061,chr17,PFN1,chr17:4945652-4949061,3409
79436908,79437167,chr6,DBIP1,chr6:79436908-79437167,259
33851100,34224952,chr18,NOL4,chr18:33851100-34224952,373852
39104063,39115186,chr6,SAYSD1,chr6:39104063-39115186,11123
3149797,3151476,chr12,TSPAN9-IT1,chr12:3149797-3151476,1679
97640686,97676434,chr10,PI4K2A,chr10:97640686-97676434,35748
8032716,8055517,chr12,FOXJ2,chr12:8032716-8055517,22801
43450352,43456632,chr6,DLK2,chr6:43450352-43456632,6280
5179535,5191868,chr17,ZNF594,chr17:5179535-5191868,12333
102885048,103019719,chr4,SLC9B1,chr4:102885048-103019719,134671
37349309,37457292,chrX,PRRG1,chrX:37349309-37457292,107983
50571919,50572140,chr14,SNRPGP1,chr14:50571919-50572140,221
50632058,50668306,chr14,SAV1,chr14:50632058-50668306,36248
5032600,5052009,chr17,SLC52A1,chr17:5032600-5052009,19409
60734342,60741828,chr10,ANK3-DT,chr10:60734342-60741828,7486
50637691,50637981,chr14,RN7SL452P,chr14:50637691-50637981,290
93060798,93069540,chr10,CYP26C1,chr10:93060798-93069540,8742
50704343,50705511,chr14,ZFP64P1,chr14:50704343-50705511,1168
4222091,4223828,chr17,RYKP1,chr17:4222091-4223828,1737
44387706,44450425,chr6,CDC5L,chr6:44387706-44450425,62719
12791355,12824222,chrX,PRPS2,chrX:12791355-12824222,32867
41098019,41138003,chr20,PLCG1-AS1,chr20:41098019-41138003,39984
44959407,44995891,chr10,RASSF4,chr10:44959407-44995891,36484
50857891,50944483,chr14,PYGL,chr14:50857891-50944483,86592
41169023,41169078,chr20,MIR6871,chr20:41169023-41169078,55
3923870,3964464,chr17,ATP2A3,chr17:3923870-3964464,40594
41196691,41197157,chr20,RPL23AP81,chr20:41196691-41197157,466
8602170,8612867,chr12,AICDA,chr12:8602170-8612867,10697
41290280,41290577,chr20,RN7SL615P,chr20:41290280-41290577,297
4627758,4685148,chr20,RPS4XP2,chr20:4627758-4685148,57390
4686350,4701590,chr20,PRNP,chr20:4686350-4701590,15240
43477523,43506556,chr6,TJAP1,chr6:43477523-43506556,29033
4721909,4728460,chr20,PRND,chr20:4721909-4728460,6551
154506159,154516242,chrX,FAM3A,chrX:154506159-154516242,10083
41163162,41164374,chr15,CIBAR1P1,chr15:41163162-41164374,1212
4731279,4740668,chr20,PRNT,chr20:4731279-4740668,9389
22427039,22437902,chr15,GOLGA8EP,chr15:22427039-22437902,10863
4735669,4736673,chr20,IDI1P3,chr20:4735669-4736673,1004
4780023,4823608,chr20,RASSF2,chr20:4780023-4823608,43585
47248300,47269033,chr11,NR1H3,chr11:47248300-47269033,20733
42739118,42743202,chr15,TTBK2-AS1,chr15:42739118-42743202,4084
27754875,28099315,chr15,OCA2,chr15:27754875-28099315,344440
136196250,136205128,chr9,LHX3,chr9:136196250-136205128,8878
96593315,96720514,chr10,PIK3AP1,chr10:96593315-96720514,127199
35668052,35699355,chr20,NFS1,chr20:35668052-35699355,31303
726699,786475,chr7,DNAAF5,chr7:726699-786475,59776
5392381,5630700,chr18,EPB41L3,chr18:5392381-5630700,238319
53592956,53604047,chr4,LNX1-AS2,chr4:53592956-53604047,11091
68928463,68951804,chr4,UGT2A3,chr4:68928463-68951804,23341
27325209,27529814,chr9,MOB3B,chr9:27325209-27529814,204605
124517275,124771311,chr9,NR6A1,chr9:124517275-124771311,254036
49692358,49713590,chr6,CRISP2,chr6:49692358-49713590,21232
121131408,121227466,chr4,TNIP3,chr4:121131408-121227466,96058
23811144,23811660,chr7,TPT1P7,chr7:23811144-23811660,516
100042193,100081869,chr10,CPN1,chr10:100042193-100081869,39676
20835376,21023362,chr7,LINC01162,chr7:20835376-21023362,187986
50872053,50904970,chr14,ABHD12B,chr14:50872053-50904970,32917
14070535,14071380,chr7,RPL6P21,chr7:14070535-14071380,845
7919230,7936187,chr12,SLC2A3,chr12:7919230-7936187,16957
17405479,17558909,chr7,LINC02889,chr7:17405479-17558909,153430
97572499,97583884,chr10,ANKRD2,chr10:97572499-97583884,11385
30150872,30153409,chr15,DNM1P30,chr15:30150872-30153409,2537
24698355,24757940,chr7,GSDME,chr7:24698355-24757940,59585
26438341,26567803,chr10,APBB1IP,chr10:26438341-26567803,129462
21609102,21610043,chr15,OR1Q1BP,chr15:21609102-21610043,941
20901441,20901609,chr15,ZNF519P2,chr15:20901441-20901609,168
39934115,40035591,chr15,EIF2AK4,chr15:39934115-40035591,101476
57114894,57174236,chr6,ZNF451-AS1,chr6:57114894-57174236,59342
70423031,70433390,chrX,GDPD2,chrX:70423031-70433390,10359
5043879,5046788,chr12,KCNA5,chr12:5043879-5046788,2909
109433772,109540896,chr4,SEC24B,chr4:109433772-109540896,107124
74881891,74903743,chr14,DLST,chr14:74881891-74903743,21852
77780337,77781876,chr10,IMPDH1P5,chr10:77780337-77781876,1539
31187715,31261910,chr10,LINC02664,chr10:31187715-31261910,74195
91906584,91909486,chr10,FGFBP3,chr10:91906584-91909486,2902
389273,442642,chr12,CCDC77,chr12:389273-442642,53369
76398699,76399586,chr9,RPSAP9,chr9:76398699-76399586,887
82924829,82925122,chr6,LAP3P1,chr6:82924829-82925122,293
121338987,121370304,chr9,STOM,chr9:121338987-121370304,31317
51615299,52087613,chr6,PKHD1,chr6:51615299-52087613,472314
74824927,75032624,chr10,KAT6B,chr10:74824927-75032624,207697
77504880,77786233,chrX,ATRX,chrX:77504880-77786233,281353
26982768,26983367,chr7,HMGB3P20,chr7:26982768-26983367,599
20002765,20003247,chr7,RPL21P75,chr7:20002765-20003247,482
90801787,90898549,chr9,SYK,chr9:90801787-90898549,96762
35699272,35700984,chr20,ROMO1,chr20:35699272-35700984,1712
24796540,24981634,chr7,OSBPL3,chr7:24796540-24981634,185094
26543546,26939539,chr15,GABRB3,chr15:26543546-26939539,395993
4615508,4649051,chr12,AKAP3,chr12:4615508-4649051,33543
35701347,35742312,chr20,RBM39,chr20:35701347-35742312,40965
15436021,15563561,chr17,TVP23C-CDRT4,chr17:15436021-15563561,127540
48263861,48264778,chr11,OR4X1,chr11:48263861-48264778,917
49920312,49921414,chr11,OR4A19P,chr11:49920312-49921414,1102
50246554,50247761,chr11,PHKG1P3,chr11:50246554-50247761,1207
19941371,19969975,chr22,COMT,chr22:19941371-19969975,28604
64099,76866,chr17,LINC02887,chr17:64099-76866,12767
8157034,8188537,chr12,ZNF705A,chr12:8157034-8188537,31503
55827219,55828154,chr11,OR5L2,chr11:55827219-55828154,935
74903951,74923302,chr14,RPS6KL1,chr14:74903951-74923302,19351
5486285,5490814,chr17,MIS12,chr17:5486285-5490814,4529
49053714,49059112,chr11,TRIM64C,chr11:49053714-49059112,5398
8437403,8438425,chr12,OR7E149P,chr12:8437403-8438425,1022
49145092,49208638,chr11,FOLH1,chr11:49145092-49208638,63546
4997950,5028401,chr17,KIF1C,chr17:4997950-5028401,30451
10214161,10214761,chr12,GABARAPL1-AS1,chr12:10214161-10214761,600
8015024,8016406,chr12,HSPD1P12,chr12:8015024-8016406,1382
8414780,8415805,chr12,OR7E140P,chr12:8414780-8415805,1025
8776219,8830947,chr12,A2ML1-AS1,chr12:8776219-8830947,54728
2876258,2889524,chr12,RHNO1,chr12:2876258-2889524,13266
99160514,99161645,chr4,PCNAP1,chr4:99160514-99161645,1131
115628812,115629707,chr4,RPF2P2,chr4:115628812-115629707,895
69389492,69402081,chr4,UGT2B25P,chr4:69389492-69402081,12589
63857441,63857769,chr6,GCNT1P4,chr6:63857441-63857769,328
63275951,63319983,chr6,LGSN,chr6:63275951-63319983,44032
95099054,95426796,chr9,FANCC,chr9:95099054-95426796,327742
74941834,74955626,chr14,PGF,chr14:74941834-74955626,13792
15443639,15444191,chr17,RPL9P2,chr17:15443639-15444191,552
9418673,9448229,chr12,DDX12P,chr12:9418673-9448229,29556
76521640,76593821,chr6,LINC02540,chr6:76521640-76593821,72181
82818509,82901166,chr4,SEC31A,chr4:82818509-82901166,82657
212389,386254,chr17,RPH3AL,chr17:212389-386254,173865
114107569,114108820,chr13,RASA3-IT1,chr13:114107569-114108820,1251
42781550,42791549,chr13,FAM216B,chr13:42781550-42791549,9999
220621,262873,chr12,SLC6A13,chr12:220621-262873,42252
44219553,44234142,chr6,SLC29A1,chr6:44219553-44234142,14589
114346167,114346637,chr13,RPL23AP97,chr13:114346167-114346637,470
93394977,93395855,chr13,HNRNPA1P29,chr13:93394977-93395855,878
93818424,93836144,chr13,GPC6-AS2,chr13:93818424-93836144,17720
106374477,106384315,chr13,LINC00460,chr13:106374477-106384315,9838
21344548,21345085,chr15,LONRF2P4,chr15:21344548-21345085,537
22056709,22057638,chr15,OR4H6P,chr15:22056709-22057638,929
75002921,75012366,chr14,EIF2B2,chr14:75002921-75012366,9445
20835372,20866314,chr15,POTEB2,chr15:20835372-20866314,30942
8199599,8218911,chr12,DEFB109F,chr12:8199599-8218911,19312
19963753,19963834,chr22,MIR4761,chr22:19963753-19963834,81
42562736,42608013,chr13,TNFSF11,chr13:42562736-42608013,45277
19969896,20016823,chr22,ARVCF,chr22:19969896-20016823,46927
8637346,8662888,chr12,MFAP5,chr12:8637346-8662888,25542
19972782,19973218,chr15,IGHV1OR15-2,chr15:19972782-19973218,436
55717749,55758774,chrX,RRAGB,chrX:55717749-55758774,41025
75013769,75051532,chr14,MLH3,chr14:75013769-75051532,37763
42571927,42572433,chr15,MYL12BP1,chr15:42571927-42572433,506
50282343,50287839,chr18,CXXC1,chr18:50282343-50287839,5496
35217345,35546193,chr15,DPH6,chr15:35217345-35546193,328848
108044970,108079184,chrX,VSIG1,chrX:108044970-108079184,34214
38561542,38688920,chrX,TSPAN7,chrX:38561542-38688920,127378
88388430,88478694,chr9,SPIN1,chr9:88388430-88478694,90264
30103720,30131757,chr15,ULK4P3,chr15:30103720-30131757,28037
5432777,5448830,chr17,C1QBP,chr17:5432777-5448830,16053
20969282,20970215,chr15,OR11J5P,chr15:20969282-20970215,933
89318500,89359663,chr9,SECISBP2,chr9:89318500-89359663,41163
40088832,40089386,chr15,BMF-AS1,chr15:40088832-40089386,554
40769980,40772449,chr15,C15orf62,chr15:40769980-40772449,2469
22813799,22830299,chr11,SVIP,chr11:22813799-22830299,16500
15829369,15908632,chr17,SPECC1P1,chr17:15829369-15908632,79263
47623172,47630305,chrX,CFP,chrX:47623172-47630305,7133
20017014,20067164,chr22,TANGO2,chr22:20017014-20067164,50150
38252836,38357249,chr15,SPRED1,chr15:38252836-38357249,104413
48432217,48433147,chr11,OR4C10P,chr11:48432217-48433147,930
6684719,6713377,chr17,SLC13A5,chr17:6684719-6713377,28658
77979817,77997881,chr13,LINC01069,chr13:77979817-77997881,18064
48627546,48628493,chr11,OR4A44P,chr11:48627546-48628493,947
48512273,48513220,chr11,OR4A40P,chr11:48512273-48513220,947
31369840,31432835,chr11,DNAJC24,chr11:31369840-31432835,62995
75020761,75020867,chr14,RNU6-689P,chr14:75020761-75020867,106
42067009,42094562,chr15,PLA2G4D,chr15:42067009-42094562,27553
75053237,75069483,chr14,ACYP1,chr14:75053237-75069483,16246
19173772,19181824,chr13,TUBA3C,chr13:19173772-19181824,8052
41333348,41364472,chrX,DDX3X,chrX:41333348-41364472,31124
55948120,55948924,chr11,OR10AF1P,chr11:55948120-55948924,804
75064109,75119502,chr14,ZC2HC1C,chr14:75064109-75119502,55393
18412318,18452063,chr11,LDHC,chr11:18412318-18452063,39745
22194885,22195317,chr15,IGHV1OR15-4,chr15:22194885-22195317,432
88978447,88978785,chr13,GRPEL2P1,chr13:88978447-88978785,338
17790761,17940501,chr7,SNX13,chr7:17790761-17940501,149740
133532164,133575519,chr9,ADAMTSL2,chr9:133532164-133575519,43355
44063511,44064313,chr15,GAPDHP55,chr15:44063511-44064313,802
18946755,19062718,chr13,PHF2P2,chr13:18946755-19062718,115963
32765544,33194714,chr15,FMN1,chr15:32765544-33194714,429170
75116426,75116600,chr14,HIF1AP1,chr14:75116426-75116600,174
8533305,8540905,chr12,CLEC4E,chr12:8533305-8540905,7600
75131469,75176612,chr14,TMED10,chr14:75131469-75176612,45143
18297554,18298733,chr13,KMT5AP1,chr13:18297554-18298733,1179
18880054,18880157,chr13,RNU6-76P,chr13:18880054-18880157,103
75202081,75202169,chr14,RNU4ATAC14P,chr14:75202081-75202169,88
10770305,10770605,chr12,HSPE1P12,chr12:10770305-10770605,300
19088487,19088581,chr13,RNA5SP24,chr13:19088487-19088581,94
18869185,18869291,chr13,RNU6-55P,chr13:18869185-18869291,106
10845849,10849475,chr12,PRR4,chr12:10845849-10849475,3626
94561442,94569913,chr14,SERPINA4,chr14:94561442-94569913,8471
19736975,19737254,chr13,RN7SL166P,chr13:19736975-19737254,279
20433778,20433846,chr13,MIR4499,chr13:20433778-20433846,68
24703556,24703665,chr13,RNY1P7,chr13:24703556-24703665,109
27255064,27255135,chr13,SNORD102,chr13:27255064-27255135,71
27255401,27255526,chr13,SNORA27,chr13:27255401-27255526,125
27402476,27402587,chr13,RNY1P1,chr13:27402476-27402587,111
27989296,27989584,chr13,RN7SL272P,chr13:27989296-27989584,288
27343687,27343746,chr13,RNU6-70P,chr13:27343687-27343746,59
28232501,28232607,chr13,RNU6-82P,chr13:28232501-28232607,106
17977409,18039209,chr17,ATPAF2,chr17:17977409-18039209,61800
27488138,27488232,chr13,RNU6-63P,chr13:27488138-27488232,94
24162416,24162504,chr13,MIR2276,chr13:24162416-24162504,88
30281765,30281869,chr13,RNU6-64P,chr13:30281765-30281869,104
105919,106856,chr6,OR4F1P,chr6:105919-106856,937
28703702,28703807,chr13,RNU6-53P,chr13:28703702-28703807,105
70566917,70589569,chr6,SDHAF4,chr6:70566917-70589569,22652
3318718,3325343,chr12,LINC02827,chr12:3318718-3325343,6625
92844182,92878038,chr9,ZNF484,chr9:92844182-92878038,33856
33829539,33829649,chr13,RNU5A-4P,chr13:33829539-33829649,110
37854852,37854970,chr13,RNA5SP26,chr13:37854852-37854970,118
38779424,38779516,chr13,RNU6-56P,chr13:38779424-38779516,92
53929982,54266280,chr6,MLIP,chr6:53929982-54266280,336298
37166352,37166658,chr13,RN7SKP1,chr13:37166352-37166658,306
39857135,39857227,chr13,SNORD116,chr13:39857135-39857227,92
8076939,8097881,chr12,NECAP1,chr12:8076939-8097881,20942
39586561,39587293,chr15,THBS1-IT1,chr15:39586561-39587293,732
94561442,94593118,chr14,SERPINA5,chr14:94561442-94593118,31676
40727828,40727875,chr13,MIR320D1,chr13:40727828-40727875,47
22401208,22406944,chr15,SPATA31E3P,chr15:22401208-22406944,5736
40810766,40810861,chr13,MIR621,chr13:40810766-40810861,95
74434775,74457944,chr18,DIPK1C,chr18:74434775-74457944,23169
39664034,39664135,chr13,MIR4305,chr13:39664034-39664135,101
39785415,39785510,chr13,RNY4P14,chr13:39785415-39785510,95
21239002,21240005,chr9,IFNA14,chr9:21239002-21240005,1003
40226827,40226932,chr13,RNY3P9,chr13:40226827-40226932,105
38454127,38487710,chr15,FAM98B,chr15:38454127-38487710,33583
40407122,40407440,chr13,RN7SKP2,chr13:40407122-40407440,318
44196129,44196200,chr13,MIR8079,chr13:44196129-44196200,71
45002150,45002447,chr13,RN7SL49P,chr13:45002150-45002447,297
74148523,74160531,chr18,TIMM21,chr18:74148523-74160531,12008
138217068,138253217,chr9,FAM157B,chr9:138217068-138253217,36149
45060729,45061086,chr13,RN7SKP3,chr13:45060729-45061086,357
45551485,45551603,chr13,RNA5SP27,chr13:45551485-45551603,118
47458941,47459234,chr13,RN7SL700P,chr13:47458941-47459234,293
45123093,45123414,chr13,RN7SKP4,chr13:45123093-45123414,321
48987915,48988017,chr13,RNU6-60P,chr13:48987915-48988017,102
49095391,49095492,chr13,RNY3P2,chr13:49095391-49095492,101
55795556,55796500,chr11,OR5D14,chr11:55795556-55796500,944
112362714,112363116,chr9,RPL32P22,chr9:112362714-112363116,402
52810050,52810140,chr13,MIR759,chr13:52810050-52810140,90
48589760,48590687,chr11,OR4A41P,chr11:48589760-48590687,927
21206181,21207143,chr9,IFNA10,chr9:21206181-21207143,962
53258077,53258372,chr13,RN7SL618P,chr13:53258077-53258372,295
48492026,48492416,chr11,OR4A48P,chr11:48492026-48492416,390
20916686,20935658,chr15,NF1P1,chr15:20916686-20935658,18972
55491205,55492148,chr11,OR4A21P,chr11:55491205-55492148,943
55174454,55174548,chr13,MIR5007,chr13:55174454-55174548,94
31371611,31381490,chr9,LINC01243,chr9:31371611-31381490,9879
4986466,4987324,chr17,CAMTA2-AS1,chr17:4986466-4987324,858
56885284,56885602,chr13,RN7SKP6,chr13:56885284-56885602,318
48420210,48421273,chr11,OR4C2P,chr11:48420210-48421273,1063
65189995,65193610,chr9,BMS1P12,chr9:65189995-65193610,3615
57991350,57991464,chr13,RNA5SP30,chr13:57991350-57991464,114
114155537,114312511,chr9,COL27A1,chr9:114155537-114312511,156974
58527655,58527751,chr13,RNY4P29,chr13:58527655-58527751,96
49833140,49839320,chr11,TRIM51FP,chr11:49833140-49839320,6180
61199798,61199880,chr13,MIR3169,chr13:61199798-61199880,82
66218250,66218324,chr13,MIR4704,chr13:66218250-66218324,74
59480070,59480132,chr13,RNU7-88P,chr13:59480070-59480132,62
35282596,35282980,chr15,NUTF2P6,chr15:35282596-35282980,384
60789560,60789661,chr13,RNY3P5,chr13:60789560-60789661,101
27365961,27472790,chr11,LGR4,chr11:27365961-27472790,106829
65966330,65966429,chr13,MIR548X2,chr13:65966330-65966429,99
60034465,60034762,chr13,RN7SL375P,chr13:60034465-60034762,297
27038978,27161319,chr15,GABRG3-AS1,chr15:27038978-27161319,122341
4967992,4987675,chr17,CAMTA2,chr17:4967992-4987675,19683
66630715,66630776,chr13,RNU7-87P,chr13:66630715-66630776,61
63783801,63783904,chr13,RNU6-81P,chr13:63783801-63783904,103
23105758,23177914,chr7,KLHL7,chr7:23105758-23177914,72156
74227506,74227803,chr18,RN7SL551P,chr18:74227506-74227803,297
68693804,68694081,chr13,RN7SL761P,chr13:68693804-68694081,277
42208413,42226990,chr15,VPS39-DT,chr15:42208413-42226990,18577
74315839,74359189,chr18,C18orf63,chr18:74315839-74359189,43350
72706017,72706123,chr13,RNU6-80P,chr13:72706017-72706123,106
21012559,21012589,chr15,IGHD3OR15-3B,chr15:21012559-21012589,30
54311972,54312048,chr13,MIR1297,chr13:54311972-54312048,76
73227147,73227260,chr13,RNY1P8,chr13:73227147-73227260,113
73191528,73191667,chr13,RNU4-10P,chr13:73191528-73191667,139
73112915,73113018,chr13,RNU6-66P,chr13:73112915-73113018,103
40952962,40956512,chr15,CHAC1,chr15:40952962-40956512,3550
72881108,72881214,chr13,RNU6-79P,chr13:72881108-72881214,106
74289100,74289214,chr13,RNY1P5,chr13:74289100-74289214,114
69802940,69803041,chr13,RNY3P10,chr13:69802940-69803041,101
74389884,74390297,chr18,FAUP1,chr18:74389884-74390297,413
76134931,76135225,chr13,RN7SL571P,chr13:76134931-76135225,294
79389534,79389631,chr13,RNA5SP33,chr13:79389534-79389631,97
74250846,74291973,chr18,CYB5A,chr18:74250846-74291973,41127
80369426,80369534,chr13,RNU6-61P,chr13:80369426-80369534,108
94612384,94624055,chr14,SERPINA3,chr14:94612384-94624055,11671
70459464,70459570,chr13,RNU6-54P,chr13:70459464-70459570,106
77623372,77623472,chr13,RNY3P7,chr13:77623372-77623472,100
77698012,77698116,chr13,MIR3665,chr13:77698012-77698116,104
81265747,81265837,chr13,RNU6-77P,chr13:81265747-81265837,90
50348936,50354861,chr15,GABPB1-IT1,chr15:50348936-50354861,5925
77947497,77947772,chr13,RN7SL810P,chr13:77947497-77947772,275
78355227,78355328,chr13,RNY3P3,chr13:78355227-78355328,101
75109587,75109693,chr13,RNU6-38P,chr13:75109587-75109693,106
49898267,49899186,chr11,OR4A1P,chr11:49898267-49899186,919
39588357,39782841,chr15,FSIP1,chr15:39588357-39782841,194484
87618665,87618740,chr13,MIR4500,chr13:87618665-87618740,75
83298071,83298167,chr13,RNU6-67P,chr13:83298071-83298167,96
92059844,92059969,chr13,RNU4ATAC3P,chr13:92059844-92059969,125
92490163,92490220,chr13,MIR548AS,chr13:92490163-92490220,57
94025470,94025598,chr13,RNA5SP35,chr13:94025470-94025598,128
47239302,47248906,chr11,ACP2,chr11:47239302-47248906,9604
94699223,94699502,chr13,RN7SL585P,chr13:94699223-94699502,279
95336106,95336201,chr13,RNY4P27,chr13:95336106-95336201,95
95310830,95310955,chr13,RNY3P8,chr13:95310830-95310955,125
91350605,91350688,chr13,MIR17,chr13:91350605-91350688,83
90781766,90781869,chr13,RNU6-75P,chr13:90781766-90781869,103
91350751,91350821,chr13,MIR18A,chr13:91350751-91350821,70
91350891,91350972,chr13,MIR19A,chr13:91350891-91350972,81
26971181,27541984,chr15,GABRG3,chr15:26971181-27541984,570803
91351065,91351135,chr13,MIR20A,chr13:91351065-91351135,70
91351192,91351278,chr13,MIR19B1,chr13:91351192-91351278,86
91351314,91351391,chr13,MIR92A1,chr13:91351314-91351391,77
94726288,94727175,chr14,RPSAP4,chr14:94726288-94727175,887
95019235,95019336,chr13,RNU6-62P,chr13:95019235-95019336,101
96169545,96169847,chr13,RN7SL164P,chr13:96169545-96169847,302
94800849,94801463,chr14,RPL15P2,chr14:94800849-94801463,614
96427229,96427292,chr13,MIR4501,chr13:96427229-96427292,63
90135712,90135841,chr13,RNA5SP34,chr13:90135712-90135841,129
94631863,94634528,chr14,ADIPOR1P2,chr14:94631863-94634528,2665
96949249,96949533,chr13,RN7SKP7,chr13:96949249-96949533,284
94640725,94646994,chr14,SERPINA13P,chr14:94640725-94646994,6269
94651397,94651529,chr13,RNA5SP36,chr13:94651397-94651529,132
90231182,90231277,chr13,MIR622,chr13:90231182-90231277,95
98203835,98204192,chr13,RN7SKP8,chr13:98203835-98204192,357
98208524,98208600,chr13,MIR3170,chr13:98208524-98208600,76
101778884,101779048,chr13,RNU1-24P,chr13:101778884-101779048,164
54423561,54441391,chr14,CNIH1,chr14:54423561-54441391,17830
101967642,101967746,chr13,MIR2681,chr13:101967642-101967746,104
102016953,102017069,chr13,RNY1P2,chr13:102016953-102017069,116
102045934,102046004,chr13,MIR4705,chr13:102045934-102046004,70
20033139,20033220,chr22,MIR185,chr22:20033139-20033220,81
98671980,98672278,chr13,RN7SL60P,chr13:98671980-98672278,298
99025234,99025345,chr13,RNU6-83P,chr13:99025234-99025345,111
109915096,109915420,chr13,RN7SKP10,chr13:109915096-109915420,324
53336943,53337346,chr6,RPS16P5,chr6:53336943-53337346,403
33012119,33013068,chr15,HNRNPA1P71,chr15:33012119-33013068,949
107320895,107320963,chr13,SNORD31B,chr13:107320895-107320963,68
99356131,99356228,chr13,MIR623,chr13:99356131-99356228,97
42581156,42581488,chr15,EIF4EBP2P2,chr15:42581156-42581488,332
110097851,110098151,chr13,RN7SL783P,chr13:110097851-110098151,300
38481692,38482531,chr6,BTBD9-AS1,chr6:38481692-38482531,839
107531171,107531248,chr13,MIR1267,chr13:107531171-107531248,77
34493291,34891844,chr18,DTNA,chr18:34493291-34891844,398553
52576787,52643058,chr6,TRAM2-AS1,chr6:52576787-52643058,66271
106155372,106155490,chr13,RNA5SP38,chr13:106155372-106155490,118
20085746,20085833,chr22,MIR3618,chr22:20085746-20085833,87
20086058,20086142,chr22,MIR1306,chr22:20086058-20086142,84
114273828,114273908,chr13,MIR4502,chr13:114273828-114273908,80
110340958,110341029,chr13,MIR8073,chr13:110340958-110341029,71
16916359,17346152,chr7,AHR,chr7:16916359-17346152,429793
114244505,114244561,chr13,MIR548AR,chr13:114244505-114244561,56
22099163,22099544,chr13,NME1P1,chr13:22099163-22099544,381
20111875,20117392,chr22,TRMT2A,chr22:20111875-20117392,5517
22113119,22113338,chr13,MTND3P1,chr13:22113119-22113338,219
22696023,22696574,chr13,FTH1P7,chr13:22696023-22696574,551
22773063,22829789,chr15,NIPA1,chr15:22773063-22829789,56726
22704739,22706206,chr13,DDX39AP1,chr13:22704739-22706206,1467
78934419,79078254,chr6,PHIP,chr6:78934419-79078254,143835
22803145,22803224,chr13,SNORD36,chr13:22803145-22803224,79
114850968,115402644,chr9,DELEC1,chr9:114850968-115402644,551676
22803296,22803648,chr13,RPL7AP73,chr13:22803296-22803648,352
22837026,22837880,chr13,IPMKP1,chr13:22837026-22837880,854
22850101,22850561,chr13,RFESDP1,chr13:22850101-22850561,460
22897341,22898005,chr13,BASP1P1,chr13:22897341-22898005,664
22915651,22916523,chr13,NUS1P2,chr13:22915651-22916523,872
124857880,124861981,chr9,RPL35,chr9:124857880-124861981,4101
23134174,23134564,chr13,HMGA1P6,chr13:23134174-23134564,390
23152586,23152686,chr13,RNY3P4,chr13:23152586-23152686,100
54474484,54489026,chr14,GMFB,chr14:54474484-54489026,14542
23169835,23170597,chr13,LINC00362,chr13:23169835-23170597,762
44254096,44257890,chr6,SLC35B2,chr6:44254096-44257890,3794
23217432,23217534,chr13,RNU6-58P,chr13:23217432-23217534,102
23243520,23247184,chr13,TATDN2P3,chr13:23243520-23247184,3664
23267506,23269150,chr13,SDAD1P4,chr13:23267506-23269150,1644
29212302,29213214,chr7,NANOGP4,chr7:29212302-29213214,912
135462727,135480777,chr9,PPP1R26-AS1,chr9:135462727-135480777,18050
23373423,23374061,chr13,RPLP1P13,chr13:23373423-23374061,638
19020991,19117636,chr7,TWIST1,chr7:19020991-19117636,96645
23418971,23428869,chr13,SACS-AS1,chr13:23418971-23428869,9898
23465776,23487712,chr13,LINC00327,chr13:23465776-23487712,21936
23298739,23311729,chr7,MALSU1,chr7:23298739-23311729,12990
10985913,10986912,chr12,TAS2R50,chr12:10985913-10986912,999
85492579,85494094,chr9,STK33P1,chr9:85492579-85494094,1515
65646982,65652679,chr9,FRG1KP,chr9:65646982-65652679,5697
58154960,58156061,chr15,MTCYBP23,chr15:58154960-58156061,1101
77580245,77580628,chr9,NUTF2P3,chr9:77580245-77580628,383
7566369,7567382,chr12,GAPDHP31,chr12:7566369-7567382,1013
30689105,30690272,chr9,RBMXP2,chr9:30689105-30690272,1167
35121573,35122084,chr15,PRELID1P4,chr15:35121573-35122084,511
25134692,25180356,chr7,C7orf31,chr7:25134692-25180356,45664
8681600,8783095,chr12,RIMKLB,chr12:8681600-8783095,101495
22646200,22824213,chr9,LINC01239,chr9:22646200-22824213,178013
24954986,24977850,chr15,SNURF,chr15:24954986-24977850,22864
23498796,23502874,chr13,LINC00352,chr13:23498796-23502874,4078
134030305,134068535,chr9,BRD3,chr9:134030305-134068535,38230
48232612,48270357,chr13,ITM2B,chr13:48232612-48270357,37745
77496119,77496671,chr6,RPS6P7,chr6:77496119-77496671,552
21250180,21260147,chr15,NBEAP4,chr15:21250180-21260147,9967
55850347,55858547,chr11,OR9M1P,chr11:55850347-55858547,8200
44825747,44884694,chr15,SORD2P,chr15:44825747-44884694,58947
20114686,20114751,chr22,MIR6816,chr22:20114686-20114751,65
83859656,83967423,chr6,CYB5R4,chr6:83859656-83967423,107767
56848478,56878078,chr11,LINC02735,chr11:56848478-56878078,29600
16791811,16833433,chr7,AGR2,chr7:16791811-16833433,41622
20115938,20127355,chr22,RANBP1,chr22:20115938-20127355,11417
10937408,11171573,chr12,TAS2R14,chr12:10937408-11171573,234165
9228533,9275817,chr12,A2MP1,chr12:9228533-9275817,47284
54566117,54793315,chr14,SAMD4A,chr14:54566117-54793315,227198
15786618,15787575,chr17,MEIS3P1,chr17:15786618-15787575,957
32112049,32343409,chr11,THEM7P,chr11:32112049-32343409,231360
55355248,55498360,chr15,DNAAF4-CCPG1,chr15:55355248-55498360,143112
20543481,20550963,chr17,TBC1D3P3,chr17:20543481-20550963,7482
54692450,54693359,chr11,OR4A7P,chr11:54692450-54693359,909
48227429,48228310,chr11,OR4B2P,chr11:48227429-48228310,881
48014406,48015855,chr11,PTPRJ-AS1,chr11:48014406-48015855,1449
81813286,81814157,chr6,LINC01526,chr6:81813286-81814157,871
54724847,54725816,chr11,OR4A6P,chr11:54724847-54725816,969
49917391,49918478,chr11,OR4A18P,chr11:49917391-49918478,1087
83210402,83431051,chr6,ME1,chr6:83210402-83431051,220649
48985868,48991881,chr11,TRIM53CP,chr11:48985868-48991881,6013
11649674,11895377,chr12,ETV6,chr12:11649674-11895377,245703
133577081,133609389,chr9,FAM163B,chr9:133577081-133609389,32308
49405091,49415789,chr11,TYRL,chr11:49405091-49415789,10698
48945694,48951895,chr11,TRIM51CP,chr11:48945694-48951895,6201
47270657,47272110,chr11,MADD-AS1,chr11:47270657-47272110,1453
5440917,5468982,chr17,DHX33,chr17:5440917-5468982,28065
33293568,33310659,chr15,RYR3-DT,chr15:33293568-33310659,17091
138150075,138177433,chr9,TUBBP5,chr9:138150075-138177433,27358
34570876,34573982,chr11,LINC02707,chr11:34570876-34573982,3106
50053410,50054309,chr11,OR4C49P,chr11:50053410-50054309,899
55773438,55774382,chr11,OR5D13,chr11:55773438-55774382,944
35546154,35860199,chr15,DPH6-DT,chr15:35546154-35860199,314045
10332861,10338292,chr12,LINC02617,chr12:10332861-10338292,5431
47778087,47848555,chr11,NUP160,chr11:47778087-47848555,70468
10069554,10111627,chr12,CLEC1A,chr12:10069554-10111627,42073
30424527,30478784,chr7,NOD1,chr7:30424527-30478784,54257
100473149,100577636,chr9,TMEFF1,chr9:100473149-100577636,104487
40929340,40939073,chr15,DLL4,chr15:40929340-40939073,9733
57314805,57646850,chr6,PRIM2,chr6:57314805-57646850,332045
42725857,42737159,chr10,RSU1P1,chr10:42725857-42737159,11302
38094368,38360098,chr10,PLD5P1,chr10:38094368-38360098,265730
48316863,48320475,chr13,PPP1R26P1,chr13:48316863-48320475,3612
48328084,48328564,chr13,PCNPP5,chr13:48328084-48328564,480
37601440,37602974,chr10,MTRNR2L7,chr10:37601440-37602974,1534
37949573,37976647,chr10,ZNF25,chr10:37949573-37976647,27074
109015135,109119947,chr9,TMEM245,chr9:109015135-109119947,104812
8056844,8066359,chr12,C3AR1,chr12:8056844-8066359,9515
48570639,48573317,chr13,LINC01077,chr13:48570639-48573317,2678
20126402,20126526,chr22,SNORA77B,chr22:20126402-20126526,124
11048332,11049256,chr12,TAS2R63P,chr12:11048332-11049256,924
55611544,55743152,chr15,PRTG,chr15:55611544-55743152,131608
8819816,8820713,chr12,A2ML1-AS2,chr12:8819816-8820713,897
20129456,20148007,chr22,ZDHHC8,chr22:20129456-20148007,18551
11061365,11062294,chr12,TAS2R46,chr12:11061365-11062294,929
6161776,6272644,chr7,CYTH3,chr7:6161776-6272644,110868
10030678,10066031,chr12,CLEC9A,chr12:10030678-10066031,35353
102854259,102864961,chr10,BORCS7,chr10:102854259-102864961,10702
49995888,50020481,chr13,TRIM13,chr13:49995888-50020481,24593
7890801,7900140,chr12,NANOGP1,chr12:7890801-7900140,9339
107484852,107490482,chr9,KLF4,chr9:107484852-107490482,5630
54859215,54859330,chr14,RNU6ATAC9P,chr14:54859215-54859330,115
54878113,54878193,chr14,MIR4308,chr14:54878113-54878193,80
6640985,6644541,chr17,TXNDC17,chr17:6640985-6644541,3556
54884849,54886213,chr14,FDPSP3,chr14:54884849-54886213,1364
83672406,83677122,chr10,LINC02650,chr10:83672406-83677122,4716
54938949,55027105,chr14,WDHD1,chr14:54938949-55027105,88156
10825317,10826358,chr12,TAS2R10,chr12:10825317-10826358,1041
89915489,89957373,chr10,LINC01375,chr10:89915489-89957373,41884
34537802,34556333,chr6,SPDEF,chr6:34537802-34556333,18531
12116025,12267044,chr12,LRP6,chr12:12116025-12267044,151019
64168959,64170850,chr10,DBF4P1,chr10:64168959-64170850,1891
40694774,40732340,chr15,RAD51,chr15:40694774-40732340,37566
93284004,93284558,chr10,RPL17P34,chr10:93284004-93284558,554
6578147,6640711,chr17,KIAA0753,chr17:6578147-6640711,62564
40391591,40587364,chr6,LRFN2,chr6:40391591-40587364,195773
80344745,80368073,chr10,DYDC2,chr10:80344745-80368073,23328
129812942,129824244,chr9,TOR1A,chr9:129812942-129824244,11302
52246460,52247362,chr6,SLC25A20P1,chr6:52246460-52247362,902
98834574,98839458,chr6,POU3F2,chr6:98834574-98839458,4884
27269357,27269678,chr7,RPL35P4,chr7:27269357-27269678,321
20148416,20151055,chr22,CCDC188,chr22:20148416-20151055,2639
29080284,29082527,chr7,CPVL-AS1,chr7:29080284-29082527,2243
35781019,35793675,chr6,CLPSL1,chr6:35781019-35793675,12656
20827326,20827753,chr7,RPL23P8,chr7:20827326-20827753,427
49996415,49996501,chr13,MIR3613,chr13:49996415-49996501,86
19257520,19258806,chr22,KRT18P62,chr22:19257520-19258806,1286
27458163,27458849,chr7,EIF4HP1,chr7:27458163-27458849,686
50015254,50020922,chr13,KCNRG,chr13:50015254-50020922,5668
58023881,58181616,chr11,OR9Q1,chr11:58023881-58181616,157735
21428043,21514822,chr7,SP4,chr7:21428043-21514822,86779
19330698,19447450,chr22,HIRA,chr22:19330698-19447450,116752
129665647,129722674,chr9,PRRX2,chr9:129665647-129722674,57027
55291883,55298270,chr11,TRIM51HP,chr11:55291883-55298270,6387
92291167,92353964,chr10,MARCHF5,chr10:92291167-92353964,62797
41101022,41140835,chr6,ADCY10P1,chr6:41101022-41140835,39813
55572128,55573060,chr11,OR4C16,chr11:55572128-55573060,932
65250543,65250826,chr9,IGKV1OR9-1,chr9:65250543-65250826,283
58348989,58349630,chr11,OR5B10P,chr11:58348989-58349630,641
86264546,86283102,chr9,ISCA1,chr9:86264546-86283102,18556
50048973,50049061,chr13,MIR16-1,chr13:50048973-50049061,88
35752814,35753719,chr20,RPF2P1,chr20:35752814-35753719,905
49923049,49923886,chr11,OR4R3P,chr11:49923049-49923886,837
50049119,50049201,chr13,MIR15A,chr13:50049119-50049201,82
48464053,48464977,chr11,OR4C9P,chr11:48464053-48464977,924
55754977,55755957,chr11,OR5D17P,chr11:55754977-55755957,980
20330702,20415754,chr7,ITGB8,chr7:20330702-20415754,85052
14673606,14674555,chr11,MORF4L1P3,chr11:14673606-14674555,949
35860249,35861498,chr11,KRT18P14,chr11:35860249-35861498,1249
37005646,37029069,chr6,FGD2,chr6:37005646-37029069,23423
81136540,81137335,chr10,RPA2P2,chr10:81136540-81137335,795
60850933,60855950,chr11,PTGDR2,chr11:60850933-60855950,5017
50099331,50099868,chr13,RPL18P10,chr13:50099331-50099868,537
35626031,35664956,chr20,CPNE1,chr20:35626031-35664956,38925
35662775,35818007,chr11,TRIM44,chr11:35662775-35818007,155232
94774156,94774633,chr10,MTND4P19,chr10:94774156-94774633,477
101181144,101181951,chr10,SMARCE1P7,chr10:101181144-101181951,807
50172089,50173181,chr13,ST13P4,chr13:50172089-50173181,1092
50361410,50361763,chr13,RPL34P26,chr13:50361410-50361763,353
58191517,58267894,chr10,IPMK,chr10:58191517-58267894,76377
50812988,50813106,chr13,RNA5SP28,chr13:50812988-50813106,118
3608240,3636250,chr17,SHPK,chr17:3608240-3636250,28010
99104038,99154192,chr9,TGFBR1,chr9:99104038-99154192,50154
50862172,50910764,chr13,RNASEH2B-AS1,chr13:50862172-50910764,48592
59574398,59615774,chr11,OSBP,chr11:59574398-59615774,41376
45055656,45056268,chr10,DUXAP4,chr10:45055656-45056268,612
37976825,37992467,chr10,ZNF25-DT,chr10:37976825-37992467,15642
100188300,100229596,chr10,CHUK,chr10:100188300-100229596,41296
5075678,5078113,chr17,ZFP3-DT,chr17:5075678-5078113,2435
16441577,16492193,chr17,LRRC75A,chr17:16441577-16492193,50616
16859412,16881987,chr7,AGR3,chr7:16859412-16881987,22575
48306223,48307152,chr11,OR4S1,chr11:48306223-48307152,929
3802158,3846246,chr17,NCBP3,chr17:3802158-3846246,44088
58266792,58268260,chr11,OR10W1,chr11:58266792-58268260,1468
55957216,55957630,chr11,OR10AK1P,chr11:55957216-55957630,414
58358124,58359069,chr11,OR5B17,chr11:58358124-58359069,945
56890613,56927885,chr11,FADS2B,chr11:56890613-56927885,37272
7689784,7695775,chr12,GDF3,chr12:7689784-7695775,5991
55004813,55005687,chr14,RPSAP13,chr14:55004813-55005687,874
11171194,11176016,chr12,SMIM10L1,chr12:11171194-11176016,4822
48216810,48217739,chr11,OR4B1,chr11:48216810-48217739,929
49570984,49599164,chr14,RPS29,chr14:49570984-49599164,28180
37170152,37175428,chr6,PIM1,chr6:37170152-37175428,5276
50909747,51024120,chr13,RNASEH2B,chr13:50909747-51024120,114373
15506866,15507354,chr17,PPIAP53,chr17:15506866-15507354,488
10212458,10223128,chr12,GABARAPL1,chr12:10212458-10223128,10670
30167804,30168004,chr7,RPS27P16,chr7:30167804-30168004,200
19127535,19159187,chr17,GRAPL,chr17:19127535-19159187,31652
17374867,17467256,chr7,LINC02888,chr7:17374867-17467256,92389
47164299,47177125,chr11,ARFGAP2,chr11:47164299-47177125,12826
36818959,36819690,chr7,NPM1P18,chr7:36818959-36819690,731
32580949,32761787,chr7,DPY19L1P1,chr7:32580949-32761787,180838
41247369,41249649,chr6,TREML5P,chr6:41247369-41249649,2280
89568144,89638749,chr6,LYRM2,chr6:89568144-89638749,70605
94683729,94736190,chr10,CYP2C18,chr10:94683729-94736190,52461
20415792,20416697,chr17,SRP68P3,chr17:20415792-20416697,905
23310209,23470491,chr7,IGF2BP3,chr7:23310209-23470491,160282
5105541,5123116,chr17,ZNF232,chr17:5105541-5123116,17575
69854131,70032366,chr14,SMOC1,chr14:69854131-70032366,178235
80271820,80289658,chr10,MAT1A,chr10:80271820-80289658,17838
20080232,20111877,chr22,DGCR8,chr22:20080232-20111877,31645
118082869,118083382,chr9,TPT1P9,chr9:118082869-118083382,513
97853226,97856717,chr9,FOXE1,chr9:97853226-97856717,3491
34790230,34795549,chr15,ACTC1,chr15:34790230-34795549,5319
84033772,84090881,chr6,MRAP2,chr6:84033772-84090881,57109
131852928,132079867,chr9,MED27,chr9:131852928-132079867,226939
5282265,5386340,chr17,RABEP1,chr17:5282265-5386340,104075
97766751,97771999,chr10,SFRP5,chr10:97766751-97771999,5248
12111163,12111489,chr12,PTMAP9,chr12:12111163-12111489,326
83161150,83193936,chr6,PGM3,chr6:83161150-83193936,32786
92046692,92291078,chr10,CPEB3,chr10:92046692-92291078,244386
10372353,10410146,chr12,KLRC4-KLRK1,chr12:10372353-10410146,37793
43989061,43990184,chr15,ACTBP7,chr15:43989061-43990184,1123
73478484,73558947,chr14,HEATR4,chr14:73478484-73558947,80463
19365766,19366044,chr22,RN7SL168P,chr22:19365766-19366044,278
59088701,59089039,chr10,RPLP1P10,chr10:59088701-59089039,338
50655967,50660472,chr10,BEND3P1,chr10:50655967-50660472,4505
19449911,19479202,chr22,UFD1,chr22:19449911-19479202,29291
92826831,93059493,chr10,EXOC6,chr10:92826831-93059493,232662
21278050,21278619,chr9,IFNA22P,chr9:21278050-21278619,569
124862130,124877733,chr9,ARPC5L,chr9:124862130-124877733,15603
25265924,25266290,chr7,TSEN15P3,chr7:25265924-25266290,366
24906135,24906594,chr7,SNRPCP19,chr7:24906135-24906594,459
20843627,20843961,chr7,RPS26P30,chr7:20843627-20843961,334
51489100,51730727,chr14,FRMD6,chr14:51489100-51730727,241627
38299811,38300322,chr7,TRGV10,chr7:38299811-38300322,511
19108375,19149290,chr9,PLIN2,chr9:19108375-19149290,40915
6931684,6939603,chr7,FAM86LP,chr7:6931684-6939603,7919
27328607,27329534,chr7,HNRNPA1P73,chr7:27328607-27329534,927
45157791,45186302,chr7,RAMP3,chr7:45157791-45186302,28511
22525899,22526937,chr17,MTND2P13,chr17:22525899-22526937,1038
6772831,6776116,chr17,PRAL,chr17:6772831-6776116,3285
20512560,20517479,chr17,KRT17P6,chr17:20512560-20517479,4919
27274107,27274477,chr17,RPL34P31,chr17:27274107-27274477,370
7968796,8094272,chr7,GLCCI1,chr7:7968796-8094272,125476
54706832,54707902,chr11,OR4A5,chr11:54706832-54707902,1070
19495385,19579034,chr17,SLC47A1,chr17:19495385-19579034,83649
124353465,124415444,chr9,PSMB7,chr9:124353465-124415444,61979
61959718,61967634,chr11,FTH1,chr11:61959718-61967634,7916
100584936,100599885,chrX,TNMD,chrX:100584936-100599885,14949
26533121,26538788,chr7,KIAA0087,chr7:26533121-26538788,5667
36597834,36600120,chr7,AOAH-IT1,chr7:36597834-36600120,2286
21900899,21945903,chr7,CDCA7L,chr7:21900899-21945903,45004
100627108,100639991,chrX,TSPAN6,chrX:100627108-100639991,12883
10226058,10329608,chr12,KLRD1,chr12:10226058-10329608,103550
136006537,136095289,chr9,NACC2,chr9:136006537-136095289,88752
58512872,58831435,chr10,BICC1,chr10:58512872-58831435,318563
134317098,134440585,chr9,RXRA,chr9:134317098-134440585,123487
62123998,62153169,chr11,INCENP,chr11:62123998-62153169,29171
19479457,19520612,chr22,CDC45,chr22:19479457-19520612,41155
73237497,73274640,chr14,PAPLN,chr14:73237497-73274640,37143
63902451,63903245,chr10,RPL7AP50,chr10:63902451-63903245,794
71964395,72013558,chr10,CHST3,chr10:71964395-72013558,49163
100800303,100800784,chrX,PPIAP89,chrX:100800303-100800784,481
27294076,27315926,chr17,WSB1,chr17:27294076-27315926,21850
100801188,100803060,chrX,RAD21P1,chrX:100801188-100803060,1872
97713173,97718150,chr10,MARVELD1,chr10:97713173-97718150,4977
57068914,57069685,chrX,SPIN2P1,chrX:57068914-57069685,771
50649641,50649740,chrX,RNU6-935P,chrX:50649641-50649740,99
42149310,42149549,chr10,KSR1P1,chr10:42149310-42149549,239
75089248,75089725,chr10,PPIAP13,chr10:75089248-75089725,477
35697300,35698037,chr10,RPL7P37,chr10:35697300-35698037,737
100248271,100249095,chr10,PHBP9,chr10:100248271-100249095,824
130494965,130496588,chrX,DENND10P1,chrX:130494965-130496588,1623
102830531,102837472,chr10,CYP17A1,chr10:102830531-102837472,6941
130645723,130646325,chrX,SPRING1P2,chrX:130645723-130646325,602
130981590,131058146,chrX,LINC01201,chrX:130981590-131058146,76556
38358512,38359162,chr7,TRGV3,chr7:38358512-38359162,650
27461766,27462969,chr7,PSMC1P2,chr7:27461766-27462969,1203
131058346,131089885,chrX,ARHGAP36,chrX:131058346-131089885,31539
10604193,10613609,chr12,MAGOHB,chr12:10604193-10613609,9416
25780032,25844585,chr9,LINC01241,chr9:25780032-25844585,64553
48171458,48647497,chr7,ABCA13,chr7:48171458-48647497,476039
125747345,125967377,chr9,PBX3,chr9:125747345-125967377,220032
20119684,20120632,chr11,NAV2-AS1,chr11:20119684-20120632,948
35997226,35997675,chr11,RPL12P31,chr11:35997226-35997675,449
36483769,36510272,chr11,TRAF6,chr11:36483769-36510272,26503
11512723,11514136,chr12,DDX55P1,chr12:11512723-11514136,1413
9347056,9400387,chr12,LINC02367,chr12:9347056-9400387,53331
92216332,92216793,chr10,NHP2P1,chr10:92216332-92216793,461
37818606,37820982,chr10,TLK2P2,chr10:37818606-37820982,2376
8427640,8428610,chr12,OR7E148P,chr12:8427640-8428610,970
36296288,36465204,chr11,PRR5L,chr11:36296288-36465204,168916
131134086,131134390,chrX,RN7SL191P,chrX:131134086-131134390,304
102173100,102185021,chrX,TCP11X3P,chrX:102173100-102185021,11921
103967140,104029233,chr10,SLK,chr10:103967140-104029233,62093
102215301,102229532,chrX,TCP11X1,chrX:102215301-102229532,14231
16399274,16402406,chr12,SUPT16HP1,chr12:16399274-16402406,3132
14567393,14624191,chr12,PLBD1-AS1,chr12:14567393-14624191,56798
21614118,21615051,chr15,OR4H6BP,chr15:21614118-21615051,933
102247167,102326722,chrX,NXF2,chrX:102247167-102326722,79555
44288719,44415758,chr15,GOLM2,chr15:44288719-44415758,127039
57086844,57170305,chr6,ZNF451,chr6:57086844-57170305,83461
7604350,7605214,chr12,NIFKP3,chr12:7604350-7605214,864
9594551,9607916,chr12,KLRB1,chr12:9594551-9607916,13365
17981192,17981572,chr17,BRI3P3,chr17:17981192-17981572,380
36269284,36289449,chr11,COMMD9,chr11:36269284-36289449,20165
102360396,102439932,chrX,NXF2B,chrX:102360396-102439932,79536
17505563,17591708,chr17,PEMT,chr17:17505563-17591708,86145
10158301,10172138,chr12,OLR1,chr12:10158301-10172138,13837
136206333,136245812,chr9,QSOX2,chr9:136206333-136245812,39479
102456862,102471842,chrX,TCP11X2,chrX:102456862-102471842,14980
62242239,62244812,chr11,SCGB1D2,chr11:62242239-62244812,2573
50298579,50304656,chr11,LINC02750,chr11:50298579-50304656,6077
102513682,102516739,chrX,TMSB15A,chrX:102513682-102516739,3057
101176306,101194147,chr10,LINC01514,chr10:101176306-101194147,17841
79177200,79177668,chrX,CTHRC1P1,chrX:79177200-79177668,468
22480439,22484840,chr15,HERC2P7,chr15:22480439-22484840,4401
58579063,58621550,chr11,ZFP91,chr11:58579063-58621550,42487
15464246,15556529,chrX,BMX,chrX:15464246-15556529,92283
42575606,42720998,chr15,STARD9,chr15:42575606-42720998,145392
100105754,100140151,chr10,CYP2C23P,chr10:100105754-100140151,34397
135479079,135488893,chr9,PPP1R26,chr9:135479079-135488893,9814
102838011,102845473,chr10,PFN1P11,chr10:102838011-102845473,7462
45099487,45154606,chr10,RSU1P2,chr10:45099487-45154606,55119
54682877,54683821,chr11,OR4A8,chr11:54682877-54683821,944
8509475,8522366,chr12,CLEC4D,chr12:8509475-8522366,12891
135343249,135346562,chr9,LINC02907,chr9:135343249-135346562,3313
63634317,63634827,chr10,MRPL35P2,chr10:63634317-63634827,510
34430880,34431649,chr11,CIR1P3,chr11:34430880-34431649,769
96620877,96621707,chr10,RPS2P36,chr10:96620877-96621707,830
19212642,19722926,chr20,SLC24A3,chr20:19212642-19722926,510284
100347233,100364826,chr10,SCD,chr10:100347233-100364826,17593
58640426,58731974,chr11,GLYAT,chr11:58640426-58731974,91548
125437393,125707234,chr9,MAPKAP1,chr9:125437393-125707234,269841
19242302,19284596,chr20,SLC24A3-AS1,chr20:19242302-19284596,42294
99737693,99942060,chr14,EML1,chr14:99737693-99942060,204367
43900874,43912369,chr10,LINC02659,chr10:43900874-43912369,11495
22030900,22031846,chr15,OR11K1P,chr15:22030900-22031846,946
59964033,59970146,chr11,OOSP4A,chr11:59964033-59970146,6113
100114417,100115223,chr10,TPM4P1,chr10:100114417-100115223,806
3367833,3371346,chr12,LINC02417,chr12:3367833-3371346,3513
64620374,64620922,chr10,RPL17P35,chr10:64620374-64620922,548
17121716,17122460,chr12,RPL7P40,chr12:17121716-17122460,744
15602881,15621484,chrX,GS1-594A7.3,chrX:15602881-15621484,18603
34335118,34336003,chr11,MMADHCP2,chr11:34335118-34336003,885
40685848,40689236,chr20,MAFB,chr20:40685848-40689236,3388
97584323,97612802,chr10,HOGA1,chr10:97584323-97612802,28479
8133772,8134849,chr12,POU5F1P3,chr12:8133772-8134849,1077
48823741,48963919,chr15,SHC4,chr15:48823741-48963919,140178
19274540,19275269,chr11,PCNAP4,chr11:19274540-19275269,729
15674932,15703724,chrX,CA5BP1,chrX:15674932-15703724,28792
33076149,33079454,chr11,LINC00294,chr11:33076149-33079454,3305
19565203,19566839,chr22,LINC00895,chr22:19565203-19566839,1636
55262155,55271114,chr11,TRIM48,chr11:55262155-55271114,8959
10699089,10723323,chr12,YBX3,chr12:10699089-10723323,24234
40854119,40854229,chr20,RNA5SP484,chr20:40854119-40854229,110
41331123,41331660,chr20,ADI1P1,chr20:41331123-41331660,537
20589293,20590367,chr17,MEIS3P2,chr17:20589293-20590367,1074
41340821,41360582,chr20,LPIN3,chr20:41340821-41360582,19761
3977103,3981899,chr17,LINC01975,chr17:3977103-3981899,4796
19603274,19603345,chr17,NMTRQ-TTG12-1,chr17:19603274-19603345,71
19714503,19724224,chr22,SEPTIN5,chr22:19714503-19724224,9721
22846922,22860474,chr11,CCDC179,chr11:22846922-22860474,13552
6643311,6651634,chr17,MED31,chr17:6643311-6651634,8323
15688830,15788411,chrX,CA5B,chrX:15688830-15788411,99581
59741325,59742049,chr11,OR10V3P,chr11:59741325-59742049,724
97589721,97590934,chr10,C10orf62,chr10:97589721-97590934,1213
6318946,6320532,chr11,CAVIN3,chr11:6318946-6320532,1586
101354033,101557321,chr10,BTRC,chr10:101354033-101557321,203288
86214237,86214576,chr6,NDUFA5P9,chr6:86214237-86214576,339
57946074,57961501,chr6,LINC00680,chr6:57946074-57961501,15427
5469092,5470360,chr17,DHX33-DT,chr17:5469092-5470360,1268
4301372,4302698,chr17,MFSD1P1,chr17:4301372-4302698,1326
20387558,20509338,chr11,PRMT3,chr11:20387558-20509338,121780
19557211,19557911,chr17,SNORA59B,chr17:19557211-19557911,700
28299321,28825894,chr7,CREB5,chr7:28299321-28825894,526573
15785716,15787589,chrX,INE2,chrX:15785716-15787589,1873
15825806,15854931,chrX,AP1S2,chrX:15825806-15854931,29125
18260597,18266552,chr17,MIEF2,chr17:18260597-18266552,5955
52765280,52778347,chr6,GSTA12P,chr6:52765280-52778347,13067
34417454,34426069,chr6,RPS10,chr6:34417454-34426069,8615
41359962,41366818,chr20,EMILIN3,chr20:41359962-41366818,6856
15151923,15155283,chr12,RERG-AS1,chr12:15151923-15155283,3360
8359054,8359834,chr12,RPS3AP43,chr12:8359054-8359834,780
22283730,22338245,chr11,SLC17A6-DT,chr11:22283730-22338245,54515
41402083,41618384,chr20,CHD6,chr20:41402083-41618384,216301
16989126,16989936,chr12,SKP1P2,chr12:16989126-16989936,810
55903341,55904278,chr11,OR5W1P,chr11:55903341-55904278,937
11021619,11022620,chr12,TAS2R19,chr12:11021619-11022620,1001
42491233,42545356,chr15,SNAP23,chr15:42491233-42545356,54123
46602861,46617909,chr11,HARBI1,chr11:46602861-46617909,15048
58291826,58292765,chr11,OR10Q2P,chr11:58291826-58292765,939
55935456,55936400,chr11,OR5I1,chr11:55935456-55936400,944
15916189,15916303,chrX,RNU5F-7P,chrX:15916189-15916303,114
55913650,55914582,chr11,OR5W2,chr11:55913650-55914582,932
15917548,15918631,chrX,SETP15,chrX:15917548-15918631,1083
20999596,21043760,chr17,USP22,chr17:20999596-21043760,44164
55000363,55009057,chrX,APEX2,chrX:55000363-55009057,8694
57919784,57930291,chr6,GUSBP4,chr6:57919784-57930291,10507
52739590,52744656,chr6,GSTA7P,chr6:52739590-52744656,5066
43358920,43494933,chr11,TTC17,chr11:43358920-43494933,136013
100050372,100051236,chr6,NPM1P38,chr6:100050372-100051236,864
15322257,15602175,chr12,PTPRO,chr12:15322257-15602175,279918
34346512,34871582,chr7,NPSR1-AS1,chr7:34346512-34871582,525070
96304409,96338564,chr10,DNTT,chr10:96304409-96338564,34155
118850688,119061247,chr4,SYNPO2,chr4:118850688-119061247,210559
105993463,106109939,chr6,PRDM1,chr6:105993463-106109939,116476
63542369,63569329,chr18,SERPINB12,chr18:63542369-63569329,26960
55009055,55030977,chrX,ALAS2,chrX:55009055-55030977,21922
20582072,20583206,chr7,EEF1A1P27,chr7:20582072-20583206,1134
43112629,43566001,chr7,HECW1,chr7:43112629-43566001,453372
67506587,67516720,chr18,DSEL,chr18:67506587-67516720,10133
136107808,136109424,chr9,LINC02846,chr9:136107808-136109424,1616
74654956,74656131,chr10,POLR3DP1,chr10:74654956-74656131,1175
31505280,31505943,chr9,MTATP6P30,chr9:31505280-31505943,663
108848186,108849561,chr10,MAPKAPK5P1,chr10:108848186-108849561,1375
36432882,36434484,chr10,MTND5P17,chr10:36432882-36434484,1602
98199011,98255649,chr9,TBC1D2,chr9:98199011-98255649,56638
12400412,12400473,chr18,RNU7-129P,chr18:12400412-12400473,61
41547422,41547922,chr20,RPL12P11,chr20:41547422-41547922,500
41684986,41685091,chr20,RNU6-1018P,chr20:41684986-41685091,105
95237572,95291012,chr10,PDLIM1,chr10:95237572-95291012,53440
12407896,12432238,chr18,PRELID3A,chr18:12407896-12432238,24342
19723539,19724771,chr22,GP1BB,chr22:19723539-19724771,1232
45252239,45254564,chr20,SLPI,chr20:45252239-45254564,2325
19783223,19854939,chr22,GNB1L,chr22:19783223-19854939,71716
107203349,107203924,chr4,RAC1P5,chr4:107203349-107203924,575
124062462,124062990,chr4,PPIAP76,chr4:124062462-124062990,528
82284971,82340013,chr4,VAMP9P,chr4:82284971-82340013,55042
19602259,19603208,chr17,MTND1P14,chr17:19602259-19603208,949
70430492,70482997,chr4,MUC7,chr4:70430492-70482997,52505
45469753,45481532,chr20,WFDC2,chr20:45469753-45481532,11779
117473215,117545068,chr10,EMX2OS,chr10:117473215-117545068,71853
17972813,18016889,chr17,DRC3,chr17:17972813-18016889,44076
62337448,62393412,chr11,ASRGL1,chr11:62337448-62393412,55964
18001786,18010562,chr10,SLC39A12-AS1,chr10:18001786-18010562,8776
55054945,55055838,chrX,HDGFL3P1,chrX:55054945-55055838,893
55075030,55078909,chrX,PAGE2B,chrX:55075030-55078909,3879
116409256,116409475,chr10,SNRPGP6,chr10:116409256-116409475,219
118280038,118353003,chr4,PRSS12,chr4:118280038-118353003,72965
55089018,55092842,chrX,PAGE2,chrX:55089018-55092842,3824
34279679,34392669,chr6,NUDT3,chr6:34279679-34392669,112990
45490818,45491671,chr20,RPL5P2,chr20:45490818-45491671,853
134078904,134079444,chr9,ARF4P1,chr9:134078904-134079444,540
45512461,45515622,chr20,SPINT3,chr20:45512461-45515622,3161
122798389,122828588,chr9,PDCL,chr9:122798389-122828588,30199
15211643,15371289,chr10,FAM171A1,chr10:15211643-15371289,159646
45534196,45539482,chr20,WFDC6,chr20:45534196-45539482,5286
45573346,45576770,chr6,RUNX2-AS1,chr6:45573346-45576770,3424
55178207,55178737,chrX,MTCO1P52,chrX:55178207-55178737,530
55179194,55179999,chrX,MTND2P24,chrX:55179194-55179999,805
55180377,55181277,chrX,MTND1P30,chrX:55180377-55181277,900
52361421,52407777,chr6,PAQR8,chr6:52361421-52407777,46356
55181392,55182442,chrX,MTRNR2L10,chrX:55181392-55182442,1050
19846138,19854896,chr22,RTL10,chr22:19846138-19854896,8758
27888838,27891033,chr11,HSP90AA2P,chr11:27888838-27891033,2195
45534196,45547662,chr20,EPPIN-WFDC6,chr20:45534196-45547662,13466
58242043,58243097,chr11,EIF4A2P3,chr11:58242043-58243097,1054
52146814,52151119,chr6,LINCMD1,chr6:52146814-52151119,4305
108097432,108097851,chr9,CHCHD4P2,chr9:108097432-108097851,419
49499923,49528078,chr6,GLYATL3,chr6:49499923-49528078,28155
56593004,56595681,chr4,GLDCP1,chr4:56593004-56595681,2677
133514586,133528612,chr9,MYMK,chr9:133514586-133528612,14026
154348524,154374634,chrX,FLNA,chrX:154348524-154374634,26110
114827763,115113876,chr4,NDST4,chr4:114827763-115113876,286113
112380080,112472405,chr9,HSDL2,chr9:112380080-112472405,92325
40334775,40387590,chr6,TDRG1,chr6:40334775-40387590,52815
20198729,20204918,chr22,LINC02891,chr22:20198729-20204918,6189
45539983,45540227,chr20,HSPD1P21,chr20:45539983-45540227,244
38010650,38065088,chr10,ZNF33A,chr10:38010650-38065088,54438
31509755,31790324,chr11,ELP4,chr11:31509755-31790324,280569
20206397,20208524,chr22,LINC00896,chr22:20206397-20208524,2127
45540626,45547752,chr20,EPPIN,chr20:45540626-45547752,7126
20241415,20283246,chr22,RTN4R,chr22:20241415-20283246,41831
36389821,36453791,chr7,ANLN,chr7:36389821-36453791,63970
103912288,103928269,chr14,ATP5MJ,chr14:103912288-103928269,15981
79902420,79951657,chr18,SLC66A2,chr18:79902420-79951657,49237
73695785,73828316,chr6,CD109,chr6:73695785-73828316,132531
20249134,20249211,chr22,MIR1286,chr22:20249134-20249211,77
45559758,45559876,chr20,RNA5SP485,chr20:45559758-45559876,118
45745737,45746287,chr20,HNRNPA1P3,chr20:45745737-45746287,550
20314238,20320080,chr22,DGCR6L,chr22:20314238-20320080,5842
38420662,38523180,chr4,LINC01258,chr4:38420662-38523180,102518
45747944,45791932,chr20,WFDC3,chr20:45747944-45791932,43988
106836498,106837601,chr4,ACTR6P1,chr4:106836498-106837601,1103
116425983,116430892,chr4,CUL4AP1,chr4:116425983-116430892,4909
115019575,115118257,chr9,TNC,chr9:115019575-115118257,98682
114713579,114714920,chr4,CIR1P2,chr4:114713579-114714920,1341
126106139,126106923,chr4,H3P15,chr4:126106139-126106923,784
19875517,19941820,chr22,TXNRD2,chr22:19875517-19941820,66303
44970981,44978809,chr10,DEPP1,chr10:44970981-44978809,7828
124435750,124437120,chr4,TUBAP10,chr4:124435750-124437120,1370
89786610,89787107,chr10,MTND5P42,chr10:89786610-89787107,497
97614553,97633500,chr10,MORN4,chr10:97614553-97633500,18947
40191053,40246967,chr4,RHOH,chr4:40191053-40246967,55914
102080742,102139699,chr14,HSP90AA1,chr14:102080742-102139699,58957
17776686,17779529,chr17,SMCR5,chr17:17776686-17779529,2843
31058840,31102522,chr18,DSC2,chr18:31058840-31102522,43682
59659146,59689534,chr15,BNIP2,chr15:59659146-59689534,30388
105686322,105687051,chr10,YWHAZP5,chr10:105686322-105687051,729
104235356,104267459,chr10,GSTO1,chr10:104235356-104267459,32103
18244815,18258738,chr17,FLII,chr17:18244815-18258738,13923
45749920,45750074,chr20,SPINT5P,chr20:45749920-45750074,154
45778698,45778823,chr20,RNU6ATAC38P,chr20:45778698-45778823,125
45791954,45811427,chr20,DNTTIP1,chr20:45791954-45811427,19473
49850421,50121329,chr7,ZPBP,chr7:49850421-50121329,270908
84124241,84227643,chr6,CEP162,chr6:84124241-84227643,103402
97319271,97321915,chr10,FRAT1,chr10:97319271-97321915,2644
85378327,85432775,chr10,LINC02647,chr10:85378327-85432775,54448
36434710,36435174,chr10,MTND4P18,chr10:36434710-36435174,464
23630115,23645639,chr14,DHRS2,chr14:23630115-23645639,15524
100273280,100286680,chr10,BLOC1S2,chr10:100273280-100286680,13400
30134986,30162762,chr7,MTURN,chr7:30134986-30162762,27776
28279211,28279700,chr7,PPIAP80,chr7:28279211-28279700,489
128061286,128222931,chr4,LARP1B,chr4:128061286-128222931,161645
47774219,47846266,chr15,LINC01491,chr15:47774219-47846266,72047
33904308,34156427,chr7,BMPER,chr7:33904308-34156427,252119
45812576,45816957,chr20,UBE2C,chr20:45812576-45816957,4381
118643760,118644198,chr10,TOMM22P5,chr10:118643760-118644198,438
45073146,45073541,chr10,RPS19P7,chr10:45073146-45073541,395
97498924,97571206,chr10,UBTD1,chr10:97498924-97571206,72282
63276018,63309126,chr15,APH1B,chr15:63276018-63309126,33108
99396870,99430624,chr10,GOT1,chr10:99396870-99430624,33754
84421028,84556152,chr6,LINC01611,chr6:84421028-84556152,135124
8486997,8513849,chr18,THEMIS3P,chr18:8486997-8513849,26852
74476192,74494177,chr14,NPC2,chr14:74476192-74494177,17985
8545635,8546817,chr18,AKR1B1P6,chr18:8545635-8546817,1182
44342650,44380179,chr6,SPATS1,chr6:44342650-44380179,37529
8609437,8639383,chr18,RAB12,chr18:8609437-8639383,29946
34150987,34358010,chr11,ABTB2,chr11:34150987-34358010,207023
75233641,75236030,chr10,COMTD1,chr10:75233641-75236030,2389
57544377,57586732,chr18,FECH,chr18:57544377-57586732,42355
97677424,97687241,chr10,AVPI1,chr10:97677424-97687241,9817
34576258,34576656,chr6,IFITM3P3,chr6:34576258-34576656,398
41714534,41857733,chr11,LINC01499,chr11:41714534-41857733,143199
99702558,99756134,chr10,CUTC,chr10:99702558-99756134,53576
39329990,39725408,chr6,KIF6,chr6:39329990-39725408,395418
62049863,62082184,chr11,LINC02733,chr11:62049863-62082184,32321
62169293,62169828,chr11,EEF1DP8,chr11:62169293-62169828,535
59712916,59713845,chr11,OR10V1,chr11:59712916-59713845,929
134649385,134653073,chr9,COL5A1-AS1,chr9:134649385-134653073,3688
38646451,38686323,chr11,LINC01493,chr11:38646451-38686323,39872
43870761,44195271,chr15,FRMD5,chr15:43870761-44195271,324510
113444731,113597743,chr9,RGS3,chr9:113444731-113597743,153012
46677080,46700619,chr11,ARHGAP1,chr11:46677080-46700619,23539
45823214,45833745,chr20,TNNC2,chr20:45823214-45833745,10531
47275154,47582558,chr7,TNS3,chr7:47275154-47582558,307404
97356358,97426076,chr10,RRP12,chr10:97356358-97426076,69718
77717599,77761207,chr14,SNW1,chr14:77717599-77761207,43608
45881227,45885266,chr20,ZSWIM1,chr20:45881227-45885266,4039
49038357,49038602,chr20,SNAP23P1,chr20:49038357-49038602,245
49040463,49046168,chr20,CSE1L-AS1,chr20:49040463-49046168,5705
49046246,49096960,chr20,CSE1L,chr20:49046246-49096960,50714
33015876,33033582,chr11,DEPDC7,chr11:33015876-33033582,17706
34466061,34535229,chr6,PACSIN1,chr6:34466061-34535229,69168
31343368,31426988,chr18,DSG1-AS1,chr18:31343368-31426988,83620
109560209,109688719,chr4,MCUB,chr4:109560209-109688719,128510
19166896,19169668,chr17,KYNUP1,chr17:19166896-19169668,2772
20491323,20491443,chr17,YWHAEP3,chr17:20491323-20491443,120
31498177,31549008,chr18,DSG2,chr18:31498177-31549008,50831
18183078,18209954,chr17,ALKBH5,chr17:18183078-18209954,26876
15768717,15771426,chr17,ZSWIM5P1,chr17:15768717-15771426,2709
20321164,20403557,chr17,CCDC144CP,chr17:20321164-20403557,82393
126064128,126073370,chr4,LINC02379,chr4:126064128-126073370,9242
13844862,13870616,chr11,LINC02545,chr11:13844862-13870616,25754
59878809,59896481,chr11,OOSP3,chr11:59878809-59896481,17672
130503357,130504344,chr4,GAPDHP56,chr4:130503357-130504344,987
59636716,59669037,chr11,PATL1,chr11:59636716-59669037,32321
136355110,136356336,chr4,TERF1P3,chr4:136355110-136356336,1226
21376357,21419870,chr17,KCNJ12,chr17:21376357-21419870,43513
130376229,130432227,chr4,LINC02479,chr4:130376229-130432227,55998
36594353,36605600,chr6,SRSF3,chr6:36594353-36605600,11247
108650585,108667820,chr4,OSTC,chr4:108650585-108667820,17235
38239580,38249572,chr7,TRGC2,chr7:38239580-38249572,9992
22406019,22413744,chr17,FLJ36000,chr17:22406019-22413744,7725
27733064,27740395,chr7,TAX1BP1-AS1,chr7:27733064-27740395,7331
38269491,38269540,chr7,TRGJ1,chr7:38269491-38269540,49
6390440,6394998,chr11,SMPD1,chr11:6390440-6394998,4558
27928924,27991787,chr17,LINC01992,chr17:27928924-27991787,62863
49113339,49188367,chr20,STAU1,chr20:49113339-49188367,75028
34658218,34878332,chr7,NPSR1,chr7:34658218-34878332,220114
48986275,49062081,chr4,CWH43,chr4:48986275-49062081,75806
44924324,45042322,chr14,KLHL28,chr14:44924324-45042322,117998
22044476,22045400,chr15,OR4Q1P,chr15:22044476-22045400,924
75291859,75493800,chr6,FILIP1,chr6:75291859-75493800,201941
56244009,56445997,chr15,TEX9,chr15:56244009-56445997,201988
18087892,18107970,chr17,DRG2,chr17:18087892-18107970,20078
7649400,7665908,chr12,APOBEC1,chr12:7649400-7665908,16508
96794125,96837477,chr6,GPR63,chr6:96794125-96837477,43352
102922663,102933596,chr14,AMN,chr14:102922663-102933596,10933
105302453,105302823,chr6,RPL35P3,chr6:105302453-105302823,370
34263311,34263673,chr6,RPL35P2,chr6:34263311-34263673,362
100136064,100136663,chr6,PRDX2P4,chr6:100136064-100136663,599
52671113,52686588,chr6,TMEM14A,chr6:52671113-52686588,15475
23134564,23260470,chr18,CABLES1,chr18:23134564-23260470,125906
69705287,69706160,chr6,NPM1P37,chr6:69705287-69706160,873
15627318,15675012,chrX,CLTRN,chrX:15627318-15675012,47694
41267926,41286682,chr6,TREM1,chr6:41267926-41286682,18756
10116777,10130258,chr12,CLEC7A,chr12:10116777-10130258,13481
59852800,59866489,chr11,TCN1,chr11:59852800-59866489,13689
154389955,154409168,chrX,RPL10,chrX:154389955-154409168,19213
104924713,104937761,chr14,PLD4,chr14:104924713-104937761,13048
89926528,90296908,chr6,BACH2,chr6:89926528-90296908,370380
98025390,98026240,chr4,RPL5P12,chr4:98025390-98026240,850
14643804,14872044,chr11,PDE3B,chr11:14643804-14872044,228240
94195940,94196513,chr4,HMGB3P15,chr4:94195940-94196513,573
109555170,109555732,chr4,CDC42P4,chr4:109555170-109555732,562
124462863,124463790,chr4,TECRP2,chr4:124462863-124463790,927
118033618,118258634,chr4,NDST3,chr4:118033618-118258634,225016
38276259,38276318,chr7,TRGJP1,chr7:38276259-38276318,59
57591908,57714745,chr15,GCOM1,chr15:57591908-57714745,122837
56559221,56559958,chr7,VN1R25P,chr7:56559221-56559958,737
63367427,63368156,chr7,VN1R31P,chr7:63367427-63368156,729
38353715,38354517,chr7,TRGV4,chr7:38353715-38354517,802
30697985,30757602,chr7,INMT,chr7:30697985-30757602,59617
11609596,11610612,chr18,SLC35G4,chr18:11609596-11610612,1016
46549580,46652830,chr6,CYP39A1,chr6:46549580-46652830,103250
31622246,31685836,chr18,B4GALT6,chr18:31622246-31685836,63590
70044215,70189070,chr14,SLC8A3,chr14:70044215-70189070,144855
30390885,30412375,chr7,LINC01176,chr7:30390885-30412375,21490
50089879,50161690,chr22,MOV10L1,chr22:50089879-50161690,71811
53374149,53422728,chrX,SMC1A,chrX:53374149-53422728,48579
43117896,43163187,chr7,HECW1-IT1,chr7:43117896-43163187,45291
118722823,118838683,chr4,SEC24D,chr4:118722823-118838683,115860
29199540,29208970,chr7,CHN2-AS1,chr7:29199540-29208970,9430
51600286,51600573,chr7,ROBO2P1,chr7:51600286-51600573,287
47655244,47661648,chr7,LINC02902,chr7:47655244-47661648,6404
33039417,33105943,chr11,TCP11L1,chr11:33039417-33105943,66526
11548030,11590369,chr12,LINC01252,chr12:11548030-11590369,42339
45574140,45723116,chr7,ADCY1,chr7:45574140-45723116,148976
135973841,136047269,chrX,SLC9A6,chrX:135973841-136047269,73428
10929236,10934845,chr12,PRH2,chr12:10929236-10934845,5609
108618000,108618285,chr6,SUMO2P8,chr6:108618000-108618285,285
79307669,79313384,chr6,LCAL1,chr6:79307669-79313384,5715
53235621,53236297,chr6,HMGB1P20,chr6:53235621-53236297,676
68226972,68329899,chr6,LINC02549,chr6:68226972-68329899,102927
12326056,12350242,chr12,MANSC1,chr12:12326056-12350242,24186
51695486,51699595,chr10,CSTF2T,chr10:51695486-51699595,4109
47032527,47035621,chr18,ELOA2,chr18:47032527-47035621,3094
13044381,13142521,chr12,FAM234B,chr12:13044381-13142521,98140
64762883,64763172,chr10,CYP2C61P,chr10:64762883-64763172,289
91163012,91284337,chr10,PCGF5,chr10:91163012-91284337,121325
49134480,49135012,chr20,ARPC3P1,chr20:49134480-49135012,532
49488453,49492508,chr18,RPL17,chr18:49488453-49492508,4055
23154683,23203161,chr11,LINC02718,chr11:23154683-23203161,48478
38253380,38253429,chr7,TRGJ2,chr7:38253380-38253429,49
62642503,62685785,chr20,SLCO4A1,chr20:62642503-62685785,43282
60056587,60071115,chr11,MS4A3,chr11:60056587-60071115,14528
89642498,89819794,chr6,MDN1,chr6:89642498-89819794,177296
38317017,38318861,chr7,TRGV9,chr7:38317017-38318861,1844
22524738,22525686,chr17,MTND1P15,chr17:22524738-22525686,948
16840895,16845881,chr17,KRT17P1,chr17:16840895-16845881,4986
63401385,63402271,chr7,VN1R33P,chr7:63401385-63402271,886
54656358,54656734,chr7,RPL31P35,chr7:54656358-54656734,376
97222173,97292673,chr10,ARHGAP19,chr10:97222173-97292673,70500
38345030,38345499,chr7,TRGV5P,chr7:38345030-38345499,469
38362864,38363518,chr7,TRGV2,chr7:38362864-38363518,654
20519312,20528687,chr17,KRT17P7,chr17:20519312-20528687,9375
50994511,51080862,chr13,GUCY1B2,chr13:50994511-51080862,86351
49773638,49921950,chr7,VWC2,chr7:49773638-49921950,148312
3839459,3842525,chr12,OTUD4P1,chr12:3839459-3842525,3066
11030387,11031407,chr12,TAS2R31,chr12:11030387-11031407,1020
64180006,64180892,chr7,VN1R38P,chr7:64180006-64180892,886
10111738,10112471,chr12,HNRNPABP1,chr12:10111738-10112471,733
15976560,15999717,chr17,ZSWIM7,chr17:15976560-15999717,23157
8295986,8396803,chr12,LINC00937,chr12:8295986-8396803,100817
53187388,53188938,chr7,HAUS6P1,chr7:53187388-53188938,1550
59728519,59729492,chr11,OR10Y1P,chr11:59728519-59729492,973
36997796,37013630,chr7,ELMO1-AS1,chr7:36997796-37013630,15834
62663019,62666724,chr20,SLCO4A1-AS1,chr20:62663019-62666724,3705
29335878,29989328,chr11,LINC02755,chr11:29335878-29989328,653450
8742428,8743072,chr12,RPSAP51,chr12:8742428-8743072,644
62695024,62700480,chr20,LINC00686,chr20:62695024-62700480,5456
983181,989640,chr7,CYP2W1,chr7:983181-989640,6459
8221260,8227618,chr12,FAM90A1,chr12:8221260-8227618,6358
62708836,62762771,chr20,NTSR1,chr20:62708836-62762771,53935
65066300,65084164,chr11,CDCA5,chr11:65066300-65084164,17864
19954490,19957996,chr14,OR4K16P,chr14:19954490-19957996,3506
20043916,20044827,chr14,OR4U1P,chr14:20043916-20044827,911
62796473,62801729,chr20,MRGBP,chr20:62796473-62801729,5256
20060045,20060983,chr14,OR4L1,chr14:20060045-20060983,938
20090130,20090227,chr14,RNA5SP380,chr14:20090130-20090227,97
20093353,20094263,chr14,OR4T1P,chr14:20093353-20094263,910
20149232,20149745,chr14,PSMB7P1,chr14:20149232-20149745,513
20173632,20173813,chr14,GTF2IP22,chr14:20173632-20173813,181
20179189,20180156,chr14,OR11G1P,chr14:20179189-20180156,967
20183925,20184298,chr14,OR11P1P,chr14:20183925-20184298,373
20204606,20210498,chr14,OR11H5P,chr14:20204606-20210498,5892
11391540,11501041,chr12,PRB2,chr12:11391540-11501041,109501
62800627,62805587,chr20,OGFR-AS1,chr20:62800627-62805587,4960
101570560,101609662,chr10,DPCD,chr10:101570560-101609662,39102
20223710,20224702,chr14,OR11H6,chr14:20223710-20224702,992
126563509,126564776,chr4,RBM48P1,chr4:126563509-126564776,1267
20229402,20230346,chr14,OR11H7,chr14:20229402-20230346,944
62804835,62814000,chr20,OGFR,chr20:62804835-62814000,9165
37905932,38025695,chr7,SFRP4,chr7:37905932-38025695,119763
135112905,135123779,chr4,LINC02485,chr4:135112905-135123779,10874
20256558,20305960,chr14,TTC5,chr14:20256558-20305960,49402
58579172,58624639,chr11,ZFP91-CNTF,chr11:58579172-58624639,45467
8227734,8231764,chr12,ALG1L10P,chr12:8227734-8231764,4030
127880893,127899224,chr4,PLK4,chr4:127880893-127899224,18331
77176760,77178180,chr9,VPS13A-AS1,chr9:77176760-77178180,1420
10358464,10361045,chr12,LINC02598,chr12:10358464-10361045,2581
37725666,37726456,chr11,RPL7AP56,chr11:37725666-37726456,790
129712896,129718635,chr9,PRRX2-AS1,chr9:129712896-129718635,5739
74485551,74499127,chr9,RORB-AS1,chr9:74485551-74499127,13576
8822621,8887001,chr12,A2ML1,chr12:8822621-8887001,64380
62433542,62556235,chr11,AHNAK,chr11:62433542-62556235,122693
91563091,91950228,chr9,ROR2,chr9:91563091-91950228,387137
45100100,45112047,chr7,TBRG4,chr7:45100100-45112047,11947
62816244,62841159,chr20,COL9A3,chr20:62816244-62841159,24915
82169986,82247754,chr6,IBTK,chr6:82169986-82247754,77768
101578882,101588270,chr10,POLL,chr10:101578882-101588270,9388
20311368,20333312,chr14,CCNB1IP1,chr14:20311368-20333312,21944
40114203,41459773,chr11,LRRC4C,chr11:40114203-41459773,1345570
83739425,83829516,chr9,GKAP1,chr9:83739425-83829516,90091
112780718,112780788,chrX,MIR4329,chrX:112780718-112780788,70
112855874,112856162,chrX,RN7SL266P,chrX:112855874-112856162,288
61950063,61965515,chr11,BEST1,chr11:61950063-61965515,15452
154622428,154623500,chrX,ATF4P1,chrX:154622428-154623500,1072
154632470,154633182,chrX,FAM223B,chrX:154632470-154633182,712
6393693,6435199,chr17,AIPL1,chr17:6393693-6435199,41506
154639978,154648275,chrX,IKBKGP1,chrX:154639978-154648275,8297
154658741,154659643,chrX,OR3B1P,chrX:154658741-154659643,902
38801568,38803883,chrX,MID1IP1-AS1,chrX:38801568-38803883,2315
131803312,131803741,chrX,PNKDP1,chrX:131803312-131803741,429
131938846,131938956,chrX,RNA5SP514,chrX:131938846-131938956,110
132023302,132075943,chrX,STK26,chrX:132023302-132075943,52641
48919853,48950965,chr18,SMAD7,chr18:48919853-48950965,31112
135495181,135501734,chr9,C9orf116,chr9:135495181-135501734,6553
51027747,51027852,chr13,RNA5SP29,chr13:51027747-51027852,105
50082169,50906856,chr13,DLEU1,chr13:50082169-50906856,824687
80030579,80034555,chr9,LINC01507,chr9:80030579-80034555,3976
124878275,124948492,chr9,GOLGA1,chr9:124878275-124948492,70217
116298876,116300320,chr4,MTRNR2L13,chr4:116298876-116300320,1444
35581117,35711834,chr18,GALNT1,chr18:35581117-35711834,130717
82490823,82491635,chr4,RPL7AP26,chr4:82490823-82491635,812
62371146,62373168,chr11,RCC2P6,chr11:62371146-62373168,2022
119494397,119628804,chr4,PDE5A,chr4:119494397-119628804,134407
59781318,59781722,chr11,FABP5P7,chr11:59781318-59781722,404
50170731,50180295,chr22,PANX2,chr22:50170731-50180295,9564
62190216,62193539,chr11,SCGB1D1,chr11:62190216-62193539,3323
33161657,33191598,chr11,CSTF3-DT,chr11:33161657-33191598,29941
61513714,61581148,chr11,SYT7,chr11:61513714-61581148,67434
50185913,50199598,chr22,TRABD,chr22:50185913-50199598,13685
38383704,38631420,chr7,AMPH,chr7:38383704-38631420,247716
129887187,130043194,chr9,FNBP1,chr9:129887187-130043194,156007
10964425,10965352,chr12,TAS2R15P,chr12:10964425-10965352,927
74597870,75065671,chr18,ZNF407,chr18:74597870-75065671,467801
62841005,62861822,chr20,TCFL5,chr20:62841005-62861822,20817
10618923,10674318,chr12,STYK1,chr12:10618923-10674318,55395
132130091,132131352,chrX,AGKP2,chrX:132130091-132131352,1261
132203024,132219480,chrX,RAP2C,chrX:132203024-132219480,16456
62845664,62845912,chr20,DPH3P1,chr20:62845664-62845912,248
62872250,62873076,chr20,ARF4P2,chr20:62872250-62873076,826
109807651,109808129,chr10,RPL21P91,chr10:109807651-109808129,478
124867510,124868326,chr10,NPM1P31,chr10:124867510-124868326,816
100143065,100143995,chr10,SPCS2P2,chr10:100143065-100143995,930
62877738,62937952,chr20,DIDO1,chr20:62877738-62937952,60214
103773718,103792619,chrX,PLP1,chrX:103773718-103792619,18901
111498191,111498941,chr10,RPS6P15,chr10:111498191-111498941,750
50266882,50281774,chr18,MBD1,chr18:50266882-50281774,14892
118297925,118342328,chr10,FAM204A,chr10:118297925-118342328,44403
51161723,51162357,chr13,RPL5P31,chr13:51161723-51162357,634
51195881,51196081,chr13,PRELID3BP2,chr13:51195881-51196081,200
2825348,2835544,chr12,NRIP2,chr12:2825348-2835544,10196
51348567,51348639,chr13,MIR5693,chr13:51348567-51348639,72
55883297,55891810,chr11,TRIM51,chr11:55883297-55891810,8513
51222334,51284239,chr13,FAM124A,chr13:51222334-51284239,61905
50217689,50245023,chr22,TUBGCP6,chr22:50217689-50245023,27334
11132958,11134644,chr12,TAS2R30,chr12:11132958-11134644,1686
20323179,20323326,chr14,SNORA79B,chr14:20323179-20323326,147
20326450,20326526,chr14,SNORD126,chr14:20326450-20326526,76
33190062,33190503,chr11,RPL29P23,chr11:33190062-33190503,441
20343075,20343407,chr14,RPPH1,chr14:20343075-20343407,332
38330343,38330935,chr7,TRGV8,chr7:38330343-38330935,592
26667020,26723427,chr11,SLC5A12,chr11:26667020-26723427,56407
24810024,24949101,chr12,BCAT1,chr12:24810024-24949101,139077
47608465,47629893,chr7,LINC01447,chr7:47608465-47629893,21428
53035633,53036925,chr7,POM121L12,chr7:53035633-53036925,1292
20365667,20413501,chr14,TEP1,chr14:20365667-20413501,47834
21259968,21260501,chr17,EIF1P5,chr17:21259968-21260501,533
23891099,23897502,chr13,C1QTNF9B,chr13:23891099-23897502,6403
6776215,6797101,chr17,FBXO39,chr17:6776215-6797101,20886
66921225,66958551,chr7,TMEM248,chr7:66921225-66958551,37326
82128535,82129656,chr4,HNRNPA3P13,chr4:82128535-82129656,1121
95840093,95841464,chr4,PDHA2,chr4:95840093-95841464,1371
112280978,112281335,chr9,HSPE1P28,chr9:112280978-112281335,357
21238870,21253410,chr17,NATD1,chr17:21238870-21253410,14540
120055623,120066858,chr4,MAD2L1,chr4:120055623-120066858,11235
135808487,135907546,chr9,CAMSAP1,chr9:135808487-135907546,99059
65408084,65408672,chrX,TLE1P1,chrX:65408084-65408672,588
65469087,65470380,chrX,AP1M2P1,chrX:65469087-65470380,1293
65550898,65552421,chrX,FRMD8P1,chrX:65550898-65552421,1523
23939557,23946782,chr13,ANKRD20A19P,chr13:23939557-23946782,7225
65588377,65741931,chrX,MSN,chrX:65588377-65741931,153554
19603797,19605048,chr17,MTND2P12,chr17:19603797-19605048,1251
124703625,124714217,chr10,FAM53B-AS1,chr10:124703625-124714217,10592
58317637,58318375,chr11,OR5BC1P,chr11:58317637-58318375,738
20612912,20633234,chr17,LINC02088,chr17:20612912-20633234,20322
62405103,62423195,chr11,SCGB1A1,chr11:62405103-62423195,18092
101610664,101695295,chr10,FBXW4,chr10:101610664-101695295,84631
16847635,16852777,chr17,KRT17P4,chr17:16847635-16852777,5142
65141032,65234216,chr7,INTS4P1,chr7:65141032-65234216,93184
60699585,60715807,chr11,MS4A8,chr11:60699585-60715807,16222
3659248,3663399,chr20,GFRA4,chr20:3659248-3663399,4151
27280482,27280912,chr17,RPS16P8,chr17:27280482-27280912,430
116043407,116044045,chr4,EIF3KP3,chr4:116043407-116044045,638
50245183,50251405,chr22,HDAC10,chr22:50245183-50251405,6222
15806241,15847996,chr17,LINC02087,chr17:15806241-15847996,41755
71254814,71301522,chrX,NONO,chrX:71254814-71301522,46708
24122065,24123814,chr13,IPO7P2,chr13:24122065-24123814,1749
27351858,27352584,chr17,SYPL1P2,chr17:27351858-27352584,726
23888842,23897263,chr13,PCOTH,chr13:23888842-23897263,8421
42471810,42472380,chr4,RPS7P7,chr4:42471810-42472380,570
49942251,49944440,chr7,GNL2P1,chr7:49942251-49944440,2189
121328642,121381059,chr4,QRFPR,chr4:121328642-121381059,52417
46634614,46634946,chr7,HMGN1P19,chr7:46634614-46634946,332
3732685,3753111,chr20,HSPA12B,chr20:3732685-3753111,20426
30378927,30469989,chr17,CPD,chr17:30378927-30469989,91062
101229577,101270148,chr10,LBX1-AS1,chr10:101229577-101270148,40571
32303699,32315363,chr13,ZAR1L,chr13:32303699-32315363,11664
124942123,124988189,chr10,ZRANB1,chr10:124942123-124988189,46066
66075800,66094697,chr7,ASL,chr7:66075800-66094697,18897
59748811,59749574,chr11,OR10V2P,chr11:59748811-59749574,763
29668886,29669628,chr11,HNRNPRP2,chr11:29668886-29669628,742
29725764,29726565,chr11,RPL7AP58,chr11:29725764-29726565,801
32384660,32386108,chr13,IFIT1P1,chr13:32384660-32386108,1448
97849843,97871580,chr10,GOLGA7B,chr10:97849843-97871580,21737
59938432,59957480,chr11,OOSP1,chr11:59938432-59957480,19048
19224063,19241620,chr11,E2F8,chr11:19224063-19241620,17557
109528119,109529008,chr10,PHB2P1,chr10:109528119-109529008,889
101023409,101348278,chr4,PPP3CA,chr4:101023409-101348278,324869
32400723,32428311,chr13,N4BP2L1,chr13:32400723-32428311,27588
99927010,99959050,chr10,DNMBP-AS1,chr10:99927010-99959050,32040
107985811,107986031,chr6,MTHFD2P3,chr6:107985811-107986031,220
44298731,44313347,chr6,AARS2,chr6:44298731-44313347,14616
42185339,42185791,chr10,IGKV1OR10-1,chr10:42185339-42185791,452
102854272,102901899,chr10,BORCS7-ASMT,chr10:102854272-102901899,47627
2959330,3040676,chr12,TEAD4,chr12:2959330-3040676,81346
3753508,3767781,chr20,C20orf27,chr20:3753508-3767781,14273
99659509,99711241,chr10,ENTPD7,chr10:99659509-99711241,51732
44427622,44529038,chr15,CTDSPL2,chr15:44427622-44529038,101416
91611343,91612492,chr9,PAICSP2,chr9:91611343-91612492,1149
134641803,134844843,chr9,COL5A1,chr9:134641803-134844843,203040
74344550,74344805,chr10,TIMM9P1,chr10:74344550-74344805,255
103396626,103446294,chr10,PDCD11,chr10:103396626-103446294,49668
44726465,44932423,chr11,TSPAN18,chr11:44726465-44932423,205958
79953005,79954011,chr6,GAPDHP63,chr6:79953005-79954011,1006
83193357,83198935,chr6,RWDD2A,chr6:83193357-83198935,5578
116038756,116039495,chr6,TPI1P3,chr6:116038756-116039495,739
112236093,112307009,chr6,LAMA4-AS1,chr6:112236093-112307009,70916
27677805,27678087,chr17,CPDP1,chr17:27677805-27678087,282
29203426,29204474,chr17,TWF1P1,chr17:29203426-29204474,1048
111430260,111431781,chr6,BRD7P4,chr6:111430260-111431781,1521
27746132,27754954,chr17,LGALS9DP,chr17:27746132-27754954,8822
74004520,74004812,chr6,TXNP7,chr6:74004520-74004812,292
99993934,100107613,chr6,MCHR2-AS1,chr6:99993934-100107613,113679
32492522,32877177,chr17,MYO1D,chr17:32492522-32877177,384655
3777504,3781448,chr20,SPEF1,chr20:3777504-3781448,3944
107867756,107958208,chr6,SEC63,chr6:107867756-107958208,90452
62559596,62574086,chr11,EEF1G,chr11:62559596-62574086,14490
3783851,3786740,chr20,CENPB,chr20:3783851-3786740,2889
3808357,3812434,chr20,LINC01730,chr20:3808357-3812434,4077
10372353,10391874,chr12,KLRK1,chr12:10372353-10391874,19521
3820524,3828838,chr20,AP5S1,chr20:3820524-3828838,8314
59105126,59125045,chr15,CCNB2,chr15:59105126-59125045,19919
3846799,3876123,chr20,MAVS,chr20:3846799-3876123,29324
118467590,118554100,chr4,CEP170P1,chr4:118467590-118554100,86510
117314597,117360655,chr4,LINC02262,chr4:117314597-117360655,46058
20669551,21575686,chr11,NELL1,chr11:20669551-21575686,906135
118640673,118640858,chr4,SEPTIN14P4,chr4:118640673-118640858,185
121071429,121080476,chr4,NDNF-AS1,chr4:121071429-121080476,9047
10551266,10551535,chr12,SLC25A39P2,chr12:10551266-10551535,269
124499940,124558445,chr4,LINC02516,chr4:124499940-124558445,58505
11481383,11481656,chr12,HIGD1AP8,chr12:11481383-11481656,273
98048555,98049043,chr4,DUTP8,chr4:98048555-98049043,488
27243968,27325959,chr12,STK38L,chr12:27243968-27325959,81991
119939540,119964293,chr4,LINC02502,chr4:119939540-119964293,24753
3888239,3888868,chr20,PANK2-AS1,chr20:3888239-3888868,629
120342056,120342647,chr4,SAR1AP3,chr4:120342056-120342647,591
3917494,3917571,chr20,MIR103A2,chr20:3917494-3917571,77
3917502,3917563,chr20,MIR103B2,chr20:3917502-3917563,61
32477274,32478841,chr13,ATP8A2P2,chr13:32477274-32478841,1567
87152833,87265943,chr6,ZNF292,chr6:87152833-87265943,113110
3686970,3712600,chr20,SIGLEC1,chr20:3686970-3712600,25630
99878336,99894428,chr4,LAMTOR3,chr4:99878336-99894428,16092
36789332,36795050,chr13,ARL2BPP3,chr13:36789332-36795050,5718
36804198,36805302,chr13,NDE1P2,chr13:36804198-36805302,1104
62060503,62062434,chr15,VPS13C-DT,chr15:62060503-62062434,1931
36844831,36920765,chr13,SMAD9,chr13:36844831-36920765,75934
102845595,102845950,chr10,PTGES3P4,chr10:102845595-102845950,355
22094522,22095472,chr15,OR4N4,chr15:22094522-22095472,950
116427847,116477957,chr10,PNLIPRP3,chr10:116427847-116477957,50110
55408495,55418798,chr15,C15orf65,chr15:55408495-55418798,10303
46918900,46993581,chr4,GABRA4,chr4:46918900-46993581,74681
59206843,59208588,chr15,LDHAL6B,chr15:59206843-59208588,1745
36045618,36051018,chr20,NORAD,chr20:36045618-36051018,5400
116577308,116583317,chr10,PNLIPP1,chr10:116577308-116583317,6009
48909483,48914232,chr10,LRRC18,chr10:48909483-48914232,4749
106969831,106975627,chr6,CD24,chr6:106969831-106975627,5796
69160584,69272217,chr15,GLCE,chr15:69160584-69272217,111633
72636497,72636765,chr10,HMGN2P34,chr10:72636497-72636765,268
97828478,97849798,chr10,LINC00866,chr10:97828478-97849798,21320
16599779,16645817,chr7,ANKMY2,chr7:16599779-16645817,46038
36076018,36076601,chr20,HMGB3P2,chr20:36076018-36076601,583
119033670,119080823,chr10,EIF3A,chr10:119033670-119080823,47153
16188485,16277685,chr12,SLC15A5,chr12:16188485-16277685,89200
36091504,36232799,chr20,EPB41L1,chr20:36091504-36232799,141295
96750824,96751728,chr6,EEF1GP6,chr6:96750824-96751728,904
91557292,91690428,chr6,CASC6,chr6:91557292-91690428,133136
60719222,60720196,chr6,GAPDHP41,chr6:60719222-60720196,974
63121833,63142061,chr15,LACTB,chr15:63121833-63142061,20228
8141168,8142697,chr12,GCSHP4,chr12:8141168-8142697,1529
98179499,98179832,chr6,EIF4EBP2P3,chr6:98179499-98179832,333
21536107,21604847,chr12,GYS2,chr12:21536107-21604847,68740
116681187,116741867,chr6,KPNA5,chr6:116681187-116741867,60680
138164097,138242349,chr4,SLC7A11,chr4:138164097-138242349,78252
20414987,20415098,chr14,RNA5SP382,chr14:20414987-20415098,111
20425852,20436166,chr14,KLHL33,chr14:20425852-20436166,10314
56051685,56063989,chr7,CCT6A,chr7:56051685-56063989,12304
30248203,30292056,chr17,BLMH,chr17:30248203-30292056,43853
36849366,36850046,chr13,SMAD9-IT1,chr13:36849366-36850046,680
36922539,36922908,chr13,LAMTOR3P1,chr13:36922539-36922908,369
36926438,36927219,chr13,RPL29P28,chr13:36926438-36927219,781
36938400,36939494,chr13,EIF4A1P5,chr13:36938400-36939494,1094
20446401,20455089,chr14,OSGEP,chr14:20446401-20455089,8688
37103259,37105664,chr13,CSNK1A1L,chr13:37103259-37105664,2405
49106068,49155661,chr15,COPS2,chr15:49106068-49155661,49593
15255213,15255823,chr12,METTL8P1,chr12:15255213-15255823,610
11091287,11092313,chr12,TAS2R43,chr12:11091287-11092313,1026
51813347,51845177,chr13,TMEM272,chr13:51813347-51845177,31830
54624605,54625488,chr6,RPSAP44,chr6:54624605-54625488,883
12357078,12471233,chr12,BORCS5,chr12:12357078-12471233,114155
81733385,81734207,chr4,MTCYBP44,chr4:81733385-81734207,822
43898962,43899351,chr4,NDUFB4P12,chr4:43898962-43899351,389
109366514,109382467,chr6,CD164,chr6:109366514-109382467,15953
82483170,82562357,chr4,TMEM150C,chr4:82483170-82562357,79187
11307077,11310436,chr12,PRB4,chr12:11307077-11310436,3359
51908218,51910621,chr13,CTAGE3P,chr13:51908218-51910621,2403
133636363,133659329,chr9,DBH,chr9:133636363-133659329,22966
16347142,16609259,chr12,MGST1,chr12:16347142-16609259,262117
51930436,52012125,chr13,ATP7B,chr13:51930436-52012125,81689
54229280,54298245,chr4,PDGFRA,chr4:54229280-54298245,68965
13921450,13924863,chr11,LINC02683,chr11:13921450-13924863,3413
74497335,74693177,chr9,RORB,chr9:74497335-74693177,195842
38367586,38368169,chr7,TRGV1,chr7:38367586-38368169,583
25016612,25026664,chr10,THNSL1,chr10:25016612-25026664,10052
38256337,38256396,chr7,TRGJP2,chr7:38256337-38256396,59
63404842,63405400,chr7,ARAFP2,chr7:63404842-63405400,558
69331835,69333633,chr7,MTCO1P25,chr7:69331835-69333633,1798
4418060,4419011,chr11,OR51R1P,chr11:4418060-4419011,951
19160789,19162274,chr17,GRAPLDR,chr17:19160789-19162274,1485
48708327,48711582,chr7,LINC02838,chr7:48708327-48711582,3255
60869438,61001440,chr10,RHOBTB1,chr10:60869438-61001440,132002
59898185,59899133,chr11,SRD5A3P1,chr11:59898185-59899133,948
28953358,28958330,chr7,TRIL,chr7:28953358-28958330,4972
45080437,45088969,chr7,NACAD,chr7:45080437-45088969,8532
20455191,20457772,chr14,APEX1,chr14:20455191-20457772,2581
31432401,31509645,chr11,IMMP1L,chr11:31432401-31509645,77244
34961540,34963777,chr17,ZNF830,chr17:34961540-34963777,2237
22722229,22722469,chr12,RPS27P22,chr12:22722229-22722469,240
63377329,63378233,chr7,VN1R32P,chr7:63377329-63378233,904
8634367,8637608,chr12,HADHAP2,chr12:8634367-8637608,3241
34356480,34358610,chr17,CCL13,chr17:34356480-34358610,2130
32728569,32753744,chr7,ZNRF2P1,chr7:32728569-32753744,25175
10809094,10810168,chr12,TAS2R9,chr12:10809094-10810168,1074
64181710,64182893,chr7,SAPCD2P1,chr7:64181710-64182893,1183
8455962,8478330,chr12,CLEC6A,chr12:8455962-8478330,22368
66407288,66409239,chr7,GTF2IP9,chr7:66407288-66409239,1951
135499984,135504673,chr9,MRPS2,chr9:135499984-135504673,4689
38322446,38322730,chr7,TRGVA,chr7:38322446-38322730,284
104031286,104085880,chr10,COL17A1,chr10:104031286-104085880,54594
30115521,30186475,chr17,NSRP1,chr17:30115521-30186475,70954
54330670,54455093,chr7,LINC01445,chr7:54330670-54455093,124423
7711433,7717559,chr12,DPPA3,chr12:7711433-7717559,6126
89301783,89303114,chr6,TUBB3P1,chr6:89301783-89303114,1331
87121693,87122688,chr6,RCN1P1,chr6:87121693-87122688,995
59829273,59845499,chr11,CBLIF,chr11:59829273-59845499,16226
19089151,19089888,chr12,RPL7P6,chr12:19089151-19089888,737
14254912,14255226,chr12,GNAI2P1,chr12:14254912-14255226,314
118460772,118710075,chr6,CEP85L,chr6:118460772-118710075,249303
55793540,55862755,chr7,SEPTIN14,chr7:55793540-55862755,69215
16990670,16992083,chr12,EEF1A1P16,chr12:16990670-16992083,1413
3381349,3593973,chr12,PRMT8,chr12:3381349-3593973,212624
109375466,109498313,chr9,PTPN3,chr9:109375466-109498313,122847
55838752,55839738,chr11,OR5D16,chr11:55838752-55839738,986
55951793,56000181,chr7,NIPSNAP2,chr7:55951793-56000181,48388
59978020,60031077,chr11,OOSP4B,chr11:59978020-60031077,53057
128269237,128288829,chr4,PGRMC2,chr4:128269237-128288829,19592
13784017,13848002,chr11,LINC02548,chr11:13784017-13848002,63985
62208673,62213943,chr11,SCGB2A1,chr11:62208673-62213943,5270
26994112,26997087,chr11,FIBIN,chr11:26994112-26997087,2975
50245450,50261716,chr22,MAPK12,chr22:50245450-50261716,16266
68030617,68036644,chr11,NDUFS8,chr11:68030617-68036644,6027
89836408,89841978,chr4,SNCA-AS1,chr4:89836408-89841978,5570
131379717,131591825,chr4,LINC02377,chr4:131379717-131591825,212108
8512374,8512726,chr12,SUPT4H1P2,chr12:8512374-8512726,352
14522,32015,chr12,WASH8P,chr12:14522-32015,17493
66702236,66782849,chr15,SMAD6,chr15:66702236-66782849,80613
10801532,10802627,chr12,TAS2R7,chr12:10801532-10802627,1095
70397931,70410195,chr4,OPRPN,chr4:70397931-70410195,12264
12338776,12339254,chr12,RPL23AP66,chr12:12338776-12339254,478
17400399,17400914,chr12,TIMM17BP1,chr12:17400399-17400914,515
19456244,19457648,chr12,EEF1A1P4,chr12:19456244-19457648,1404
11185993,11186937,chr12,TAS2R42,chr12:11185993-11186937,944
8232512,8242948,chr12,FAM86FP,chr12:8232512-8242948,10436
47477243,47477572,chr6,CD2AP-DT,chr6:47477243-47477572,329
84796614,84810403,chr4,WDFY3-AS1,chr4:84796614-84810403,13789
125723267,125724217,chr4,TMEM248P1,chr4:125723267-125724217,950
29340482,29340822,chr17,RPL35AP35,chr17:29340482-29340822,340
73571550,73620631,chr4,RASSF6,chr4:73571550-73620631,49081
15783288,15784307,chr17,IL6STP1,chr17:15783288-15784307,1019
20962768,21092745,chr12,SLCO1B7,chr12:20962768-21092745,129977
56011051,56051604,chr7,PSPH,chr7:56011051-56051604,40553
30600796,30615980,chr17,SMURF2P1,chr17:30600796-30615980,15184
32111562,32112590,chr17,WDR45BP1,chr17:32111562-32112590,1028
58879050,58933679,chr15,SLTM,chr15:58879050-58933679,54629
22529934,22530609,chr17,MTATP6P3,chr17:22529934-22530609,675
16853935,16854309,chr17,COTL1P1,chr17:16853935-16854309,374
66856647,66860475,chr11,LRFN4,chr11:66856647-66860475,3828
117633706,117645087,chr6,NEPNP,chr6:117633706-117645087,11381
84429584,84430802,chr6,SMARCE1P2,chr6:84429584-84430802,1218
2812622,2859791,chr12,ITFG2,chr12:2812622-2859791,47169
799310,979776,chr17,NXN,chr17:799310-979776,180466
62296281,62299075,chr11,SCGB1D4,chr11:62296281-62299075,2794
108751654,108769942,chr6,LINC00222,chr6:108751654-108769942,18288
65160194,65160382,chr11,PDCL2P2,chr11:65160194-65160382,188
36236131,36270918,chr20,AAR2,chr20:36236131-36270918,34787
58343737,58344664,chr11,OR5B19P,chr11:58343737-58344664,927
45371397,45388511,chr11,LINC02687,chr11:45371397-45388511,17114
46159185,46170980,chr6,ENPP5,chr6:46159185-46170980,11795
65040901,65044828,chr11,SAC3D1,chr11:65040901-65044828,3927
38349355,38350022,chr7,TRGV5,chr7:38349355-38350022,667
52750087,52763475,chr6,GSTA2,chr6:52750087-52763475,13388
55887456,55942530,chr7,ZNF713,chr7:55887456-55942530,55074
60890547,60906585,chr11,PRPF19,chr11:60890547-60906585,16038
115888169,115925207,chr9,LINC00474,chr9:115888169-115925207,37038
99918519,99994247,chr6,MCHR2,chr6:99918519-99994247,75728
98658904,98664550,chr4,TSPAN5-DT,chr4:98658904-98664550,5646
36572862,36677683,chr9,MELK,chr9:36572862-36677683,104821
130494673,130495285,chr4,PGBD4P4,chr4:130494673-130495285,612
37116779,37117185,chr7,RPS17P13,chr7:37116779-37117185,406
49016682,49017154,chr4,TPI1P4,chr4:49016682-49017154,472
135371177,135371924,chr4,KRT18P54,chr4:135371177-135371924,747
36512941,36724549,chr7,AOAH,chr7:36512941-36724549,211608
55948871,56033361,chr4,CEP135,chr4:55948871-56033361,84490
90513573,90587072,chr6,MAP3K7,chr6:90513573-90587072,73499
29289061,29318328,chr10,LYZL1,chr10:29289061-29318328,29267
19061912,19062669,chr17,SNORD3B-1,chr17:19061912-19062669,757
22573425,22575105,chr12,LRRC34P1,chr12:22573425-22575105,1680
257724,261096,chr20,DEFB132,chr20:257724-261096,3372
16829999,16832830,chr17,KRT16P2,chr17:16829999-16832830,2831
270863,290778,chr20,C20orf96,chr20:270863-290778,19915
10907926,10909562,chr12,TAS2R13,chr12:10907926-10909562,1636
108296099,108296532,chr10,PTGES3P5,chr10:108296099-108296532,433
30897336,30906238,chr17,TEFM,chr17:30897336-30906238,8902
101845599,102056193,chr10,ARMH3,chr10:101845599-102056193,210594
39087347,39145482,chr12,LINC02406,chr12:39087347-39145482,58135
297570,300321,chr20,ZCCHC3,chr20:297570-300321,2751
24583561,24584549,chr12,KNOP1P1,chr12:24583561-24584549,988
316860,348490,chr20,NRSN2-AS1,chr20:316860-348490,31630
33374238,33439819,chr12,SYT10,chr12:33374238-33439819,65581
20468954,20477089,chr14,PNP,chr14:20468954-20477089,8135
33077188,33162371,chr11,CSTF3,chr11:33077188-33162371,85183
31937007,32001038,chr17,SUZ12,chr17:31937007-32001038,64031
346782,359660,chr20,NRSN2,chr20:346782-359660,12878
50263713,50270767,chr22,MAPK11,chr22:50263713-50270767,7054
99950006,100195099,chr4,H2AZ1-DT,chr4:99950006-100195099,245093
104323369,104327004,chr10,ITPRIP-AS1,chr10:104323369-104327004,3635
47501854,47523638,chr10,AGAP9,chr10:47501854-47523638,21784
2786931,2794295,chr12,CBX3P4,chr12:2786931-2794295,7364
100395341,100880126,chr4,EMCN,chr4:100395341-100880126,484785
407498,432139,chr20,RBCK1,chr20:407498-432139,24641
97426191,97433444,chr10,PGAM1,chr10:97426191-97433444,7253
63241590,63248321,chr7,SEPTIN7P4,chr7:63241590-63248321,6731
29980113,29982392,chr11,LINC01616,chr11:29980113-29982392,2279
15620134,15882329,chr12,EPS8,chr12:15620134-15882329,262195
46743048,46846308,chr11,CKAP5,chr11:46743048-46846308,103260
30558809,30577766,chrX,TASL,chrX:30558809-30577766,18957
30617454,30617693,chrX,CKS1BP6,chrX:30617454-30617693,239
30630298,30630825,chrX,FTLP2,chrX:30630298-30630825,527
20505537,20511169,chr14,RNASE10,chr14:20505537-20511169,5632
30671635,30672166,chrX,GK-IT1,chrX:30671635-30672166,531
50590063,50793462,chr7,GRB10,chr7:50590063-50793462,203399
93073475,93077885,chr10,CYP26A1,chr10:93073475-93077885,4410
30699998,30724174,chrX,GK-AS1,chrX:30699998-30724174,24176
20524287,20525422,chr14,PTCD2P1,chr14:20524287-20525422,1135
36013056,36017972,chr17,CCL23,chr17:36013056-36017972,4916
20528115,20528959,chr14,SETP1,chr14:20528115-20528959,844
30834623,30835300,chrX,TAB3-AS1,chrX:30834623-30835300,677
30854321,30854707,chrX,TAB3-AS2,chrX:30854321-30854707,386
24558087,24672677,chrX,PCYT1B,chrX:24558087-24672677,114590
20556093,20560931,chr14,RNASE9,chr14:20556093-20560931,4838
97393197,97393547,chr10,RPL34P20,chr10:97393197-97393547,350
34574123,34579369,chr17,TMEM132E-DT,chr17:34574123-34579369,5246
33529787,33533760,chr17,AA06,chr17:33529787-33533760,3973
22184967,22185402,chr15,IGHV4OR15-8,chr15:22184967-22185402,435
59246130,59363181,chr10,FAM13C,chr10:59246130-59363181,117051
44354691,44355692,chr15,GAPDHP43,chr15:44354691-44355692,1001
18039408,18068405,chr17,GID4,chr17:18039408-18068405,28997
48988476,49046447,chr15,SECISBP2L,chr15:48988476-49046447,57971
99174744,99175479,chr6,BDH2P1,chr6:99174744-99175479,735
79484991,79537458,chr6,LCA5,chr6:79484991-79537458,52467
24632257,24632601,chrX,H2BP7,chrX:24632257-24632601,344
24650073,24658237,chrX,PCYT1B-AS1,chrX:24650073-24658237,8164
24693873,24996986,chrX,POLA1,chrX:24693873-24996986,303113
138298856,138312658,chr4,LINC00498,chr4:138298856-138312658,13802
48483343,48489526,chr4,SLC10A4,chr4:48483343-48489526,6183
19351368,19447711,chr22,C22orf39,chr22:19351368-19447711,96343
138057464,138178177,chr4,SLC7A11-AS1,chr4:138057464-138178177,120713
69745871,69746851,chr6,GAPDHP42,chr6:69745871-69746851,980
15999784,16045015,chr17,TTC19,chr17:15999784-16045015,45231
20583559,20609884,chr14,RNASE11,chr14:20583559-20609884,26325
44246166,44253888,chr6,HSP90AB1,chr6:44246166-44253888,7722
46035769,46124054,chr4,GABRG1,chr4:46035769-46124054,88285
41699503,41799456,chr22,MEI1,chr22:41699503-41799456,99953
134196333,134201789,chr4,PABPC4L,chr4:134196333-134201789,5456
423596,462566,chr20,TBC1D20,chr20:423596-462566,38970
20590193,20590823,chr14,RNASE12,chr14:20590193-20590823,630
52044805,52046954,chr4,LINC02480,chr4:52044805-52046954,2149
20640696,20641691,chr14,OR6S1,chr14:20640696-20641691,995
86823468,86849384,chr4,SLC10A6,chr4:86823468-86849384,25916
20684560,20701216,chr14,RNASE4,chr14:20684560-20701216,16656
143870864,143905563,chr4,GYPE,chr4:143870864-143905563,34699
20693480,20707120,chr14,EGILA,chr14:20693480-20707120,13640
20720742,20723127,chr14,RANBP20P,chr14:20720742-20723127,2385
20734578,20735011,chr14,EDDM3DP,chr14:20734578-20735011,433
20745887,20748380,chr14,EDDM3A,chr14:20745887-20748380,2493
29255839,29294148,chr17,NUFIP2,chr17:29255839-29294148,38309
20768404,20770948,chr14,EDDM3B,chr14:20768404-20770948,2544
82275071,82276600,chr4,BIN2P1,chr4:82275071-82276600,1529
20781268,20782467,chr14,RNASE6,chr14:20781268-20782467,1199
127623271,127726737,chr4,INTU,chr4:127623271-127726737,103466
24744441,24744570,chrX,SCARNA23,chrX:24744441-24744570,129
20801228,20802855,chr14,RNASE1,chr14:20801228-20802855,1627
30553502,30563493,chr17,TBC1D29P,chr17:30553502-30563493,9991
24788392,24789069,chrX,EEF1B2P3,chrX:24788392-24789069,677
25003694,25016420,chrX,ARX,chrX:25003694-25016420,12726
41831215,41834665,chr22,SREBF2-AS1,chr22:41831215-41834665,3450
63608618,63833948,chr15,HERC1,chr15:63608618-63833948,225330
41833079,41907307,chr22,SREBF2,chr22:41833079-41907307,74228
133654586,133657313,chr9,DBH-AS1,chr9:133654586-133657313,2727
25029545,25030235,chrX,PAFAH1B2P1,chrX:25029545-25030235,690
25060649,25060939,chrX,RN7SL91P,chrX:25060649-25060939,290
135447446,135450154,chr9,SOCS5P2,chr9:135447446-135450154,2708
156020826,156025710,chrX,WASH6P,chrX:156020826-156025710,4884
112683926,112718149,chr9,INIP,chr9:112683926-112718149,34223
126643488,126644390,chr6,PRELID1P1,chr6:126643488-126644390,902
68039025,68050895,chr11,TCIRG1,chr11:68039025-68050895,11870
20955487,20956436,chr14,RNASE2,chr14:20955487-20956436,949
108004357,108005568,chr6,RPL3P7,chr6:108004357-108005568,1211
49565924,49580166,chr6,CYP2AC1P,chr6:49565924-49580166,14242
121858179,121858768,chr6,HMGB3P18,chr6:121858179-121858768,589
104864464,104941447,chr6,LIN28B-AS1,chr6:104864464-104941447,76983
20963579,20963867,chr14,RN7SL189P,chr14:20963579-20963867,288
62460940,62461503,chr6,DHFRP5,chr6:62460940-62461503,563
36534987,36539310,chr17,PIGW,chr17:36534987-36539310,4323
20999255,21001871,chr14,SLC39A2,chr14:20999255-21001871,2616
111259327,111445354,chr6,MFSD4B,chr6:111259327-111445354,186027
75099586,75182123,chr10,SAMD8,chr10:75099586-75182123,82537
36088256,36090169,chr17,CCL3,chr17:36088256-36090169,1913
24146225,24149654,chrX,ZFX-AS1,chrX:24146225-24149654,3429
24429573,24429920,chrX,RPS26P58,chrX:24429573-24429920,347
137618992,137870016,chr9,EHMT1,chr9:137618992-137870016,251024
21023314,21023386,chr14,MIR6717,chr14:21023314-21023386,72
21024109,21036276,chr14,TPPP2,chr14:21024109-21036276,12167
97916353,97917401,chr4,CRYZP2,chr4:97916353-97917401,1048
119621068,119621880,chr10,RAD1P1,chr10:119621068-119621880,812
63634967,63809274,chrX,ARHGEF9,chrX:63634967-63809274,174307
3723903,3726699,chr17,HASPIN,chr17:3723903-3726699,2796
118872054,118872602,chr10,RPL17P36,chr10:118872054-118872602,548
472498,543835,chr20,CSNK2A1,chr20:472498-543835,71337
34360328,34363233,chr17,CCL1,chr17:34360328-34363233,2905
94117792,94207556,chr4,SMARCAD1-DT,chr4:94117792-94207556,89764
132591064,132678503,chr4,LINC01256,chr4:132591064-132678503,87439
30117079,30117172,chr17,hsa-mir-423,chr17:30117079-30117172,93
104309698,104338465,chr10,ITPRIP,chr10:104309698-104338465,28767
116249964,116254075,chr6,TSPYL4,chr6:116249964-116254075,4111
55327469,55402493,chr6,GFRAL,chr6:55327469-55402493,75024
104353833,104455102,chr10,CFAP58,chr10:104353833-104455102,101269
37044860,37045189,chr6,COX6A1P2,chr6:37044860-37045189,329
21032818,21034807,chr14,RNASE13,chr14:21032818-21034807,1989
113222166,113224072,chr6,SOCS5P5,chr6:113222166-113224072,1906
53794497,53924125,chr6,LRRC1,chr6:53794497-53924125,129628
21042316,21044234,chr14,RNASE7,chr14:21042316-21044234,1918
35578046,35726413,chr17,AP2B1,chr17:35578046-35726413,148367
61211652,61212203,chr4,RPL17P19,chr4:61211652-61212203,551
68414064,68472121,chr10,DNA2,chr10:68414064-68472121,58057
17383352,17384647,chr12,PSMC1P8,chr12:17383352-17384647,1295
21057822,21058455,chr14,RNASE8,chr14:21057822-21058455,633
99276369,99291003,chr4,ADH1A,chr4:99276369-99291003,14634
19107854,19108183,chr12,BORCS8P1,chr12:19107854-19108183,329
21070273,21090248,chr14,ARHGEF40,chr14:21070273-21090248,19975
60040409,60048044,chr11,OOSP2,chr11:60040409-60048044,7635
42456757,42590355,chr12,PRICKLE1,chr12:42456757-42590355,133598
132592084,132592536,chr4,AARS1P1,chr4:132592084-132592536,452
107931800,107932254,chr6,RPL23AP50,chr6:107931800-107932254,454
38273587,38273647,chr7,TRGJP,chr7:38273587-38273647,60
41722538,41723512,chr4,OR5M14P,chr4:41722538-41723512,974
64024409,64030105,chr7,LINC01005,chr7:64024409-64030105,5696
41900944,41901012,chr22,MIR33A,chr22:41900944-41901012,68
58622665,58625733,chr11,CNTF,chr11:58622665-58625733,3068
53926676,53947804,chr7,LINC02854,chr7:53926676-53947804,21128
41922032,41926806,chr22,TNFRSF13C,chr22:41922032-41926806,4774
45391626,45392205,chr7,ELK1P1,chr7:45391626-45392205,579
50818723,50847619,chr6,TFAP2B,chr6:50818723-50847619,28896
41923222,41923297,chr22,MIR378I,chr22:41923222-41923297,75
69594793,69597493,chr7,CT66,chr7:69594793-69597493,2700
41938737,41947152,chr22,CENPM,chr22:41938737-41947152,8415
38655205,38656613,chr7,KRT8P20,chr7:38655205-38656613,1408
129093317,129116640,chr4,C4orf33,chr4:129093317-129116640,23323
35298249,35299440,chr15,RBM17P4,chr15:35298249-35299440,1191
64207090,64220508,chr7,ZNF735,chr7:64207090-64220508,13418
66848417,66958386,chr11,PC,chr11:66848417-66958386,109969
42139034,42156636,chr15,PLA2G4F,chr15:42139034-42156636,17602
109288571,109290503,chr6,PTCHD3P3,chr6:109288571-109290503,1932
116453014,116453565,chr6,CBX3P9,chr6:116453014-116453565,551
26667068,26995239,chr7,SKAP2,chr7:26667068-26995239,328171
113428540,113433555,chr6,LINC02518,chr6:113428540-113433555,5015
69866556,70212468,chr6,COL19A1,chr6:69866556-70212468,345912
81919995,81920387,chr4,COX5BP1,chr4:81919995-81920387,392
73710302,73714527,chr4,UMLILO,chr4:73710302-73714527,4225
41952174,41958933,chr22,LINC00634,chr22:41952174-41958933,6759
73397114,73421482,chr4,ALB,chr4:73397114-73421482,24368
41998725,42058456,chr22,WBP2NL,chr22:41998725-42058456,59731
64825572,64826579,chr10,ANXA2P3,chr10:64825572-64826579,1007
107694973,108197849,chr10,LINC01435,chr10:107694973-108197849,502876
43582758,43650713,chr7,STK17A,chr7:43582758-43650713,67955
63548708,63549508,chr6,RPL7AP34,chr6:63548708-63549508,800
52687930,52703825,chr6,GSTA8P,chr6:52687930-52703825,15895
53354715,53355065,chr6,RPL31P28,chr6:53354715-53355065,350
84019204,84026100,chr6,LINC02857,chr6:84019204-84026100,6896
42000446,42001991,chr22,SLC25A5P1,chr22:42000446-42001991,1545
125781161,125932034,chr6,NCOA7,chr6:125781161-125932034,150873
42058334,42070842,chr22,NAGA,chr22:42058334-42070842,12508
99788564,99789410,chr10,NANOGP6,chr10:99788564-99789410,846
30655489,30717266,chr10,SVIL2P,chr10:30655489-30717266,61777
42548828,42569994,chr15,HAUS2,chr15:42548828-42569994,21166
32471513,32472409,chr7,SLC25A5P5,chr7:32471513-32472409,896
63934449,63935331,chr7,VN1R34P,chr7:63934449-63935331,882
99526350,99531177,chr10,LINC01475,chr10:99526350-99531177,4827
51016212,51316818,chr7,COBL,chr7:51016212-51316818,300606
100288149,100330264,chr10,PKD2L1,chr10:100288149-100330264,42115
21090077,21104722,chr14,ZNF219,chr14:21090077-21104722,14645
129803157,129811281,chr9,TOR1B,chr9:129803157-129811281,8124
131469059,131469536,chr6,RPL21P67,chr6:131469059-131469536,477
79964582,79970822,chr18,HSBP1L1,chr18:79964582-79970822,6240
107028199,107051586,chr6,MTRES1,chr6:107028199-107051586,23387
133761894,133992604,chr9,VAV2,chr9:133761894-133992604,230710
79970813,80033949,chr18,TXNL4A,chr18:79970813-80033949,63136
3791047,3873448,chr12,PARP11,chr12:3791047-3873448,82401
44216926,44218234,chr6,MYMX,chr6:44216926-44218234,1308
42074248,42079438,chr22,PHETA2,chr22:42074248-42079438,5190
59676757,59677321,chr15,PIGHP1,chr15:59676757-59677321,564
108782126,108787053,chr6,ZPR1P1,chr6:108782126-108787053,4927
132808392,132942823,chr10,CFAP46,chr10:132808392-132942823,134431
83512534,83525704,chr6,PRSS35,chr6:83512534-83525704,13170
21110295,21113472,chr14,CKAP2P1,chr14:21110295-21113472,3177
54770583,54771134,chr6,KRASP1,chr6:54770583-54771134,551
41208713,41217947,chr6,TREML3P,chr6:41208713-41217947,9234
21113639,21113745,chr14,RNU6-252P,chr14:21113639-21113745,106
22664359,22686213,chr15,WHAMMP3,chr15:22664359-22686213,21854
21148370,21159060,chr14,OR5AU1,chr14:21148370-21159060,10690
42076058,42076161,chr22,SNORD13P1,chr22:42076058-42076161,103
122996235,123072925,chr6,CLVS2,chr6:122996235-123072925,76690
41800679,41832164,chr22,CCDC134,chr22:41800679-41832164,31485
21162513,21163743,chr14,SMARCE1P3,chr14:21162513-21163743,1230
21200079,21206900,chr14,LINC00641,chr14:21200079-21206900,6821
68930525,69062762,chr15,NOX5,chr15:68930525-69062762,132237
21351476,21384019,chr14,SUPT16H,chr14:21351476-21384019,32543
35249772,35249833,chr22,RNU7-167P,chr22:35249772-35249833,61
35257452,35295807,chr22,HMGXB4,chr22:35257452-35295807,38355
71075564,71076375,chr6,BECN1P2,chr6:71075564-71076375,811
46856717,46918642,chr11,LRP4,chr11:46856717-46918642,61925
44258166,44265788,chr6,NFKBIE,chr6:44258166-44265788,7622
80034389,80050651,chr18,RBFA,chr18:80034389-80050651,16262
63670196,63671502,chrX,ARHGEF9-IT1,chrX:63670196-63671502,1306
63766875,63767400,chrX,BTF3P8,chrX:63766875-63767400,525
63786002,63786087,chrX,MIR1468,chrX:63786002-63786087,85
123216339,123637093,chr6,TRDN,chr6:123216339-123637093,420754
3606633,3764819,chr12,CRACR2A,chr12:3606633-3764819,158186
154021573,154137103,chrX,MECP2,chrX:154021573-154137103,115530
38257879,38265678,chr7,TRGC1,chr7:38257879-38265678,7799
80046900,80095482,chr18,RBFADN,chr18:80046900-80095482,48582
53316149,53316740,chr7,RNF138P2,chr7:53316149-53316740,591
15200317,15562015,chr7,AGMO,chr7:15200317-15562015,361698
80077707,80078259,chr18,SLC25A6P4,chr18:80077707-80078259,552
80109262,80147523,chr18,ADNP2,chr18:80109262-80147523,38261
106140143,106188722,chr10,LINC02624,chr10:106140143-106188722,48579
4097451,4099519,chr12,HSPA8P5,chr12:4097451-4099519,2068
14237091,14237321,chr12,MRPS18CP4,chr12:14237091-14237321,230
99697407,99697949,chr10,EBAG9P1,chr10:99697407-99697949,542
70667776,70862011,chr6,SMAP1,chr6:70667776-70862011,194235
8235415,8242564,chr12,LINC02449,chr12:8235415-8242564,7149
113482616,113483113,chr10,PPIAP39,chr10:113482616-113483113,497
62270158,62273160,chr11,SCGB2A2,chr11:62270158-62273160,3002
21392150,21392253,chr14,SNORD9,chr14:21392150-21392253,103
114994657,114996593,chr10,LINC02626,chr10:114994657-114996593,1936
20684177,20698971,chr14,ANG,chr14:20684177-20698971,14794
61406642,61453381,chr10,TMEM26,chr10:61406642-61453381,46739
35335640,35335758,chr22,MIR3909,chr22:35335640-35335758,118
80157232,80247514,chr18,PARD6G,chr18:80157232-80247514,90282
35336721,35336799,chr22,MIR6069,chr22:35336721-35336799,78
44217150,44334577,chr7,CAMK2B,chr7:44217150-44334577,117427
136114581,136118875,chr9,TMEM250,chr9:136114581-136118875,4294
103364239,103364820,chr14,HMGB3P26,chr14:103364239-103364820,581
103374033,103374916,chr14,RPSAP5,chr14:103374033-103374916,883
15107783,15348675,chr12,RERG,chr12:15107783-15348675,240892
35400134,35425431,chr22,MCM5,chr22:35400134-35425431,25297
103412119,103412761,chr14,RPL10AP1,chr14:103412119-103412761,642
28108248,28527041,chr11,METTL15,chr11:28108248-28527041,418793
103529196,103537073,chr14,TRMT61A,chr14:103529196-103537073,7877
132261356,132354986,chr9,SETX,chr9:132261356-132354986,93630
79797938,79900184,chr18,KCNG2,chr18:79797938-79900184,102246
35247025,35572669,chr10,CCNY,chr10:35247025-35572669,325644
103550345,103550406,chr14,RNU7-160P,chr14:103550345-103550406,61
11103,16352,chr18,LINC02564,chr18:11103-16352,5249
103567405,103567545,chr14,RNU4-68P,chr14:103567405-103567545,140
80140,88570,chr18,IL9RP4,chr18:80140-88570,8430
38201566,38203792,chr12,TUBB8P5,chr12:38201566-38203792,2226
140783578,140784366,chrX,CDR1,chrX:140783578-140784366,788
112256,112339,chr18,MIR8078,chr18:112256-112339,83
104112131,104115842,chrX,ZCCHC18,chrX:104112131-104115842,3711
103697609,103715504,chr14,XRCC3,chr14:103697609-103715504,17895
158383,214629,chr18,USP14,chr18:158383-214629,56246
10363638,10398506,chr12,KLRK1-AS1,chr12:10363638-10398506,34868
55220346,55224108,chrX,PAGE5,chrX:55220346-55224108,3762
92013842,92014734,chr6,RPL5P19,chr6:92013842-92014734,892
126683036,126683847,chr6,RPS4XP9,chr6:126683036-126683847,811
27654893,27722058,chr11,BDNF,chr11:27654893-27722058,67165
79914814,79947553,chr6,ELOVL4,chr6:79914814-79947553,32739
15911302,16037381,chr12,DERA,chr12:15911302-16037381,126079
129738331,129753042,chr9,PTGES,chr9:129738331-129753042,14711
132271982,132273332,chr6,EEF1A1P36,chr6:132271982-132273332,1350
70635249,70637314,chr15,SALRNA2,chr15:70635249-70637314,2065
117265558,117273565,chr6,VGLL2,chr6:117265558-117273565,8007
69160851,69165521,chrX,PJA1,chrX:69160851-69165521,4670
67819704,67834582,chr15,SKOR1,chr15:67819704-67834582,14878
132375548,132406851,chr9,TTF1,chr9:132375548-132406851,31303
120258650,120311556,chrX,TMEM255A,chrX:120258650-120311556,52906
53497341,53616970,chr6,GCLC,chr6:53497341-53616970,119629
34927859,34981078,chr17,CCT6B,chr17:34927859-34981078,53219
129612330,129771527,chr4,LINC02466,chr4:129612330-129771527,159197
35943981,36232136,chr11,LDLRAD3,chr11:35943981-36232136,288155
70881342,70892433,chr15,THAP10,chr15:70881342-70892433,11091
105244622,105439171,chr9,SLC44A1,chr9:105244622-105439171,194549
59669312,59676041,chr11,PATL1-DT,chr11:59669312-59676041,6729
43522036,43523264,chr11,CTBP2P6,chr11:43522036-43523264,1228
59806140,59810778,chr11,MRPL16,chr11:59806140-59810778,4638
68578993,68727806,chr15,CORO2B,chr15:68578993-68727806,148813
100185870,100190782,chr4,DDIT4L,chr4:100185870-100190782,4912
35380361,35394214,chr22,HMOX1,chr22:35380361-35394214,13853
109534655,109534990,chr10,BTF3P15,chr10:109534655-109534990,335
20120980,20136163,chr12,LINC02468,chr12:20120980-20136163,15183
119104086,119137984,chr10,DENND10,chr10:119104086-119137984,33898
101268253,101293057,chrX,TAF7L,chrX:101268253-101293057,24804
268148,270278,chr18,THOC1-DT,chr18:268148-270278,2130
109065,122340,chr18,ROCK1P1,chr18:109065-122340,13275
12049844,12211084,chr12,BCL2L14,chr12:12049844-12211084,161240
150264435,151015727,chr4,LRBA,chr4:150264435-151015727,751292
47177522,47186443,chr11,PACSIN3,chr11:47177522-47186443,8921
832238,832469,chr18,BOLA2P1,chr18:832238-832469,231
904871,912172,chr18,ADCYAP1,chr18:904871-912172,7301
63046034,63049387,chr15,TPM1-AS,chr15:63046034-63049387,3353
111876051,111903990,chrX,TRPC5OS,chrX:111876051-111903990,27939
45192244,45240894,chr22,KIAA0930,chr22:45192244-45240894,48650
64841883,64868002,chr15,PLEKHO2,chr15:64841883-64868002,26119
135520659,135582510,chrX,INTS6L,chrX:135520659-135582510,61851
28592223,28613623,chr14,LINC02300,chr14:28592223-28613623,21400
28593779,28593919,chr14,EIF4A1P12,chr14:28593779-28593919,140
28673241,28673727,chr14,BTF3P2,chr14:28673241-28673727,486
28726675,28765292,chr14,FOXG1-AS1,chr14:28726675-28765292,38617
926083,927993,chr18,LINC01904,chr18:926083-927993,1910
62066977,62070917,chr15,C2CD4A,chr15:62066977-62070917,3940
50967991,50988121,chr18,ELAC1,chr18:50967991-50988121,20130
28766787,28770277,chr14,FOXG1,chr14:28766787-28770277,3490
60004234,60061730,chr15,FOXB1,chr15:60004234-60061730,57496
28782909,28785798,chr14,LINC02282,chr14:28782909-28785798,2889
65044818,65058553,chr11,NAALADL1,chr11:65044818-65058553,13735
28800084,28830204,chr14,LINC02281,chr14:28800084-28830204,30120
118674167,118755249,chr10,CACUL1,chr10:118674167-118755249,81082
35918066,35930773,chr17,RDM1,chr17:35918066-35930773,12707
35400691,35401768,chr15,HNRNPA1P45,chr15:35400691-35401768,1077
20960675,20961581,chr15,OR11J2P,chr15:20960675-20961581,906
2781904,2782371,chr12,RPL23AP14,chr12:2781904-2782371,467
75958097,75983011,chr14,TGFB3,chr14:75958097-75983011,24914
2849046,2857039,chr12,TEX52,chr12:2849046-2857039,7993
60053204,60054092,chr15,MESTP2,chr15:60053204-60054092,888
4720400,4851927,chr12,GALNT8,chr12:4720400-4851927,131527
40764068,40767708,chr15,GCHFR,chr15:40764068-40767708,3640
118501430,118502906,chr6,BRD7P3,chr6:118501430-118502906,1476
134293931,134295397,chr9,LINC02247,chr9:134293931-134295397,1466
24149173,24216255,chrX,ZFX,chrX:24149173-24216255,67082
35797206,35845397,chr6,LHFPL5,chr6:35797206-35845397,48191
134025481,134034666,chr9,BRD3OS,chr9:134025481-134034666,9185
51028394,51085045,chr18,SMAD4,chr18:51028394-51085045,56651
97332497,97334729,chr10,FRAT2,chr10:97332497-97334729,2232
36819222,36829104,chr13,RFXAP,chr13:36819222-36829104,9882
121133090,121133723,chr10,RPL19P16,chr10:121133090-121133723,633
129791196,129791837,chr9,UBE2V1P4,chr9:129791196-129791837,641
63321378,63381846,chr15,CA12,chr15:63321378-63381846,60468
121653795,121654690,chr6,SLC25A5P7,chr6:121653795-121654690,895
99355337,99377240,chr9,NAMA,chr9:99355337-99377240,21903
118004916,118046941,chr10,RAB11FIP2,chr10:118004916-118046941,42025
24806169,24927578,chr22,SGSM1,chr22:24806169-24927578,121409
111299028,111483715,chr6,REV3L,chr6:111299028-111483715,184687
37632063,37869802,chr13,TRPC4,chr13:37632063-37869802,237739
75970924,75971587,chr14,TGFB3-AS1,chr14:75970924-75971587,663
80357029,80360338,chr9,NPAP1P4,chr9:80357029-80360338,3309
3077355,3286564,chr12,TSPAN9,chr12:3077355-3286564,209209
103041469,103042094,chr14,RPL13P6,chr14:103041469-103042094,625
126914774,127223166,chr9,RALGPS1,chr9:126914774-127223166,308392
103084210,103090027,chr14,LBHD2,chr14:103084210-103090027,5817
103120847,103123007,chr14,LINC00677,chr14:103120847-103123007,2160
119638456,119639082,chr10,RPS8P4,chr10:119638456-119639082,626
103121476,103137439,chr14,TNFAIP2,chr14:103121476-103137439,15963
117196168,117196654,chr10,RPL12P26,chr10:117196168-117196654,486
123135970,123139423,chr10,HMX3,chr10:123135970-123139423,3453
114821744,114899832,chr10,FHIP2A,chr10:114821744-114899832,78088
47079603,47236662,chr12,PCED1B,chr12:47079603-47236662,157059
48255392,48267444,chrX,SSX1,chrX:48255392-48267444,12052
103139675,103141959,chr14,NDUFB4P11,chr14:103139675-103141959,2284
103148597,103149408,chr14,RPL21P12,chr14:103148597-103149408,811
103184204,103185039,chr14,GCSHP2,chr14:103184204-103185039,835
459939,563509,chr12,B4GALNT3,chr12:459939-563509,103570
47836902,48002561,chrX,ZNF81,chrX:47836902-48002561,165659
103187221,103189028,chr14,LINC00605,chr14:103187221-103189028,1807
103241492,103241972,chr14,RPL21P13,chr14:103241492-103241972,480
103279223,103279955,chr14,RAP2CP1,chr14:103279223-103279955,732
65120630,65122177,chr11,FAU,chr11:65120630-65122177,1547
2537525,2571509,chr18,METTL4,chr18:2537525-2571509,33984
107825755,107931637,chrX,MID2,chrX:107825755-107931637,105882
133670450,133671718,chr10,DUX4L24,chr10:133670450-133671718,1268
103333544,103345025,chr14,EIF5,chr14:103333544-103345025,11481
118932674,118933295,chr10,LDHAP5,chr10:118932674-118933295,621
67290636,67521844,chr15,IQCH-AS1,chr15:67290636-67521844,231208
124619292,124744378,chr10,FAM53B,chr10:124619292-124744378,125086
125166677,125166937,chr10,MRPS21P6,chr10:125166677-125166937,260
101252821,101263550,chr10,LINC02681,chr10:101252821-101263550,10729
33235552,33247621,chr15,TMCO5B,chr15:33235552-33247621,12069
55811367,55812476,chr11,OR5L1,chr11:55811367-55812476,1109
30230779,30296707,chr12,LINC02386,chr12:30230779-30296707,65928
60842113,60851081,chr11,CCDC86,chr11:60842113-60851081,8968
34036681,34039872,chr17,TLK2P1,chr17:34036681-34039872,3191
112950247,113167678,chr10,TCF7L2,chr10:112950247-113167678,217431
46764761,46832408,chr12,SLC38A4,chr12:46764761-46832408,67647
2571557,2616635,chr18,NDC80,chr18:2571557-2616635,45078
41016807,41027893,chr15,INO80-AS1,chr15:41016807-41027893,11086
70286595,70290514,chrX,PDZD11,chrX:70286595-70290514,3919
62330946,62331813,chr11,NPM1P35,chr11:62330946-62331813,867
67541072,67542604,chr15,MAP2K5-DT,chr15:67541072-67542604,1532
32265832,32324659,chr17,RHBDL3,chr17:32265832-32324659,58827
65027439,65040572,chr11,SNX15,chr11:65027439-65040572,13133
59132434,59372871,chr15,MYO1E,chr15:59132434-59372871,240437
24540423,24555935,chr22,GUCD1,chr22:24540423-24555935,15512
126326829,126507041,chr9,MVB12B,chr9:126326829-126507041,180212
70528940,70908711,chrX,TEX11,chrX:70528940-70908711,379771
134880810,134887523,chr9,FCN2,chr9:134880810-134887523,6713
15971890,15972609,chr12,EGLN3P1,chr12:15971890-15972609,719
31647160,31673114,chr12,ETFBKMT,chr12:31647160-31673114,25954
2593674,2594913,chr18,KATNBL1P3,chr18:2593674-2594913,1239
119935053,119937832,chr9,LINC01613,chr9:119935053-119937832,2779
2649761,2649867,chr18,RNU6-340P,chr18:2649761-2649867,106
2652170,2655395,chr18,CBX3P2,chr18:2652170-2655395,3225
124451425,124478589,chr9,ADGRD2,chr9:124451425-124478589,27164
36428618,36439566,chr17,TBC1D3F,chr17:36428618-36439566,10948
2655726,2805017,chr18,SMCHD1,chr18:2655726-2805017,149291
49770960,49771136,chr12,LSM6P2,chr12:49770960-49771136,176
65386621,65413525,chr11,FRMD8,chr11:65386621-65413525,26904
31671142,31729121,chr12,AMN1,chr12:31671142-31729121,57979
36486629,36499310,chr17,ZNHIT3,chr17:36486629-36499310,12681
38685346,38687037,chr7,FAM183BP,chr7:38685346-38687037,1691
116153791,116402321,chr9,PAPPA,chr9:116153791-116402321,248530
36109024,36110872,chr7,MARK2P13,chr7:36109024-36110872,1848
63398046,63398957,chr7,SLC25A1P2,chr7:63398046-63398957,911
63931141,63931968,chr7,SLC25A1P3,chr7:63931141-63931968,827
103337849,103337974,chr14,SNORA28,chr14:103337849-103337974,125
94960277,94962976,chr14,LINC02279,chr14:94960277-94962976,2699
95137919,95137986,chr14,MIR3173,chr14:95137919-95137986,67
95181940,95319908,chr14,CLMN,chr14:95181940-95319908,137968
82589848,82590691,chr7,MTHFD2P5,chr7:82589848-82590691,843
69803316,69804046,chr15,GEMIN8P1,chr15:69803316-69804046,730
55798034,55798876,chr7,CICP12,chr7:55798034-55798876,842
34710757,34711480,chr7,RPL7P31,chr7:34710757-34711480,723
68818221,68946811,chr15,SPESP1,chr15:68818221-68946811,128590
36560857,36703752,chr22,CACNG2,chr22:36560857-36703752,142895
88759700,89338528,chr7,ZNF804B,chr7:88759700-89338528,578828
44447577,44449344,chr15,HNRNPMP1,chr15:44447577-44449344,1767
79144688,79175318,chrX,GPR174,chrX:79144688-79175318,30630
32218464,32255347,chr22,SLC5A4,chr22:32218464-32255347,36883
27471729,27482433,chr11,LGR4-AS1,chr11:27471729-27482433,10704
119615724,119693370,chrX,SEPTIN6,chrX:119615724-119693370,77646
67627831,67628019,chr7,MTATP6P21,chr7:67627831-67628019,188
70858714,70860162,chr15,KRT8P9,chr15:70858714-70860162,1448
98807670,98850081,chr9,GALNT12,chr9:98807670-98850081,42411
68097737,68098250,chr7,MTCO1P57,chr7:68097737-68098250,513
65354751,65357613,chr11,TIGD3,chr11:65354751-65357613,2862
69072926,69095820,chr15,EWSAT1,chr15:69072926-69095820,22894
44379119,44490658,chr7,NUDCD3,chr7:44379119-44490658,111539
68488609,68488840,chr11,NDUFA3P2,chr11:68488609-68488840,231
60615729,60687267,chr11,LINC00301,chr11:60615729-60687267,71538
62253730,62270680,chr15,GOLGA2P11,chr15:62253730-62270680,16950
33162226,33922841,chr22,LARGE1,chr22:33162226-33922841,760615
60785333,60801305,chr11,MS4A10,chr11:60785333-60801305,15972
131782570,131782813,chr9,EIF4A1P3,chr9:131782570-131782813,243
100731240,100732355,chr9,ACTG1P19,chr9:100731240-100732355,1115
40218500,40264890,chr15,BUB1B-PAK6,chr15:40218500-40264890,46390
38980370,39013551,chr7,POU6F2-AS2,chr7:38980370-39013551,33181
18840085,18931287,chr17,PRPSAP2,chr17:18840085-18931287,91202
134132242,134135772,chr9,WDR5-DT,chr9:134132242-134135772,3530
65647823,65718688,chr7,INTS4P2,chr7:65647823-65718688,70865
10588063,10599669,chr12,KLRA1P,chr12:10588063-10599669,11606
28144907,28145204,chr11,ATP5MGP8,chr11:28144907-28145204,297
67812557,67873367,chr11,ENPP7P7,chr11:67812557-67873367,60810
33247820,33264720,chr9,BAG1,chr9:33247820-33264720,16900
65170154,65173244,chr11,SPDYC,chr11:65170154-65173244,3090
121435595,121449727,chr6,GJA1,chr6:121435595-121449727,14132
79069285,79378287,chr18,ATP9B,chr18:79069285-79378287,309002
63189560,63267776,chr15,RAB8B,chr15:63189560-63267776,78216
63449819,63456687,chr7,ZNF734P,chr7:63449819-63456687,6868
132445867,132513198,chr6,STX7,chr6:132445867-132513198,67331
95319483,95335757,chr14,LINC02292,chr14:95319483-95335757,16274
74988279,75018893,chr11,NEU3,chr11:74988279-75018893,30614
104450979,104451433,chr14,CEND1P1,chr14:104450979-104451433,454
47353754,47369935,chr12,LINC02416,chr12:47353754-47369935,16181
64045434,64085339,chr7,ZNF727,chr7:64045434-64085339,39905
760080,776015,chr20,SLC52A3,chr20:760080-776015,15935
104474678,104605647,chr14,TMEM179,chr14:104474678-104605647,130969
27389789,27446625,chr12,ARNTL2-AS1,chr12:27389789-27446625,56836
85421122,85489293,chr7,LINC00972,chr7:85421122-85489293,68171
88564793,88566281,chr7,KPNA2P2,chr7:88564793-88566281,1488
63117501,63154934,chr7,SEPTIN14P1,chr7:63117501-63154934,37433
27494418,27506769,chr11,LIN7C,chr11:27494418-27506769,12351
49582885,49605639,chr12,FAM186B,chr12:49582885-49605639,22754
83955777,84492724,chr7,SEMA3A,chr7:83955777-84492724,536947
79964215,79964519,chr6,RPL35AP18,chr6:79964215-79964519,304
57706695,57782762,chr15,POLR2M,chr15:57706695-57782762,76067
136231024,136250335,chr6,MTFR2,chr6:136231024-136250335,19311
104661120,104665558,chr14,LINC02280,chr14:104661120-104665558,4438
104677694,104677749,chr14,MIR4710,chr14:104677694-104677749,55
65213840,65242757,chr11,SLC22A20P,chr11:65213840-65242757,28917
48921711,49036693,chr20,ARFGEF2,chr20:48921711-49036693,114982
104753147,104768494,chr14,SIVA1,chr14:104753147-104768494,15347
21403081,21403651,chr9,IFNA12P,chr9:21403081-21403651,570
124481236,124507420,chr9,NR5A1,chr9:124481236-124507420,26184
7765216,7774121,chr12,NANOGNB,chr12:7765216-7774121,8905
68121624,68130518,chr11,CHKA-DT,chr11:68121624-68130518,8894
15882387,15903478,chr12,STRAP,chr12:15882387-15903478,21091
68707440,68751520,chr11,TESMIN,chr11:68707440-68751520,44080
115633540,115643916,chr6,LINC02534,chr6:115633540-115643916,10376
116457323,116458669,chr6,KRT18P22,chr6:116457323-116458669,1346
46129989,46146688,chr6,ENPP4,chr6:46129989-46146688,16699
56360362,56360541,chr7,SEPTIN14P24,chr7:56360362-56360541,179
72474330,72602987,chr15,ARIH1,chr15:72474330-72602987,128657
63087070,63088261,chr7,ZNF90P3,chr7:63087070-63088261,1191
124777133,124814885,chr9,OLFML2A,chr9:124777133-124814885,37752
64085560,64086576,chr7,TRIM60P17,chr7:64085560-64086576,1016
104800596,104804712,chr14,ZBTB42,chr14:104800596-104804712,4116
65873074,65959563,chr7,VKORC1L1,chr7:65873074-65959563,86489
117675469,117710727,chr6,NUS1,chr6:117675469-117710727,35258
67006778,67050863,chr11,SYT12,chr11:67006778-67050863,44085
1268800,1310381,chrX,CSF2RA,chrX:1268800-1310381,41581
95086228,95158010,chr14,DICER1,chr14:95086228-95158010,71782
128864921,129093600,chr4,SCLT1,chr4:128864921-129093600,228679
48088628,48108736,chr7,UPP1,chr7:48088628-48108736,20108
75601509,75718281,chr6,SENP6,chr6:75601509-75718281,116772
79036413,79037568,chr9,KRT18P24,chr9:79036413-79037568,1155
65736555,65738784,chr9,FOXD4L4,chr9:65736555-65738784,2229
82057647,82063682,chr9,SPATA31B1P,chr9:82057647-82063682,6035
97412096,97496125,chr9,TDRD7,chr9:97412096-97496125,84029
31064105,31104757,chr22,SMTN,chr22:31064105-31104757,40652
68261338,68272001,chr11,C11orf24,chr11:68261338-68272001,10663
77072100,77073295,chr9,RFC5P1,chr9:77072100-77073295,1195
48183644,48185926,chr12,CCDC184,chr12:48183644-48185926,2282
122761844,122762233,chr9,SKA2P1,chr9:122761844-122762233,389
87011652,87013151,chr9,CDC20P1,chr9:87011652-87013151,1499
47135498,47138370,chr12,IFITM3P6,chr12:47135498-47138370,2872
100578079,100588389,chr9,CAVIN4,chr9:100578079-100588389,10310
47709734,47725567,chr12,ENDOU,chr12:47709734-47725567,15833
21186694,21187671,chr9,IFNA4,chr9:21186694-21187671,977
21409117,21410185,chr9,IFNA8,chr9:21409117-21410185,1068
107420191,107466613,chr9,LINC01509,chr9:107420191-107466613,46422
40278176,40307935,chr15,PLCB2,chr15:40278176-40307935,29759
65116403,65117701,chr11,ZNHIT2,chr11:65116403-65117701,1298
117704175,117724735,chr9,TLR4,chr9:117704175-117724735,20560
85934737,85935663,chr11,SLC25A1P1,chr11:85934737-85935663,926
67735600,67784229,chr11,OR7E11P,chr11:67735600-67784229,48629
87329407,87330052,chr11,PSMA2P1,chr11:87329407-87330052,645
67886477,67906350,chr11,LINC02754,chr11:67886477-67906350,19873
78423982,78429836,chr11,LINC02728,chr11:78423982-78429836,5854
5299864,5304716,chr9,RLN2,chr9:5299864-5304716,4852
83328926,83329246,chr11,CYCSP28,chr11:83328926-83329246,320
26559032,26572263,chr11,MUC15,chr11:26559032-26572263,13231
24566964,24584168,chr12,LINC00477,chr12:24566964-24584168,17204
41955234,42087830,chr18,PIK3C3,chr18:41955234-42087830,132596
31791185,31792298,chr12,H3-5,chr12:31791185-31792298,1113
21178589,21179188,chr9,IFNWP15,chr9:21178589-21179188,599
98606833,98608133,chr9,SEPTIN7P7,chr9:98606833-98608133,1300
75576496,75630716,chr4,CDKL2,chr4:75576496-75630716,54220
138137095,138143864,chr9,IL9RP1,chr9:138137095-138143864,6769
31280584,31327058,chr12,SINHCAF,chr12:31280584-31327058,46474
78741720,78742744,chr9,MTND2P8,chr9:78741720-78742744,1024
33264879,33282070,chr9,CHMP5,chr9:33264879-33282070,17191
56358974,56368663,chr20,FAM210B,chr20:56358974-56368663,9689
82401578,82402456,chr4,IGBP1P4,chr4:82401578-82402456,878
5231419,5235304,chr9,INSL4,chr9:5231419-5235304,3885
73646178,73662819,chr11,PLEKHB1,chr11:73646178-73662819,16641
85475150,86002668,chr4,ARHGAP24,chr4:85475150-86002668,527518
56369389,56392337,chr20,AURKA,chr20:56369389-56392337,22948
138319898,138320835,chr9,OR4F8BP,chr9:138319898-138320835,937
98288109,98708935,chr9,GABBR2,chr9:98288109-98708935,420826
26905181,26938326,chr12,INTS13,chr12:26905181-26938326,33145
43758680,43807342,chr7,BLVRA,chr7:43758680-43807342,48662
57638725,57639112,chr7,BSNDP4,chr7:57638725-57639112,387
56114681,56116417,chr7,NUPR2,chr7:56114681-56116417,1736
94833904,94834447,chr7,ARF1P1,chr7:94833904-94834447,543
113105788,113120685,chr13,F7,chr13:113105788-113120685,14897
56631739,56632727,chr7,TRIM60P16,chr7:56631739-56632727,988
42224931,42452051,chr6,TRERF1,chr6:42224931-42452051,227120
63768257,63771047,chr7,CICP24,chr7:63768257-63771047,2790
34750253,34752053,chr7,NCAPD2P1,chr7:34750253-34752053,1800
95035731,95214338,chr7,PPP1R9A-AS1,chr7:95035731-95214338,178607
51259429,51260167,chr7,RPL7L1P2,chr7:51259429-51260167,738
88448788,88449017,chr7,EIF4A1P13,chr7:88448788-88449017,229
53064316,53079404,chr12,SPRYD3,chr12:53064316-53079404,15088
92447482,92460075,chr7,GATAD1,chr7:92447482-92460075,12593
88725955,89111398,chr4,FAM13A,chr4:88725955-89111398,385443
49258493,49259846,chr7,DDX43P2,chr7:49258493-49259846,1353
63937905,63938509,chr7,ARAFP1,chr7:63937905-63938509,604
214520,268050,chr18,THOC1,chr18:214520-268050,53530
36253456,36264553,chr17,TBC1D3I,chr17:36253456-36264553,11097
55436056,55572988,chr7,VOPP1,chr7:55436056-55572988,136932
42615221,42646547,chr12,LINC02402,chr12:42615221-42646547,31326
82086155,82088768,chr9,DDX10P2,chr9:82086155-82088768,2613
80782338,80782770,chr9,RPS19P6,chr9:80782338-80782770,432
65282101,65285209,chr9,FOXD4L5,chr9:65282101-65285209,3108
45050901,45103107,chr12,DBX2-AS1,chr12:45050901-45103107,52206
87084161,87085151,chr9,NFYCP2,chr9:87084161-87085151,990
3483714,3492819,chr12,THCAT155,chr12:3483714-3492819,9105
50857255,50857662,chr6,RPS17P5,chr6:50857255-50857662,407
1333837,1333953,chr9,RNA5SP279,chr9:1333837-1333953,116
11076769,11079171,chr12,TAS2R64P,chr12:11076769-11079171,2402
100427118,100437484,chr6,SIM1-AS1,chr6:100427118-100437484,10366
6007826,6007904,chr9,MIR4665,chr9:6007826-6007904,78
1001858,1001963,chr9,RNU6-1073P,chr9:1001858-1001963,105
4850297,4850375,chr9,MIR101-2,chr9:4850297-4850375,78
12300266,12300451,chr9,RNU2-47P,chr9:12300266-12300451,185
47477789,47627263,chr6,CD2AP,chr6:47477789-47627263,149474
15525782,15526081,chr9,RN7SL98P,chr9:15525782-15526081,299
15544188,15544294,chr9,RNU6-246P,chr9:15544188-15544294,106
6661651,6661942,chr9,RN7SL123P,chr9:6661651-6661942,291
19063656,19063786,chr9,SCARNA8,chr9:19063656-19063786,130
30652051,30667887,chr22,DUSP18,chr22:30652051-30667887,15836
19073843,19073946,chr9,RNU6-264P,chr9:19073843-19073946,103
15431899,15432006,chr9,RNU6-319P,chr9:15431899-15432006,107
15112363,15114698,chr12,RERG-IT1,chr12:15112363-15114698,2335
17053901,17054204,chr9,RN7SL720P,chr9:17053901-17054204,303
15143289,15143386,chr9,RNU6-559P,chr9:15143289-15143386,97
21512115,21512185,chr9,MIR31,chr9:21512115-21512185,70
21524307,21524382,chr9,SNORD39,chr9:21524307-21524382,75
15776181,15776286,chr9,RNU6-14P,chr9:15776181-15776286,105
21699314,21699596,chr9,RN7SL151P,chr9:21699314-21699596,282
25088811,25089151,chr9,RN7SKP120,chr9:25088811-25089151,340
6542094,6542353,chr9,RN7SL25P,chr9:6542094-6542353,259
12764761,12765055,chr9,RN7SL849P,chr9:12764761-12765055,294
24905469,24905735,chr9,RMRPP5,chr9:24905469-24905735,266
28888879,28888955,chr9,MIR873,chr9:28888879-28888955,76
33174170,33174295,chr9,RNU4ATAC15P,chr9:33174170-33174295,125
28863626,28863706,chr9,MIR876,chr9:28863626-28863706,80
36823539,36823599,chr9,MIR4475,chr9:36823539-36823599,60
36864254,36864308,chr9,MIR4540,chr9:36864254-36864308,54
36893462,36893531,chr9,MIR4476,chr9:36893462-36893531,69
48147789,48181213,chr12,ASB8,chr12:48147789-48181213,33424
37333857,37333957,chr9,RNU6-677P,chr9:37333857-37333957,100
40759600,40759706,chr9,RNU6-156P,chr9:40759600-40759706,106
40929010,40929092,chr9,MIR1299,chr9:40929010-40929092,82
41237440,41237557,chr9,RNA5SP530,chr9:41237440-41237557,117
44752558,44862788,chr22,ARHGAP8,chr22:44752558-44862788,110230
41578903,41579186,chr9,RN7SL565P,chr9:41578903-41579186,283
41233755,41233835,chr9,MIR4477A,chr9:41233755-41233835,80
42011350,42011610,chr9,RN7SL343P,chr9:42011350-42011610,260
42863200,42863306,chr9,RNU6-599P,chr9:42863200-42863306,106
62363581,62363864,chr9,RN7SL544P,chr9:62363581-62363864,283
62802320,62802438,chr9,RNA5SP283,chr9:62802320-62802438,118
61427617,61427877,chr9,RN7SL462P,chr9:61427617-61427877,260
64380194,64380300,chr9,RNU6-1193P,chr9:64380194-64380300,106
136146702,136211359,chrX,FHL1,chrX:136146702-136211359,64657
64880369,64880475,chr9,RNU6-1293P,chr9:64880369-64880475,106
28700064,28718970,chr13,SLC46A3,chr13:28700064-28718970,18906
70188571,70188750,chr9,RNU2-5P,chr9:70188571-70188750,179
69884363,69884654,chr9,RN7SL570P,chr9:69884363-69884654,291
72299720,72299838,chr9,RNA5SP285,chr9:72299720-72299838,118
66142221,66142327,chr9,RNU6-538P,chr9:66142221-66142327,106
73750972,73751077,chr9,RNA5SP286,chr9:73750972-73751077,105
74799895,74800222,chr9,RN7SKP47,chr9:74799895-74800222,327
74857675,74857781,chr9,RNU6-445P,chr9:74857675-74857781,106
67175775,67176035,chr9,RN7SL422P,chr9:67175775-67176035,260
78165465,78165778,chr9,RN7SKP59,chr9:78165465-78165778,313
77635203,77635309,chr9,RNU6-1303P,chr9:77635203-77635309,106
81725243,81725349,chr9,RNU6-1035P,chr9:81725243-81725349,106
83200940,83201228,chr9,RN7SKP242,chr9:83200940-83201228,288
83596444,83596584,chr9,RNU4-15P,chr9:83596444-83596584,140
88610241,88610669,chr7,SLC66A2P1,chr7:88610241-88610669,428
86422938,86423128,chr9,RNU2-36P,chr9:86422938-86423128,190
83275941,83276114,chr9,RNU4-29P,chr9:83275941-83276114,173
86258358,86258646,chr9,RN7SKP264,chr9:86258358-86258646,288
75198071,75198177,chr9,RNU6-1228P,chr9:75198071-75198177,106
81885496,81885598,chr9,RNA5SP287,chr9:81885496-81885598,102
90023441,90023535,chr9,MIR4290,chr9:90023441-90023535,94
89312225,89312306,chr9,MIR3153,chr9:89312225-89312306,81
91636251,91636361,chr9,MIR3910-1,chr9:91636251-91636361,110
93962762,94004382,chr7,BET1,chr7:93962762-94004382,41620
91636264,91636345,chr9,MIR3910-2,chr9:91636264-91636345,81
37489891,37513501,chr17,DUSP14,chr17:37489891-37513501,23610
92820977,92821079,chr9,RNU6-714P,chr9:92820977-92821079,102
93819357,93819421,chr9,MIR4291,chr9:93819357-93819421,64
94175957,94176036,chr9,MIRLET7A1,chr9:94175957-94176036,79
94176347,94176433,chr9,MIRLET7F1,chr9:94176347-94176433,86
94178834,94178920,chr9,MIRLET7D,chr9:94178834-94178920,86
88745836,88745905,chr9,MIR4289,chr9:88745836-88745905,69
96256216,96256319,chr9,RNU6-1160P,chr9:96256216-96256319,103
97363554,97363681,chr9,MIR1302-8,chr9:97363554-97363681,127
98868535,98948006,chr6,FBXL4,chr6:98868535-98948006,79471
98229149,98229217,chr9,MIR6854,chr9:98229149-98229217,68
99185587,99185866,chr9,RN7SL794P,chr9:99185587-99185866,279
99145840,99145966,chr9,RNA5SP290,chr9:99145840-99145966,126
100581079,100581379,chr9,RN7SKP87,chr9:100581079-100581379,300
68296532,68432163,chr15,ITGA11,chr15:68296532-68432163,135631
107663140,107663246,chr9,RNU6-996P,chr9:107663140-107663246,106
98032230,98032335,chr9,RNU6-918P,chr9:98032230-98032335,105
102256604,102256710,chr9,RNU6-329P,chr9:102256604-102256710,106
107475036,107475139,chr9,RNU6-492P,chr9:107475036-107475139,103
103689473,103689577,chr9,RNA5SP291,chr9:103689473-103689577,104
107811616,107811914,chr9,RN7SL659P,chr9:107811616-107811914,298
107797744,107797847,chr9,RNU6-1064P,chr9:107797744-107797847,103
111271156,111271214,chr9,MIR7702,chr9:111271156-111271214,58
105096756,105097061,chr9,RN7SKP191,chr9:105096756-105097061,305
34980512,35009743,chr17,LIG3,chr17:34980512-35009743,29231
112137797,112137900,chr9,RNU6-855P,chr9:112137797-112137900,103
99284022,99284373,chr9,RN7SKP225,chr9:99284022-99284373,351
107918866,107918978,chr9,RNA5SP293,chr9:107918866-107918978,112
109511475,109511545,chr9,MIR3927,chr9:109511475-109511545,70
110903337,110903445,chr9,RNU6-432P,chr9:110903337-110903445,108
27270830,27275192,chr13,RASL11A,chr13:27270830-27275192,4362
111097325,111097413,chr9,RNY4P18,chr9:111097325-111097413,88
111411644,111411742,chr9,RNA5SP294,chr9:111411644-111411742,98
117707996,117708102,chr9,RNU6-1082P,chr9:117707996-117708102,106
112242550,112242839,chr9,RN7SL57P,chr9:112242550-112242839,289
112252258,112252378,chr9,RNA5SP295,chr9:112252258-112252378,120
112272596,112272837,chr9,RN7SL430P,chr9:112272596-112272837,241
120244979,120245050,chr9,MIR147A,chr9:120244979-120245050,71
111996635,111996739,chr9,RNU6-710P,chr9:111996635-111996739,104
124887410,124887549,chr9,RNU4-82P,chr9:124887410-124887549,139
124607159,124607458,chr9,RN7SL302P,chr9:124607159-124607458,299
110369592,110369698,chr9,RNU6-1039P,chr9:110369592-110369698,106
114209434,114209529,chr9,MIR455,chr9:114209434-114209529,95
124692442,124692551,chr9,MIR181A2,chr9:124692442-124692551,109
104017633,104019748,chr6,R3HDM2P2,chr6:104017633-104019748,2115
124693710,124693798,chr9,MIR181B2,chr9:124693710-124693798,88
126408041,126408410,chr9,NRON,chr9:126408041-126408410,369
129869605,129869671,chr9,MIR6855,chr9:129869605-129869671,66
89326625,89352722,chr6,UBE2J1,chr6:89326625-89352722,26097
46169458,46169748,chr13,RN7SL288P,chr13:46169458-46169748,290
125512902,125513207,chr9,RN7SL30P,chr9:125512902-125513207,305
134850742,134850807,chr9,MIR3689F,chr9:134850742-134850807,65
132421641,132421690,chr9,RNU5D-2P,chr9:132421641-132421690,49
46249942,46250213,chr13,RN7SKP5,chr13:46249942-46250213,271
134164439,134164564,chr9,RNU6ATAC,chr9:134164439-134164564,125
134379411,134379472,chr9,MIR4669,chr9:134379411-134379472,61
134849487,134849564,chr9,MIR3689A,chr9:134849487-134849564,77
134849298,134849369,chr9,MIR3689C,chr9:134849298-134849369,71
46270077,46270617,chr13,ABITRAMP1,chr13:46270077-46270617,540
134849609,134849682,chr9,MIR3689D1,chr9:134849609-134849682,73
134850277,134850356,chr9,MIR3689D2,chr9:134850277-134850356,79
131725168,131725467,chr9,RN7SL328P,chr9:131725168-131725467,299
134850125,134850272,chr9,MIR3689B,chr9:134850125-134850272,147
134850570,134850641,chr9,MIR3689E,chr9:134850570-134850641,71
137838419,137838516,chr9,MIR602,chr9:137838419-137838516,97
138259595,138259698,chr9,RNU6-785P,chr9:138259595-138259698,103
54419444,54420328,chr7,SLC25A5P3,chr7:54419444-54420328,884
46296445,46297844,chr13,LINC00563,chr13:46296445-46297844,1399
108848416,108974476,chr6,ARMC2,chr6:108848416-108974476,126060
97117698,97181763,chr7,SDHAF3,chr7:97117698-97181763,64065
127397138,127408424,chr9,SLC2A8,chr9:127397138-127408424,11286
46374401,46374590,chr13,RNU2-6P,chr13:46374401-46374590,189
46410454,46410557,chr13,RNU6-68P,chr13:46410454-46410557,103
46437394,46437988,chr13,PPP1R2P4,chr13:46437394-46437988,594
46460609,46461121,chr13,OR7E101P,chr13:46460609-46461121,512
2877223,2941138,chr12,TULP3,chr12:2877223-2941138,63915
50458436,50565405,chr7,DDC,chr7:50458436-50565405,106969
46490930,46491121,chr13,COX17P1,chr13:46490930-46491121,191
46505118,46505436,chr13,FKBP1AP3,chr13:46505118-46505436,318
68312591,68449275,chr11,LRP5,chr11:68312591-68449275,136684
12310962,12318316,chr8,DEFB130A,chr8:12310962-12318316,7354
46053186,46105033,chr13,CPB2,chr13:46053186-46105033,51847
24162045,24397880,chr18,OSBPL1A,chr18:24162045-24397880,235835
7556700,7559712,chr8,FAM90A7P,chr8:7556700-7559712,3012
7990415,7997521,chr8,DEFB109C,chr8:7990415-7997521,7106
107702154,107824317,chr6,SCML4,chr6:107702154-107824317,122163
8701937,8704096,chr8,CLDN23,chr8:8701937-8704096,2159
6935820,6938306,chr8,DEFA4,chr8:6935820-6938306,2486
12172761,12175771,chr8,FAM90A2P,chr8:12172761-12175771,3010
65530418,65578349,chr15,HACD3,chr15:65530418-65578349,47931
7549053,7552062,chr8,FAM90A6P,chr8:7549053-7552062,3009
7028641,7029489,chr8,DEFA11P,chr8:7028641-7029489,848
99816827,99870190,chr4,DAPP1,chr4:99816827-99870190,53363
20449655,20450083,chr12,UBE2L2,chr12:20449655-20450083,428
54575387,54588659,chr12,PPP1R1A,chr12:54575387-54588659,13272
78188812,78215232,chr11,USP35,chr11:78188812-78215232,26420
39097224,39104067,chr22,APOBEC3H,chr22:39097224-39104067,6843
9136255,9151574,chr8,PPP1R3B,chr8:9136255-9151574,15319
116511639,116524788,chr6,CALHM5,chr6:116511639-116524788,13149
13353401,13353530,chr8,MTND4P7,chr8:13353401-13353530,129
34889255,35091406,chr6,ANKS1A,chr6:34889255-35091406,202151
17576433,17644071,chr8,PDGFRL,chr8:17576433-17644071,67638
127730400,127774292,chr4,SLC25A31,chr4:127730400-127774292,43892
38297023,38323217,chr17,MRPL45,chr17:38297023-38323217,26194
31715342,31715781,chr12,STMN1P1,chr12:31715342-31715781,439
43835967,44389762,chr12,TMEM117,chr12:43835967-44389762,553795
9563171,9563950,chr4,RPS3AP19,chr4:9563171-9563950,779
7470308,7475082,chr8,DEFB104B,chr8:7470308-7475082,4774
46125920,46211871,chr13,LCP1,chr13:46125920-46211871,85951
68447463,68497604,chr4,TMPRSS11E,chr4:68447463-68497604,50141
32227890,32228108,chr17,UBL5P2,chr17:32227890-32228108,218
80751200,80762826,chr11,LINC02720,chr11:80751200-80762826,11626
32150433,32151504,chr17,ARGFXP2,chr17:32150433-32151504,1071
7723091,7726101,chr8,FAM90A18P,chr8:7723091-7726101,3010
28041737,28196381,chr17,NLK,chr17:28041737-28196381,154644
7298744,7355359,chr8,FAM66B,chr8:7298744-7355359,56615
89700764,89701325,chr11,UBTFL10,chr11:89700764-89701325,561
43733759,43734564,chr11,PHBP2,chr11:43733759-43734564,805
69809968,69819416,chr11,FGF3,chr11:69809968-69819416,9448
133149294,133208606,chr4,PCDH10,chr4:133149294-133208606,59312
36965248,36968172,chr22,LL22NC01-81G9.3,chr22:36965248-36968172,2924
89981441,89989559,chr11,TRIM51EP,chr11:89981441-89989559,8118
48727435,48765790,chr12,TEX49,chr12:48727435-48765790,38355
36991120,37007851,chr22,TEX33,chr22:36991120-37007851,16731
65314866,65322417,chr11,CDC42EP2,chr11:65314866-65322417,7551
53994895,54003337,chr12,HOXC9,chr12:53994895-54003337,8442
9555912,9782346,chr8,TNKS,chr8:9555912-9782346,226434
89841997,89850970,chr11,TRIM53BP,chr11:89841997-89850970,8973
152618628,152680012,chr4,TMEM154,chr4:152618628-152680012,61384
75071148,75072052,chr11,OR2AT2P,chr11:75071148-75072052,904
39755025,40106089,chr12,SLC2A13,chr12:39755025-40106089,351064
66842835,66846552,chr11,RCE1,chr11:66842835-66846552,3717
56392371,56406362,chr20,CSTF1,chr20:56392371-56406362,13991
104728094,104859919,chr6,HACE1,chr6:104728094-104859919,131825
32007872,32053504,chr17,LRRC37B,chr17:32007872-32053504,45632
68053198,68129869,chr4,TMPRSS11F,chr4:68053198-68129869,76671
37019635,37029821,chr22,MPST,chr22:37019635-37029821,10186
82893009,82900960,chr4,THAP9-AS1,chr4:82893009-82900960,7951
55221025,55221975,chr12,OR10A7,chr12:55221025-55221975,950
127424374,127445372,chr9,ZNF79,chr9:127424374-127445372,20998
29500840,29784759,chr12,TMTC1,chr12:29500840-29784759,283919
127447674,127451406,chr9,RPL12,chr9:127447674-127451406,3732
88513498,88513663,chr14,RNU4-22P,chr14:88513498-88513663,165
45647689,45665622,chr11,CHST1,chr11:45647689-45665622,17933
57319138,57325039,chr15,LINC01413,chr15:57319138-57325039,5901
40300670,40301820,chr15,PLCB2-AS1,chr15:40300670-40301820,1150
75079265,75080131,chr11,NPM1P50,chr11:75079265-75080131,866
73443164,73560013,chr15,REC114,chr15:73443164-73560013,116849
91157994,91234388,chr11,LINC02748,chr11:91157994-91234388,76394
37891347,37891448,chr22,RNU6-900P,chr22:37891347-37891448,101
88562970,88627596,chr14,ZC3H14,chr14:88562970-88627596,64626
37943050,37953669,chr22,C22orf23,chr22:37943050-37953669,10619
60577856,60608418,chr11,MS4A19P,chr11:60577856-60608418,30562
40749925,40811184,chr4,NSUN7,chr4:40749925-40811184,61259
67925651,67926431,chr11,RPS3AP40,chr11:67925651-67926431,780
89968502,89974072,chr11,TRIM64,chr11:89968502-89974072,5570
98106862,98209638,chr7,LMTK2,chr7:98106862-98209638,102776
56459428,56459583,chr20,RPL39P,chr20:56459428-56459583,155
73567012,73569294,chr15,NPTN-IT1,chr15:73567012-73569294,2282
56468585,56519449,chr20,RTF2,chr20:56468585-56519449,50864
78435968,78574874,chr11,NARS2,chr11:78435968-78574874,138906
12991362,13125052,chr18,CEP192,chr18:12991362-13125052,133690
70503907,70505928,chr15,LINC02205,chr15:70503907-70505928,2021
68749501,68750691,chr15,CARS1P1,chr15:68749501-68750691,1190
127448501,127448630,chr9,SNORA65,chr9:127448501-127448630,129
53225828,53321350,chrX,IQSEC2,chrX:53225828-53321350,95522
73873564,73889214,chr15,TBC1D21,chr15:73873564-73889214,15650
127505339,127578989,chr9,NIBAN2,chr9:127505339-127578989,73650
63291518,63304056,chr7,ZNF733P,chr7:63291518-63304056,12538
55681074,55713252,chr7,FKBP9P1,chr7:55681074-55713252,32178
37952607,38041915,chr22,POLR2F,chr22:37952607-38041915,89308
143996104,144019380,chr4,GYPB,chr4:143996104-144019380,23276
36153254,36301538,chr7,EEPD1,chr7:36153254-36301538,148284
39626167,39908300,chr12,C12orf40,chr12:39626167-39908300,282133
7705182,7706113,chr8,OR7E154P,chr8:7705182-7706113,931
17027238,17122642,chr8,MICU3,chr8:17027238-17122642,95404
63113635,63114805,chr7,SAPCD2P4,chr7:63113635-63114805,1170
26922110,26922912,chr7,RPL7AP38,chr7:26922110-26922912,802
7787794,7799146,chr12,NANOG,chr12:7787794-7799146,11352
93130056,93148385,chr7,SAMD9L,chr7:93130056-93148385,18329
74493851,74669117,chr11,POLD3,chr11:74493851-74669117,175266
125797856,125818858,chr6,NCOA7-AS1,chr6:125797856-125818858,21002
71165076,71165770,chr6,LYPLA1P3,chr6:71165076-71165770,694
73560014,73634134,chr15,NPTN,chr15:73560014-73634134,74120
81491439,81752774,chr6,TENT5A,chr6:81491439-81752774,261335
45777242,45851753,chr13,SIAH3,chr13:45777242-45851753,74511
34285742,34288334,chr17,CCL11,chr17:34285742-34288334,2592
112616703,112617880,chr6,PA2G4P5,chr6:112616703-112617880,1177
46183063,46270017,chr12,SLC38A1,chr12:46183063-46270017,86954
6898878,6899468,chr8,RPL23AP96,chr8:6898878-6899468,590
117431591,117432442,chr6,RAP1BP3,chr6:117431591-117432442,851
213186,232231,chr8,RPL23AP53,chr8:213186-232231,19045
38419280,38512385,chr17,ARHGAP23,chr17:38419280-38512385,93105
63998874,64016130,chr7,ZNF722P,chr7:63998874-64016130,17256
56228634,56229782,chr7,CCNJP1,chr7:56228634-56229782,1148
46455131,46515958,chr13,LINC01198,chr13:46455131-46515958,60827
121679972,121680459,chr6,RPL23AP48,chr6:121679972-121680459,487
70663502,70664279,chr6,SLC25A6P6,chr6:70663502-70664279,777
70412828,70413950,chr6,FAM135A-AS1,chr6:70412828-70413950,1122
37967563,37967624,chr22,MIR6820,chr22:37967563-37967624,61
7287392,7290402,chr8,FAM90A5P,chr8:7287392-7290402,3010
37988794,37988853,chr22,MIR4534,chr22:37988794-37988853,59
105096822,105137157,chr6,BVES,chr6:105096822-105137157,40335
84528122,84528830,chr7,RPL7P30,chr7:84528122-84528830,708
56805336,56808148,chr7,CICP28,chr7:56805336-56808148,2812
33010948,33011746,chr4,MAPRE1P2,chr4:33010948-33011746,798
83663419,83664625,chr7,RAD23BP2,chr7:83663419-83664625,1206
38056311,38075701,chr22,PICK1,chr22:38056311-38075701,19390
56362458,56365270,chr7,CICP8,chr7:56362458-56365270,2812
82754012,83162930,chr7,PCLO,chr7:82754012-83162930,408918
140859807,141212877,chr4,RNF150,chr4:140859807-141212877,353070
12721906,12756073,chr8,LONRF1,chr8:12721906-12756073,34167
75051048,75156732,chrX,ABCB7,chrX:75051048-75156732,105684
56517187,56526152,chr20,FAM209A,chr20:56517187-56526152,8965
127690348,127724873,chr9,PTRH1,chr9:127690348-127724873,34525
56533246,56536520,chr20,FAM209B,chr20:56533246-56536520,3274
56412112,56460387,chr20,CASS4,chr20:56412112-56460387,48275
37091314,37091806,chr6,RPL12P2,chr6:37091314-37091806,492
68424560,68424997,chr10,RPL26P29,chr10:68424560-68424997,437
109680442,109681041,chr10,XIAPP1,chr10:109680442-109681041,599
132961340,132962237,chr10,LINC01167,chr10:132961340-132962237,897
137543897,137544372,chr6,BTF3L4P3,chr6:137543897-137544372,475
122849078,122879641,chr10,FAM24B,chr10:122849078-122879641,30563
112087591,112102790,chr6,FAM229B,chr6:112087591-112102790,15199
96310701,96818864,chr4,LINC02267,chr4:96310701-96818864,508163
69027831,69044578,chr4,UGT2B26P,chr4:69027831-69044578,16747
127472794,127519191,chr6,SOGA3,chr6:127472794-127519191,46397
74890005,74902219,chr15,MPI,chr15:74890005-74902219,12214
35976493,35981497,chr17,CCL16,chr17:35976493-35981497,5004
13785007,13821580,chr20,NDUFAF5,chr20:13785007-13821580,36573
68038544,68039647,chr4,POLR2MP1,chr4:68038544-68039647,1103
118589997,118595648,chr10,PRLHR,chr10:118589997-118595648,5651
127690687,127690795,chr9,MIR3911,chr9:127690687-127690795,108
127706988,127716002,chr9,CFAP157,chr9:127706988-127716002,9014
75125217,75125862,chr10,RPS26P42,chr10:75125217-75125862,645
93729948,93784391,chr11,TAF1D,chr11:93729948-93784391,54443
122271296,122338159,chr10,BTBD16,chr10:122271296-122338159,66863
58984215,59046959,chr4,LINC02429,chr4:58984215-59046959,62744
34270221,34272242,chr17,CCL7,chr17:34270221-34272242,2021
141220887,141234697,chr4,ZNF330,chr4:141220887-141234697,13810
118959763,119149387,chr6,FAM184A,chr6:118959763-119149387,189624
17500012,17500605,chr8,SLC7A2-IT1,chr8:17500012-17500605,593
127716079,127731590,chr9,TTC16,chr9:127716079-127731590,15511
1565509,1622417,chr8,DLGAP2-AS1,chr8:1565509-1622417,56908
33109557,33877180,chr7,BBS9,chr7:33109557-33877180,767623
10054292,10428891,chr8,MSRA,chr8:10054292-10428891,374599
124397303,124418976,chr10,OAT,chr10:124397303-124418976,21673
36064272,36072032,chr17,CCL18,chr17:36064272-36072032,7760
127731524,127735313,chr9,TOR2A,chr9:127731524-127735313,3789
36072866,36090134,chr17,CCL3-AS1,chr17:36072866-36090134,17268
35996440,36001553,chr17,CCL15,chr17:35996440-36001553,5113
46211940,46277366,chr13,LRRC63,chr13:46211940-46277366,65426
68632371,68632727,chr10,COX20P1,chr10:68632371-68632727,356
138309613,138663403,chr4,LINC00499,chr4:138309613-138663403,353790
39737927,39747291,chr17,GRB7,chr17:39737927-39747291,9364
129467190,129770983,chr10,MGMT,chr10:129467190-129770983,303793
49237946,49278426,chr20,ZNFX1,chr20:49237946-49278426,40480
127738317,127778710,chr9,SH2D3C,chr9:127738317-127778710,40393
102714538,102743492,chr10,SFXN2,chr10:102714538-102743492,28954
100934023,100944553,chr13,LINC00411,chr13:100934023-100944553,10530
7332387,7333979,chr8,USP17L1,chr8:7332387-7333979,1592
38084652,38111015,chr22,BAIAP2L2,chr22:38084652-38111015,26363
14111968,14140052,chr4,LINC01085,chr4:14111968-14140052,28084
10474789,10475045,chr8,PRSS52P,chr8:10474789-10475045,256
12628476,12629256,chr8,RPS3AP35,chr8:12628476-12629256,780
7495911,7509311,chr8,DEFB107B,chr8:7495911-7509311,13400
979073,993440,chr4,SLC26A1,chr4:979073-993440,14367
101053776,101416508,chr13,NALCN,chr13:101053776-101416508,362732
5476548,5476966,chr8,RPL23AP54,chr8:5476548-5476966,418
7881392,7882663,chr8,DEFB103A,chr8:7881392-7882663,1271
85957175,86069882,chr11,PICALM,chr11:85957175-86069882,112707
21628089,21630064,chr22,YDJC,chr22:21628089-21630064,1975
20934435,20934837,chr8,TMEM97P2,chr8:20934435-20934837,402
22492631,22493044,chr8,BTF3P3,chr8:22492631-22493044,413
52051304,52097299,chr4,SPATA18,chr4:52051304-52097299,45995
7373114,7377500,chr8,DEFB108C,chr8:7373114-7377500,4386
49278178,49299600,chr20,ZFAS1,chr20:49278178-49299600,21422
22713251,23000000,chr8,PEBP4,chr8:22713251-23000000,286749
21632716,21637329,chr22,CCDC116,chr22:21632716-21637329,4613
7055304,7056739,chr8,DEFA5,chr8:7055304-7056739,1435
21797460,21797759,chr8,OR6R2P,chr8:21797460-21797759,299
14309033,14309672,chr8,EIF4EP5,chr8:14309033-14309672,639
21642302,21644299,chr22,SDF2L1,chr22:21642302-21644299,1997
10525532,10554166,chr8,PRSS55,chr8:10525532-10554166,28634
113751262,113783429,chr10,PLEKHS1,chr10:113751262-113783429,32167
88592434,88708541,chr4,HERC3,chr4:88592434-88708541,116107
21652981,21653058,chr22,MIR301B,chr22:21652981-21653058,77
21653304,21653385,chr22,MIR130B,chr22:21653304-21653385,81
6808517,6835524,chr8,XKR5,chr8:6808517-6835524,27007
21666000,21700015,chr22,PPIL2,chr22:21666000-21700015,34015
35983656,36001621,chr17,CCL15-CCL14,chr17:35983656-36001621,17965
10482878,10547585,chr8,PRSS51,chr8:10482878-10547585,64707
34169372,34195937,chr17,LINC01989,chr17:34169372-34195937,26565
49278940,49279028,chr20,SNORD12C,chr20:49278940-49279028,88
7768977,7771988,chr8,FAM90A10P,chr8:7768977-7771988,3011
49280319,49280409,chr20,SNORD12B,chr20:49280319-49280409,90
49280683,49280772,chr20,SNORD12,chr20:49280683-49280772,89
50731580,50756795,chr20,PARD6B,chr20:50731580-50756795,25215
7761330,7764340,chr8,FAM90A9P,chr8:7761330-7764340,3010
127785679,127790792,chr9,CDK9,chr9:127785679-127790792,5113
115992466,115992773,chrX,RN7SL712P,chrX:115992466-115992773,307
116043483,116044418,chrX,AKR1B1P8,chrX:116043483-116044418,935
8317736,8386439,chr8,PRAG1,chr8:8317736-8386439,68703
50840615,50840749,chr20,TMSB4XP6,chr20:50840615-50840749,134
116106921,116108430,chrX,API5P1,chrX:116106921-116108430,1509
133394094,133422520,chr10,MTG1,chr10:133394094-133422520,28426
116170744,116174974,chrX,AGTR2,chrX:116170744-116174974,4230
25803298,25804526,chr12,TDGP1,chr12:25803298-25804526,1228
50888916,50931437,chr20,ADNP,chr20:50888916-50931437,42521
38316762,38329721,chr12,ALG10B,chr12:38316762-38329721,12959
3066807,3219968,chr18,MYOM1,chr18:3066807-3219968,153161
129803288,129843909,chrX,ZDHHC9,chrX:129803288-129843909,40621
137193756,137198367,chr4,LINC02510,chr4:137193756-137198367,4611
151670504,151761007,chr4,GATB,chr4:151670504-151761007,90503
37084992,37406836,chr17,ACACA,chr17:37084992-37406836,321844
7295014,7298024,chr8,FAM90A20P,chr8:7295014-7298024,3010
7038571,7039439,chr8,DEFA7P,chr8:7038571-7039439,868
28943877,28944537,chr6,LINC01556,chr6:28943877-28944537,660
137945366,137972522,chr6,LINC02865,chr6:137945366-137972522,27156
200385,200562,chr8,SEPTIN14P8,chr8:200385-200562,177
142147162,142224685,chr6,VTA1,chr6:142147162-142224685,77523
20113343,20113672,chr8,RPL30P9,chr8:20113343-20113672,329
50112082,50120457,chr12,COX14,chr12:50112082-50120457,8375
7753682,7756692,chr8,FAM90A19P,chr8:7753682-7756692,3010
7976393,7977985,chr8,USP17L3,chr8:7976393-7977985,1592
127785833,127785923,chr9,MIR3960,chr9:127785833-127785923,90
127785918,127786007,chr9,MIR2861,chr9:127785918-127786007,89
7006293,7007389,chr8,DEFT1P2,chr8:7006293-7007389,1096
42687195,42717120,chr12,LINC02450,chr12:42687195-42717120,29925
127794597,127814327,chr9,FPGS,chr9:127794597-127814327,19730
7264526,7267536,chr8,FAM90A3P,chr8:7264526-7267536,3010
132943967,132965289,chr10,LINC01166,chr10:132943967-132965289,21322
133623895,133626795,chr10,FRG2B,chr10:133623895-133626795,2900
53993810,53996785,chr12,HOXC-AS2,chr12:53993810-53996785,2975
21690398,21812357,chr8,GFRA2,chr8:21690398-21812357,121959
68277745,68295862,chr15,FEM1B,chr15:68277745-68295862,18117
113010937,113011415,chr6,FCF1P10,chr6:113010937-113011415,478
40344344,40346151,chr6,LINC00951,chr6:40344344-40346151,1807
48688458,48716998,chr12,CCNT1,chr12:48688458-48716998,28540
116100851,116249497,chr6,NT5DC1,chr6:116100851-116249497,148646
88820297,88820432,chr14,RNU4-92P,chr14:88820297-88820432,135
89110148,89111223,chr14,MPPE1P1,chr14:89110148-89111223,1075
122990807,123008812,chr10,IKZF5,chr10:122990807-123008812,18005
129871309,129877567,chrX,SALL4P2,chrX:129871309-129877567,6258
50913731,50914411,chr20,PSMD10P1,chr20:50913731-50914411,680
129906121,129929761,chrX,UTP14A,chrX:129906121-129929761,23640
88824153,88881078,chr14,TTC8,chr14:88824153-88881078,56925
50930984,50945148,chr20,ADNP-AS1,chr20:50930984-50945148,14164
50958818,50963929,chr20,MOCS3,chr20:50958818-50963929,5111
97309138,97309958,chr10,RPL12P27,chr10:97309138-97309958,820
19823443,19823943,chr20,RPL12P12,chr20:19823443-19823943,500
102743948,102834516,chr10,WBP1L,chr10:102743948-102834516,90568
20017310,20033655,chr20,NAA20,chr20:20017310-20033655,16345
73994673,74047827,chr15,PML,chr15:73994673-74047827,53154
118572871,118573620,chr10,SLC25A18P1,chr10:118572871-118573620,749
102887874,102888188,chr10,RPL22P17,chr10:102887874-102888188,314
133664429,133665106,chr10,DUX4L28,chr10:133664429-133665106,677
125119049,125264407,chr6,TPD52L1,chr6:125119049-125264407,145358
125823546,125853695,chr10,BCCIP,chr10:125823546-125853695,30149
20034368,20056046,chr20,CRNKL1,chr20:20034368-20056046,21678
31073860,31104799,chr12,DDX11,chr12:31073860-31104799,30939
40056850,40158252,chr4,N4BP2,chr4:40056850-40158252,101402
129981107,130058071,chrX,BCORL1,chrX:129981107-130058071,76964
28679183,28683469,chr11,LINC02758,chr11:28679183-28683469,4286
87094734,87096585,chr11,XIAPP2,chr11:87094734-87096585,1851
94543840,94621421,chr11,PIWIL4,chr11:94543840-94621421,77581
13083361,13604610,chr8,DLC1,chr8:13083361-13604610,521249
115819842,115820487,chr10,NTAN1P1,chr10:115819842-115820487,645
132537787,132783480,chr10,INPP5A,chr10:132537787-132783480,245693
78979818,79002677,chr18,SALL3,chr18:78979818-79002677,22859
21697536,21735794,chr22,YPEL1,chr22:21697536-21735794,38258
108719946,108736563,chrX,IRS4,chrX:108719946-108736563,16617
15494566,15607236,chrX,ACE2,chrX:15494566-15607236,112670
56651343,57029811,chr18,WDR7,chr18:56651343-57029811,378468
21722895,21723182,chr22,RN7SL280P,chr22:21722895-21723182,287
147506091,147506765,chr4,GTF2F2P1,chr4:147506091-147506765,674
137448087,137448501,chr4,RPS23P2,chr4:137448087-137448501,414
20350578,20377251,chr22,USP41,chr22:20350578-20377251,26673
143577302,143700675,chr4,FREM3,chr4:143577302-143700675,123373
72836745,73142318,chr11,FCHSD2,chr11:72836745-73142318,305573
134327063,134328798,chr4,PES1P1,chr4:134327063-134328798,1735
103607451,103629690,chrX,TCEAL3,chrX:103607451-103629690,22239
94298535,94342876,chr4,HPGDS,chr4:94298535-94342876,44341
20394115,20408461,chr22,ZNF74,chr22:20394115-20408461,14346
137301001,137301187,chr4,SERF1AP1,chr4:137301001-137301187,186
137978547,138131182,chr4,LINC00616,chr4:137978547-138131182,152635
104681146,104722535,chr14,INF2,chr14:104681146-104722535,41389
104166453,104195902,chrX,FAM199X,chrX:104166453-104195902,29449
44270450,44307506,chr6,TMEM151B,chr6:44270450-44307506,37056
104250038,104254933,chrX,ESX1,chrX:104250038-104254933,4895
121178700,121185966,chr10,LINC01153,chr10:121178700-121185966,7266
102589372,102589813,chr13,LINC00555,chr13:102589372-102589813,441
124007668,124093598,chr10,CHST15,chr10:124007668-124093598,85930
41308166,41308565,chr6,RPL32P15,chr6:41308166-41308565,399
132518830,132519295,chr6,RPL21P66,chr6:132518830-132519295,465
276322,303356,chrX,PLCXD1,chrX:276322-303356,27034
20416797,20416899,chr22,RNU6-225P,chr22:20416797-20416899,102
46997708,47042350,chr6,ADGRF1,chr6:46997708-47042350,44642
102596986,102679958,chr13,TPP2,chr13:102596986-102679958,82972
20441519,20495844,chr22,KLHL22,chr22:20441519-20495844,54325
19757606,20002457,chr20,RIN2,chr20:19757606-20002457,244851
119683127,119683823,chr10,TXNP1,chr10:119683127-119683823,696
99013103,99013952,chr10,ARL5AP2,chr10:99013103-99013952,849
6941742,7117797,chr18,LAMA1,chr18:6941742-7117797,176055
154585133,154586816,chrX,CTAG1A,chrX:154585133-154586816,1683
20475203,20475311,chr22,RNY1P9,chr22:20475203-20475311,108
46719196,46739506,chr11,F2,chr11:46719196-46739506,20310
20481935,20482213,chr22,RN7SL812P,chr22:20481935-20482213,278
20482815,20484105,chr22,KRT18P5,chr22:20482815-20484105,1290
36136536,36163913,chr9,GLIPR2,chr9:36136536-36163913,27377
129645259,129654956,chrX,APLN,chrX:129645259-129654956,9697
3927309,4015558,chr20,RNF24,chr20:3927309-4015558,88249
23957414,23961195,chr22,GSTT2B,chr22:23957414-23961195,3781
129738949,129769536,chrX,XPNPEP2,chrX:129738949-129769536,30587
121989163,122254545,chr10,TACC2,chr10:121989163-122254545,265382
97366681,97491899,chr4,STPG2-AS1,chr4:97366681-97491899,125218
6950726,6951599,chr8,DEFA8P,chr8:6950726-6951599,873
133124104,133126063,chr4,R3HDM2P1,chr4:133124104-133126063,1959
7926337,7952413,chr8,ZNF705B,chr8:7926337-7952413,26076
36169388,36171334,chr9,CCIN,chr9:36169388-36171334,1946
129133106,129134098,chr4,CDRT15P11,chr4:129133106-129134098,992
80182637,80197410,chr4,PRDM8-AS1,chr4:80182637-80197410,14773
36267783,36267922,chr9,RNU4-53P,chr9:36267783-36267922,139
129779949,129795201,chrX,SASH3,chrX:129779949-129795201,15252
49502145,49506022,chr4,ANKRD20A17P,chr4:49502145-49506022,3877
128061233,128068206,chr9,NAIF1,chr9:128061233-128068206,6973
7143632,7143841,chr8,SNRPCP6,chr8:7143632-7143841,209
23966888,23972556,chr22,DDTL,chr22:23966888-23972556,5668
144646156,144745271,chr4,HHIP,chr4:144646156-144745271,99115
18774547,18774918,chr8,RPL35P6,chr8:18774547-18774918,371
12684154,12685153,chr8,OR7E8P,chr8:12684154-12685153,999
94706431,94876748,chr11,AMOTL1,chr11:94706431-94876748,170317
10050485,10054254,chr8,MSRA-DT,chr8:10050485-10054254,3769
93099513,93118023,chr7,SAMD9,chr7:93099513-93118023,18510
7564350,7567360,chr8,FAM90A21P,chr8:7564350-7567360,3010
125986479,126203817,chr6,TRMT11,chr6:125986479-126203817,217338
14084845,15238431,chr8,SGCZ,chr8:14084845-15238431,1153586
692498,705808,chr16,FBXL16,chr16:692498-705808,13310
128108581,128118693,chr9,SLC25A25-AS1,chr9:128108581-128118693,10112
53779783,53780263,chr7,RAC1P9,chr7:53779783-53780263,480
86216785,86217733,chr7,SOCS5P1,chr7:86216785-86217733,948
128128529,128130628,chr9,PTGES2-AS1,chr9:128128529-128130628,2099
24011192,24178628,chr22,CABIN1,chr22:24011192-24178628,167436
4023917,4024444,chr20,FTLP3,chr20:4023917-4024444,527
4059633,4060113,chr20,RPL21P2,chr20:4059633-4060113,480
128149071,128153453,chr9,LCN2,chr9:128149071-128153453,4382
1442162,1473842,chr20,NSFL1C,chr20:1442162-1473842,31680
47561205,47571908,chrX,ARAF,chrX:47561205-47571908,10703
12115767,12177550,chr8,FAM66D,chr8:12115767-12177550,61783
95478444,95540233,chr7,ASB4,chr7:95478444-95540233,61789
95025258,95027596,chr11,KDM4E,chr11:95025258-95027596,2338
81552226,81552516,chr11,MTND4LP18,chr11:81552226-81552516,290
97135015,97135561,chr7,HMGB3P21,chr7:97135015-97135561,546
78215293,78418348,chr11,GAB2,chr11:78215293-78418348,203055
63893286,63894641,chr7,GABPAP,chr7:63893286-63894641,1355
7811720,7815716,chr8,DEFB107A,chr8:7811720-7815716,3996
110673856,110795819,chrX,CHRDL1,chrX:110673856-110795819,121963
64108625,64110147,chr7,MTCO1P8,chr7:64108625-64110147,1522
81610884,81611326,chr7,DDX43P3,chr7:81610884-81611326,442
100539203,100568220,chr7,AGFG2,chr7:100539203-100568220,29017
20275773,20290458,chr8,LZTS1-AS1,chr8:20275773-20290458,14685
154781213,154828813,chr4,RBM46,chr4:154781213-154828813,47600
589357,629272,chr16,RAB40C,chr16:589357-629272,39915
8783354,8893630,chr8,MFHAS1,chr8:8783354-8893630,110276
39299001,39314461,chr6,KCNK17,chr6:39299001-39314461,15460
132367786,132368479,chr4,ELL2P2,chr4:132367786-132368479,693
128160265,128163924,chr9,BBLN,chr9:128160265-128163924,3659
148078762,148444698,chr4,NR3C2,chr4:148078762-148444698,365936
86832540,86833449,chr11,OR7E13P,chr11:86832540-86833449,909
10764961,10839884,chr8,PINX1,chr8:10764961-10839884,74923
95049422,95051338,chr11,KDM4F,chr11:95049422-95051338,1916
128275379,128316123,chr9,SWI5,chr9:128275379-128316123,40744
92412550,92447813,chr7,TMBIM7P,chr7:92412550-92447813,35263
89498748,89499198,chr11,H3P34,chr11:89498748-89499198,450
92528773,92540481,chr7,RBM48,chr7:92528773-92540481,11708
89710299,89717872,chr11,TRIM77,chr11:89710299-89717872,7573
132722787,132736935,chr6,VNN3,chr6:132722787-132736935,14148
110944285,111227361,chrX,PAK3,chrX:110944285-111227361,283076
86857059,86857947,chr11,OR7E2P,chr11:86857059-86857947,888
508568,515294,chr18,LINC01925,chr18:508568-515294,6726
89993536,89999741,chr11,TRIM53AP,chr11:89993536-89999741,6205
580380,582114,chr18,CETN1,chr18:580380-582114,1734
2268155,2273418,chr16,MIR3677HG,chr16:2268155-2273418,5263
586517,586850,chr18,RN7SKP146,chr18:586517-586850,333
95143637,95145125,chr11,BUD13P1,chr11:95143637-95145125,1488
2883213,2899382,chr16,FLYWCH2,chr16:2883213-2899382,16169
93661682,93730358,chr11,CEP295,chr11:93661682-93730358,68676
128305159,128322447,chr9,TRUB2,chr9:128305159-128322447,17288
657653,673578,chr18,TYMS,chr18:657653-673578,15925
88639014,88640416,chr7,EEF1A1P28,chr7:88639014-88640416,1402
91692008,91880702,chr7,MTERF1,chr7:91692008-91880702,188694
7934412,7938770,chr8,DEFB108A,chr8:7934412-7938770,4358
35953617,35959472,chr20,SCAND1,chr20:35953617-35959472,5855
567005,569495,chr16,NHLRC4,chr16:567005-569495,2490
17224966,17246878,chr8,CNOT7,chr8:17224966-17246878,21912
44714844,44728509,chr20,CCN5,chr20:44714844-44728509,13665
98617285,98629869,chr7,NPTX2,chr7:98617285-98629869,12584
128322544,128334072,chr9,COQ4,chr9:128322544-128334072,11528
649311,667833,chr16,WDR90,chr16:649311-667833,18522
151099624,151104642,chr4,RPS3A,chr4:151099624-151104642,5018
56163145,56163533,chr7,IFITM3P4,chr7:56163145-56163533,388
93969442,94011113,chr7,BET1-AS1,chr7:93969442-94011113,41671
92468380,92477986,chr7,ERVW-1,chr7:92468380-92477986,9606
32052197,32101856,chr20,HCK,chr20:32052197-32101856,49659
88794106,88795737,chr7,TEX47,chr7:88794106-88795737,1631
95976598,96343195,chr11,MAML2,chr11:95976598-96343195,366597
29024999,29031476,chr22,ZNRF3-AS1,chr22:29024999-29031476,6477
100015572,100041689,chr7,ZKSCAN1,chr7:100015572-100041689,26117
29073035,29168333,chr22,KREMEN1,chr22:29073035-29168333,95298
94962620,94973586,chr11,CWC15,chr11:94962620-94973586,10966
128340527,128361470,chr9,SLC27A4,chr9:128340527-128361470,20943
670318,712662,chr18,ENOSF1,chr18:670318-712662,42344
44467897,44468304,chr7,RPL32P18,chr7:44467897-44468304,407
90282560,90284172,chr11,TUBAP2,chr11:90282560-90284172,1612
29134014,29134120,chr22,RNU6-810P,chr22:29134014-29134120,106
90251204,90915052,chr11,DISC1FP1,chr11:90251204-90915052,663848
29191697,29191808,chr22,RNU6-1219P,chr22:29191697-29191808,111
97732084,97740472,chr7,TAC1,chr7:97732084-97740472,8388
29205896,29259597,chr22,EMID1,chr22:29205896-29259597,53701
111169221,111169403,chrX,FCF1P4,chrX:111169221-111169403,182
111229889,111231061,chrX,GLUD1P9,chrX:111229889-111231061,1172
111245099,111270483,chrX,CAPN6,chrX:111245099-111270483,25384
89293745,89294246,chr11,CBX3P7,chr11:89293745-89294246,501
7746034,7749044,chr8,FAM90A17P,chr8:7746034-7749044,3010
128342153,128342770,chr9,TMSB4XP4,chr9:128342153-128342770,617
81821272,82718299,chr11,MIR4300HG,chr11:81821272-82718299,897027
128371361,128392016,chr9,URM1,chr9:128371361-128392016,20655
111421510,111421608,chrX,RNU6-496P,chrX:111421510-111421608,98
111434427,111435024,chrX,HMGB1P12,chrX:111434427-111435024,597
111619677,111621489,chrX,EIF4BP7,chrX:111619677-111621489,1812
15417215,15766649,chr8,TUSC3,chr8:15417215-15766649,349434
56056590,56394094,chr6,COL21A1,chr6:56056590-56394094,337504
100644195,100675788,chrX,SRPX2,chrX:100644195-100675788,31593
94545330,94740355,chr11,PIWIL4-AS1,chr11:94545330-94740355,195025
54752250,54759974,chr7,SEC61G,chr7:54752250-54759974,7724
77717712,77718411,chr11,RSF1-IT2,chr11:77717712-77718411,699
77589391,77610356,chr11,AQP11,chr11:77589391-77610356,20965
39603536,39609777,chr17,NEUROD2,chr17:39603536-39609777,6241
46358188,46372773,chr12,SLC38A2,chr12:46358188-46372773,14585
67254786,67502260,chr15,IQCH,chr15:67254786-67502260,247474
72685075,72693808,chr11,ARAP1-AS1,chr11:72685075-72693808,8733
128392618,128392714,chr9,MIR219A2,chr9:128392618-128392714,96
128392621,128392708,chr9,MIR219B,chr9:128392621-128392708,87
94973709,94999519,chr11,KDM4D,chr11:94973709-94999519,25810
128468957,128473012,chr9,ODF2-AS1,chr9:128468957-128473012,4055
34889066,34895764,chr9,FAM205C,chr9:34889066-34895764,6698
93998643,93999218,chr11,HPRT1P3,chr11:93998643-93999218,575
32927910,32945106,chr17,TMEM98,chr17:32927910-32945106,17196
104036640,104039196,chr11,DDI1,chr11:104036640-104039196,2556
34917175,34918296,chr9,GLULP4,chr9:34917175-34918296,1121
34922184,34922921,chr9,YWHAZP6,chr9:34922184-34922921,737
55736779,55739605,chr7,CICP11,chr7:55736779-55739605,2826
97222644,97259987,chr11,LINC02553,chr11:97222644-97259987,37343
34957608,34982544,chr9,PHF24,chr9:34957608-34982544,24936
120362085,120383249,chrX,ATP1B4,chrX:120362085-120383249,21164
55595229,55636698,chr4,NMU,chr4:55595229-55636698,41469
101310914,101321823,chr7,IFT22,chr7:101310914-101321823,10909
89177875,89295759,chr11,TYR,chr11:89177875-89295759,117884
34985410,34989379,chr9,DNAJB5-DT,chr9:34985410-34989379,3969
35010703,35011285,chr9,SYF2P2,chr9:35010703-35011285,582
109196201,109196309,chr9,RNU6-984P,chr9:109196201-109196309,108
92027498,92027824,chr9,HSPE1P22,chr9:92027498-92027824,326
92108858,92108989,chr9,MTATP6P29,chr9:92108858-92108989,131
91114724,91115951,chr11,OSBPL9P2,chr11:91114724-91115951,1227
92109013,92110095,chr9,MTCO3P29,chr9:92109013-92110095,1082
92110168,92110514,chr9,MTND3P23,chr9:92110168-92110514,346
92110575,92110868,chr9,MTND4LP7,chr9:92110575-92110868,293
92110865,92111897,chr9,MTND4P15,chr9:92110865-92111897,1032
105706299,105707937,chr11,HSPD1P13,chr11:105706299-105707937,1638
92141298,92160114,chr9,LINC00475,chr9:92141298-92160114,18816
120426148,120469365,chrX,LAMP2,chrX:120426148-120469365,43217
102729367,102759072,chr13,CCDC168,chr13:102729367-102759072,29705
102711796,102727050,chr11,MMP8,chr11:102711796-102727050,15254
92171241,92173494,chr9,BEND3P2,chr9:92171241-92173494,2253
92177235,92191156,chr9,PRSS47,chr9:92177235-92191156,13921
54842008,54902826,chr14,GCH1,chr14:54842008-54902826,60818
102765888,102773811,chr13,TEX30,chr13:102765888-102773811,7923
92292458,92292547,chr9,MIR3651,chr9:92292458-92292547,89
92292461,92292593,chr9,SNORA84,chr9:92292461-92292593,132
37848597,37900397,chr7,NME8,chr7:37848597-37900397,51800
92297358,92325636,chr9,NOL8,chr9:92297358-92325636,28278
29259872,29268209,chr22,RHBDD3,chr22:29259872-29268209,8337
158201604,158255416,chr4,TMEM144,chr4:158201604-158255416,53812
87024583,87025777,chr11,HNRNPCP8,chr11:87024583-87025777,1194
106112459,106132116,chr11,LINC02719,chr11:106112459-106132116,19657
120503037,120503096,chrX,RNU7-37P,chrX:120503037-120503096,59
120594010,120621159,chrX,MCTS1,chrX:120594010-120621159,27149
90131515,90192894,chr11,NAALAD2,chr11:90131515-90192894,61379
1493344,1510457,chr16,TELO2,chr16:1493344-1510457,17113
49219347,49244077,chr20,DDX27,chr20:49219347-49244077,24730
120625674,120630054,chrX,C1GALT1C1,chrX:120625674-120630054,4380
120709061,120709392,chrX,H3P46,chrX:120709061-120709392,331
120733094,120733396,chrX,GLRX5P1,chrX:120733094-120733396,302
29268009,29300525,chr22,EWSR1,chr22:29268009-29300525,32516
70615547,70616567,chr15,SALRNA3,chr15:70615547-70616567,1020
15943127,15943532,chr8,RPL32P19,chr8:15943127-15943532,405
17469518,17471618,chr8,ADAM24P,chr8:17469518-17471618,2100
36601583,36608964,chr17,MRM1,chr17:36601583-36608964,7381
38078529,38078999,chr12,AK6P2,chr12:38078529-38078999,470
120505920,120604074,chrX,CUL4B,chrX:120505920-120604074,98154
55951877,55956500,chr7,MRPS17,chr7:55951877-55956500,4623
70796597,70802688,chr15,RPL29P30,chr15:70796597-70802688,6091
102784281,102798976,chr13,POGLUT2,chr13:102784281-102798976,14695
16992181,17002345,chr8,FGF20,chr8:16992181-17002345,10164
74919791,74938083,chr15,COX5A,chr15:74919791-74938083,18292
53746337,53757227,chr12,CISTR,chr12:53746337-53757227,10890
63594031,63595291,chr14,GCATP1,chr14:63594031-63595291,1260
63601509,63601814,chr14,HSPE1P2,chr14:63601509-63601814,305
49900311,49932764,chr12,LINC02395,chr12:49900311-49932764,32453
25118656,25125260,chr7,CYCS,chr7:25118656-25125260,6604
63618043,63618144,chr14,RNU6-597P,chr14:63618043-63618144,101
155274,155481,chr8,WBP1LP3,chr8:155274-155481,207
34255218,34257203,chr17,CCL2,chr17:34255218-34257203,1985
63630678,63630781,chr14,RNU6-1162P,chr14:63630678-63630781,103
7836436,7841242,chr8,DEFB104A,chr8:7836436-7841242,4806
63684216,63728065,chr14,SGPP1,chr14:63684216-63728065,43849
797989,798135,chr18,RNU1-109P,chr18:797989-798135,146
596988,650334,chr18,CLUL1,chr18:596988-650334,53346
7891003,7892555,chr8,HSPD1P2,chr8:7891003-7892555,1552
63734697,63735923,chr14,EIF2S2P1,chr14:63734697-63735923,1226
63736444,63736505,chr14,RNU7-116P,chr14:63736444-63736505,61
63808546,63808732,chr14,RPS28P1,chr14:63808546-63808732,186
64095024,64095125,chr14,MIR548H1,chr14:64095024-64095125,101
29748309,29798492,chr8,LINC02099,chr8:29748309-29798492,50183
40287879,40304657,chr17,CDC6,chr17:40287879-40304657,16778
74097106,74098414,chr15,COMMD4P2,chr15:74097106-74098414,1308
65960684,65982215,chr7,GUSB,chr7:65960684-65982215,21531
100657250,100676069,chr14,LINC00523,chr14:100657250-100676069,18819
74202705,74336472,chr15,CCDC33,chr15:74202705-74336472,133767
22687659,22693480,chr8,EGR3,chr8:22687659-22693480,5821
629239,634117,chr16,WFIKKN1,chr16:629239-634117,4878
100725705,100738224,chr14,DLK1,chr14:100725705-100738224,12519
102799110,102875994,chr13,BIVM-ERCC5,chr13:102799110-102875994,76884
25841725,26045413,chr8,EBF2,chr8:25841725-26045413,203688
102047437,102084554,chr11,CFAP300,chr11:102047437-102084554,37117
234521,272183,chr16,FAM234A,chr16:234521-272183,37662
53962308,53974956,chr12,HOTAIR,chr12:53962308-53974956,12648
102691487,102705769,chr11,MMP27,chr11:102691487-102705769,14282
39980807,39997959,chr17,PSMD3,chr17:39980807-39997959,17152
62183028,62203568,chr20,MTG2,chr20:62183028-62203568,20540
54630811,54634895,chr12,LACRT,chr12:54630811-54634895,4084
113581501,113581947,chr6,RPS27AP11,chr6:113581501-113581947,446
55732144,55732431,chr7,SUMO2P3,chr7:55732144-55732431,287
113904132,113921642,chr6,LINC02880,chr6:113904132-113921642,17510
86782357,86803409,chr7,GRM3-AS1,chr7:86782357-86803409,21052
3786772,3806121,chr20,CDC25B,chr20:3786772-3806121,19349
107176286,107177530,chr11,ASS1P13,chr11:107176286-107177530,1244
7231089,7232044,chr18,LRRC30,chr18:7231089-7232044,955
102799119,102841533,chr13,BIVM,chr13:102799119-102841533,42414
92487020,92528520,chr7,PEX1,chr7:92487020-92528520,41500
106051098,106077459,chr11,KBTBD3,chr11:106051098-106077459,26361
21242232,21526112,chr18,GREB1L,chr18:21242232-21526112,283880
100779410,100861031,chr14,MEG3,chr14:100779410-100861031,81621
49951512,49962924,chr12,AQP5-AS1,chr12:49951512-49962924,11412
134960378,135103056,chr6,HBS1L,chr6:134960378-135103056,142678
7738387,7741396,chr8,FAM90A8P,chr8:7738387-7741396,3009
38082046,38087392,chr12,CLUHP8,chr12:38082046-38087392,5346
146077717,146121913,chr4,LINC01095,chr4:146077717-146121913,44196
100687288,100993941,chr11,ARHGAP42,chr11:100687288-100993941,306653
27771949,27812640,chr8,ESCO2,chr8:27771949-27812640,40691
52565782,52573843,chr12,KRT74,chr12:52565782-52573843,8061
40872214,40874234,chr15,RHOV,chr15:40872214-40874234,2020
96902801,96903050,chr4,COX7A2P2,chr4:96902801-96903050,249
77157207,77433388,chr4,CCNG2,chr4:77157207-77433388,276181
75388267,75388828,chr15,RPL13P4,chr15:75388267-75388828,561
36450146,36457535,chr17,TBC1D3JP,chr17:36450146-36457535,7389
5432108,5521536,chr12,NTF3,chr12:5432108-5521536,89428
57953424,58497866,chr15,ALDH1A2,chr15:57953424-58497866,544442
43054089,43054386,chr12,MRPS36P5,chr12:43054089-43054386,297
30628988,30695869,chr12,IPO8,chr12:30628988-30695869,66881
89854953,89862893,chr11,TRIM51BP,chr11:89854953-89862893,7940
39757718,39864312,chr17,IKZF3,chr17:39757718-39864312,106594
94493979,94499578,chr11,ANKRD49,chr11:94493979-94499578,5599
614746,738106,chr8,ERICH1,chr8:614746-738106,123360
36297713,36780220,chr18,FHOD3,chr18:36297713-36780220,482507
77313606,77314032,chr11,TOMM20P1,chr11:77313606-77314032,426
100666459,100666962,chr11,PPIAP43,chr11:100666459-100666962,503
89776981,89782582,chr11,TRIM64DP,chr11:89776981-89782582,5601
155451617,155452405,chr4,MTCYBP17,chr4:155451617-155452405,788
144572238,144572983,chr4,KRT18P51,chr4:144572238-144572983,745
74652636,74652911,chr11,RANP3,chr11:74652636-74652911,275
90085950,90087131,chr11,UBTFL1,chr11:90085950-90087131,1181
73580253,73580517,chr11,HMGN2P38,chr11:73580253-73580517,264
145335263,145343559,chr4,LINC02266,chr4:145335263-145343559,8296
113815630,113845744,chr13,GAS6-AS1,chr13:113815630-113845744,30114
17246931,17302427,chr8,VPS37A,chr8:17246931-17302427,55496
102317450,102339403,chr11,BIRC3,chr11:102317450-102339403,21953
136795919,137212799,chr4,LINC02511,chr4:136795919-137212799,416880
45063473,45065351,chr12,RACGAP1P1,chr12:45063473-45065351,1878
113820549,113864076,chr13,GAS6,chr13:113820549-113864076,43527
50103982,50111313,chr12,GPD1,chr12:50103982-50111313,7331
153710160,153760024,chr4,RNF175,chr4:153710160-153760024,49864
110093392,110171841,chr11,ZC3H12C,chr11:110093392-110171841,78449
147637785,147684163,chr4,PRMT9,chr4:147637785-147684163,46378
45880950,45882266,chr12,KNOP1P2,chr12:45880950-45882266,1316
13566869,13568288,chr8,C8orf48,chr8:13566869-13568288,1419
52250466,52258867,chr12,KRT87P,chr12:52250466-52258867,8401
73051710,73305205,chr15,NEO1,chr15:73051710-73305205,253495
47463087,47463621,chr12,ADI1P3,chr12:47463087-47463621,534
49594091,49594258,chr12,POLR2KP1,chr12:49594091-49594258,167
53999022,54000010,chr12,HOXC-AS1,chr12:53999022-54000010,988
23841929,23854806,chr8,STC1,chr8:23841929-23854806,12877
158270378,158278676,chr4,AIDAP2,chr4:158270378-158278676,8298
89324353,89498187,chr11,NOX4,chr11:89324353-89498187,173834
43659827,43661101,chr12,EEF1A1P17,chr12:43659827-43661101,1274
113864112,113866834,chr13,GAS6-DT,chr13:113864112-113866834,2722
49791146,49828750,chr12,NCKAP5L,chr12:49791146-49828750,37604
30578318,30658236,chr8,GTF2E2,chr8:30578318-30658236,79918
113878489,113883651,chr13,LINC00454,chr13:113878489-113883651,5162
155206529,155209027,chr4,NPY2R-AS1,chr4:155206529-155209027,2498
145375543,145376253,chr4,RTN3P1,chr4:145375543-145376253,710
68061822,68063269,chr4,SYT14P1,chr4:68061822-68063269,1447
44008620,44010143,chr12,ZNF75BP,chr12:44008620-44010143,1523
47377638,47420192,chr12,LINC02156,chr12:47377638-47420192,42554
88695913,88697829,chr4,NAP1L5,chr4:88695913-88697829,1916
100190033,100215505,chr4,DDIT4L-AS1,chr4:100190033-100215505,25472
129903010,129904163,chr4,EEF1GP8,chr4:129903010-129904163,1153
155381042,155381239,chr4,YWHAEP4,chr4:155381042-155381239,197
113888306,113923512,chr13,LINC00452,chr13:113888306-113923512,35206
27284886,27311272,chr8,TRIM35,chr8:27284886-27311272,26386
4649095,4694317,chr12,NDUFA9,chr12:4649095-4694317,45222
93232340,93361123,chr7,VPS50,chr7:93232340-93361123,128783
2536573,2643580,chr20,TMC2,chr20:2536573-2643580,107007
123745750,123746226,chr4,RPL21P50,chr4:123745750-123746226,476
92325953,92620529,chr9,CENPP,chr9:92325953-92620529,294576
154604134,154612967,chr4,FGG,chr4:154604134-154612967,8833
325552,330224,chr20,SOX12,chr20:325552-330224,4672
113923052,113928991,chr13,LINC00565,chr13:113923052-113928991,5939
23747562,23751268,chr20,CST1,chr20:23747562-23751268,3706
48037726,48047221,chr13,NUDT15,chr13:48037726-48047221,9495
92383268,92404696,chr9,OGN,chr9:92383268-92404696,21428
7170550,7170741,chr8,SNRPCP15,chr8:7170550-7170741,191
23685640,23689038,chr20,CST4,chr20:23685640-23689038,3398
36278960,36279483,chr8,MTND6P19,chr8:36278960-36279483,523
33485182,33501262,chr8,MAK16,chr8:33485182-33501262,16080
48053323,48095131,chr13,MED4,chr13:48053323-48095131,41808
53567071,53609907,chr20,ZNF217,chr20:53567071-53609907,42836
287440,352723,chr16,AXIN1,chr16:287440-352723,65283
108708539,108840686,chr10,LINC02661,chr10:108708539-108840686,132147
29306582,29312785,chr22,GAS2L1,chr22:29306582-29312785,6203
113550837,113589602,chr10,HABP2,chr10:113550837-113589602,38765
3249306,3407669,chr20,DNAAF9,chr20:3249306-3407669,158363
47221,49615,chr18,TUBB8B,chr18:47221-49615,2394
19901717,19967259,chr8,LPL,chr8:19901717-19967259,65542
12328944,12377227,chr18,AFG3L2,chr18:12328944-12377227,48283
92456205,92482506,chr9,ASPN,chr9:92456205-92482506,26301
135751119,135752583,chrX,MGAT2P2,chrX:135751119-135752583,1464
34208415,34209675,chr12,DUX4L27,chr12:34208415-34209675,1260
135759846,135768191,chrX,CT45A3,chrX:135759846-135768191,8345
125473686,125473932,chr10,RPS27P18,chr10:125473686-125473932,246
117197489,117210299,chr10,KCNK18,chr10:117197489-117210299,12810
135777130,135785298,chrX,CT45A5,chrX:135777130-135785298,8168
124445243,124450035,chr10,NKX1-2,chr10:124445243-124450035,4792
53368670,53369009,chr6,RPL31P33,chr6:53368670-53369009,339
124461823,124617888,chr10,LHPP,chr10:124461823-124617888,156065
104936616,105083332,chr6,LIN28B,chr6:104936616-105083332,146716
57229573,57234935,chr12,SHMT2,chr12:57229573-57234935,5362
135794685,135802787,chrX,CT45A6,chrX:135794685-135802787,8102
124664048,124712732,chr4,ANKRD50,chr4:124664048-124712732,48684
92527984,92528058,chr9,MIR4670,chr9:92527984-92528058,74
135811668,135820012,chrX,CT45A2,chrX:135811668-135820012,8344
92613183,92670131,chr9,IPPK,chr9:92613183-92670131,56948
34189780,34191079,chr6,KRT18P9,chr6:34189780-34191079,1299
135846497,135854538,chrX,CT45A8,chrX:135846497-135854538,8041
16360686,16397323,chr4,ZEB2P1,chr4:16360686-16397323,36637
159007119,159007835,chr4,PSME2P3,chr4:159007119-159007835,716
125836337,125896436,chr10,DHX32,chr10:125836337-125896436,60099
122779716,122784074,chr6,FABP7,chr6:122779716-122784074,4358
141569931,141576077,chr4,LINC02276,chr4:141569931-141576077,6146
7272148,7275158,chr8,FAM90A4P,chr8:7272148-7275158,3010
165404067,165406350,chr4,HADHAP1,chr4:165404067-165406350,2283
45888625,45891208,chr20,NEURL2,chr20:45888625-45891208,2583
168863770,169010275,chr4,CBR4,chr4:168863770-169010275,146505
135863418,135871812,chrX,CT45A9,chrX:135863418-135871812,8394
48077137,48079991,chr13,MED4-AS1,chr13:48077137-48079991,2854
48134358,48134534,chr13,POLR2KP2,chr13:48134358-48134534,176
125956770,125980244,chr6,HINT3,chr6:125956770-125980244,23474
678504,679777,chr16,STUB1-DT,chr16:678504-679777,1273
135960588,135974029,chrX,MMGT1,chrX:135960588-135974029,13441
48771128,48771827,chr13,PSME2P2,chr13:48771128-48771827,699
29312933,29319679,chr22,RASL10A,chr22:29312933-29319679,6746
3888839,3929887,chr20,PANK2,chr20:3888839-3929887,41048
52236681,52244500,chr6,IL17F,chr6:52236681-52244500,7819
28890395,29064764,chr8,HMBOX1,chr8:28890395-29064764,174369
139924148,139924231,chrX,MIR505,chrX:139924148-139924231,83
139955728,139965521,chrX,CXorf66,chrX:139955728-139965521,9793
48303744,48599436,chr13,RB1,chr13:48303744-48599436,295692
140032344,140033480,chrX,HNRNPA3P3,chrX:140032344-140033480,1136
2088708,2135898,chr16,PKD1,chr16:2088708-2135898,47190
140085855,140086150,chrX,RN7SL727P,chrX:140085855-140086150,295
29333163,29333258,chr22,SNORD125,chr22:29333163-29333258,95
132674885,132675383,chr6,HLFP1,chr6:132674885-132675383,498
126627484,126628570,chr6,YAP1P3,chr6:126627484-126628570,1086
111293779,111412429,chrX,DCX,chrX:111293779-111412429,118650
95991107,95992349,chr6,KRT18P50,chr6:95991107-95992349,1242
150934968,150935566,chr6,ARL4AP5,chr6:150934968-150935566,598
49358185,49360420,chr6,EEF1A1P42,chr6:49358185-49360420,2235
29432944,29435005,chr22,RFPL4AP6,chr22:29432944-29435005,2061
156634494,156642454,chr4,LINC02272,chr4:156634494-156642454,7960
29436534,29478868,chr22,RFPL1S,chr22:29436534-29478868,42334
116460739,116463692,chr6,CALHM6-AS1,chr6:116460739-116463692,2953
83834099,83921465,chr9,KIF27,chr9:83834099-83921465,87366
137425426,137425864,chr4,STMN1P2,chr4:137425426-137425864,438
89364616,89412273,chr6,RRAGD,chr6:89364616-89412273,47657
98740742,98741231,chr4,BTF3P13,chr4:98740742-98741231,489
125574371,125578445,chr10,TEX36-AS1,chr10:125574371-125578445,4074
29438583,29442455,chr22,RFPL1,chr22:29438583-29442455,3872
122458551,122514907,chr10,HTRA1,chr10:122458551-122514907,56356
142933195,143184861,chr4,USP38-DT,chr4:142933195-143184861,251666
30005971,30009956,chr6,HLA-J,chr6:30005971-30009956,3985
29480218,29491390,chr22,NEFH,chr22:29480218-29491390,11172
127781821,127840733,chr4,HSPA4L,chr4:127781821-127840733,58912
29505879,29555216,chr22,THOC5,chr22:29505879-29555216,49337
70734503,70734962,chr6,NDUFAB1P1,chr6:70734503-70734962,459
79679803,79754503,chr18,CTDP1,chr18:79679803-79754503,74700
13714322,13784919,chr20,ESF1,chr20:13714322-13784919,70597
16788879,16790501,chr17,FAM106C,chr17:16788879-16790501,1622
36103827,36105621,chr17,CCL4,chr17:36103827-36105621,1794
130839347,131063322,chr6,EPB41L2,chr6:130839347-131063322,223975
23180979,23325162,chr13,SGCG,chr13:23180979-23325162,144183
100814491,100814574,chr14,MIR2392,chr14:100814491-100814574,83
100852390,100852487,chr14,MIR770,chr14:100852390-100852487,97
100869060,100869148,chr14,MIR493,chr14:100869060-100869148,88
100874493,100874585,chr14,MIR337,chr14:100874493-100874585,92
39671122,39696797,chr17,PGAP3,chr17:39671122-39696797,25675
100875033,100875104,chr14,MIR665,chr14:100875033-100875104,71
100881007,100881120,chr14,MIR431,chr14:100881007-100881120,113
100881886,100881978,chr14,MIR433,chr14:100881886-100881978,92
100882979,100883075,chr14,MIR127,chr14:100882979-100883075,96
100884483,100884576,chr14,MIR432,chr14:100884483-100884576,93
100884702,100884783,chr14,MIR136,chr14:100884702-100884783,81
50934867,50959140,chr20,DPM1,chr20:50934867-50959140,24273
100894770,101038859,chr14,MEG8,chr14:100894770-101038859,144089
83938311,83956986,chr9,C9orf64,chr9:83938311-83956986,18675
79311824,79406477,chr13,RBM26,chr13:79311824-79406477,94653
18391282,18401218,chr8,NAT2,chr8:18391282-18401218,9936
83968083,83980616,chr9,HNRNPK,chr9:83968083-83980616,12533
128096659,128126423,chr10,MKI67,chr10:128096659-128126423,29764
7122857,7123704,chr8,RPS3AP30,chr8:7122857-7123704,847
77420412,77485607,chr15,HMG20A,chr15:77420412-77485607,65195
13770939,13938638,chrX,GPM6B,chrX:13770939-13938638,167699
93188534,93226469,chr7,HEPACAM2,chr7:93188534-93226469,37935
51003656,51023107,chr20,KCNG1,chr20:51003656-51023107,19451
44680173,45068510,chr18,SETBP1,chr18:44680173-45068510,388337
10723768,10730511,chr8,SOX7,chr8:10723768-10730511,6743
128809700,128875224,chr4,JADE1,chr4:128809700-128875224,65524
45702038,45708817,chr20,WFDC13,chr20:45702038-45708817,6779
45705102,45705180,chr20,MIR3617,chr20:45705102-45705180,78
45722347,45725830,chr20,SPINT4,chr20:45722347-45725830,3483
20144855,20183206,chr8,SLC18A1,chr8:20144855-20183206,38351
117277274,117375440,chr10,PDZD8,chr10:117277274-117375440,98166
40219304,40284136,chr17,WIPF2,chr17:40219304-40284136,64832
45890144,45898949,chr20,CTSA,chr20:45890144-45898949,8805
133756559,133757825,chr10,DUX4L14,chr10:133756559-133757825,1266
122910610,122913111,chr10,FAM24A,chr10:122910610-122913111,2501
125576522,125683163,chr10,TEX36,chr10:125576522-125683163,106641
32760279,32762924,chr7,LINC00997,chr7:32760279-32762924,2645
64106065,64106819,chr7,MTCO3P8,chr7:64106065-64106819,754
97885868,97886074,chr7,SNRPCP9,chr7:97885868-97886074,206
58044226,58401540,chr18,NEDD4L,chr18:58044226-58401540,357314
101195007,101201038,chr7,MOGAT3,chr7:101195007-101201038,6031
117734510,117753329,chr10,LINC02674,chr10:117734510-117753329,18819
14006726,14029893,chrX,GEMIN8,chrX:14006726-14029893,23167
131095218,131095777,chr10,TCERG1L-AS1,chr10:131095218-131095777,559
102452919,102462008,chr11,TMEM123-DT,chr11:102452919-102462008,9089
67056847,67072017,chr11,RHOD,chr11:67056847-67072017,15170
75724041,75727688,chr15,ODF3L1,chr15:75724041-75727688,3647
110002631,110182734,chrX,TMEM164,chrX:110002631-110182734,180103
124748149,124791887,chr10,EEF1AKMT2,chr10:124748149-124791887,43738
100897920,100897996,chr14,SNORD112,chr14:100897920-100897996,76
100911139,100911213,chr14,MIR370,chr14:100911139-100911213,74
100924824,100924892,chr14,SNORD113-1,chr14:100924824-100924892,68
100927342,100927413,chr14,SNORD113-2,chr14:100927342-100927413,71
100929919,100929990,chr14,SNORD113-3,chr14:100929919-100929990,71
100936491,100936565,chr14,SNORD113-4,chr14:100936491-100936565,74
100938187,100938264,chr14,SNORD113-5,chr14:100938187-100938264,77
100939556,100939630,chr14,SNORD113-6,chr14:100939556-100939630,74
100941126,100941202,chr14,SNORD113-7,chr14:100941126-100941202,76
100943451,100943524,chr14,SNORD113-8,chr14:100943451-100943524,73
36544912,36589848,chr17,GGNBP2,chr17:36544912-36589848,44936
100945649,100945720,chr14,SNORD113-9,chr14:100945649-100945720,71
74445977,74461182,chr15,UBL7,chr15:74445977-74461182,15205
100949833,100949904,chr14,SNORD114-1,chr14:100949833-100949904,71
100951856,100951933,chr14,SNORD114-2,chr14:100951856-100951933,77
100953349,100953423,chr14,SNORD114-3,chr14:100953349-100953423,74
87718354,87719411,chr11,LINC02711,chr11:87718354-87719411,1057
100954374,100954448,chr14,SNORD114-4,chr14:100954374-100954448,74
100955370,100955439,chr14,SNORD114-5,chr14:100955370-100955439,69
55764797,55773288,chr7,PSPHP1,chr7:55764797-55773288,8491
100957166,100957237,chr14,SNORD114-6,chr14:100957166-100957237,71
100963054,100963130,chr14,SNORD114-7,chr14:100963054-100963130,76
35768652,36131382,chr13,DCLK1,chr13:35768652-36131382,362730
93721513,93721865,chr11,SCARNA9,chr11:93721513-93721865,352
100966029,100966100,chr14,SNORD114-9,chr14:100966029-100966100,71
56502284,56503044,chr7,NMD3P2,chr7:56502284-56503044,760
100967052,100967123,chr14,SNORD114-10,chr14:100967052-100967123,71
100968111,100968185,chr14,SNORD114-11,chr14:100968111-100968185,74
100968948,100969022,chr14,SNORD114-12,chr14:100968948-100969022,74
110055329,110055426,chrX,MIR652,chrX:110055329-110055426,97
110082118,110082218,chrX,MIR3978,chrX:110082118-110082218,100
100969879,100969952,chr14,SNORD114-13,chr14:100969879-100969952,73
110224985,110225063,chrX,SNORD96B,chrX:110224985-110225063,78
100972103,100972177,chr14,SNORD114-14,chr14:100972103-100972177,74
110305420,110307221,chrX,AMMECR1-IT1,chrX:110305420-110307221,1801
100972670,100972741,chr14,SNORD114-15,chr14:100972670-100972741,71
100973595,100973664,chr14,SNORD114-16,chr14:100973595-100973664,69
110358816,110456334,chrX,RTL9,chrX:110358816-110456334,97518
100974806,100974880,chr14,SNORD114-17,chr14:100974806-100974880,74
100975825,100975896,chr14,SNORD114-18,chr14:100975825-100975896,71
100976477,100976551,chr14,SNORD114-19,chr14:100976477-100976551,74
100981004,100981075,chr14,SNORD114-20,chr14:100981004-100981075,71
100981975,100982046,chr14,SNORD114-21,chr14:100981975-100982046,71
96518110,96587452,chr10,TM9SF3,chr10:96518110-96587452,69342
100982926,100982997,chr14,SNORD114-22,chr14:100982926-100982997,71
100983876,100983947,chr14,SNORD114-23,chr14:100983876-100983947,71
100984777,100984848,chr14,SNORD114-24,chr14:100984777-100984848,71
100986057,100986128,chr14,SNORD114-25,chr14:100986057-100986128,71
100987046,100987117,chr14,SNORD114-26,chr14:100987046-100987117,71
119758588,119760202,chrX,SOWAHD,chrX:119758588-119760202,1614
100988161,100988230,chr14,SNORD114-27,chr14:100988161-100988230,69
107928448,107963482,chr11,RAB39A,chr11:107928448-107963482,35034
100989130,100989201,chr14,SNORD114-28,chr14:100989130-100989201,71
119786504,119791630,chrX,RPL39,chrX:119786504-119791630,5126
100990091,100990160,chr14,SNORD114-29,chr14:100990091-100990160,69
100991919,100991990,chr14,SNORD114-30,chr14:100991919-100991990,71
100993236,100993310,chr14,SNORD114-31,chr14:100993236-100993310,74
101022066,101022132,chr14,MIR379,chr14:101022066-101022132,66
101023325,101023420,chr14,MIR411,chr14:101023325-101023420,95
101023794,101023856,chr14,MIR299,chr14:101023794-101023856,62
101025017,101025077,chr14,MIR380,chr14:101025017-101025077,60
101025564,101025651,chr14,MIR1197,chr14:101025564-101025651,87
101025732,101025817,chr14,MIR323A,chr14:101025732-101025817,85
101026020,101026107,chr14,MIR758,chr14:101026020-101026107,87
101026785,101026864,chr14,MIR329-1,chr14:101026785-101026864,79
101027100,101027183,chr14,MIR329-2,chr14:101027100-101027183,83
63342711,63343200,chr7,ARAFP3,chr7:63342711-63343200,489
101029634,101029714,chr14,MIR494,chr14:101029634-101029714,80
119787353,119787484,chrX,SNORA69,chrX:119787353-119787484,131
101030052,101030129,chr14,MIR1193,chr14:101030052-101030129,77
101031987,101032064,chr14,MIR543,chr14:101031987-101032064,77
101033755,101033836,chr14,MIR495,chr14:101033755-101033836,81
101039690,101039755,chr14,MIR376C,chr14:101039690-101039755,65
101040069,101040148,chr14,MIR376A2,chr14:101040069-101040148,79
101040219,101040299,chr14,MIR654,chr14:101040219-101040299,80
119805311,119852998,chrX,UPF3B,chrX:119805311-119852998,47687
101040436,101040535,chr14,MIR376B,chr14:101040436-101040535,99
101040782,101040849,chr14,MIR376A1,chr14:101040782-101040849,67
101041363,101041445,chr14,MIR300,chr14:101041363-101041445,82
101042977,101043062,chr14,MIR1185-1,chr14:101042977-101043062,85
101044198,101044283,chr14,MIR1185-2,chr14:101044198-101044283,85
52446651,52452146,chr12,KRT6B,chr12:52446651-52452146,5495
101045157,101051795,chr14,MIR381HG,chr14:101045157-101051795,6638
101045920,101045994,chr14,MIR381,chr14:101045920-101045994,74
101046455,101046538,chr14,MIR487B,chr14:101046455-101046538,83
101047321,101047398,chr14,MIR539,chr14:101047321-101047398,77
93784227,93814963,chr11,MED17,chr11:93784227-93814963,30736
101047901,101047979,chr14,MIR889,chr14:101047901-101047979,78
101048658,101048748,chr14,MIR544A,chr14:101048658-101048748,90
101049550,101049646,chr14,MIR655,chr14:101049550-101049646,96
101052446,101052525,chr14,MIR487A,chr14:101052446-101052525,79
101054306,101054381,chr14,MIR382,chr14:101054306-101054381,75
68049706,68050478,chr4,MTND2P41,chr4:68049706-68050478,772
101054687,101054759,chr14,MIR134,chr14:101054687-101054759,72
101055258,101055323,chr14,MIR668,chr14:101055258-101055323,65
101055419,101055491,chr14,MIR485,chr14:101055419-101055491,72
101056219,101056300,chr14,MIR323B,chr14:101056219-101056300,81
101059755,101059838,chr14,MIR154,chr14:101059755-101059838,83
101060573,101060674,chr14,MIR496,chr14:101060573-101060674,101
101062050,101062118,chr14,MIR377,chr14:101062050-101062118,68
101064495,101064578,chr14,MIR541,chr14:101064495-101064578,83
101065300,101065378,chr14,MIR409,chr14:101065300-101065378,78
20564538,20564889,chr17,COTL1P2,chr17:20564538-20564889,351
101065447,101065537,chr14,MIR412,chr14:101065447-101065537,90
101065598,101065667,chr14,MIR369,chr14:101065598-101065667,69
101065912,101065991,chr14,MIR410,chr14:101065912-101065991,79
38722974,38932394,chr7,VPS41,chr7:38722974-38932394,209420
101066724,101066801,chr14,MIR656,chr14:101066724-101066801,77
101068283,101072937,chr14,MEG9,chr14:101068283-101072937,4654
20493634,20494155,chr17,KRT16P5,chr17:20493634-20494155,521
56470944,56488414,chr12,GLS2,chr12:56470944-56488414,17470
29554808,29581327,chr22,NIPSNAP1,chr22:29554808-29581327,26519
86594315,86815171,chr4,PTPN13,chr4:86594315-86815171,220856
19904302,19978343,chr17,AKAP10,chr17:19904302-19978343,74041
101120840,101123545,chr14,LINC02285,chr14:101120840-101123545,2705
119870475,119871733,chrX,RNF113A,chrX:119870475-119871733,1258
119871832,119876662,chrX,NDUFA1,chrX:119871832-119876662,4830
19344578,19384587,chr14,LINC01297,chr14:19344578-19384587,40009
19371822,19373490,chr14,GRAMD4P3,chr14:19371822-19373490,1668
119895837,119920716,chrX,AKAP14,chrX:119895837-119920716,24879
19402486,19434341,chr14,POTEG,chr14:19402486-19434341,31855
29603556,29698598,chr22,NF2,chr22:29603556-29698598,95042
2155698,2178129,chr16,TRAF7,chr16:2155698-2178129,22431
119920672,119943751,chrX,NKAP,chrX:119920672-119943751,23079
19422815,19422921,chr14,RNU6-1268P,chr14:19422815-19422921,106
19485336,19489148,chr14,MED15P6,chr14:19485336-19489148,3812
97446170,97457370,chr10,ZDHHC16,chr10:97446170-97457370,11200
83969748,83969857,chr9,MIR7-1,chr9:83969748-83969857,109
33370824,33473146,chr8,FUT10,chr8:33370824-33473146,102322
24680408,24712472,chr13,ATP12A,chr13:24680408-24712472,32064
36194869,36196758,chr17,CCL3L3,chr17:36194869-36196758,1889
19688261,19691194,chr14,ARHGAP42P4,chr14:19688261-19691194,2933
35605262,35610041,chr9,TESK1,chr9:35605262-35610041,4779
41514934,41923554,chrX,CASK,chrX:41514934-41923554,408620
19719015,19830253,chr14,OR4N2,chr14:19719015-19830253,111238
19733355,19734302,chr14,OR11K2P,chr14:19733355-19734302,947
19759868,19760774,chr14,OR4H12P,chr14:19759868-19760774,906
19796345,19797293,chr14,OR4N1P,chr14:19796345-19797293,948
19847367,19848263,chr14,OR4K6P,chr14:19847367-19848263,896
37406886,37479725,chr17,TADA2A,chr17:37406886-37479725,72839
19868197,19869143,chr14,OR4K3,chr14:19868197-19869143,946
19905917,19906600,chr14,OR4K4P,chr14:19905917-19906600,683
7312846,7319951,chr8,DEFB109B,chr8:7312846-7319951,7105
24052009,24069729,chr14,CARMIL3,chr14:24052009-24069729,17720
94913047,94913766,chr11,ST13P11,chr11:94913047-94913766,719
94021354,94114208,chr11,HEPHL1,chr11:94021354-94114208,92854
35235475,35796550,chr8,UNC5D,chr8:35235475-35796550,561075
106489745,106535662,chr13,EFNB2,chr13:106489745-106535662,45917
2275881,2340746,chr16,ABCA3,chr16:2275881-2340746,64865
35608094,35608159,chr9,MIR4667,chr9:35608094-35608159,65
95089846,95132645,chr11,ENDOD1,chr11:95089846-95132645,42799
35657751,35658018,chr9,RMRP,chr9:35657751-35658018,267
35658290,35661511,chr9,CCDC107,chr9:35658290-35661511,3221
93818232,93850618,chr11,VSTM5,chr11:93818232-93850618,32386
92245974,92401383,chr7,ANKIB1,chr7:92245974-92401383,155409
94512461,94532123,chr11,C11orf97,chr11:94512461-94532123,19662
67627852,67629135,chr15,HNRNPA1P5,chr15:67627852-67629135,1283
89797655,89808575,chr11,TRIM49,chr11:89797655-89808575,10920
42040036,42256578,chr13,DGKH,chr13:42040036-42256578,216542
68778535,68820897,chr15,ANP32A,chr15:68778535-68820897,42362
24078662,24115010,chr14,NRL,chr14:24078662-24115010,36348
93885396,93890753,chr7,TFPI2,chr7:93885396-93890753,5357
35658875,35675866,chr9,ARHGEF39,chr9:35658875-35675866,16991
65261920,65305589,chr11,POLA2,chr11:65261920-65305589,43669
38335041,38335514,chr7,TRGV7,chr7:38335041-38335514,473
24094053,24110598,chr14,PCK2,chr14:24094053-24110598,16545
86876906,87059654,chr7,ELAPOR2,chr7:86876906-87059654,182748
35671776,35672044,chr9,RN7SL22P,chr9:35671776-35672044,268
35681992,35690056,chr9,TPM2,chr9:35681992-35690056,8064
16374618,16375082,chr8,MRPL49P2,chr8:16374618-16375082,464
6959289,6960161,chr8,DEFA9P,chr8:6959289-6960161,872
32970376,32997877,chr17,SPACA3,chr17:32970376-32997877,27501
20972021,20995119,chr8,LINC02153,chr8:20972021-20995119,23098
54644589,54648493,chr12,DCD,chr12:54644589-54648493,3904
74748845,74756607,chr15,CYP1A2,chr15:74748845-74756607,7762
16107878,16567490,chr8,MSR1,chr8:16107878-16567490,459612
38847860,38853764,chr17,RPL23,chr17:38847860-38853764,5904
50182196,50236385,chr15,SLC27A2,chr15:50182196-50236385,54189
34164773,34166954,chr12,TUBB8P4,chr12:34164773-34166954,2181
89639237,89698718,chr11,FOLH1B,chr11:89639237-89698718,59481
47661249,47706030,chr12,RPAP3,chr12:47661249-47706030,44781
46060991,46089962,chr20,NCOA5,chr20:46060991-46089962,28971
88113251,88175443,chr11,RAB38,chr11:88113251-88175443,62192
68683779,68691175,chr11,GAL,chr11:68683779-68691175,7396
46099518,46100176,chr20,RPL13P2,chr20:46099518-46100176,658
46118278,46129863,chr20,CD40,chr20:46118278-46129863,11585
53862233,53863339,chr7,HAUS6P3,chr7:53862233-53863339,1106
39626740,39636626,chr17,PPP1R1B,chr17:39626740-39636626,9886
94907202,95296415,chr7,PPP1R9A,chr7:94907202-95296415,389213
49156329,49156847,chr15,NDUFAF4P1,chr15:49156329-49156847,518
102746968,102836766,chr11,WTAPP1,chr11:102746968-102836766,89798
78437431,78501453,chr15,IREB2,chr15:78437431-78501453,64022
11555,14090,chr16,DDX11L10,chr16:11555-14090,2535
52715567,52721655,chr12,KRT126P,chr12:52715567-52721655,6088
102520508,102530750,chr11,MMP7,chr11:102520508-102530750,10242
35696948,35732195,chr9,TLN1,chr9:35696948-35732195,35247
2140803,2154165,chr16,RAB26,chr16:2140803-2154165,13362
52768155,52777345,chr12,KRT76,chr12:52768155-52777345,9190
26433029,26434065,chr8,DNAJB6P2,chr8:26433029-26434065,1036
24114195,24125242,chr14,DCAF11,chr14:24114195-24125242,11047
107790991,107928293,chr11,SLC35F2,chr11:107790991-107928293,137302
41698495,41699182,chr12,MTND2P17,chr12:41698495-41699182,687
53985065,53990279,chr12,HOXC10,chr12:53985065-53990279,5214
26514031,26658178,chr8,DPYSL2,chr8:26514031-26658178,144147
36890229,36951893,chr20,SAMHD1,chr20:36890229-36951893,61664
45729706,45908040,chr12,ARID2,chr12:45729706-45908040,178334
102576832,102625332,chr11,MMP20,chr11:102576832-102625332,48500
35934518,35943713,chr17,LYZL6,chr17:35934518-35943713,9195
22910,25123,chr16,WASIR2,chr16:22910-25123,2213
1444934,1475084,chr16,CLCN7,chr16:1444934-1475084,30150
40439467,40439917,chr17,RPL23AP75,chr17:40439467-40439917,450
91794319,91872086,chr11,LINC02756,chr11:91794319-91872086,77767
38078262,38124770,chr17,NPEPPSP1,chr17:38078262-38124770,46508
38351844,38405593,chr17,SOCS7,chr17:38351844-38405593,53749
67521131,67530146,chr15,C15orf61,chr15:67521131-67530146,9015
73376399,73397474,chr11,RELT,chr11:73376399-73397474,21075
75023586,75117462,chr15,PPCDC,chr15:75023586-75117462,93876
35710676,35710741,chr9,MIR6852,chr9:35710676-35710741,65
35732598,35736999,chr9,CREB3,chr9:35732598-35736999,4401
57937458,57939015,chr6,POM121L14P,chr6:57937458-57939015,1557
20579724,20580911,chr17,CDRT15L2,chr17:20579724-20580911,1187
143450805,143490616,chr6,PEX3,chr6:143450805-143490616,39811
37375985,37392708,chr17,C17orf78,chr17:37375985-37392708,16723
105137714,105531697,chr11,CARD18,chr11:105137714-105531697,393983
35732922,35732995,chr9,MIR6853,chr9:35732922-35732995,73
20436337,20447249,chr17,NOS2P3,chr17:20436337-20447249,10912
35736866,35749228,chr9,GBA2,chr9:35736866-35749228,12362
53973126,53977643,chr12,HOXC11,chr12:53973126-53977643,4517
87815035,87816157,chr11,MTCYBP41,chr11:87815035-87816157,1122
73161779,73162928,chr15,NPM1P43,chr15:73161779-73162928,1149
87037844,87328824,chr11,TMEM135,chr11:87037844-87328824,290980
7955014,8008755,chr8,FAM66E,chr8:7955014-8008755,53741
40360652,40364737,chr17,GJD3,chr17:40360652-40364737,4085
19695461,19709037,chr7,POLR1F,chr7:19695461-19709037,13576
74173710,74176872,chr15,ISLR,chr15:74173710-74176872,3162
149592687,149601878,chr6,RPS18P9,chr6:149592687-149601878,9191
119140767,119165714,chr10,SFXN4,chr10:119140767-119165714,24947
62021570,62022174,chr12,RPS3P6,chr12:62021570-62022174,604
122399551,122433119,chr6,HSF2,chr6:122399551-122433119,33568
39252663,39402523,chr17,FBXL20,chr17:39252663-39402523,149860
54608187,54610462,chr12,GLYCAM1,chr12:54608187-54610462,2275
64100305,64150721,chr7,GUSBP6,chr7:64100305-64150721,50416
155457961,155458640,chr4,MTATP6P9,chr4:155457961-155458640,679
54845568,54859241,chr4,LINC02358,chr4:54845568-54859241,13673
22609228,22625015,chr12,ETNK1-DT,chr12:22609228-22625015,15787
74350768,74364620,chr15,PPIAP46,chr15:74350768-74364620,13852
37575587,37576384,chr12,ZNF970P,chr12:37575587-37576384,797
75081702,75084717,chr4,LINC02562,chr4:75081702-75084717,3015
27596917,27614700,chr8,CLU,chr8:27596917-27614700,17783
100583982,100601117,chr7,FBXO24,chr7:100583982-100601117,17135
45071769,45072843,chr12,SSBL3P,chr12:45071769-45072843,1074
17509353,17590049,chr12,LINC02378,chr12:17509353-17590049,80696
174636920,174829247,chr4,GLRA3,chr4:174636920-174829247,192327
74062780,74063785,chr15,DNM1P33,chr15:74062780-74063785,1005
73319859,73368958,chr15,HCN4,chr15:73319859-73368958,49099
62755227,62756233,chr12,GAPDHP44,chr12:62755227-62756233,1006
38206231,38207192,chr12,NF1P12,chr12:38206231-38207192,961
59523278,59524184,chr12,LINC02448,chr12:59523278-59524184,906
75321397,75322693,chr15,ANP32BP1,chr15:75321397-75322693,1296
54008985,54012769,chr12,HOXC8,chr12:54008985-54012769,3784
43155315,43163110,chr12,LINC02461,chr12:43155315-43163110,7795
35749287,35758585,chr9,RGP1,chr9:35749287-35758585,9298
74630558,74696292,chr15,EDC3,chr15:74630558-74696292,65734
128768228,128769948,chr4,JADRR,chr4:128768228-128769948,1720
54307859,54390142,chr6,TINAG,chr6:54307859-54390142,82283
134383467,134545648,chr4,LINC02462,chr4:134383467-134545648,162181
38646822,38907430,chr12,CPNE8,chr12:38646822-38907430,260608
92268767,92277075,chr4,LNCPRESS2,chr4:92268767-92277075,8308
168755816,168756382,chr4,RPL9P16,chr4:168755816-168756382,566
152551277,152552364,chr4,RPS3AP18,chr4:152551277-152552364,1087
35752990,35756613,chr9,MSMP,chr9:35752990-35756613,3623
2922662,2923202,chr16,RPL23AP86,chr16:2922662-2923202,540
128912810,128916429,chr10,LINC02667,chr10:128912810-128916429,3619
4788397,4796491,chr16,SMIM22,chr16:4788397-4796491,8094
152769354,152779730,chr4,TIGD4,chr4:152769354-152779730,10376
100336856,100337625,chr11,RPA2P3,chr11:100336856-100337625,769
50531759,50543463,chr7,DDC-AS1,chr7:50531759-50543463,11704
133683668,133684936,chr10,DUX4L20,chr10:133683668-133684936,1268
84544304,84544519,chr4,RPL3P13,chr4:84544304-84544519,215
101451564,101872562,chr11,TRPC6,chr11:101451564-101872562,420998
135565117,135567157,chr4,TARS2P1,chr4:135565117-135567157,2040
125753580,125775821,chr10,MMP21,chr10:125753580-125775821,22241
174236658,174283667,chr4,FBXO8,chr4:174236658-174283667,47009
51382284,51384660,chr7,CICP17,chr7:51382284-51384660,2376
35808045,35812272,chr9,SPAG8,chr9:35808045-35812272,4227
99392048,99408597,chr7,PDAP1,chr7:99392048-99408597,16549
131901008,131959834,chr10,PPP2R2D,chr10:131901008-131959834,58826
95578202,95644706,chr13,DZIP1,chr13:95578202-95644706,66504
2211593,2214840,chr16,PGP,chr16:2211593-2214840,3247
63963431,63964123,chr7,VN1R35P,chr7:63963431-63964123,692
86937528,87016679,chr6,HTR1E,chr6:86937528-87016679,79151
97437518,97437896,chr7,AP1S2P1,chr7:97437518-97437896,378
41167231,41168221,chr17,KRTAP4-3,chr17:41167231-41168221,990
98385801,98386584,chr7,RPS3AP26,chr7:98385801-98386584,783
35983288,35987004,chr17,CCL14,chr17:35983288-35987004,3716
95359872,95396375,chr7,PON3,chr7:95359872-95396375,36503
84687351,84764598,chr6,TBX18,chr6:84687351-84764598,77247
680224,682870,chr16,STUB1,chr16:680224-682870,2646
41265339,41266641,chr17,KRTAP9-6,chr17:41265339-41266641,1302
35812960,35815354,chr9,HINT2,chr9:35812960-35815354,2394
39728496,39730532,chr17,MIEN1,chr17:39728496-39730532,2036
44402685,44427144,chr15,CTDSPL2-DT,chr15:44402685-44427144,24459
49961872,49965682,chr12,AQP5,chr12:49961872-49965682,3810
139028745,139043302,chr6,ABRACL,chr6:139028745-139043302,14557
67542703,67807117,chr15,MAP2K5,chr15:67542703-67807117,264414
41158506,41163186,chr6,TREM2,chr6:41158506-41163186,4680
38936432,38967403,chr17,FBXO47,chr17:38936432-38967403,30971
102110447,102233424,chr11,YAP1,chr11:102110447-102233424,122977
24223233,24260056,chr12,SOX5-AS1,chr12:24223233-24260056,36823
118046279,118210158,chr10,CASC2,chr10:118046279-118210158,163879
157076125,157172090,chr4,GLRB,chr4:157076125-157172090,95965
35814451,35865518,chr9,TMEM8B,chr9:35814451-35865518,51067
101127104,101139247,chr7,SERPINE1,chr7:101127104-101139247,12143
113933028,114011308,chr6,HDAC2,chr6:113933028-114011308,78280
41812680,41823213,chr17,FKBP10,chr17:41812680-41823213,10533
63587602,63627101,chr20,GMEB2,chr20:63587602-63627101,39499
24136163,24138967,chr14,PSME1,chr14:24136163-24138967,2804
52084744,52108261,chr12,OR7E47P,chr12:52084744-52108261,23517
64111752,64112572,chr7,MTND1P2,chr7:64111752-64112572,820
54556970,54571726,chr7,VSTM2A-OT1,chr7:54556970-54571726,14756
95018163,95018397,chr7,HINT1P2,chr7:95018163-95018397,234
6870592,6877936,chr8,DEFB1,chr8:6870592-6877936,7344
51328442,51346679,chr12,CELA1,chr12:51328442-51346679,18237
56490682,56491635,chr7,RBM22P3,chr7:56490682-56491635,953
89882353,90211635,chr7,STEAP2-AS1,chr7:89882353-90211635,329282
95297676,95324532,chr7,PON1,chr7:95297676-95324532,26856
7730739,7733749,chr8,FAM90A16P,chr8:7730739-7733749,3010
133637408,133637892,chr10,RARRES2P2,chr10:133637408-133637892,484
133667151,133668419,chr10,DUX4L25,chr10:133667151-133668419,1268
128181032,128317726,chr10,LINC01163,chr10:128181032-128317726,136694
62965325,62965969,chr12,RPL14P1,chr12:62965325-62965969,644
7894677,7896716,chr8,DEFB4A,chr8:7894677-7896716,2039
54058254,54122235,chr12,FLJ12825,chr12:54058254-54122235,63981
122832158,122846175,chr10,CUZD1,chr10:122832158-122846175,14017
56511002,56512703,chr12,HSPD1P4,chr12:56511002-56512703,1701
131727587,131791492,chr4,SNHG27,chr4:131727587-131791492,63905
29920560,29953724,chr8,LINC02209,chr8:29920560-29953724,33164
100570131,100571136,chr7,IRS3P,chr7:100570131-100571136,1005
30638580,30646064,chr8,SMIM18,chr8:30638580-30646064,7484
63639705,63657682,chr20,STMN3,chr20:63639705-63657682,17977
29336,38321,chr16,IL9RP3,chr16:29336-38321,8985
932387,958656,chr4,TMEM175,chr4:932387-958656,26269
48105139,48146404,chr12,PFKM,chr12:48105139-48146404,41265
81699010,81770438,chr7,HGF,chr7:81699010-81770438,71428
35816391,35828747,chr9,FAM221B,chr9:35816391-35828747,12356
127135426,127196591,chr10,INSYN2A,chr10:127135426-127196591,61165
636817,648474,chr16,MCRIP2,chr16:636817-648474,11657
63659300,63698684,chr20,RTEL1-TNFRSF6B,chr20:63659300-63698684,39384
7428888,7430348,chr8,DEFB103B,chr8:7428888-7430348,1460
30194319,30236002,chr17,SLC6A4,chr17:30194319-30236002,41683
133673749,133675017,chr10,DUX4L23,chr10:133673749-133675017,1268
27733316,27772653,chr8,CCDC25,chr8:27733316-27772653,39337
35859055,35859980,chr9,OR13E1P,chr9:35859055-35859980,925
35874810,35875194,chr9,NDUFA5P4,chr9:35874810-35875194,384
35906202,35907136,chr9,HRCT1,chr9:35906202-35907136,934
127877841,127892941,chr10,CLRN3,chr10:127877841-127892941,15100
47745736,48037968,chr13,SUCLA2,chr13:47745736-48037968,292232
89752785,89753975,chr11,UBTFL2,chr11:89752785-89753975,1190
35909490,35937153,chr9,SPAAR,chr9:35909490-35937153,27663
67119263,67258082,chr11,KDM2A,chr11:67119263-67258082,138819
35943210,35943934,chr9,PGAM1P2,chr9:35943210-35943934,724
132965534,132976354,chr10,LINC01168,chr10:132965534-132976354,10820
35957108,35958154,chr9,OR2S2,chr9:35957108-35958154,1046
35971344,35972318,chr9,YBX1P10,chr9:35971344-35972318,974
126272818,126273411,chr10,SAR1AP2,chr10:126272818-126273411,593
29608900,29609501,chr22,RPEP4,chr22:29608900-29609501,601
79505804,79567802,chr9,LNCARSR,chr9:79505804-79567802,61998
99047639,99048319,chr10,RPL7P36,chr10:99047639-99048319,680
133640789,133642894,chr10,AGGF1P2,chr10:133640789-133642894,2105
2223580,2235742,chr16,E4F1,chr16:2223580-2235742,12162
120851305,120909524,chr10,WDR11,chr10:120851305-120909524,58219
29720003,29731833,chr22,CABP7,chr22:29720003-29731833,11830
79391304,79391759,chr9,CHCHD2P9,chr9:79391304-79391759,455
63696652,63698684,chr20,TNFRSF6B,chr20:63696652-63698684,2032
20341669,20622499,chr9,MLLT3,chr9:20341669-20622499,280830
29730956,29767011,chr22,ZMAT5,chr22:29730956-29767011,36055
63698642,63708025,chr20,ARFRP1,chr20:63698642-63708025,9383
29767369,29770413,chr22,UQCR10,chr22:29767369-29770413,3044
30285117,30289622,chr22,CASTOR1,chr22:30285117-30289622,4505
105612667,105632296,chr6,LINC02836,chr6:105612667-105632296,19629
142966293,143059682,chr6,LINC01277,chr6:142966293-143059682,93389
24138959,24141591,chr14,EMC9,chr14:24138959-24141591,2632
136256627,136289851,chr6,BCLAF1,chr6:136256627-136289851,33224
20411148,20411238,chr9,MIR4473,chr9:20411148-20411238,90
20418321,20418427,chr9,RNU4-26P,chr9:20418321-20418427,106
20502265,20502342,chr9,MIR4474,chr9:20502265-20502342,77
20683304,20684688,chr9,FOCAD-AS1,chr9:20683304-20684688,1384
20716105,20716188,chr9,MIR491,chr9:20716105-20716188,83
20786927,20787055,chr9,SNORA30B,chr9:20786927-20787055,128
137306896,137423211,chr9,EXD3,chr9:137306896-137423211,116315
8298492,8299772,chr16,LINC02152,chr16:8298492-8299772,1280
64911902,64958691,chr15,ANKDD1A,chr15:64911902-64958691,46789
525155,527407,chr16,LINC00235,chr16:525155-527407,2252
27417690,27431623,chr17,TBC1D3P5,chr17:27417690-27431623,13933
24143362,24147570,chr14,PSME2,chr14:24143362-24147570,4208
2253116,2268397,chr16,RNPS1,chr16:2253116-2268397,15281
46549089,46550802,chr8,HSPA8P13,chr8:46549089-46550802,1713
40121971,40136917,chr17,MSL1,chr17:40121971-40136917,14946
143424753,143426013,chr4,RPSAP36,chr4:143424753-143426013,1260
171536034,171638763,chr4,LINC02174,chr4:171536034-171638763,102729
171040564,171059163,chr4,LINC02431,chr4:171040564-171059163,18599
119167720,119178812,chr10,PRDX3,chr10:119167720-119178812,11092
81555910,81556425,chr11,MTND6P25,chr11:81555910-81556425,515
67974286,67975243,chr11,OR7E1P,chr11:67974286-67975243,957
67785273,67792335,chr11,ALG1L8P,chr11:67785273-67792335,7062
23528956,23575463,chr8,SLC25A37,chr8:23528956-23575463,46507
30291990,30326947,chr22,TBC1D10A,chr22:30291990-30326947,34957
129135926,129139740,chr4,ZSWIM5P3,chr4:129135926-129139740,3814
63233035,63234245,chr7,PHKG1P1,chr7:63233035-63234245,1210
117800844,117828698,chr11,FXYD2,chr11:117800844-117828698,27854
137434364,137441816,chr9,ENTPD8,chr9:137434364-137441816,7452
64106822,64107572,chr7,MTATP6P18,chr7:64106822-64107572,750
169094259,169270956,chr4,SH3RF1,chr4:169094259-169270956,176697
30284597,30367689,chr7,ZNRF2,chr7:30284597-30367689,83092
63707465,63736142,chr20,ZGPAT,chr20:63707465-63736142,28677
85381118,85381375,chr7,DYNLL1P7,chr7:85381118-85381375,257
74409289,74433958,chr15,SEMA7A,chr15:74409289-74433958,24669
101201809,101203526,chr7,DGAT2L7P,chr7:101201809-101203526,1717
64110547,64111550,chr7,MTND2P4,chr7:64110547-64111550,1003
29333064,29350684,chr8,DUSP4,chr8:29333064-29350684,17620
57599794,57610104,chr7,NCOR1P3,chr7:57599794-57610104,10310
97435909,97446017,chr10,EXOSC1,chr10:97435909-97446017,10108
150078445,150257438,chr4,DCLK2,chr4:150078445-150257438,178993
99325898,99366262,chr7,ARPC1A,chr7:99325898-99366262,40364
15764703,15765664,chr17,CDRT15P2,chr17:15764703-15765664,961
16666107,16667118,chr17,NEK4P2,chr17:16666107-16667118,1011
137450026,137450086,chr9,MIR7114,chr9:137450026-137450086,60
21075362,21092351,chr17,LINC01563,chr17:21075362-21092351,16989
137459952,137550402,chr9,PNPLA7,chr9:137459952-137550402,90450
7592006,7592916,chr8,OR7E157P,chr8:7592006-7592916,910
40340867,40343136,chr17,RARA-AS1,chr17:40340867-40343136,2269
9002147,9116746,chr8,ERI1,chr8:9002147-9116746,114599
40309180,40357643,chr17,RARA,chr17:40309180-40357643,48463
89869282,89876017,chr11,TRIM64B,chr11:89869282-89876017,6735
7279770,7282780,chr8,FAM90A13P,chr8:7279770-7282780,3010
92560758,92590393,chr7,FAM133B,chr7:92560758-92590393,29635
7246726,7247571,chr8,OR7E125P,chr8:7246726-7247571,845
107707378,107719693,chr11,SLN,chr11:107707378-107719693,12315
40948736,40948869,chr15,ISCA1P4,chr15:40948736-40948869,133
41981582,42051190,chr15,PLA2G4E,chr15:41981582-42051190,69608
30131671,30144665,chr8,MBOAT4,chr8:30131671-30144665,12994
75549480,75606020,chr13,UCHL3,chr13:75549480-75606020,56540
100684162,100687955,chr11,ARHGAP42-AS1,chr11:100684162-100687955,3793
108505435,108593768,chr11,EXPH5,chr11:108505435-108593768,88333
24440930,24526970,chr8,ADAM7,chr8:24440930-24526970,86040
137551879,137552555,chr9,MRPL41,chr9:137551879-137552555,676
137554444,137578925,chr9,DPH7,chr9:137554444-137578925,24481
73483196,73483943,chr15,MRPS15P1,chr15:73483196-73483943,747
42800968,42802405,chr15,KRT8P50,chr15:42800968-42802405,1437
24143489,24143565,chr14,MIR7703,chr14:24143489-24143565,76
56005715,56007176,chr15,CNOT6LP1,chr15:56005715-56007176,1461
114294824,114404756,chr10,AFAP1L2,chr10:114294824-114404756,109932
57246960,57247893,chr15,HNRNPA3P11,chr15:57246960-57247893,933
63736283,63739103,chr20,LIME1,chr20:63736283-63739103,2820
66205317,66420543,chr7,TPST1,chr7:66205317-66420543,215226
24146683,24160660,chr14,RNF31,chr14:24146683-24160660,13977
75186651,75186968,chr15,RPL36AP45,chr15:75186651-75186968,317
30331988,30356919,chr22,SF3A1,chr22:30331988-30356919,24931
75251743,75252934,chr15,NIFKP4,chr15:75251743-75252934,1191
72041194,72041653,chr15,EIF5A2P1,chr15:72041194-72041653,459
75843307,75901078,chr15,UBE2Q2,chr15:75843307-75901078,57771
103907189,104164379,chr11,PDGFD,chr11:103907189-104164379,257190
97851677,97872542,chr7,ASNS,chr7:97851677-97872542,20865
143513702,143557486,chr4,SMARCA5,chr4:143513702-143557486,43784
109741625,109823893,chr11,LINC02715,chr11:109741625-109823893,82268
25184689,25418082,chr8,DOCK5,chr8:25184689-25418082,233393
97000274,97000711,chr11,MED28P5,chr11:97000274-97000711,437
91115961,91116555,chr11,OSBPL9P3,chr11:91115961-91116555,594
63739776,63744050,chr20,SLC2A4RG,chr20:63739776-63744050,4274
108008898,108107761,chr11,CUL5,chr11:108008898-108107761,98863
137582081,137590512,chr9,ZMYND19,chr9:137582081-137590512,8431
75604700,75635994,chr13,LMO7-AS1,chr13:75604700-75635994,31294
30368811,30421771,chr22,RNF215,chr22:30368811-30421771,52960
137605685,137615360,chr9,ARRDC1,chr9:137605685-137615360,9675
125725634,125752110,chr10,EDRF1-AS1,chr10:125725634-125752110,26476
75688556,75689197,chr13,FAM204CP,chr13:75688556-75689197,641
99205708,99206006,chr13,RN7SKP9,chr13:99205708-99206006,298
99215372,99215758,chr13,H2AZP3,chr13:99215372-99215758,386
99294539,99307399,chr13,GPR183,chr13:99294539-99307399,12860
41186944,41187136,chr17,KRTAP4-17P,chr17:41186944-41187136,192
119029714,119033730,chr10,NANOS1,chr10:119029714-119033730,4016
22530612,22531392,chr17,MTCO3P13,chr17:22530612-22531392,780
19063346,19064136,chr17,SNORD3B-2,chr17:19063346-19064136,790
45336314,45336447,chr13,SNORA31B,chr13:45336314-45336447,133
63808076,63816521,chr20,ZBTB46-AS1,chr20:63808076-63816521,8445
45337480,45337609,chr13,SNORA31,chr13:45337480-45337609,129
40553769,40565472,chr17,CCR7,chr17:40553769-40565472,11703
72814406,72843674,chr11,ATG16L2,chr11:72814406-72843674,29268
125896564,126009592,chr10,FANK1,chr10:125896564-126009592,113028
153466346,153636711,chr4,TMEM131L,chr4:153466346-153636711,170365
63400208,63472677,chr20,KCNQ2,chr20:63400208-63472677,72469
18312760,18313533,chr17,RPL21P121,chr17:18312760-18313533,773
45341345,45417975,chr13,TPT1-AS1,chr13:45341345-45417975,76630
30396941,30425303,chr22,SEC14L2,chr22:30396941-30425303,28362
78759206,78811464,chr15,ADAMTS7,chr15:78759206-78811464,52258
16812447,16812651,chr17,NOS2P4,chr17:16812447-16812651,204
39835037,39836080,chr17,KRT8P34,chr17:39835037-39836080,1043
18271428,18315007,chr17,TOP3A,chr17:18271428-18315007,43579
27633868,27676776,chr8,SCARA3,chr8:27633868-27676776,42908
137640986,137641547,chr9,SETP5,chr9:137640986-137641547,561
87914493,87923505,chr9,SPATA31C1,chr9:87914493-87923505,9012
87998229,87998335,chr9,RNU6-86P,chr9:87998229-87998335,106
88016300,88016793,chr9,RPS10P3,chr9:88016300-88016793,493
16203935,16410990,chr9,C9orf92,chr9:16203935-16410990,207055
126413869,126421879,chr10,LINC00601,chr10:126413869-126421879,8010
133759859,133761125,chr10,DUX4L15,chr10:133759859-133761125,1266
23634876,23635507,chr8,SINHCAFP3,chr8:23634876-23635507,631
16726814,16727524,chr9,BNC2-AS1,chr9:16726814-16727524,710
123008979,123058290,chr10,ACADSB,chr10:123008979-123058290,49311
212824,215893,chr9,DOCK8-AS1,chr9:212824-215893,3069
28949676,28955955,chr8,HMBOX1-IT1,chr8:28949676-28955955,6279
16275681,16276296,chr8,CCT3P1,chr8:16275681-16276296,615
29218905,29219472,chr8,HMGB1P23,chr8:29218905-29219472,567
7015869,7018297,chr8,DEFA3,chr8:7015869-7018297,2428
94656325,94669695,chr7,PEG10,chr7:94656325-94669695,13370
477750,478423,chr9,RPL12P25,chr9:477750-478423,673
58691106,58693125,chr15,HSP90AB4P,chr15:58691106-58693125,2019
104025540,104026763,chr6,NPM1P10,chr6:104025540-104026763,1223
12570350,12571130,chr8,RPS3AP34,chr8:12570350-12571130,780
40250664,40252969,chr15,PAK6-AS1,chr15:40250664-40252969,2305
558826,558930,chr9,RNU6-1327P,chr9:558826-558930,104
659986,660326,chr9,EIF1P1,chr9:659986-660326,340
12290071,12296180,chr8,DEFB131D,chr8:12290071-12296180,6109
52264014,52284881,chr6,MCM3,chr6:52264014-52284881,20867
74379083,74390535,chr15,LINC02255,chr15:74379083-74390535,11452
841690,969090,chr9,DMRT1,chr9:841690-969090,127400
10474565,10482388,chr8,LINCR-0001,chr8:10474565-10482388,7823
101287482,101289771,chr7,AZGP1P2,chr7:101287482-101289771,2289
7825139,7829053,chr8,DEFB106A,chr8:7825139-7829053,3914
39837561,39837613,chrX,MIR1587,chrX:39837561-39837613,52
39865424,39865888,chrX,RPS11P7,chrX:39865424-39865888,464
97898347,97899115,chr7,RPS3AP29,chr7:97898347-97899115,768
105532169,105567677,chr7,RINT1,chr7:105532169-105567677,35508
33540185,33540493,chr8,RPL10P18,chr8:33540185-33540493,308
24158603,24158722,chr14,RNA5SP383,chr14:24158603-24158722,119
40359183,40360726,chrX,IMPDH1P2,chrX:40359183-40360726,1543
7190901,7191563,chr8,RPS3AP33,chr8:7190901-7191563,662
125666875,125667950,chr10,ALDOAP2,chr10:125666875-125667950,1075
976655,991732,chr9,DMRT3,chr9:976655-991732,15077
133740606,133741284,chr10,DUX4L29,chr10:133740606-133741284,678
24161265,24166565,chr14,IRF9,chr14:24161265-24166565,5300
110644336,110839468,chr10,RBM20,chr10:110644336-110839468,195132
40049815,40177329,chrX,BCOR,chrX:40049815-40177329,127514
93318199,93346414,chr9,C9orf129,chr9:93318199-93346414,28215
93375556,93375667,chr9,RNU6-829P,chr9:93375556-93375667,111
78540405,78552417,chr15,PSMA4,chr15:78540405-78552417,12012
93431441,93453581,chr9,FAM120AOS,chr9:93431441-93453581,22140
30095408,30177208,chr8,LEPROTL1,chr8:30095408-30177208,81800
140620782,140756385,chr4,TBC1D9,chr4:140620782-140756385,135603
109864766,109923553,chr10,XPNPEP1,chr10:109864766-109923553,58787
55638274,55638842,chr7,CDC42P2,chr7:55638274-55638842,568
93890913,93893601,chr7,TFPI2-DT,chr7:93890913-93893601,2688
100572228,100573900,chr7,SAP25,chr7:100572228-100573900,1672
43527844,43579620,chr17,ETV4,chr17:43527844-43579620,51776
93451685,93566112,chr9,FAM120A,chr9:93451685-93566112,114427
31751179,32428131,chr7,PDE1C,chr7:31751179-32428131,676952
153780591,153789083,chr4,SFRP2,chr4:153780591-153789083,8492
26748150,26867278,chr8,ADRA1A,chr8:26748150-26867278,119128
175574868,175576140,chr4,ADAM20P2,chr4:175574868-175576140,1272
132680849,132714055,chr6,VNN1,chr6:132680849-132714055,33206
30421045,30421148,chr22,RNU6-564P,chr22:30421045-30421148,103
111726908,111766389,chr11,PPP2R1B,chr11:111726908-111766389,39481
89236383,89307800,chr4,GPRIN3,chr4:89236383-89307800,71417
30425623,30429054,chr22,MTFP1,chr22:30425623-30429054,3431
39881804,39900071,chr6,DAAM2-AS1,chr6:39881804-39900071,18267
24180219,24188869,chr14,IPO4,chr14:24180219-24188869,8650
51244558,51270415,chr12,SMAGP,chr12:51244558-51270415,25857
29748757,29750100,chr4,EEF1A1P21,chr4:29748757-29750100,1343
56467617,56503681,chr4,SRP72,chr4:56467617-56503681,36064
109327175,109327914,chr6,RPL7P28,chr6:109327175-109327914,739
135619165,135620171,chr6,GAPDHP73,chr6:135619165-135620171,1006
33591330,33600023,chr8,DUSP26,chr8:33591330-33600023,8693
14381,18068,chr16,WASH4P,chr16:14381-18068,3687
1528688,1555580,chr16,TMEM204,chr16:1528688-1555580,26892
45390353,45391267,chr13,RCN1P2,chr13:45390353-45391267,914
38142700,38150992,chr8,STAR,chr8:38142700-38150992,8292
142301854,142446266,chr6,ADGRG6,chr6:142301854-142446266,144412
54016931,54056030,chr12,HOXC4,chr12:54016931-54056030,39099
30447959,30472017,chr22,SEC14L3,chr22:30447959-30472017,24058
45393316,45418455,chr13,SLC25A30,chr13:45393316-45418455,25139
52729517,52736142,chr12,KRT125P,chr12:52729517-52736142,6625
4696510,4734378,chr16,ANKS3,chr16:4696510-4734378,37868
62234390,62235515,chr12,KLF17P1,chr12:62234390-62235515,1125
48355792,48356614,chr12,OR5BK1P,chr12:48355792-48356614,822
52748776,52750127,chr12,BTBD10P1,chr12:52748776-52750127,1351
63055275,63055765,chr12,RSL24D1P5,chr12:63055275-63055765,490
31959370,31993107,chr12,RESF1,chr12:31959370-31993107,33737
12696307,12697273,chr8,OR7E15P,chr8:12696307-12697273,966
93594841,93594894,chr9,MIR548AU,chr9:93594841-93594894,53
36279491,36279696,chr8,MTND5P41,chr8:36279491-36279696,205
120902393,120929173,chr9,TRAF1,chr9:120902393-120929173,26780
16745636,16746761,chr17,UPF3AP1,chr17:16745636-16746761,1125
23678697,23682938,chr8,NKX3-1,chr8:23678697-23682938,4241
38530031,38605952,chr17,SRCIN1,chr17:38530031-38605952,75921
20197381,20226819,chr8,ATP6V1B2,chr8:20197381-20226819,29438
120952335,121050275,chr9,C5,chr9:120952335-121050275,97940
68248242,68253604,chr12,IL22,chr12:68248242-68253604,5362
31071233,31072041,chrX,FTHL17,chrX:31071233-31072041,808
31348192,31348296,chrX,RNU6-894P,chrX:31348192-31348296,104
32102065,32102176,chrX,RNA5SP501,chrX:32102065-32102176,111
32205902,32206738,chrX,NPM1P8,chrX:32205902-32206738,836
32583656,32583752,chrX,MIR3915,chrX:32583656-32583752,96
32641474,32641559,chrX,MIR548F5,chrX:32641474-32641559,85
32754940,32756400,chrX,DMD-AS3,chrX:32754940-32756400,1460
33041395,33041721,chrX,TBCAP1,chrX:33041395-33041721,326
153403844,153404141,chrX,RN7SL667P,chrX:153403844-153404141,297
153479266,153487088,chrX,ECMXP,chrX:153479266-153487088,7822
153494980,153509546,chrX,BGN,chrX:153494980-153509546,14566
109907004,109907741,chr11,TFAMP2,chr11:109907004-109907741,737
119364359,119526664,chr11,USP2-AS1,chr11:119364359-119526664,162305
37858618,37899497,chr8,RAB11FIP1,chr8:37858618-37899497,40879
30481311,30481911,chr22,SDC4P,chr22:30481311-30481911,600
30488902,30505711,chr22,SEC14L4,chr22:30488902-30505711,16809
94638045,94652884,chr11,LINC02700,chr11:94638045-94652884,14839
52229093,52229588,chr12,METTL7AP1,chr12:52229093-52229588,495
68705634,68707066,chr12,KRT8P39,chr12:68705634-68707066,1432
53131350,53131985,chr12,VTI1BP3,chr12:53131350-53131985,635
51681212,51682831,chrX,CENPVL2,chrX:51681212-51682831,1619
41764144,41774671,chr12,LINC02400,chr12:41764144-41774671,10527
51710512,51712131,chrX,CENPVL1,chrX:51710512-51712131,1619
51743442,51746232,chrX,GSPT2,chrX:51743442-51746232,2790
68052859,68121444,chr11,CHKA,chr11:68052859-68121444,68585
39667981,39670475,chr17,PNMT,chr17:39667981-39670475,2494
51870706,51870809,chrX,RNU6-504P,chrX:51870706-51870809,103
51617020,51618912,chrX,CENPVL3,chrX:51617020-51618912,1892
41188320,41574745,chr12,PDZRN4,chr12:41188320-41574745,386425
68070520,68071767,chrX,PGK1P1,chrX:68070520-68071767,1247
68102068,68102132,chrX,RNU6-1225P,chrX:68102068-68102132,64
68132868,68133437,chrX,AKIRIN1P2,chrX:68132868-68133437,569
98454119,98454617,chr7,PPIAP82,chr7:98454119-98454617,498
68498562,68537282,chrX,YIPF6,chrX:68498562-68537282,38720
38003976,38014902,chr17,TBC1D3D,chr17:38003976-38014902,10926
65773620,65802067,chr7,GTF2IP5,chr7:65773620-65802067,28447
165517255,165517501,chr4,SCGB1D5P,chr4:165517255-165517501,246
170343089,170372311,chr4,LINC02512,chr4:170343089-170372311,29222
45418162,45420371,chr13,SLC25A30-AS1,chr13:45418162-45420371,2209
1392794,1445440,chr5,SLC6A3,chr5:1392794-1445440,52646
153658572,153659653,chr4,WDR45P1,chr4:153658572-153659653,1081
150582151,150584693,chr4,MAB21L2,chr4:150582151-150584693,2542
45333471,45341284,chr13,TPT1,chr13:45333471-45341284,7813
98214624,98252232,chr7,TECPR1,chr7:98214624-98252232,37608
157572490,157576154,chr4,LINC02433,chr4:157572490-157576154,3664
49595148,49595688,chr12,PARK7P1,chr12:49595148-49595688,540
98470367,98658611,chr4,TSPAN5,chr4:98470367-98658611,188244
133680369,133681637,chr10,DUX4L21,chr10:133680369-133681637,1268
27022546,27066343,chr12,MED21,chr12:27022546-27066343,43797
113687547,113706373,chr11,TMPRSS5,chr11:113687547-113706373,18826
41280604,41280810,chr17,KRTAP9-10P,chr17:41280604-41280810,206
127737185,127741183,chr10,FOXI2,chr10:127737185-127741183,3998
68539443,68539549,chrX,RNU6-245P,chrX:68539443-68539549,106
38869859,38921770,chr17,LASP1,chr17:38869859-38921770,51911
122729429,122826868,chr10,DMBT1L1,chr10:122729429-122826868,97439
67949349,68433913,chrX,OPHN1,chrX:67949349-68433913,484564
37516399,37521447,chr8,LINC01605,chr8:37516399-37521447,5048
30542536,30544305,chr22,SIRPAP1,chr22:30542536-30544305,1769
121178133,121223014,chr9,RAB14,chr9:121178133-121223014,44881
30554635,30574665,chr22,GAL3ST1,chr22:30554635-30574665,20030
38030534,38060365,chr8,EIF4EBP1,chr8:38030534-38060365,29831
117241093,117279430,chr10,SLC18A2,chr10:117241093-117279430,38337
4135638,4147429,chr5,LINC02063,chr5:4135638-4147429,11791
63558913,63668939,chr12,DPY19L2,chr12:63558913-63668939,110026
73143236,73143518,chr15,FKBP1AP2,chr15:73143236-73143518,282
7487679,7489593,chr8,DEFB105B,chr8:7487679-7489593,1914
74337759,74367646,chr15,CYP11A1,chr15:74337759-74367646,29887
7571995,7575006,chr8,FAM90A22P,chr8:7571995-7575006,3011
2692874,2760108,chr20,EBF4,chr20:2692874-2760108,67234
1253147,1295068,chr5,TERT,chr5:1253147-1295068,41921
121203159,121203435,chr9,RN7SL181P,chr9:121203159-121203435,276
25427847,25458476,chr8,KCTD9,chr8:25427847-25458476,30629
121280768,121285530,chr9,GSN-AS1,chr9:121280768-121285530,4762
94743668,94757681,chr4,BMPR1B-DT,chr4:94743668-94757681,14013
27756766,27800529,chr17,NOS2,chr17:27756766-27800529,43763
101334084,101339347,chr9,ACNATP,chr9:101334084-101339347,5263
101356466,101356844,chr9,TRMT112P4,chr9:101356466-101356844,378
101375344,101376603,chr9,FYTTD1P1,chr9:101375344-101376603,1259
101387633,101398618,chr9,MRPL50,chr9:101387633-101398618,10985
144109303,144140751,chr4,GYPA,chr4:144109303-144140751,31448
96015974,96215612,chr6,FUT9,chr6:96015974-96215612,199638
684622,690444,chr16,WDR24,chr16:684622-690444,5822
108554543,108569750,chr7,THAP5,chr7:108554543-108569750,15207
101468349,101482199,chr9,TMEM246-AS1,chr9:101468349-101482199,13850
125219962,125302078,chr6,HDDC2,chr6:125219962-125302078,82116
101473170,101533537,chr9,PGAP4,chr9:101473170-101533537,60367
101533853,101563344,chr9,RNF20,chr9:101533853-101563344,29491
124489823,124490578,chr10,RPS10P18,chr10:124489823-124490578,755
132783179,132786147,chr10,NKX6-2,chr10:132783179-132786147,2968
43508728,43522542,chr7,LUARIS,chr7:43508728-43522542,13814
62082450,62083305,chr15,NPM1P47,chr15:62082450-62083305,855
2239402,2252300,chr16,ECI1,chr16:2239402-2252300,12898
75299953,75302965,chr15,DNM1P34,chr15:75299953-75302965,3012
124801819,124836667,chr10,ABRAXAS2,chr10:124801819-124836667,34848
63965834,63966124,chr7,VN1R36P,chr7:63965834-63966124,290
74826627,74831802,chr15,CPLX3,chr15:74826627-74831802,5175
151396515,151409364,chrX,VMA21,chrX:151396515-151409364,12849
87196160,87220587,chr7,TMEM243,chr7:87196160-87220587,24427
42849637,42897290,chr8,RNF170,chr8:42849637-42897290,47653
74069857,74082550,chr15,GOLGA6A,chr15:74069857-74082550,12693
137143820,137173648,chr6,IL22RA2,chr6:137143820-137173648,29828
2780614,2781041,chr20,RPL19P1,chr20:2780614-2781041,427
2794074,2800627,chr20,CPXM1,chr20:2794074-2800627,6553
116881477,117126586,chr10,SHTN1,chr10:116881477-117126586,245109
154428633,154436516,chrX,ATP6AP1,chrX:154428633-154436516,7883
53981509,53985519,chr12,HOXC-AS3,chr12:53981509-53985519,4010
46781373,46783443,chr7,EPS15P1,chr7:46781373-46783443,2070
50129289,50167533,chr12,CERS5,chr12:50129289-50167533,38244
101591604,101595021,chr9,PPP3R2,chr9:101591604-101595021,3417
32485338,32495283,chr7,LSM5,chr7:32485338-32495283,9945
123803865,124825640,chr6,NKAIN2,chr6:123803865-124825640,1021775
101354182,101385400,chr9,BAAT,chr9:101354182-101385400,31218
57118551,57121548,chrX,SPIN2B,chrX:57118551-57121548,2997
2814987,2815833,chr20,C20orf141,chr20:2814987-2815833,846
74179466,74212267,chr15,STRA6,chr15:74179466-74212267,32801
108218392,108234243,chr13,ABHD13,chr13:108218392-108234243,15851
116461370,116463771,chr6,CALHM6,chr6:116461370-116463771,2401
26840685,26892803,chr9,CAAP1,chr9:26840685-26892803,52118
108301212,108301331,chr13,RNA5SP39,chr13:108301212-108301331,119
144136450,144136775,chr6,MRPL42P3,chr6:144136450-144136775,325
2816302,2820284,chr20,TMEM239,chr20:2816302-2820284,3982
48186220,48196795,chrX,SSX5,chrX:48186220-48196795,10575
129831244,129861547,chr6,TMEM244,chr6:129831244-129861547,30303
2835314,2841190,chr20,PCED1A,chr20:2835314-2841190,5876
7847876,7868867,chr8,SPAG11A,chr8:7847876-7868867,20991
1363205,1414751,chr16,UNKL,chr16:1363205-1414751,51546
56276529,56276796,chr6,DHFRP6,chr6:56276529-56276796,267
108480226,108481817,chr13,HCFC2P1,chr13:108480226-108481817,1591
133502252,133892802,chr6,TARID,chr6:133502252-133892802,390550
1317752,1345099,chr5,CLPTM1L,chr5:1317752-1345099,27347
30576625,30607083,chr22,PES1,chr22:30576625-30607083,30458
107591091,107666779,chr11,ELMOD1,chr11:107591091-107666779,75688
26880178,26880549,chr9,H3P31,chr9:26880178-26880549,371
106900164,106930861,chrX,CLDN2,chrX:106900164-106930861,30697
46771256,46797420,chr13,ESD,chr13:46771256-46797420,26164
26895678,26895970,chr9,RN7SL100P,chr9:26895678-26895970,292
26903372,26947242,chr9,PLAA,chr9:26903372-26947242,43870
57592011,57597477,chrX,ZXDB,chrX:57592011-57597477,5466
57286706,57489193,chrX,FAAH2,chrX:57286706-57489193,202487
55753653,55875590,chr6,BMP5,chr6:55753653-55875590,121937
115030564,115126314,chr7,LINC01393,chr7:115030564-115126314,95750
116590385,116609175,chr10,PNLIPRP1,chr10:116590385-116609175,18790
101219769,101264502,chrX,DRP2,chrX:101219769-101264502,44733
74282266,74282660,chr6,FAM136FP,chr6:74282266-74282660,394
54846771,54945099,chr6,FAM83B,chr6:54846771-54945099,98328
29632091,29632644,chr8,RPL17P33,chr8:29632091-29632644,553
101154456,101161596,chr7,AP1S1,chr7:101154456-101161596,7140
34757505,34773857,chr6,SNRPC,chr6:34757505-34773857,16352
65174117,65176470,chr11,PGAM1P8,chr11:65174117-65176470,2353
37762595,37779768,chr8,PLPBP,chr8:37762595-37779768,17173
117427772,117817525,chr11,DSCAML1,chr11:117427772-117817525,389753
111353702,111354183,chr6,FCF1P5,chr6:111353702-111354183,481
146543833,146554953,chr6,RAB32,chr6:146543833-146554953,11120
24189149,24195687,chr14,TM9SF1,chr14:24189149-24195687,6538
2840703,2866732,chr20,VPS16,chr20:2840703-2866732,26029
26955780,26956295,chr9,IFT74-AS1,chr9:26955780-26956295,515
26993136,27005672,chr9,LRRC19,chr9:26993136-27005672,12536
116118909,116158747,chr6,COL10A1,chr6:116118909-116158747,39838
118495815,118686163,chrX,DOCK11,chrX:118495815-118686163,190348
27198287,27198401,chr9,RNA5SP280,chr9:27198287-27198401,114
18358086,18379331,chr16,NPIPA9,chr16:18358086-18379331,21245
27245680,27284869,chr9,LINC00032,chr9:27245680-27284869,39189
101205977,101218420,chr7,PLOD3,chr7:101205977-101218420,12443
111555381,111606906,chr6,TRAF3IP2,chr6:111555381-111606906,51525
27284654,27297150,chr9,EQTN,chr9:27284654-27297150,12496
71664301,71680644,chr12,THAP2,chr12:71664301-71680644,16343
32486993,32491253,chr17,CDK5R1,chr17:32486993-32491253,4260
68201349,68225810,chr12,IL26,chr12:68201349-68225810,24461
46831546,46897076,chr13,HTR2A,chr13:46831546-46897076,65530
41237999,41239004,chr17,KRTAP9-8,chr17:41237999-41239004,1005
280450,283010,chr16,ARHGDIG,chr16:280450-283010,2560
6532467,6645729,chr9,GLDC,chr9:6532467-6645729,113262
41301826,41302851,chr17,KRTAP29-1,chr17:41301826-41302851,1025
20583758,20591180,chr17,ZSWIM5P2,chr17:20583758-20591180,7422
76599671,76600470,chr12,RPL7AP9,chr12:76599671-76600470,799
46852143,46856299,chr13,HTR2A-AS1,chr13:46852143-46856299,4156
46371463,46373778,chr12,SLC38A2-AS1,chr12:46371463-46373778,2315
36210924,36212878,chr17,CCL4L2,chr17:36210924-36212878,1954
60144648,60153678,chr13,DIAPH3-AS2,chr13:60144648-60153678,9030
60187738,60187830,chr13,RNY4P28,chr13:60187738-60187830,92
59596029,59789855,chr12,SLC16A7,chr12:59596029-59789855,193826
60214352,60214946,chr13,LINC00434,chr13:60214352-60214946,594
5420664,5490220,chr5,ICE1,chr5:5420664-5490220,69556
60274776,60276006,chr13,TARDBPP2,chr13:60274776-60276006,1230
60613608,60613734,chr13,RNA5SP31,chr13:60613608-60613734,126
94695027,94695819,chr7,RPS3AP25,chr7:94695027-94695819,792
60636888,60638097,chr13,EIF4A1P6,chr13:60636888-60638097,1209
60396457,60573878,chr13,TDRD3,chr13:60396457-60573878,177421
1510427,1612072,chr16,IFT140,chr16:1510427-1612072,101645
24205696,24208362,chr14,TSSK4,chr14:24205696-24208362,2666
23296897,23425328,chr8,LOXL2,chr8:23296897-23425328,128431
80369575,80679277,chr7,CD36,chr7:80369575-80679277,309702
88257620,88284769,chr4,PPM1K,chr4:88257620-88284769,27149
1201595,1225111,chr5,SLC6A19,chr5:1201595-1225111,23516
24209615,24213830,chr14,CHMP4A,chr14:24209615-24213830,4215
132296055,132401475,chr6,MOXD1,chr6:132296055-132401475,105420
39953263,39977768,chr17,GSDMA,chr17:39953263-39977768,24505
6968141,6969113,chr8,DEFA10P,chr8:6968141-6969113,972
29673922,29748109,chr8,LINC00589,chr8:29673922-29748109,74187
102642792,102644140,chr10,TRIM8-DT,chr10:102642792-102644140,1348
123666355,123697399,chr10,GPR26,chr10:123666355-123697399,31044
20246165,20303963,chr8,LZTS1,chr8:20246165-20303963,57798
7373115,7391907,chr5,LINC02142,chr5:7373115-7391907,18792
37289649,37317260,chr20,MANBAL,chr20:37289649-37317260,27611
115093365,115948999,chr10,ATRNL1,chr10:115093365-115948999,855634
27082690,27084036,chr17,TUFMP1,chr17:27082690-27084036,1346
38925168,38929384,chr17,LINC00672,chr17:38925168-38929384,4216
52751978,52753821,chr12,KRT127P,chr12:52751978-52753821,1843
5140330,5320304,chr5,ADAMTS16,chr5:5140330-5320304,179974
31324316,31325829,chr12,FLJ13224,chr12:31324316-31325829,1513
47157118,47157771,chr8,RPL10AP2,chr8:47157118-47157771,653
41275659,41276697,chr17,KRTAP9-7,chr17:41275659-41276697,1038
74292324,74293096,chr12,VENTXP3,chr12:74292324-74293096,772
25459199,25507911,chr8,CDCA2,chr8:25459199-25507911,48712
43079302,43079780,chr17,RPL21P4,chr17:43079302-43079780,478
177729638,177907936,chr4,LINC01099,chr4:177729638-177907936,178298
100508194,100881372,chr6,ASCC3,chr6:100508194-100881372,373178
52249300,52309163,chr12,KRT86,chr12:52249300-52309163,59863
113387779,113400416,chr11,ANKK1,chr11:113387779-113400416,12637
183037665,183040119,chr4,CIBAR1P2,chr4:183037665-183040119,2454
30607003,30627271,chr22,TCN2,chr22:30607003-30627271,20268
39921041,39927601,chr17,ORMDL3,chr17:39921041-39927601,6560
604257,610309,chr20,TCF15,chr20:604257-610309,6052
158769026,158908050,chr4,FNIP2,chr4:158769026-158908050,139024
24213943,24216070,chr14,MDP1,chr14:24213943-24216070,2127
50794894,50877177,chr20,BCAS4,chr20:50794894-50877177,82283
36267168,36267274,chr13,RNU6-71P,chr13:36267168-36267274,106
73308276,73369388,chr11,ARHGEF17,chr11:73308276-73369388,61112
149548210,149549924,chrX,HSFX3,chrX:149548210-149549924,1714
57905430,57910458,chrX,ZXDA,chrX:57905430-57910458,5028
52360006,52367481,chr12,KRT85,chr12:52360006-52367481,7475
111768011,112082776,chrX,TRPC5,chrX:111768011-112082776,314765
36301638,36370180,chr13,SPART,chr13:36301638-36370180,68542
26138343,26140736,chrX,MAGEB18,chrX:26138343-26140736,2393
45886491,45887622,chr20,SPATA25,chr20:45886491-45887622,1131
26160601,26161824,chrX,MAGEB6B,chrX:26160601-26161824,1223
27019527,27047934,chr17,GTF2IP6,chr17:27019527-27047934,28407
24213955,24232352,chr14,NEDD8-MDP1,chr14:24213955-24232352,18397
75688794,75689096,chr12,RPL10P13,chr12:75688794-75689096,302
26192440,26195646,chrX,MAGEB6,chrX:26192440-26195646,3206
45406057,45410610,chr20,DBNDD2,chr20:45406057-45410610,4553
163323962,163344832,chr4,NPY1R,chr4:163323962-163344832,20870
26216169,26218270,chrX,MAGEB5,chrX:26216169-26218270,2101
41801947,41812604,chr17,P3H4,chr17:41801947-41812604,10657
56521820,56596193,chr12,RBMS2,chr12:56521820-56596193,74373
26557675,26881029,chrX,VENTXP1,chrX:26557675-26881029,323354
527712,554636,chr16,CAPN15,chr16:527712-554636,26924
101778969,101780538,chrX,GK4P,chrX:101778969-101780538,1569
101832112,101857577,chrX,NXF5,chrX:101832112-101857577,25465
4787332,4788584,chr8,PAICSP4,chr8:4787332-4788584,1252
105808225,105820349,chr10,LINC02627,chr10:105808225-105820349,12124
1798385,1801366,chr5,MRPL36,chr5:1798385-1801366,2981
110355130,110407613,chr11,LINC02732,chr11:110355130-110407613,52483
24216857,24232367,chr14,NEDD8,chr14:24216857-24232367,15510
28345590,28402701,chr8,ZNF395,chr8:28345590-28402701,57111
125960208,125960406,chr10,GNG10P1,chr10:125960208-125960406,198
163494442,163520539,chr4,TMA16,chr4:163494442-163520539,26097
115659658,115843146,chr11,LINC02698,chr11:115659658-115843146,183488
132207492,132331847,chr10,STK32C,chr10:132207492-132331847,124355
6310441,6339884,chr5,LINC02145,chr5:6310441-6339884,29443
107403404,107404589,chr11,SMARCE1P1,chr11:107403404-107404589,1185
97674909,97697340,chr9,XPA,chr9:97674909-97697340,22431
7859159,7869037,chr5,FASTKD3,chr5:7859159-7869037,9878
74748849,74842413,chr11,RNF169,chr11:74748849-74842413,93564
23834503,23839128,chr22,DERL3,chr22:23834503-23839128,4625
24239643,24242674,chr14,TINF2,chr14:24239643-24242674,3031
137447570,137459334,chr9,NSMF,chr9:137447570-137459334,11764
41271311,41271835,chr17,KRTAP9-11P,chr17:41271311-41271835,524
75815210,76144232,chr11,UVRAG,chr11:75815210-76144232,329022
16817983,16822579,chr17,KRT16P6,chr17:16817983-16822579,4596
2204248,2209453,chr16,MLST8,chr16:2204248-2209453,5205
16683438,16684227,chr17,RNASEH1P2,chr17:16683438-16684227,789
36323884,36334759,chr17,TBC1D3G,chr17:36323884-36334759,10875
26375913,26382953,chr8,SDAD1P1,chr8:26375913-26382953,7040
133778246,133778699,chr10,RPL23AP60,chr10:133778246-133778699,453
30155830,30156232,chr8,DCTN6-DT,chr8:30155830-30156232,402
36581180,36581591,chr8,RPL23P10,chr8:36581180-36581591,411
175494614,175496000,chr4,TSEN2P1,chr4:175494614-175496000,1386
28299683,28300566,chr8,RPL5P22,chr8:28299683-28300566,883
125784980,125823258,chr10,UROS,chr10:125784980-125823258,38278
15806149,15807283,chr8,PPM1AP1,chr8:15806149-15807283,1134
5396477,5396968,chr5,MTCO1P31,chr5:5396477-5396968,491
36277763,36278886,chr8,MTCYBP19,chr8:36277763-36278886,1123
94451857,94668227,chr4,PDLIM5,chr4:94451857-94668227,216370
1225381,1246189,chr5,SLC6A18,chr5:1225381-1246189,20808
33015261,33017043,chr8,MTND2P32,chr8:33015261-33017043,1782
64034344,64039962,chr20,C20orf204,chr20:64034344-64039962,5618
103702210,103728655,chrX,GLRA4,chrX:103702210-103728655,26445
23879493,23879790,chr22,RN7SL268P,chr22:23879493-23879790,297
23894383,23895227,chr22,MIF,chr22:23894383-23895227,844
37736601,37758422,chr8,ERLIN2,chr8:37736601-37758422,21821
362835,397559,chr20,TRIB3,chr20:362835-397559,34724
68642519,68642993,chr12,ATP5PDP4,chr12:68642519-68642993,474
67351436,67352039,chr12,MRPL40P1,chr12:67351436-67352039,603
150143044,150250392,chr6,PPP1R14C,chr6:150143044-150250392,107348
23894426,23898930,chr22,MIF-AS1,chr22:23894426-23898930,4504
50085200,50100707,chr12,SMARCD1,chr12:50085200-50100707,15507
66055587,66056587,chrX,ATXN7L3P1,chrX:66055587-66056587,1000
66074835,66076347,chrX,EIF4BP9,chrX:66074835-66076347,1512
64083376,64084398,chr20,LKAAEAR1,chr20:64083376-64084398,1022
66360766,66361776,chrX,MTFR1P1,chrX:66360766-66361776,1010
7396138,7830081,chr5,ADCY2,chr5:7396138-7830081,433943
110346103,110440372,chrX,GNG5P2,chrX:110346103-110440372,94269
23980058,23983915,chr22,GSTT2,chr22:23980058-23983915,3857
110520312,110523021,chrX,TDGF1P3,chrX:110520312-110523021,2709
40475828,40501623,chr17,TNS4,chr17:40475828-40501623,25795
63538489,63547749,chr20,SRMS,chr20:63538489-63547749,9260
48508959,48520814,chrX,PORCN,chrX:48508959-48520814,11855
77734475,77735026,chr11,FTH1P16,chr11:77734475-77735026,551
31847637,31870664,chr20,DUSP15,chr20:31847637-31870664,23027
24181487,24189106,chr22,SUSD2,chr22:24181487-24189106,7619
24249114,24264432,chr14,TGM1,chr14:24249114-24264432,15318
159240786,159243329,chr6,FNDC1-IT1,chr6:159240786-159243329,2543
67991100,68004982,chr11,UNC93B1,chr11:67991100-68004982,13882
152898047,152899280,chr6,TUBB4BP7,chr6:152898047-152899280,1233
31851871,31859291,chr17,COPRS,chr17:31851871-31859291,7420
35119824,35231056,chr22,LINC01399,chr22:35119824-35231056,111232
63719980,65707226,chr6,EYS,chr6:63719980-65707226,1987246
74836118,74843346,chr15,ULK3,chr15:74836118-74843346,7228
123116107,123117781,chrX,MRRFP1,chrX:123116107-123117781,1674
123184153,123490915,chrX,GRIA3,chrX:123184153-123490915,306762
35299275,35347992,chr22,TOM1,chr22:35299275-35347992,48717
36346431,36369601,chr13,SPART-AS1,chr13:36346431-36369601,23170
18311904,18312651,chr17,RPL7AP65,chr17:18311904-18312651,747
44395281,44503430,chr17,GPATCH8,chr17:44395281-44503430,108149
65084210,65088398,chr11,ZFPL1,chr11:65084210-65088398,4188
69894101,69895085,chr13,PSMC1P13,chr13:69894101-69895085,984
24290598,24299780,chr14,DHRS1,chr14:24290598-24299780,9182
70107213,70171738,chr13,ATXN8OS,chr13:70107213-70171738,64525
33079643,33111751,chr20,BPIFB4,chr20:33079643-33111751,32108
98445185,98577940,chr13,STK24,chr13:98445185-98577940,132755
8450701,8486930,chr5,MIR4458HG,chr5:8450701-8486930,36229
3452816,3461660,chr5,LINC02162,chr5:3452816-3461660,8844
6839460,7219291,chr5,LINC02196,chr5:6839460-7219291,379831
57819927,57846729,chr12,CTDSP2,chr12:57819927-57846729,26802
110788026,110788976,chr11,HNRNPA1P60,chr11:110788026-110788976,950
16616848,16617881,chr17,SRSF6P2,chr17:16616848-16617881,1033
72700474,72705607,chr11,ARAP1-AS2,chr11:72700474-72705607,5133
1173141,1178605,chr5,CTD-3080P12.3,chr5:1173141-1178605,5464
20408311,20434286,chr17,USP32P3,chr17:20408311-20434286,25975
80653429,80653988,chr11,ARL6IP1P3,chr11:80653429-80653988,559
109982192,109983043,chr11,RPSAP50,chr11:109982192-109983043,851
90031106,90042025,chr11,TRIM49C,chr11:90031106-90042025,10919
123514473,123514872,chrX,H3P47,chrX:123514473-123514872,399
16067139,16180762,chr5,MARCHF11,chr5:16067139-16180762,113623
26547669,26548463,chr8,PSME2P5,chr8:26547669-26548463,794
41178448,41317731,chr20,ZHX3,chr20:41178448-41317731,139283
7418991,7420546,chr8,HSPD1P3,chr8:7418991-7420546,1555
42851184,42858130,chr17,AOC3,chr17:42851184-42858130,6946
24299850,24309124,chr14,NOP9,chr14:24299850-24309124,9274
17156482,17224799,chr8,ZDHHC2,chr8:17156482-17224799,68317
10353695,10440388,chr5,MARCHF6,chr5:10353695-10440388,86693
9463320,9741037,chrX,TBL1X,chrX:9463320-9741037,277717
93478472,93543391,chr11,SMCO4,chr11:93478472-93543391,64919
63844700,64162217,chr12,SRGAP1,chr12:63844700-64162217,317517
124942608,125143528,chr9,SCAI,chr9:124942608-125143528,200920
38574931,38575431,chr22,RPS29P31,chr22:38574931-38575431,500
106075501,106098699,chr11,AASDHPPT,chr11:106075501-106098699,23198
18315293,18328056,chr17,SMCR8,chr17:18315293-18328056,12763
38681957,38685421,chr22,TOMM22,chr22:38681957-38685421,3464
18968789,19004764,chr17,FAM83G,chr17:18968789-19004764,35975
101203614,101204495,chr7,RPSAP46,chr7:101203614-101204495,881
12945642,13031503,chr8,TRMT9B,chr8:12945642-13031503,85861
118688033,118690599,chr11,TREHP1,chr11:118688033-118690599,2566
64107829,64108486,chr7,MTCO2P8,chr7:64107829-64108486,657
38705742,38738299,chr22,GTPBP1,chr22:38705742-38738299,32557
99419749,99466197,chr7,ATP5MF-PTCD1,chr7:99419749-99466197,46448
134115235,134115736,chr6,HMGA1P7,chr6:134115235-134115736,501
74235801,74311640,chr11,P4HA3,chr11:74235801-74311640,75839
137995270,137996147,chr6,RPSAP42,chr6:137995270-137996147,877
112347330,112351294,chr6,RFPL4B,chr6:112347330-112351294,3964
9725346,9786297,chrX,GPR143,chrX:9725346-9786297,60951
41825057,41836260,chr17,NT5C3B,chr17:41825057-41836260,11203
141635650,141636503,chr6,RPS3AP23,chr6:141635650-141636503,853
24305734,24312053,chr14,LTB4R2,chr14:24305734-24312053,6319
31465471,31476757,chr20,DEFB124,chr20:31465471-31476757,11286
99966720,99976042,chr7,AZGP1,chr7:99966720-99976042,9322
34194569,34269344,chr20,ASIP,chr20:34194569-34269344,74775
24311450,24318036,chr14,LTB4R,chr14:24311450-24318036,6586
52362123,52529886,chr6,EFHC1,chr6:52362123-52529886,167763
40114651,40127468,chr8,LINC02866,chr8:40114651-40127468,12817
64103802,64107565,chr20,NPBWR2,chr20:64103802-64107565,3763
13995369,16053197,chr20,MACROD2,chr20:13995369-16053197,2057828
17296794,17413528,chr8,MTMR7,chr8:17296794-17413528,116734
55645620,55646951,chr7,TUBBP6,chr7:55645620-55646951,1331
13569601,13633575,chrX,EGFL6,chrX:13569601-13633575,63974
24336025,24340022,chr14,RIPK3,chr14:24336025-24340022,3997
97946987,97947998,chr7,OR7E7P,chr7:97946987-97947998,1011
52341197,52354036,chr12,KRT89P,chr12:52341197-52354036,12839
38722743,38723505,chr22,PRDX3P1,chr22:38722743-38723505,762
41890314,42129510,chr9,CNTNAP3B,chr9:41890314-42129510,239196
57906039,57959148,chr12,ATP23,chr12:57906039-57959148,53109
13574746,13575066,chrX,RPL30P15,chrX:13574746-13575066,320
13590292,13590346,chrX,MIR6086,chrX:13590292-13590346,54
13596236,13596548,chrX,RN7SKP20,chrX:13596236-13596548,312
13653189,13681964,chrX,TCEANC,chrX:13653189-13681964,28775
42126499,42130865,chr22,CYP2D6,chr22:42126499-42130865,4366
13689128,13710504,chrX,RAB9A,chrX:13689128-13710504,21376
118880103,118881288,chr7,GTF3AP6,chr7:118880103-118881288,1185
64104093,64105295,chr7,MTND4P2,chr7:64104093-64105295,1202
13734743,13777955,chrX,OFD1,chrX:13734743-13777955,43212
113791466,113791752,chr11,LRRC37A13P,chr11:113791466-113791752,286
79773563,79935460,chr12,PPP1R12A,chr12:79773563-79935460,161897
94509219,94557019,chr7,CASD1,chr7:94509219-94557019,47800
122697709,122699846,chr10,C10orf120,chr10:122697709-122699846,2137
102396332,102470384,chr11,TMEM123,chr11:102396332-102470384,74052
24365673,24379604,chr14,NFATC4,chr14:24365673-24379604,13931
32026210,32139495,chr8,NRG1-IT1,chr8:32026210-32139495,113285
133746641,133747907,chr10,DUX4L11,chr10:133746641-133747907,1266
123154402,123170467,chr10,BUB3,chr10:123154402-123170467,16065
37934281,37940124,chr8,GOT1L1,chr8:37934281-37940124,5843
36306336,36528637,chr20,DLGAP4,chr20:36306336-36528637,222301
115578049,115578243,chr11,RPL12P46,chr11:115578049-115578243,194
117820163,117876667,chr11,FXYD6-FXYD2,chr11:117820163-117876667,56504
14450216,14450883,chr18,LONRF2P1,chr18:14450216-14450883,667
14477955,14499278,chr18,CXADRP3,chr18:14477955-14499278,21323
7256904,7259914,chr8,FAM90A15P,chr8:7256904-7259914,3010
1456480,1523962,chr5,LPCAT1,chr5:1456480-1523962,67482
48488963,48533256,chr13,RCBTB2,chr13:48488963-48533256,44293
14485806,14487501,chr18,GRAMD4P7,chr18:14485806-14487501,1695
14507339,14543600,chr18,POTEC,chr18:14507339-14543600,36261
51817575,51899186,chr8,PCMTD1,chr8:51817575-51899186,81611
122960327,122961086,chr11,ATP5PBP5,chr11:122960327-122961086,759
77514936,77637794,chr11,CLNS1A,chr11:77514936-77637794,122858
281040,291403,chr19,PLPP2,chr19:281040-291403,10363
38291616,38292078,chr7,TRGV11,chr7:38291616-38292078,462
111091006,111125454,chr7,LRRN3,chr7:111091006-111125454,34448
49994513,50012659,chr22,IL17REL,chr22:49994513-50012659,18146
71366222,71532374,chrX,TAF1,chrX:71366222-71532374,166152
33722305,33723079,chr8,VENTXP5,chr8:33722305-33723079,774
5395378,5395957,chr5,MTCO1P30,chr5:5395378-5395957,579
46838788,46839205,chr8,MTND6P20,chr8:46838788-46839205,417
177442519,177681381,chr4,AGA-DT,chr4:177442519-177681381,238862
10441524,10472029,chr5,ROPN1L,chr5:10441524-10472029,30505
50015123,50056935,chr22,TTLL8,chr22:50015123-50056935,41812
93921735,93928610,chr7,GNG11,chr7:93921735-93928610,6875
26383054,26505636,chr8,BNIP3L,chr8:26383054-26505636,122582
155452526,155453044,chr4,MTND6P17,chr4:155452526-155453044,518
154626945,154753120,chr4,LRAT,chr4:154626945-154753120,126175
80742538,80922359,chr7,SEMA3C,chr7:80742538-80922359,179821
14531676,14531782,chr18,RNU6-1021P,chr18:14531676-14531782,106
75674322,75712848,chr15,CSPG4,chr15:75674322-75712848,38526
14570844,14571788,chr18,OR4K7P,chr18:14570844-14571788,944
14613137,14614184,chr18,OR4K8P,chr18:14613137-14614184,1047
14629832,14632806,chr18,SNX19P3,chr18:14629832-14632806,2974
14680604,14681106,chr18,VN1R74P,chr18:14680604-14681106,502
14695422,14706597,chr18,GTF2IP8,chr18:14695422-14706597,11175
50059391,50085426,chr22,MLC1,chr22:50059391-50085426,26035
14759188,14759294,chr18,RNU6-1210P,chr18:14759188-14759294,106
119208531,119211760,chr10,GRK5-IT1,chr10:119208531-119211760,3229
78236062,78279690,chr9,CEP78,chr9:78236062-78279690,43628
14830166,14830242,chr18,MIR3156-2,chr18:14830166-14830242,76
14877611,14884052,chr18,LINC01906,chr18:14877611-14884052,6441
125972188,125973126,chr10,FANK1-AS1,chr10:125972188-125973126,938
14888709,14890086,chr18,FGF7P1,chr18:14888709-14890086,1377
60951,71626,chr19,WASH5P,chr19:60951-71626,10675
154535005,154550400,chr4,PLRG1,chr4:154535005-154550400,15395
124984317,125161170,chr10,CTBP2,chr10:124984317-125161170,176853
20481330,20483991,chr17,TNPO1P3,chr17:20481330-20483991,2661
36591879,36600804,chr17,DHRS11,chr17:36591879-36600804,8925
14946267,14974215,chr18,LINC01443,chr18:14946267-14974215,27948
18288283,18316996,chr20,ZNF133,chr20:18288283-18316996,28713
41895933,41972557,chr15,EHD4,chr15:41895933-41972557,76624
14969001,14970468,chr18,LINC01444,chr18:14969001-14970468,1467
859664,863641,chr19,CFD,chr19:859664-863641,3977
1887332,1900493,chr5,CTD-2194D22.4,chr5:1887332-1900493,13161
49053572,49069857,chrX,CCDC120,chrX:49053572-49069857,16285
1877413,1887236,chr5,IRX4,chr5:1877413-1887236,9823
65089324,65111862,chr11,VPS51,chr11:65089324-65111862,22538
14728272,14854667,chr18,ANKRD30B,chr18:14728272-14854667,126395
75195643,75212169,chr15,C15orf39,chr15:75195643-75212169,16526
751112,764318,chr19,MISP,chr19:751112-764318,13206
42900797,42914438,chr17,G6PC1,chr17:42900797-42914438,13641
4803203,4847288,chr16,GLYR1,chr16:4803203-4847288,44085
76163,77686,chr19,FAM138F,chr19:76163-77686,1523
29067278,29263124,chr8,KIF13B,chr8:29067278-29263124,195846
99408641,99419616,chr7,BUD31,chr7:99408641-99419616,10975
75903876,75942511,chr15,FBXO22,chr15:75903876-75942511,38635
198264,246544,chr19,LINC01002,chr19:198264-246544,48280
9830330,9830627,chr18,RN7SL862P,chr18:9830330-9830627,297
43014607,43025123,chr17,VAT1,chr17:43014607-43025123,10516
9844717,9844846,chr18,RNA5SP449,chr18:9844717-9844846,129
9880580,9880886,chr18,PIGPP4,chr18:9880580-9880886,306
9885766,9889275,chr18,TXNDC2,chr18:9885766-9889275,3509
50274979,50307646,chr22,PLXNB2,chr22:50274979-50307646,32667
174283730,174333380,chr4,CEP44,chr4:174283730-174333380,49650
9914016,9960021,chr18,VAPA,chr18:9914016-9960021,46005
6289857,6290624,chr5,HMGB3P3,chr5:6289857-6290624,767
112762377,112790423,chr7,TMEM168,chr7:112762377-112790423,28046
12574830,12804363,chr5,LINC01194,chr5:12574830-12804363,229533
65122183,65127371,chr11,MRPL49,chr11:65122183-65127371,5188
9035033,9546075,chr5,SEMA5A,chr5:9035033-9546075,511042
49071161,49074002,chrX,PRAF2,chrX:49071161-49074002,2841
39637090,39664201,chr17,STARD3,chr17:39637090-39664201,27111
86791059,86952910,chr11,PRSS23,chr11:86791059-86952910,161851
38340700,38340998,chr7,TRGV6,chr7:38340700-38340998,298
123991910,123992669,chr10,YBX2P1,chr10:123991910-123992669,759
133657235,133660635,chr10,CLUHP5,chr10:133657235-133660635,3400
3162617,3173549,chr20,LZTS3,chr20:3162617-3173549,10932
94738652,94739411,chr7,ATP5PBP2,chr7:94738652-94739411,759
49074433,49101170,chrX,WDR45,chrX:49074433-49101170,26737
122930901,122954311,chr10,C10orf88,chr10:122930901-122954311,23410
101308270,101314800,chr7,EMSLR,chr7:101308270-101314800,6530
83877205,83882474,chr13,SLITRK1,chr13:83877205-83882474,5269
131573966,131628242,chr6,MED23,chr6:131573966-131628242,54276
9923920,9924021,chr18,RNA5SP450,chr18:9923920-9924021,101
116210506,116258783,chr7,TES,chr7:116210506-116258783,48277
58410569,58569844,chr15,LIPC,chr15:58410569-58569844,159275
113711720,113712398,chr11,MTRF1LP1,chr11:113711720-113712398,678
67791648,67805336,chr11,FAM86C2P,chr11:67791648-67805336,13688
10666483,11149569,chr18,PIEZO2,chr18:10666483-11149569,483086
30713478,30764426,chr13,ALOX5AP,chr13:30713478-30764426,50948
183505058,183512429,chr4,ING2,chr4:183505058-183512429,7371
1180561,1185415,chr20,TMEM74B,chr20:1180561-1185415,4854
122454653,122457352,chr10,ARMS2,chr10:122454653-122457352,2699
156279,157215,chr19,OR4F8P,chr19:156279-157215,936
2873420,3039076,chr20,PTPRA,chr20:2873420-3039076,165656
97878475,97959558,chr11,LINC02713,chr11:97878475-97959558,81083
94062,94974,chr19,OR4G3P,chr19:94062-94974,912
161383897,162164004,chr4,FSTL5,chr4:161383897-162164004,780107
125719515,125764143,chr10,EDRF1,chr10:125719515-125764143,44628
145485,145812,chr19,WBP1LP11,chr19:145485-145812,327
99175,106077,chr19,OR4G1P,chr19:99175-106077,6902
113779747,113780500,chr11,CLDN25,chr11:113779747-113780500,753
193239,195595,chr19,CICP19,chr19:193239-195595,2356
825097,832018,chr19,AZU1,chr19:825097-832018,6921
95165513,95232541,chr11,SESN3,chr11:95165513-95232541,67028
63003553,63006902,chr12,LDHAL6CP,chr12:63003553-63006902,3349
43513643,43514421,chr8,SNX18P27,chr8:43513643-43514421,778
101710804,102402457,chr13,FGF14,chr13:101710804-102402457,691653
48294026,48294694,chr8,IDI1P2,chr8:48294026-48294694,668
10488820,10489142,chr5,RPL30P7,chr5:10488820-10489142,322
53191323,53207282,chr12,ITGB7,chr12:53191323-53207282,15959
42896946,43030535,chr8,HOOK3,chr8:42896946-43030535,133589
1370543,1370945,chr5,MTCO2P32,chr5:1370543-1370945,402
63509303,63510165,chr7,PHKG1P2,chr7:63509303-63510165,862
52891837,52897807,chr7,SGO1P2,chr7:52891837-52897807,5970
4693694,4695859,chr16,NUDT16L1,chr16:4693694-4695859,2165
80377554,80377835,chr7,SNRPBP1,chr7:80377554-80377835,281
16661907,16936288,chr5,MYO10,chr5:16661907-16936288,274381
57450177,57473559,chr7,ZNF716,chr7:57450177-57473559,23382
1039997,1065572,chr19,ABCA7,chr19:1039997-1065572,25575
91213815,91361918,chr9,AUH,chr9:91213815-91361918,148103
115061537,115231355,chr7,LINC01392,chr7:115061537-115231355,169818
37683843,37951936,chr7,EPDR1,chr7:37683843-37951936,268093
11965210,11968068,chr16,TNFRSF17,chr16:11965210-11968068,2858
20567138,20691444,chr13,IFT88,chr13:20567138-20691444,124306
113265137,113274032,chr11,NCAM1-AS1,chr11:113265137-113274032,8895
6835535,6885276,chr8,GS1-24F4.2,chr8:6835535-6885276,49741
123035867,123036224,chr11,RPL34P23,chr11:123035867-123036224,357
108470417,108569666,chr7,PNPLA8,chr7:108470417-108569666,99249
72114595,72257193,chr9,GDA,chr9:72114595-72257193,142598
90057605,90062999,chr11,TRIM64EP,chr11:90057605-90062999,5394
4510669,4538828,chr16,CDIP1,chr16:4510669-4538828,28159
19817391,19852083,chr8,INTS10,chr8:19817391-19852083,34692
77738680,77739568,chr11,RSF1-IT1,chr11:77738680-77739568,888
138425523,138436869,chr4,LINC00500,chr4:138425523-138436869,11346
112393118,112624567,chr11,LINC02763,chr11:112393118-112624567,231449
82531653,82534139,chr15,DNM1P38,chr15:82531653-82534139,2486
147732063,148072776,chr4,ARHGAP10,chr4:147732063-148072776,340713
73978926,73994622,chr15,STOML1,chr15:73978926-73994622,15696
59713456,59805882,chr11,STX3,chr11:59713456-59805882,92426
19036282,19122454,chr22,DGCR2,chr22:19036282-19122454,86172
6924697,6926076,chr8,DEFA6,chr8:6924697-6926076,1379
128191655,128255248,chr9,DNM1,chr9:128191655-128255248,63593
26835817,26836300,chr8,COX6B1P4,chr8:26835817-26836300,483
108211222,108261246,chr6,SNX3,chr6:108211222-108261246,50024
46334681,46438190,chr13,RUBCNL,chr13:46334681-46438190,103509
30156319,30183639,chr8,DCTN6,chr8:30156319-30183639,27320
1226044,1296421,chr20,RAD21L1,chr20:1226044-1296421,70377
925781,975939,chr19,ARID3A,chr19:925781-975939,50158
133743332,133744598,chr10,DUX4L10,chr10:133743332-133744598,1266
18317942,18336736,chr16,NPIPA8,chr16:18317942-18336736,18794
114900722,114901366,chr10,RPL15P13,chr10:114900722-114901366,644
131092391,131311721,chr10,TCERG1L,chr10:131092391-131311721,219330
71686082,71705047,chr12,TMEM19,chr12:71686082-71705047,18965
152754903,152875991,chr6,LINC02840,chr6:152754903-152875991,121088
86945679,86955395,chr11,FZD4,chr11:86945679-86955395,9716
17101769,17470960,chr16,XYLT1,chr16:17101769-17470960,369191
122882683,122963862,chr11,JHY,chr11:122882683-122963862,81179
95404862,95435329,chr7,PON2,chr7:95404862-95435329,30467
20501513,20512357,chr17,KRT16P3,chr17:20501513-20512357,10844
121079494,121334745,chr6,TBC1D32,chr6:121079494-121334745,255251
6987178,6989721,chr8,DEFT1P,chr8:6987178-6989721,2543
20361732,20370262,chr12,PDE3A-AS1,chr12:20361732-20370262,8530
41699391,41700251,chr12,MTND1P24,chr12:41699391-41700251,860
43640389,43661922,chr17,MEOX1,chr17:43640389-43661922,21533
1107637,1174268,chr19,SBNO2,chr19:1107637-1174268,66631
119207571,119459745,chr10,GRK5,chr10:119207571-119459745,252174
3953387,4116442,chr16,ADCY9,chr16:3953387-4116442,163055
26291508,26372680,chr8,PPP2R2A,chr8:26291508-26372680,81172
170581470,170605450,chr4,HSP90AA6P,chr4:170581470-170605450,23980
54395261,54419266,chr12,ITGA5,chr12:54395261-54419266,24005
169010430,169010939,chr4,CBR4-DT,chr4:169010430-169010939,509
165684639,165762778,chr4,LINC01179,chr4:165684639-165762778,78139
59123381,59259113,chr20,ZNF831,chr20:59123381-59259113,135732
72576141,72674591,chr11,PDE2A,chr11:72576141-72674591,98450
171812254,173041559,chr4,GALNTL6,chr4:171812254-173041559,1229305
33490075,33650036,chr20,CBFA2T2,chr20:33490075-33650036,159961
50908672,51005895,chr15,AP4E1,chr15:50908672-51005895,97223
19124879,19125646,chr22,TSSK1A,chr22:19124879-19125646,767
43483865,43610338,chr17,DHX8,chr17:43483865-43610338,126473
19130279,19144684,chr22,ESS2,chr22:19130279-19144684,14405
109940104,110008381,chr10,ADD3-AS1,chr10:109940104-110008381,68277
105685383,105685865,chr10,PPIAP38,chr10:105685383-105685865,482
99329356,99394330,chr10,CNNM1,chr10:99329356-99394330,64974
32937402,33441101,chr18,CCDC178,chr18:32937402-33441101,503699
168497052,168928457,chr4,PALLD,chr4:168497052-168928457,431405
12659799,12803887,chr16,CPPED1,chr16:12659799-12803887,144088
59136625,59138182,chr10,TRAF6P1,chr10:59136625-59138182,1557
133749950,133751216,chr10,DUX4L12,chr10:133749950-133751216,1266
116439468,116440044,chr10,HMGB3P8,chr10:116439468-116440044,576
125700436,125719566,chr10,EDRF1-DT,chr10:125700436-125719566,19130
53378503,53378861,chr6,RPA3P2,chr6:53378503-53378861,358
132570322,132571359,chr6,TAAR6,chr6:132570322-132571359,1037
109959218,109960184,chr7,EIF3IP1,chr7:109959218-109960184,966
113616927,113650090,chr6,LINC02541,chr6:113616927-113650090,33163
80936414,81261210,chr12,ACSS3,chr12:80936414-81261210,324796
4748239,4767624,chr16,ZNF500,chr16:4748239-4767624,19385
125674353,125720218,chr6,LINC02523,chr6:125674353-125720218,45865
100603625,100675093,chr13,TMTC4,chr13:100603625-100675093,71468
19131308,19132622,chr22,TSSK2,chr22:19131308-19132622,1314
93106872,93107383,chr10,NIP7P1,chr10:93106872-93107383,511
63211446,63213024,chr6,FKBP1C,chr6:63211446-63213024,1578
119793589,119816642,chr10,PHACTR2P1,chr10:119793589-119816642,23053
19146993,19150292,chr22,GSC2,chr22:19146993-19150292,3299
19171395,19172839,chr22,LINC01311,chr22:19171395-19172839,1444
137823673,137868233,chr6,WAKMAR2,chr6:137823673-137868233,44560
19175581,19178739,chr22,SLC25A1,chr22:19175581-19178739,3158
100463009,100483744,chr10,WNT8B,chr10:100463009-100483744,20735
118548296,118561716,chr6,PLN,chr6:118548296-118561716,13420
122471917,122726373,chr6,PKIB,chr6:122471917-122726373,254456
11833850,11851580,chr16,RSL1D1,chr16:11833850-11851580,17730
405445,409147,chr19,C2CD4C,chr19:405445-409147,3702
127867881,127868487,chr10,BUB1P1,chr10:127867881-127868487,606
10493291,10502728,chr5,LINC02212,chr5:10493291-10502728,9437
47365496,47384293,chr10,ZNF488,chr10:47365496-47384293,18797
1753506,1780988,chr19,ONECUT3,chr19:1753506-1780988,27482
18049232,18049872,chr5,RPL36AP21,chr5:18049232-18049872,640
94524204,94656572,chr7,SGCE,chr7:94524204-94656572,132368
1000419,1009732,chr19,GRIN3B,chr19:1000419-1009732,9313
25187800,25324386,chr5,LINC02211,chr5:25187800-25324386,136586
116749905,116751261,chr10,RPL5P27,chr10:116749905-116751261,1356
133677059,133678327,chr10,DUX4L22,chr10:133677059-133678327,1268
19041009,19041386,chr5,RPL32P14,chr5:19041009-19041386,377
133753250,133754516,chr10,DUX4L13,chr10:133753250-133754516,1266
1855970,1856568,chr5,LINC02116,chr5:1855970-1856568,598
17670168,17670571,chr5,H3P22,chr5:17670168-17670571,403
123171535,123171875,chr10,RPS26P39,chr10:123171535-123171875,340
116324448,116380029,chr10,CCDC172,chr10:116324448-116380029,55581
6371874,6378571,chr5,MED10,chr5:6371874-6378571,6697
52468516,52473805,chr12,KRT6C,chr12:52468516-52473805,5289
21444833,21445439,chr17,PDLIM1P2,chr17:21444833-21445439,606
41717742,41734644,chr17,HAP1,chr17:41717742-41734644,16902
119499817,119542719,chr10,RGS10,chr10:119499817-119542719,42902
9854371,9899970,chr5,LINC02221,chr5:9854371-9899970,45599
1026586,1039068,chr19,CNN2,chr19:1026586-1039068,12482
119177205,119349761,chr6,MAN1A1,chr6:119177205-119349761,172556
79934901,79942712,chr12,PPP1R12A-AS1,chr12:79934901-79942712,7811
23458601,23484971,chr8,ENTPD4-DT,chr8:23458601-23484971,26370
10275875,10307902,chr5,CMBL,chr5:10275875-10307902,32027
111322778,111323397,chr10,BTBD7P2,chr10:111322778-111323397,619
74527584,74527947,chr10,MRPL35P3,chr10:74527584-74527947,363
27809624,27838082,chr8,PBK,chr8:27809624-27838082,28458
117144564,117169108,chr10,MIR3663HG,chr10:117144564-117169108,24544
133676729,133677429,chr6,FTH1P26,chr6:133676729-133677429,700
63390136,63438320,chr15,LINC02568,chr15:63390136-63438320,48184
18150170,18177397,chr22,USP18,chr22:18150170-18177397,27227
149304107,149304428,chr6,FABP12P1,chr6:149304107-149304428,321
116545931,116567855,chr10,PNLIP,chr10:116545931-116567855,21924
49976923,50033136,chr12,RACGAP1,chr12:49976923-50033136,56213
155461633,155462663,chr4,MTND2P33,chr4:155461633-155462663,1030
33666943,33668525,chr20,ACTL10,chr20:33666943-33668525,1582
33912323,33913336,chr20,TPM3P2,chr20:33912323-33913336,1013
33965162,33965576,chr20,PIGPP3,chr20:33965162-33965576,414
117560269,117602542,chr6,GOPC,chr6:117560269-117602542,42273
159026139,159026527,chr4,FABP5P12,chr4:159026139-159026527,388
49858238,50182817,chr15,ATP8B4,chr15:49858238-50182817,324579
184088706,184221230,chr4,ENPP6,chr4:184088706-184221230,132524
39404285,39451272,chr17,MED1,chr17:39404285-39451272,46987
17521801,17522397,chr5,TAF11L4,chr5:17521801-17522397,596
58839718,58911192,chr20,GNAS,chr20:58839718-58911192,71474
81875194,82987179,chr10,NRG3,chr10:81875194-82987179,1111985
143513472,143514635,chr4,SMARCA5-AS1,chr4:143513472-143514635,1163
17625551,17625959,chr5,H3P21,chr5:17625551-17625959,408
183639635,183659203,chr4,RWDD4,chr4:183639635-183659203,19568
10761065,10770294,chr5,DAP-DT,chr5:10761065-10770294,9229
18178038,18205915,chr22,FAM230D,chr22:18178038-18205915,27877
18340145,18345899,chr22,GGTLC5P,chr22:18340145-18345899,5754
3930806,3950586,chr16,LINC02861,chr16:3930806-3950586,19780
18361820,18391105,chr22,FAM230J,chr22:18361820-18391105,29285
7851186,7906025,chr5,MTRR,chr5:7851186-7906025,54839
12081237,12081902,chr16,RPS23P6,chr16:12081237-12081902,665
4562814,4563128,chr16,SUB1P3,chr16:4562814-4563128,314
110609978,110815958,chr6,CDK19,chr6:110609978-110815958,205980
1477830,1478583,chr16,RPS3AP2,chr16:1477830-1478583,753
11868128,11916082,chr16,GSPT1,chr16:11868128-11916082,47954
18400407,18404206,chr22,PPP1R26P3,chr22:18400407-18404206,3799
147458724,147459321,chr4,PRMT5P1,chr4:147458724-147459321,597
18110100,18146683,chr22,TUBA8,chr22:18110100-18146683,36583
184474802,184477304,chr4,IRF2-DT,chr4:184474802-184477304,2502
30027713,30028900,chr8,MAP2K1P1,chr8:30027713-30028900,1187
181905790,181906467,chr4,CCNHP1,chr4:181905790-181906467,677
117128521,117138301,chr10,VAX1,chr10:117128521-117138301,9780
23385783,23457695,chr8,ENTPD4,chr8:23385783-23457695,71912
184365180,184382416,chr4,LINC02362,chr4:184365180-184382416,17236
116663696,116670264,chr10,C10orf82,chr10:116663696-116670264,6568
40443450,40457725,chr17,IGFBP4,chr17:40443450-40457725,14275
42886388,42992271,chr13,EPSTI1,chr13:42886388-42992271,105883
2977538,2995179,chr19,TLE6,chr19:2977538-2995179,17641
147617386,147672044,chr4,TMEM184C,chr4:147617386-147672044,54658
19756703,19783593,chr22,TBX1,chr22:19756703-19783593,26890
93206857,93209627,chr10,XRCC6P1,chr10:93206857-93209627,2770
46917492,47103478,chr18,KATNAL2,chr18:46917492-47103478,185986
160990318,160992342,chr6,MAP3K4-AS1,chr6:160990318-160992342,2024
34319435,34321402,chr17,CCL8,chr17:34319435-34321402,1967
139677639,139860476,chr6,FILNC1,chr6:139677639-139860476,182837
119726042,119829147,chr10,INPP5F,chr10:119726042-119829147,103105
29855759,29856332,chr17,RPL9P30,chr17:29855759-29856332,573
69672757,69867236,chr6,LMBRD1,chr6:69672757-69867236,194479
155458870,155459563,chr4,MTCO2P9,chr4:155458870-155459563,693
27612588,27613251,chr17,ITM2BP1,chr17:27612588-27613251,663
190087705,190088979,chr4,DUX4L3,chr4:190087705-190088979,1274
43766125,43778977,chr17,DUSP3,chr17:43766125-43778977,12852
141636583,141733987,chr4,IL15,chr4:141636583-141733987,97404
30316333,30334059,chr17,TMIGD1,chr17:30316333-30334059,17726
43510958,43531620,chr15,MAP1A,chr15:43510958-43531620,20662
12703066,12704056,chr8,OR7E10P,chr8:12703066-12704056,990
40346461,40390463,chr22,ADSL,chr22:40346461-40390463,44002
13824149,13827323,chr18,MC5R,chr18:13824149-13827323,3174
25691959,26137685,chr16,HS3ST4,chr16:25691959-26137685,445726
54151606,54224669,chr18,MBD2,chr18:54151606-54224669,73063
58434890,58498735,chr15,LIPC-AS1,chr15:58434890-58498735,63845
73925989,73952137,chr15,LOXL1,chr15:73925989-73952137,26148
47260878,47736306,chr8,SPIDR,chr8:47260878-47736306,475428
42810134,42833350,chr17,BECN1,chr17:42810134-42833350,23216
7830378,7851151,chr5,C5orf49,chr5:7830378-7851151,20773
668105,674174,chr16,RHOT2,chr16:668105-674174,6069
708935,748329,chr19,PALM,chr19:708935-748329,39394
3496229,3504004,chr5,LINC01017,chr5:3496229-3504004,7775
21882585,21884310,chr5,HSPD1P1,chr5:21882585-21884310,1725
10479371,10482309,chr5,LINC01513,chr5:10479371-10482309,2938
9641305,9903852,chr5,LINC02112,chr5:9641305-9903852,262547
65381484,65422947,chr15,IGDCC4,chr15:65381484-65422947,41463
5375723,5376836,chr5,ALG3P1,chr5:5375723-5376836,1113
54222284,54222412,chr18,SNORA37,chr18:54222284-54222412,128
14581792,14616180,chr5,OTULINL,chr5:14581792-14616180,34388
114809375,114811170,chr10,TAF9BP2,chr10:114809375-114811170,1795
54269517,54321266,chr18,POLI,chr18:54269517-54321266,51749
100232298,100267680,chr10,CWF19L1,chr10:100232298-100267680,35382
135866983,135913680,chr4,LINC00613,chr4:135866983-135913680,46697
189973599,189973847,chr4,MLLT10P2,chr4:189973599-189973847,248
23570370,23676104,chr13,TNFRSF19,chr13:23570370-23676104,105734
185445182,185471752,chr4,CCDC110,chr4:185445182-185471752,26570
21385194,21456126,chr14,CHD8,chr14:21385194-21456126,70932
5395972,5396335,chr5,MTCO2P30,chr5:5395972-5396335,363
10441290,10441792,chr5,ROPN1L-AS1,chr5:10441290-10441792,502
57325472,57326447,chr15,NDUFB10P1,chr15:57325472-57326447,975
70570958,70586606,chr15,LINC02204,chr15:70570958-70586606,15648
186373,195696,chr19,SEPTIN14P19,chr19:186373-195696,9323
59594875,59640239,chr15,GCNT3,chr15:59594875-59640239,45364
18886622,18887095,chr5,UBE2V1P12,chr5:18886622-18887095,473
35605341,35608935,chr10,GJD4,chr10:35605341-35608935,3594
114938195,114977676,chr10,TRUB1,chr10:114938195-114977676,39481
128208749,128241441,chr11,LINC02098,chr11:128208749-128241441,32692
896503,913245,chr19,R3HDM4,chr19:896503-913245,16742
37288137,37371106,chr5,NUP155,chr5:37288137-37371106,82969
110429948,110464884,chr11,FDX1,chr11:110429948-110464884,34936
106550106,106551121,chr10,RPL23AP59,chr10:106550106-106551121,1015
109996368,110135565,chr10,ADD3,chr10:109996368-110135565,139197
43753738,43758791,chr17,SOST,chr17:43753738-43758791,5053
76931738,76954393,chr15,RCN2,chr15:76931738-76954393,22655
120111286,120185529,chr11,TRIM29,chr11:120111286-120185529,74243
46762506,46833154,chr17,WNT3,chr17:46762506-46833154,70648
83151331,83152190,chr12,RPL6P25,chr12:83151331-83152190,859
67709047,67729475,chr12,LINC02421,chr12:67709047-67729475,20428
53097436,53102345,chr12,IGFBP6,chr12:53097436-53102345,4909
190067935,190069209,chr4,DUX4L8,chr4:190067935-190069209,1274
27651334,27665712,chr17,NOS2P1,chr17:27651334-27665712,14378
184387729,184474550,chr4,IRF2,chr4:184387729-184474550,86821
54357906,54385218,chr18,C18orf54,chr18:54357906-54385218,27312
1086574,1095380,chr19,POLR2E,chr19:1086574-1095380,8806
110456396,110463287,chr13,COL4A2-AS2,chr13:110456396-110463287,6891
43025231,43032041,chr17,RND2,chr17:43025231-43032041,6810
113857345,113863475,chr6,MARCKS,chr6:113857345-113863475,6130
110502575,110508179,chr13,COL4A2-AS1,chr13:110502575-110508179,5604
122789049,122809720,chr6,SMPDL3A,chr6:122789049-122809720,20671
110523066,110561722,chr13,RAB20,chr13:110523066-110561722,38656
43398993,43401137,chr17,ARL4D,chr17:43398993-43401137,2144
52644558,52652211,chr12,KRT2,chr12:52644558-52652211,7653
41108878,41109178,chr15,CYCSP2,chr15:41108878-41109178,300
42798800,42811587,chr17,CNTD1,chr17:42798800-42811587,12787
75791470,75792683,chr15,DNM1P49,chr15:75791470-75792683,1213
136475862,136476150,chr6,NDUFS5P1,chr6:136475862-136476150,288
110641412,110713603,chr13,CARS2,chr13:110641412-110713603,72191
139135080,139180802,chr6,HECA,chr6:139135080-139180802,45722
63125872,63158021,chr15,RPS27L,chr15:63125872-63158021,32149
23059415,23145021,chr22,RSPH14,chr22:23059415-23145021,85606
56416363,56449426,chr12,TIMELESS,chr12:56416363-56449426,33063
126257921,126258355,chr6,PPP1R14BP5,chr6:126257921-126258355,434
15436015,15503608,chr17,CDRT4,chr17:15436015-15503608,67593
55939790,55940624,chr6,NPM1P36,chr6:55939790-55940624,834
89422099,89423048,chr6,NACAP7,chr6:89422099-89423048,949
149218641,149411613,chr6,TAB2,chr6:149218641-149411613,192972
22519195,22519504,chr17,MTND6P35,chr17:22519195-22519504,309
22519617,22520709,chr17,MTCYBP13,chr17:22519617-22520709,1092
48621156,48626358,chr17,HOXB9,chr17:48621156-48626358,5202
40367952,40368438,chr17,PPIAP54,chr17:40367952-40368438,486
16620734,16653856,chr17,ZNF624,chr17:16620734-16653856,33122
23070519,23125032,chr22,GNAZ,chr22:23070519-23125032,54513
190084412,190085686,chr4,DUX4L1,chr4:190084412-190085686,1274
116494989,116545684,chr6,TRAPPC3L,chr6:116494989-116545684,50695
148526493,148527139,chr4,ASS1P8,chr4:148526493-148527139,646
4984390,5129948,chr9,JAK2,chr9:4984390-5129948,145558
54324358,54357964,chr18,STARD6,chr18:54324358-54357964,33606
40894450,40903975,chr15,VPS18,chr15:40894450-40903975,9525
158841117,158857632,chr6,OSTCP1,chr6:158841117-158857632,16515
116616479,116632985,chr6,RSPH4A,chr6:116616479-116632985,16506
23179704,23318037,chr22,BCR,chr22:23179704-23318037,138333
3172346,3180332,chr19,S1PR4,chr19:3172346-3180332,7986
184299129,184299640,chr4,MYL12BP2,chr4:184299129-184299640,511
163343892,163351934,chr4,NPY5R,chr4:163343892-163351934,8042
3185563,3209575,chr19,NCLN,chr19:3185563-3209575,24012
132769370,132813339,chr6,SLC18B1,chr6:132769370-132813339,43969
2235816,2238711,chr16,DNASE1L2,chr16:2235816-2238711,2895
12446512,12658107,chr18,SPIRE1,chr18:12446512-12658107,211595
189982523,189984871,chr4,TUBB7P,chr4:189982523-189984871,2348
41177446,41178221,chr17,KRTAP4-2,chr17:41177446-41178221,775
154724586,154724880,chr4,NDUFB2P1,chr4:154724586-154724880,294
158893134,159038760,chr4,C4orf45,chr4:158893134-159038760,145626
21692523,21704612,chr17,KCNJ18,chr17:21692523-21704612,12089
82355142,82420075,chr15,UBE2Q2P2,chr15:82355142-82420075,64933
4433940,4488208,chr17,SPNS3,chr17:4433940-4488208,54268
183233628,183240634,chr4,WWC2-AS1,chr4:183233628-183240634,7006
72708186,72708565,chr11,RPS12P20,chr11:72708186-72708565,379
74812716,74825757,chr15,LMAN1L,chr15:74812716-74825757,13041
177728757,178028971,chr4,LINC01098,chr4:177728757-178028971,300214
46701030,46705912,chr11,ZNF408,chr11:46701030-46705912,4882
89146055,89165565,chr6,PM20D2,chr6:89146055-89165565,19510
152536264,152539263,chr4,MIR4453HG,chr4:152536264-152539263,2999
165277812,165279679,chr4,GK3P,chr4:165277812-165279679,1867
89080164,89080667,chr6,PNRC1-DT,chr6:89080164-89080667,503
86970466,86971193,chr6,RPL7P29,chr6:86970466-86971193,727
121250270,121250978,chr11,RPS4XP12,chr11:121250270-121250978,708
169788790,169799549,chr6,LINC00242,chr6:169788790-169799549,10759
125158461,125164609,chr11,PKNOX2-DT,chr11:125158461-125164609,6148
34219439,34220066,chr6,CYCSP55,chr6:34219439-34220066,627
47231532,47309905,chr6,TNFRSF21,chr6:47231532-47309905,78373
181064089,181159149,chr4,LINC00290,chr4:181064089-181159149,95060
105609994,105982092,chr11,GRIA4,chr11:105609994-105982092,372098
155462873,155463823,chr4,MTND1P22,chr4:155462873-155463823,950
48294335,48308762,chr17,SKAP1-AS2,chr17:48294335-48308762,14427
10896045,11201833,chr8,XKR6,chr8:10896045-11201833,305788
165873237,166104457,chr4,TLL1,chr4:165873237-166104457,231220
439978,445939,chr17,RFLNB,chr17:439978-445939,5961
134917393,134950115,chr6,ALDH8A1,chr6:134917393-134950115,32722
123706207,123940267,chr10,CPXM2,chr10:123706207-123940267,234060
21446683,21520444,chr16,SMG1P3,chr16:21446683-21520444,73761
47194002,47194347,chr8,ATP6V1G1P2,chr8:47194002-47194347,345
35525176,35525763,chr8,LSM12P1,chr8:35525176-35525763,587
48557262,48560333,chr17,HOXB-AS2,chr17:48557262-48560333,3071
49082028,49082165,chrX,RNU4-52P,chrX:49082028-49082165,137
49113407,49123735,chrX,GPKOW,chrX:49113407-49123735,10328
40298697,40353133,chr8,SIRLNT,chr8:40298697-40353133,54436
15500180,15939795,chr5,FBXL7,chr5:15500180-15939795,439615
30769388,30824692,chr17,CRLF3,chr17:30769388-30824692,55304
25419258,25424654,chr8,GNRH1,chr8:25419258-25424654,5396
79574979,79690964,chr12,PAWR,chr12:79574979-79690964,115985
112040783,112175297,chr9,SUSD1,chr9:112040783-112175297,134514
13250235,13250662,chr5,RPS23P5,chr5:13250235-13250662,427
46341354,46341599,chr15,MTND5P40,chr15:46341354-46341599,245
49152651,49152944,chrX,RN7SL262P,chrX:49152651-49152944,293
22142352,22152356,chr5,PMCHL1,chr5:22142352-22152356,10004
49162564,49168483,chrX,MAGIX,chrX:49162564-49168483,5919
56421544,56465137,chr15,MNS1,chr15:56421544-56465137,43593
19410496,19499113,chr16,TMC5,chr16:19410496-19499113,88617
46822174,46907309,chr8,LINC00293,chr8:46822174-46907309,85135
144150517,144191939,chr6,STX11,chr6:144150517-144191939,41422
12914068,13032886,chr5,LINC02220,chr5:12914068-13032886,118818
30248350,30248893,chr5,HPRT1P2,chr5:30248350-30248893,543
25174802,25602229,chr10,GPR158,chr10:25174802-25602229,427427
15384220,15384853,chr5,MARK2P5,chr5:15384220-15384853,633
88609897,88963618,chr6,RNGTT,chr6:88609897-88963618,353721
17353695,17354624,chr5,FTH1P10,chr5:17353695-17354624,929
8333481,8457558,chr5,LINC02226,chr5:8333481-8457558,124077
62643994,62935150,chr12,PPM1H,chr12:62643994-62935150,291156
49155656,49367869,chr15,GALK2,chr15:49155656-49367869,212213
149781930,149787737,chrX,MAGEA9,chrX:149781930-149787737,5807
27057399,27058221,chr17,VN1R71P,chr17:27057399-27058221,822
120938701,120942023,chrX,CT47A10,chrX:120938701-120942023,3322
43780435,43787620,chr17,CFAP97D1,chr17:43780435-43787620,7185
10564070,10657816,chr5,ANKRD33B,chr5:10564070-10657816,93746
23179918,23180172,chr22,BCRP8,chr22:23179918-23180172,254
23261782,23262071,chr22,RN7SL263P,chr22:23261782-23262071,289
23262767,23265005,chr22,FBXW4P1,chr22:23262767-23265005,2238
120943561,120946883,chrX,CT47A9,chrX:120943561-120946883,3322
99875577,100009947,chr10,DNMBP,chr10:99875577-100009947,134370
41226648,41227652,chr17,KRTAP9-2,chr17:41226648-41227652,1004
35617844,35814611,chr5,SPEF2,chr5:35617844-35814611,196767
120948422,120951744,chrX,CT47A8,chrX:120948422-120951744,3322
41754604,41786931,chr17,JUP,chr17:41754604-41786931,32327
52514575,52520530,chr12,KRT5,chr12:52514575-52520530,5955
120958165,120961487,chrX,CT47A6,chrX:120958165-120961487,3322
120963026,120966348,chrX,CT47A5,chrX:120963026-120966348,3322
37807905,37817176,chr22,GCAT,chr22:37807905-37817176,9271
120967886,120971208,chrX,CT47A4,chrX:120967886-120971208,3322
120972746,120976068,chrX,CT47A3,chrX:120972746-120976068,3322
4304598,4323843,chr19,FSD1,chr19:4304598-4323843,19245
120977606,120980928,chrX,CT47A2,chrX:120977606-120980928,3322
155342658,155376970,chr4,MAP9,chr4:155342658-155376970,34312
149592512,149595314,chrX,HSFX2,chrX:149592512-149595314,2802
94446740,94447179,chr6,MTCYBP36,chr6:94446740-94447179,439
71288811,71309059,chr6,OGFRL1,chr6:71288811-71309059,20248
135020513,135022542,chrX,RTL8B,chrX:135020513-135022542,2029
135032355,135033546,chrX,RTL8C,chrX:135032355-135033546,1191
72521608,72838297,chr9,TMC1,chr9:72521608-72838297,316689
32188323,32188817,chr10,PPIAP31,chr10:32188323-32188817,494
120336413,120489937,chr11,ARHGEF12,chr11:120336413-120489937,153524
49866896,49904217,chr12,FAIM2,chr12:49866896-49904217,37321
151099529,151099933,chr6,RPL32P16,chr6:151099529-151099933,404
135050932,135052196,chrX,RTL8A,chrX:135050932-135052196,1264
97458324,97498794,chr10,MMS19,chr10:97458324-97498794,40470
149977922,149978416,chr6,BTF3P10,chr6:149977922-149978416,494
71584721,71585906,chr6,KRT19P1,chr6:71584721-71585906,1185
134897874,134898759,chr6,MEMO1P2,chr6:134897874-134898759,885
135059685,135123952,chrX,SMIM10L2B-AS1,chrX:135059685-135123952,64267
37823382,37825485,chr22,GALR3,chr22:37823382-37825485,2103
135075136,135076597,chrX,NCLP2,chrX:135075136-135076597,1461
153667318,153668106,chr6,MTCO3P31,chr6:153667318-153668106,788
135094985,135098712,chrX,SMIM10L2B,chrX:135094985-135098712,3727
63227485,63227743,chr6,SPTLC1P3,chr6:63227485-63227743,258
37844272,37844371,chr22,MIR658,chr22:37844272-37844371,99
37847678,37847774,chr22,MIR659,chr22:37847678-37847774,96
135118955,135120526,chrX,ETDB,chrX:135118955-135120526,1571
37848868,37889407,chr22,EIF3L,chr22:37848868-37889407,40539
166409364,166906451,chr6,RPS6KA2,chr6:166409364-166906451,497087
264140,278283,chr2,ACP1,chr2:264140-278283,14143
135156540,135171398,chrX,CT55,chrX:135156540-135171398,14858
110712736,110723339,chr13,ING1,chr13:110712736-110723339,10603
135248920,135344109,chrX,ZNF75D,chrX:135248920-135344109,95189
41101019,41101100,chr13,MIR3168,chr13:41101019-41101100,81
41121876,41122171,chr13,RN7SL597P,chr13:41121876-41122171,295
41127569,41132802,chr13,KBTBD6,chr13:41127569-41132802,5233
135252061,135253583,chrX,ETDA,chrX:135252061-135253583,1522
21397292,21397401,chr14,SNORD8,chr14:21397292-21397401,109
3750772,3761692,chr19,APBA3,chr19:3750772-3761692,10920
21419620,21419960,chr14,EIF4EBP1P1,chr14:21419620-21419960,340
135309480,135309659,chrX,ETDC,chrX:135309480-135309659,179
21429508,21429806,chr14,RN7SL650P,chr14:21429508-21429806,298
41170700,41171148,chr13,CALM2P3,chr13:41170700-41171148,448
21459020,21476960,chr14,RAB2B,chr14:21459020-21476960,17940
135344796,135363413,chrX,ZNF449,chrX:135344796-135363413,18617
41189834,41194569,chr13,KBTBD7,chr13:41189834-41194569,4735
54802746,54803589,chr12,VDAC1P5,chr12:54802746-54803589,843
63871739,63872044,chr12,RPL36AP41,chr12:63871739-63872044,305
39206917,39800322,chr18,MIR924HG,chr18:39206917-39800322,593405
41199832,41200807,chr13,MORF4L1P4,chr13:41199832-41200807,975
135421944,135428075,chrX,SMIM10L2A,chrX:135421944-135428075,6131
135428168,135428285,chrX,RNA5SP515,chrX:135428168-135428285,117
135432960,135438634,chrX,CROCCP1,chrX:135432960-135438634,5674
135464329,135465484,chrX,WDR4P1,chrX:135464329-135465484,1155
41216369,41263577,chr13,MTRF1,chr13:41216369-41263577,47208
23664262,23686397,chrX,PRDX4,chrX:23664262-23686397,22135
49707725,49764934,chr12,TMBIM6,chr12:49707725-49764934,57209
68536580,68540883,chr9,TMEM252,chr9:68536580-68540883,4303
170060222,170091699,chr4,AADAT,chr4:170060222-170091699,31477
43211835,43220041,chr17,TMEM106A,chr17:43211835-43220041,8206
3708362,3750813,chr19,TJP3,chr19:3708362-3750813,42451
127224265,127393660,chr9,GARNL3,chr9:127224265-127393660,169395
92265702,92265807,chr14,RNU6-366P,chr14:92265702-92265807,105
92322581,92501481,chr14,SLC24A4,chr14:92322581-92501481,178900
23701055,23766475,chrX,ACOT9,chrX:23701055-23766475,65420
8618581,8619104,chr5,MTND6P2,chr5:8618581-8619104,523
19233366,19234487,chr5,HSPD1P15,chr5:19233366-19234487,1121
20606710,20616441,chr5,LINC02146,chr5:20606710-20616441,9731
78976555,78979074,chr18,LINC01896,chr18:78976555-78979074,2519
41967139,41968366,chr5,MTHFD2P6,chr5:41967139-41968366,1227
31101540,31162789,chr18,DSCAS,chr18:31101540-31162789,61249
34998101,35048135,chr5,AGXT2,chr5:34998101-35048135,50034
42780610,42797066,chr17,WNK4,chr17:42780610-42797066,16456
70630519,70650945,chr18,GTSCR1,chr18:70630519-70650945,20426
3725054,3880713,chr16,CREBBP,chr16:3725054-3880713,155659
24534551,24708542,chr18,LINC01915,chr18:24534551-24708542,173991
41287741,41288320,chr13,RAC1P3,chr13:41287741-41288320,579
1374066,1543711,chr2,TPO,chr2:1374066-1543711,169645
41311267,41377030,chr13,NAA16,chr13:41311267-41377030,65763
35290282,35328390,chr18,ZNF271P,chr18:35290282-35328390,38108
63769428,63813937,chr8,LINC01289,chr8:63769428-63813937,44509
78593052,78621295,chr15,CHRNA3,chr15:78593052-78621295,28243
121447331,121453013,chr11,SORL1-AS1,chr11:121447331-121453013,5682
27490781,27545564,chr8,EPHX2,chr8:27490781-27545564,54783
119987952,119995037,chr11,LINC02744,chr11:119987952-119995037,7085
48723185,48724758,chr17,PRAC2,chr17:48723185-48724758,1573
190091005,190092279,chr4,DUX4L2,chr4:190091005-190092279,1274
37905657,37942822,chr22,MICALL1,chr22:37905657-37942822,37165
43444707,43451200,chr17,MIR2117HG,chr17:43444707-43451200,6493
65145691,65145972,chr11,HIGD1AP10,chr11:65145691-65145972,281
30567700,30571748,chr17,KRT17P3,chr17:30567700-30571748,4048
31724198,31742715,chr18,LRRC37A7P,chr18:31724198-31742715,18517
23833353,23907938,chrX,APOO,chrX:23833353-23907938,74585
122115340,122116215,chr11,BLID,chr11:122115340-122116215,875
190173774,190185942,chr4,DUX4,chr4:190173774-190185942,12168
78581675,78582156,chr11,COPS8P3,chr11:78581675-78582156,481
123049787,123050353,chr11,RPS26P43,chr11:123049787-123050353,566
19082437,19084834,chr17,KYNUP2,chr17:19082437-19084834,2397
123313657,123315340,chr11,LINC02727,chr11:123313657-123315340,1683
5721812,5876328,chr18,MIR3976HG,chr18:5721812-5876328,154516
21504558,21505059,chr17,RPL21P120,chr17:21504558-21505059,501
113789231,113791366,chr11,ATF4P4,chr11:113789231-113791366,2135
162322188,162323907,chr4,MTHFD2P4,chr4:162322188-162323907,1719
46978156,46979253,chr17,RPRML,chr17:46978156-46979253,1097
174829668,174978180,chr4,ADAM29,chr4:174829668-174978180,148512
124622836,124635926,chr11,TBRG1,chr11:124622836-124635926,13090
125747664,125761269,chr6,HEY2,chr6:125747664-125761269,13605
17759154,17770821,chr17,RAI1-AS1,chr17:17759154-17770821,11667
23836742,23837321,chrX,RPL9P7,chrX:23836742-23837321,579
30624413,30625494,chr17,SH3GL1P2,chr17:30624413-30625494,1081
58244843,58272012,chr14,PSMA3,chr14:58244843-58272012,27169
23908006,23939509,chrX,CXorf58,chrX:23908006-23939509,31503
49505657,49574064,chr17,NGFR-AS1,chr17:49505657-49574064,68407
122859678,122859988,chr6,ATP5MGP2,chr6:122859678-122859988,310
46833201,46886730,chr17,WNT9B,chr17:46833201-46886730,53529
38937920,39074399,chr5,RICTOR,chr5:38937920-39074399,136479
2538112,2538754,chr19,ELOCP28,chr19:2538112-2538754,642
840999,848175,chr19,PRTN3,chr19:840999-848175,7176
41033627,41097787,chr6,OARD1,chr6:41033627-41097787,64160
154762742,154777689,chrX,DKC1,chrX:154762742-154777689,14947
136940435,136944738,chr9,FBXW5,chr9:136940435-136944738,4303
43125551,43153671,chr17,NBR2,chr17:43125551-43153671,28120
71822291,72118577,chr15,MYO9A,chr15:71822291-72118577,296286
17674026,17677688,chr17,SMCR2,chr17:17674026-17677688,3662
41249687,41250653,chr17,KRTAP9-4,chr17:41249687-41250653,966
3473986,3480525,chr19,SMIM24,chr19:3473986-3480525,6539
159665833,159777828,chr4,LINC02233,chr4:159665833-159777828,111995
27629798,27649560,chr17,LGALS9,chr17:27629798-27649560,19762
41447830,41529273,chr22,ACO2,chr22:41447830-41529273,81443
136945185,136946975,chr9,C8G,chr9:136945185-136946975,1790
152320544,152536092,chr4,FBXW7,chr4:152320544-152536092,215548
39841688,39896298,chr18,LINC01902,chr18:39841688-39896298,54610
2252252,2269759,chr19,JSRP1,chr19:2252252-2269759,17507
136949551,136955497,chr9,LCN12,chr9:136949551-136955497,5946
63367295,63381631,chr18,KDSR-DT,chr18:63367295-63381631,14336
630886,658340,chr18,TYMSOS,chr18:630886-658340,27454
5455417,5456856,chr19,ZNRF4,chr19:5455417-5456856,1439
8695856,8707699,chr18,GACAT2,chr18:8695856-8707699,11843
3314403,3469217,chr19,NFIC,chr19:3314403-3469217,154814
76491629,76493920,chr18,ZNF516-AS1,chr18:76491629-76493920,2291
72868388,72881399,chr18,NETO1-DT,chr18:72868388-72881399,13011
19334011,19337804,chr16,LINC02858,chr16:19334011-19337804,3793
18781295,18790383,chr16,RPS15A,chr16:18781295-18790383,9088
9121179,9136645,chr18,NDUFV2-AS1,chr18:9121179-9136645,15466
124739942,124747210,chr11,NRGN,chr11:124739942-124747210,7268
136969243,136971990,chr9,LINC02692,chr9:136969243-136971990,2747
3593732,3598363,chr18,DLGAP1-AS1,chr18:3593732-3598363,4631
63271404,63272336,chr12,HNRNPA1P69,chr12:63271404-63272336,932
136975092,136981742,chr9,PTGDS,chr9:136975092-136981742,6650
52763405,52763893,chr12,ARL2BPP2,chr12:52763405-52763893,488
134950708,134951568,chr11,LINC02697,chr11:134950708-134951568,860
101129077,101209591,chr11,PGR-AS1,chr11:101129077-101209591,80514
51281038,51324668,chr12,BIN2,chr12:51281038-51324668,43630
58445788,58453766,chr18,MIR122HG,chr18:58445788-58453766,7978
41354557,41354659,chr13,RNU6-57P,chr13:41354557-41354659,102
41384773,41385183,chr13,TUBBP2,chr13:41384773-41385183,410
41431248,41432201,chr13,OR7E36P,chr13:41431248-41432201,953
121452314,121633763,chr11,SORL1,chr11:121452314-121633763,181449
102673731,102714397,chr10,ARL3,chr10:102673731-102714397,40666
41439834,41440847,chr13,OR7E155P,chr13:41439834-41440847,1013
36179996,36187459,chr18,COSMOC,chr18:36179996-36187459,7463
41442770,41443666,chr13,OR7E37P,chr13:41442770-41443666,896
6462144,6463030,chr18,RPL6P27,chr18:6462144-6463030,886
41457550,41470871,chr13,RGCC,chr13:41457550-41470871,13321
136981904,136986410,chr9,LCNL1,chr9:136981904-136986410,4506
177309874,177362936,chr4,NEIL3,chr4:177309874-177362936,53062
98457077,99235862,chr10,HPSE2,chr10:98457077-99235862,778785
58284773,58285363,chr14,HMGB1P14,chr14:58284773-58285363,590
58288033,58289158,chr14,LINC00216,chr14:58288033-58289158,1125
136992422,136993984,chr9,PAXX,chr9:136992422-136993984,1562
58292293,58292388,chr14,RNU6-341P,chr14:58292293-58292388,95
22164886,22169878,chr18,GATA6-AS1,chr18:22164886-22169878,4992
58298504,58373887,chr14,ARID4A,chr14:58298504-58373887,75383
176213673,176277571,chr4,ASB5,chr4:176213673-176277571,63898
41566835,41961120,chr13,VWA8,chr13:41566835-41961120,394285
154778684,154821007,chrX,MPP1,chrX:154778684-154821007,42323
136994608,136996568,chr9,CLIC3,chr9:136994608-136996568,1960
3603000,3610103,chr18,DLGAP1-AS2,chr18:3603000-3610103,7103
137027464,137037957,chr9,LINC02908,chr9:137027464-137037957,10493
150599883,150843665,chr6,PLEKHG1,chr6:150599883-150843665,243782
137030174,137032088,chr9,FUT7,chr9:137030174-137032088,1914
116849499,116911788,chr10,ENO4,chr10:116849499-116911788,62289
180573464,180574027,chr4,NDUFB5P1,chr4:180573464-180574027,563
80147908,80179839,chr18,PARD6G-AS1,chr18:80147908-80179839,31931
17932720,17933275,chr16,RPL7P47,chr16:17932720-17933275,555
164725310,164726706,chr4,CHORDC1P3,chr4:164725310-164726706,1396
170745518,170745977,chr6,RPL23AP47,chr6:170745518-170745977,459
18374521,18401940,chr16,PKD1P5,chr16:18374521-18401940,27419
176184579,176195585,chr4,SPATA4,chr4:176184579-176195585,11006
137039463,137046179,chr9,NPDC1,chr9:137039463-137046179,6716
132617022,132624275,chr6,TAAR2,chr6:132617022-132624275,7253
69643360,69699476,chr12,BEST3,chr12:69643360-69699476,56116
96889315,96897891,chr6,NDUFAF4,chr6:96889315-96897891,8576
143422832,143450695,chr6,ADAT2,chr6:143422832-143450695,27863
25140577,25149032,chr16,LCMT1-AS2,chr16:25140577-25149032,8455
72893584,72933036,chr10,OIT3,chr10:72893584-72933036,39452
49813961,49851059,chr18,SNHG22,chr18:49813961-49851059,37098
171289475,171298267,chr4,LINC02504,chr4:171289475-171298267,8792
46972476,46974617,chr8,MAPK6P4,chr8:46972476-46974617,2141
150827663,150828384,chr6,PDCL3P5,chr6:150827663-150828384,721
105157900,105180014,chr6,POPDC3,chr6:105157900-105180014,22114
114690143,114690634,chr10,PPIAP19,chr10:114690143-114690634,491
130213488,130483193,chr10,LINC02646,chr10:130213488-130483193,269705
28089673,28191156,chr8,ELP3,chr8:28089673-28191156,101483
137048107,137054061,chr9,ENTPD2,chr9:137048107-137054061,5954
91726810,91727070,chr6,MTATP6P25,chr6:91726810-91727070,260
143490424,143506406,chr6,VDAC1P8,chr6:143490424-143506406,15982
190037916,190038399,chr4,RARRES2P4,chr4:190037916-190038399,483
190195727,190196190,chr4,RPL23AP84,chr4:190195727-190196190,463
112987476,112987865,chr10,RPS15AP30,chr10:112987476-112987865,389
5237826,5290608,chr18,LINC00667,chr18:5237826-5290608,52782
176683538,176792922,chr4,VEGFC,chr4:176683538-176792922,109384
113854661,113917194,chr10,NHLRC2,chr10:113854661-113917194,62533
11968508,11968743,chr16,UBL5P4,chr16:11968508-11968743,235
42359498,42412949,chr15,CAPN3,chr15:42359498-42412949,53451
170199769,170200258,chr6,RPL12P23,chr6:170199769-170200258,489
9446010,9455505,chr16,LINC01195,chr16:9446010-9455505,9495
41189749,41201149,chr6,TREML2,chr6:41189749-41201149,11400
15104723,15131601,chr16,PKD1P6-NPIPP1,chr16:15104723-15131601,26878
279558,288851,chr2,ALKAL2,chr2:279558-288851,9293
154817099,154817401,chrX,HMGN1P37,chrX:154817099-154817401,302
155459704,155461237,chr4,MTCO1P9,chr4:155459704-155461237,1533
26584755,26594813,chr16,LINC02195,chr16:26584755-26594813,10058
5916139,5978142,chr19,RANBP3,chr19:5916139-5978142,62003
154884972,154885558,chrX,H2AB1,chrX:154884972-154885558,586
116254173,116444861,chr6,DSE,chr6:116254173-116444861,190688
117542445,117549546,chr10,EMX2,chr10:117542445-117549546,7101
160539254,160586817,chr4,LINC02477,chr4:160539254-160586817,47563
137062127,137070557,chr9,SAPCD2,chr9:137062127-137070557,8430
154886355,154888061,chrX,F8A1,chrX:154886355-154888061,1706
268301,275980,chr16,RGS11,chr16:268301-275980,7679
154908885,154919103,chrX,EEF1A1P31,chrX:154908885-154919103,10218
173168811,173323967,chr4,GALNT7,chr4:173168811-173323967,155156
154919578,154920182,chrX,ZNF622P1,chrX:154919578-154920182,604
102546734,102548213,chrX,FOXN3P1,chrX:102546734-102548213,1479
102549965,102571695,chrX,NXF4,chrX:102549965-102571695,21730
62183035,62268844,chr10,RTKN2,chr10:62183035-62268844,85809
102599512,102714671,chrX,ARMCX5-GPRASP2,chrX:102599512-102714671,115159
137077517,137084539,chr9,UAP1L1,chr9:137077517-137084539,7022
17604177,17605377,chr5,TAF11L11,chr5:17604177-17605377,1200
24835280,24840583,chr5,LINC02239,chr5:24835280-24840583,5303
102615473,102615820,chrX,H3P45,chrX:102615473-102615820,347
102651092,102659083,chrX,GPRASP1,chrX:102651092-102659083,7991
41306952,41510628,chr5,PLCXD3,chr5:41306952-41510628,203676
3379675,3485094,chr2,TRAPPC12,chr2:3379675-3485094,105419
137084946,137086817,chr9,MAN1B1-DT,chr9:137084946-137086817,1871
96343221,96359365,chr10,OPALIN,chr10:96343221-96359365,16144
50719565,50756219,chr17,LUC7L3,chr17:50719565-50756219,36654
137110546,137115177,chr9,DPP7,chr9:137110546-137115177,4631
4773481,4774865,chr5,LINC02114,chr5:4773481-4774865,1384
150042546,150043353,chr6,PHBP1,chr6:150042546-150043353,807
51346249,51643939,chr18,LINC01630,chr18:51346249-51643939,297690
51351247,51392867,chr12,GALNT6,chr12:51351247-51392867,41620
163110073,163166890,chr4,NAF1,chr4:163110073-163166890,56817
102678707,102678813,chrX,RNU6-589P,chrX:102678707-102678813,106
102705784,102706240,chrX,BEND7P1,chrX:102705784-102706240,456
89433152,89633834,chr6,ANKRD6,chr6:89433152-89633834,200682
17378906,17387310,chr5,LINC02111,chr5:17378906-17387310,8404
102720688,102753540,chrX,BHLHB9,chrX:102720688-102753540,32852
20611806,20937800,chr5,LINC02241,chr5:20611806-20937800,325994
183321764,183322426,chr4,CLDN24,chr4:183321764-183322426,662
109341813,109342697,chrX,GAPDHP77,chrX:109341813-109342697,884
176875688,176908031,chr4,LINC02509,chr4:176875688-176908031,32343
109372906,109482086,chrX,GUCY2F,chrX:109372906-109482086,109180
58370023,58395641,chr14,TOMM20L-DT,chr14:58370023-58395641,25618
58395928,58408702,chr14,TOMM20L,chr14:58395928-58408702,12774
176012038,176014417,chr4,MARK2P4,chr4:176012038-176014417,2379
165547532,165551060,chr4,NOL8P1,chr4:165547532-165551060,3528
137139154,137168756,chr9,GRIN1,chr9:137139154-137168756,29602
58408495,58427531,chr14,TIMM9,chr14:58408495-58427531,19036
109535781,109544698,chrX,NXT2,chrX:109535781-109544698,8917
185585444,185956652,chr4,SORBS2,chr4:185585444-185956652,371208
41568286,41568395,chr13,MIR5006,chr13:41568286-41568395,109
41807677,41807973,chr13,RN7SL515P,chr13:41807677-41807973,296
99610522,99620609,chr10,SLC25A28,chr10:99610522-99620609,10087
41905118,41905224,chr13,RNU6-74P,chr13:41905118-41905224,106
41925598,41927349,chr13,KARS1P1,chr13:41925598-41927349,1751
3497366,3519531,chr2,ADI1,chr2:3497366-3519531,22165
41955808,41981565,chr13,VWA8-AS1,chr13:41955808-41981565,25757
130226677,130314917,chr11,ZBTB44,chr11:130226677-130314917,88240
109568478,109570289,chrX,MFN1P1,chrX:109568478-109570289,1811
42003430,42003637,chr13,RPS28P8,chr13:42003430-42003637,207
109623700,109625172,chrX,KCNE5,chrX:109623700-109625172,1472
317912,342118,chr2,LINC01865,chr2:317912-342118,24206
73005833,73006595,chr10,RPL17P50,chr10:73005833-73006595,762
42068932,42071093,chr13,MAPK6P3,chr13:42068932-42071093,2161
109624244,109733403,chrX,ACSL4,chrX:109624244-109733403,109159
97168751,97187578,chr13,LINC00456,chr13:97168751-97187578,18827
15093263,15093611,chr10,GAPDHP45,chr10:15093263-15093611,348
3957652,3974124,chr2,LINC01304,chr2:3957652-3974124,16472
92140278,92145846,chr12,BTG1,chr12:92140278-92145846,5568
123356450,123537767,chr10,LINC02641,chr10:123356450-123537767,181317
97362972,97363101,chr13,RNA5SP37,chr13:97362972-97363101,129
10839964,10847594,chr8,PINX1-DT,chr8:10839964-10847594,7630
30117384,30117779,chr8,RPS15AP24,chr8:30117384-30117779,395
12205759,12206389,chr8,ENPP7P12,chr8:12205759-12206389,630
30349866,30350347,chr8,PPIAP84,chr8:30349866-30350347,481
97434169,97469128,chr13,RAP2A,chr13:97434169-97469128,34959
113834725,113854383,chr10,DCLRE1A,chr10:113834725-113854383,19658
77219603,77317234,chr12,LINC02464,chr12:77219603-77317234,97631
58427385,58551297,chr14,KIAA0586,chr14:58427385-58551297,123912
48008415,48064708,chr8,UBE2V2,chr8:48008415-48064708,56293
69239569,69274358,chr12,CPSF6,chr12:69239569-69274358,34789
2895048,3126026,chr2,LINC01250,chr2:2895048-3126026,230978
29327680,29388583,chr22,AP1B1,chr22:29327680-29388583,60903
677186,697382,chr2,TMEM18-DT,chr2:677186-697382,20196
97475742,97476459,chr13,PSMA6P4,chr13:97475742-97476459,717
545805,546667,chr2,LINC01875,chr2:545805-546667,862
48389567,48444704,chr13,LPAR6,chr13:48389567-48444704,55137
125671522,125680874,chr11,ACRV1,chr11:125671522-125680874,9352
14872332,14872713,chr5,ANKH-DT,chr5:14872332-14872713,381
6615389,6651104,chr2,MIR7515HG,chr2:6615389-6651104,35715
91765899,91767196,chr10,FAF2P1,chr10:91765899-91767196,1297
31983885,31984554,chr10,RPL34P19,chr10:31983885-31984554,669
3357264,3536094,chr5,LINC01019,chr5:3357264-3536094,178830
118341437,118398468,chr10,LINC00867,chr10:118341437-118398468,57031
7346986,7348671,chr5,LINC02123,chr5:7346986-7348671,1685
29421476,29422012,chr10,PTCHD3P1,chr10:29421476-29422012,536
100150094,100186033,chr10,ERLIN1,chr10:100150094-100186033,35939
46909742,46911512,chr17,LINC01974,chr17:46909742-46911512,1770
32354350,32444740,chr5,ZFR,chr5:32354350-32444740,90390
784974,788397,chr16,RPUSD1,chr16:784974-788397,3423
6755447,6775647,chr17,XAF1,chr17:6755447-6775647,20200
110615545,110639996,chr13,NAXD,chr13:110615545-110639996,24451
89908540,89909047,chr11,MTND1P35,chr11:89908540-89909047,507
125113161,125126781,chr11,KRT18P59,chr11:125113161-125126781,13620
129537869,129538114,chr11,RPS27P20,chr11:129537869-129538114,245
93083598,93083675,chr12,RPL41P5,chr12:93083598-93083675,77
124633113,124695707,chr11,SIAE,chr11:124633113-124695707,62594
19432545,19436075,chr22,MRPL40,chr22:19432545-19436075,3530
71849228,71850428,chr12,MRS2P2,chr12:71849228-71850428,1200
95803097,95823307,chr12,LINC02410,chr12:95803097-95823307,20210
53142053,53142327,chr12,HIGD1AP1,chr12:53142053-53142327,274
42416475,42541926,chr8,SLC20A2,chr8:42416475-42541926,125451
49619334,49619612,chr12,HIGD1AP9,chr12:49619334-49619612,278
33909238,33917804,chr10,LINC02629,chr10:33909238-33917804,8566
18912777,18936553,chr22,PRODH,chr22:18912777-18936553,23776
52377812,52385652,chr12,KRT84,chr12:52377812-52385652,7840
2071036,2096673,chr19,MOB3A,chr19:2071036-2096673,25637
104268873,104304950,chr10,GSTO2,chr10:104268873-104304950,36077
107152562,107459564,chr6,PDSS2,chr6:107152562-107459564,307002
3481242,3482409,chr2,TRAPPC12-AS1,chr2:3481242-3482409,1167
50763710,50821162,chr12,ATF1,chr12:50763710-50821162,57452
75911204,75911628,chr11,PPP1R1AP1,chr11:75911204-75911628,424
94055023,94055972,chr11,PHBP16,chr11:94055023-94055972,949
899462,905539,chr2,LINC01939,chr2:899462-905539,6077
122838500,122872643,chr11,CRTAM,chr11:122838500-122872643,34143
53647916,53665756,chr6,KLHL31,chr6:53647916-53665756,17840
31913143,31913754,chr10,HMGB1P7,chr10:31913143-31913754,611
27447669,27453393,chr16,IL21R-AS1,chr16:27447669-27453393,5724
5558167,5578349,chr19,TINCR,chr19:5558167-5578349,20182
84687712,84709578,chr6,TBX18-AS1,chr6:84687712-84709578,21866
798041,800734,chr16,GNG13,chr16:798041-800734,2693
3658200,3702671,chr2,ALLC,chr2:3658200-3702671,44471
20070250,20072136,chr13,KRR1P1,chr13:20070250-20072136,1886
3141576,3155175,chr19,GNA15-DT,chr19:3141576-3155175,13599
34109560,34815325,chr10,PARD3,chr10:34109560-34815325,705765
20102701,20103230,chr13,LINC01072,chr13:20102701-20103230,529
2511219,2702694,chr19,GNG7,chr19:2511219-2702694,191475
20138255,20161052,chr13,GJA3,chr13:20138255-20161052,22797
157289025,157323601,chr6,TMEM242,chr6:157289025-157323601,34576
78863993,79452008,chr12,SYT1,chr12:78863993-79452008,588015
8961200,8979025,chr8,RPL10P19,chr8:8961200-8979025,17825
23278231,23381294,chr16,SCNN1B,chr16:23278231-23381294,103063
20178978,20179462,chr13,PPIAP28,chr13:20178978-20179462,484
6366010,6375422,chr2,LINC01247,chr2:6366010-6375422,9412
20181531,20181942,chr13,LINC00556,chr13:20181531-20181942,411
5576660,5576938,chr19,SNRPEP4,chr19:5576660-5576938,278
123057489,123063230,chr11,HSPA8,chr11:123057489-123063230,5741
20187463,20192938,chr13,GJB2,chr13:20187463-20192938,5475
950849,1367613,chr2,SNTG2,chr2:950849-1367613,416764
4247080,4269088,chr19,YJU2,chr19:4247080-4269088,22008
19313693,19396218,chr8,SH2D4A,chr8:19313693-19396218,82525
48721719,48722518,chr17,PRAC1,chr17:48721719-48722518,799
46204729,46207386,chr6,ACTG1P9,chr6:46204729-46207386,2657
134211450,134211527,chr6,RPS29P32,chr6:134211450-134211527,77
52186375,52190638,chr6,IL17A,chr6:52186375-52190638,4263
43168170,43168249,chr17,BRCA1P1,chr17:43168170-43168249,79
2269509,2273490,chr19,OAZ1,chr19:2269509-2273490,3981
40140318,40172171,chr17,CASC3,chr17:40140318-40172171,31853
44577894,44582287,chr7,TMED4,chr7:44577894-44582287,4393
20221962,20232365,chr13,GJB6,chr13:20221962-20232365,10403
106045423,106325791,chr6,ATG5,chr6:106045423-106325791,280368
55625845,55773194,chr5,SLC38A9,chr5:55625845-55773194,147349
134986508,135147963,chr7,AGBL3,chr7:134986508-135147963,161455
109853312,109853919,chrX,RPS5P7,chrX:109853312-109853919,607
155380709,155381299,chrX,H2AB2,chrX:155380709-155381299,590
155382095,155383801,chrX,F8A2,chrX:155382095-155383801,1706
153444473,153470587,chrX,TREX2,chrX:153444473-153470587,26114
55102028,55542054,chr8,XKR4,chr8:55102028-55542054,440026
5602505,5691488,chr2,LINC01248,chr2:5602505-5691488,88983
49740216,49741321,chr8,PSAT1P1,chr8:49740216-49741321,1105
3136033,3163749,chr19,GNA15,chr19:3136033-3163749,27716
49352630,49352844,chr8,RFPL4AP7,chr8:49352630-49352844,214
47117703,47189422,chr17,CDC27,chr17:47117703-47189422,71719
33039523,33039793,chr8,RANP9,chr8:33039523-33039793,270
3617548,3617757,chr2,TMSB4XP2,chr2:3617548-3617757,209
47164870,47165524,chr8,NDUFA5P12,chr8:47164870-47165524,654
9081395,9081727,chr2,RPL30P3,chr2:9081395-9081727,332
118823824,118826968,chrX,ZCCHC12,chrX:118823824-118826968,3144
118839539,118919669,chrX,LINC01285,chrX:118839539-118919669,80130
3594832,3644644,chr2,COLEC11,chr2:3594832-3644644,49812
48384590,48385049,chr8,RPL29P19,chr8:48384590-48385049,459
24219654,24245108,chr22,GGT5,chr22:24219654-24245108,25454
116287380,116508541,chr7,CAV2,chr7:116287380-116508541,221161
560394,565529,chr16,PRR35,chr16:560394-565529,5135
118877886,118879185,chrX,AKR7A2P2,chrX:118877886-118879185,1299
32440704,32448803,chr8,NRG1-IT3,chr8:32440704-32448803,8099
118938153,118939134,chrX,COBLP1,chrX:118938153-118939134,981
118974614,119018355,chrX,LONRF3,chrX:118974614-119018355,43741
5623035,5668478,chr19,SAFB,chr19:5623035-5668478,45443
28316986,28343355,chr8,PNOC,chr8:28316986-28343355,26369
85036314,85264457,chr12,LRRIQ1,chr12:85036314-85264457,228143
18334400,18352476,chr16,PKD1P4,chr16:18334400-18352476,18076
10606349,10712187,chr8,RP1L1,chr8:10606349-10712187,105838
4616493,4690974,chr16,MGRN1,chr16:4616493-4690974,74481
26504701,26514092,chr8,PNMA2,chr8:26504701-26514092,9391
95286318,95286838,chr12,CBX3P5,chr12:95286318-95286838,520
81946444,82443777,chr7,CACNA2D1,chr7:81946444-82443777,497333
70638073,70920738,chr12,PTPRR,chr12:70638073-70920738,282665
19958677,20091829,chr13,ZMYM2,chr13:19958677-20091829,133152
2828822,2882820,chrX,GYG2,chrX:2828822-2882820,53998
25318256,25320080,chr22,IGLL3P,chr22:25318256-25320080,1824
30382119,30385401,chr8,RBPMS-AS1,chr8:30382119-30385401,3282
144004916,144008262,chr6,HYMAI,chr6:144004916-144008262,3346
157323964,157324477,chr6,TMEM242-DT,chr6:157323964-157324477,513
108907615,108907873,chr6,ATP5MFP2,chr6:108907615-108907873,258
25351418,25405377,chr22,LRP5L,chr22:25351418-25405377,53959
116571409,116597675,chr6,RWDD1,chr6:116571409-116597675,26266
38105493,38144076,chr8,ASH2L,chr8:38105493-38144076,38583
37505688,37506857,chr5,KCTD9P5,chr5:37505688-37506857,1169
25437306,25437823,chr22,IGLVIVOR22-1,chr22:25437306-25437823,517
25455646,25455711,chr22,MIR6817,chr22:25455646-25455711,65
24487100,24644978,chr5,CDH10,chr5:24487100-24644978,157878
39021113,39033277,chr22,APOBEC3D,chr22:39021113-39033277,12164
116496899,116500630,chr11,LINC02151,chr11:116496899-116500630,3731
65014182,65040570,chr11,ARL2-SNX15,chr11:65014182-65040570,26388
7922425,8278186,chr2,LINC00298,chr2:7922425-8278186,355761
47951967,47957883,chr17,PRR15L,chr17:47951967-47957883,5916
124949205,124954044,chr11,CCDC15-DT,chr11:124949205-124954044,4839
129375848,129452279,chr11,BARX2,chr11:129375848-129452279,76431
47200446,47223679,chr17,MYL4,chr17:47200446-47223679,23233
3541430,3558333,chr2,RNASEH1,chr2:3541430-3558333,16903
18077923,18105396,chr22,PEX26,chr22:18077923-18105396,27473
137170858,137172056,chr9,TMEM210,chr9:137170858-137172056,1198
137174784,137188560,chr9,ANAPC2,chr9:137174784-137188560,13776
123069872,123195248,chr11,CLMP,chr11:123069872-123195248,125376
17518367,17518963,chr5,TAF11L3,chr5:17518367-17518963,596
31941261,31941583,chr7,SNX2P2,chr7:31941261-31941583,322
40909497,40984643,chr5,C7,chr5:40909497-40984643,75146
132608225,132609302,chr6,TAAR3P,chr6:132608225-132609302,1077
109390215,109441171,chr6,PPIL6,chr6:109390215-109441171,50956
37375522,37376023,chr7,RPS10P14,chr7:37375522-37376023,501
9473658,9496543,chr2,IAH1,chr2:9473658-9496543,22885
65335174,65335668,chr7,RSL24D1P3,chr7:65335174-65335668,494
141803701,141804652,chr7,MTND1P3,chr7:141803701-141804652,951
50464496,50468906,chr17,CHAD,chr17:50464496-50468906,4410
108569867,108574850,chr7,DNAJB9,chr7:108569867-108574850,4983
123051161,123051401,chr11,RPL31P47,chr11:123051161-123051401,240
68154863,68213828,chr11,KMT5B,chr11:68154863-68213828,58965
100589402,100604206,chr7,PCOLCE-AS1,chr7:100589402-100604206,14804
20774113,20787720,chr22,SERPIND1,chr22:20774113-20787720,13607
2852740,2853760,chrX,GYG2-AS1,chrX:2852740-2853760,1020
128241278,128257629,chr7,LEP,chr7:128241278-128257629,16351
2903972,2929349,chrX,ARSD,chrX:2903972-2929349,25377
41232449,41233454,chr17,KRTAP9-3,chr17:41232449-41233454,1005
137188660,137190370,chr9,SSNA1,chr9:137188660-137190370,1710
30831966,30895869,chr17,ATAD5,chr17:30831966-30895869,63903
94782886,94783525,chr7,GRPEL2P3,chr7:94782886-94783525,639
80458635,80512064,chr7,GNAT3,chr7:80458635-80512064,53429
137191617,137204193,chr9,TPRN,chr9:137191617-137204193,12576
20859007,20891214,chr22,SNAP29,chr22:20859007-20891214,32207
55879835,56014169,chr8,LYN,chr8:55879835-56014169,134334
2904904,2906081,chrX,ARSD-AS1,chrX:2904904-2906081,1177
3006546,3034111,chrX,ARSH,chrX:3006546-3034111,27565
42892319,42892817,chr5,PPIAP77,chr5:42892319-42892817,498
137204082,137205648,chr9,TMEM203,chr9:137204082-137205648,1566
69598296,70793506,chr7,AUTS2,chr7:69598296-70793506,1195210
3041471,3112727,chrX,ARSF,chrX:3041471-3112727,71256
137224635,137226315,chr9,CYSRT1,chr9:137224635-137226315,1680
55160167,55167297,chr5,GPX8,chr5:55160167-55167297,7130
20917407,20953747,chr22,CRKL,chr22:20917407-20953747,36340
137227502,137229640,chr9,RNF224,chr9:137227502-137229640,2138
137230757,137236555,chr9,SLC34A3,chr9:137230757-137236555,5798
20957092,20964679,chr22,LINC01637,chr22:20957092-20964679,7587
51383448,51394730,chr5,ISL1,chr5:51383448-51394730,11282
3058220,3058502,chrX,RN7SL578P,chrX:3058220-3058502,282
3112900,3113596,chrX,RPS24P21,chrX:3112900-3113596,696
77910739,78129295,chrX,PGK1,chrX:77910739-78129295,218556
40092793,40100589,chr17,NR1D1,chr17:40092793-40100589,7796
20982269,20999032,chr22,LZTR1,chr22:20982269-20999032,16763
137241287,137243707,chr9,TUBB4B,chr9:137241287-137243707,2420
77967949,77969638,chrX,PGAM4,chrX:77967949-77969638,1689
78129748,78139650,chrX,TAF9B,chrX:78129748-78139650,9902
739588,740164,chr2,LINC01115,chr2:739588-740164,576
22528853,22528921,chr17,NMTRS-TGA3-1,chr17:22528853-22528921,68
50762460,50762798,chr8,CYCSP22,chr8:50762460-50762798,338
112461468,112461920,chr11,RPL23AP62,chr11:112461468-112461920,452
31860904,31901708,chr17,UTP6,chr17:31860904-31901708,40804
4890437,4902896,chr19,ARRDC5,chr19:4890437-4902896,12459
125442881,125592568,chr11,FEZ1,chr11:125442881-125592568,149687
54509422,54871720,chr8,RP1,chr8:54509422-54871720,362298
142751469,142956698,chr6,HIVEP2,chr6:142751469-142956698,205229
137243584,137247770,chr9,FAM166A,chr9:137243584-137247770,4186
78165696,78172422,chrX,FNDC3CP,chrX:78165696-78172422,6726
43511058,43521811,chr5,C5orf34-AS1,chr5:43511058-43521811,10753
490944,503905,chr2,LINC01874,chr2:490944-503905,12961
5586999,5624046,chr19,SAFB2,chr19:5586999-5624046,37047
3688021,3688981,chr2,GAPDHP48,chr2:3688021-3688981,960
14704800,14871778,chr5,ANKH,chr5:14704800-14871778,166978
44873188,45112779,chrX,KDM6A,chrX:44873188-45112779,239591
137250219,137253497,chr9,STPG3-AS1,chr9:137250219-137253497,3278
9488486,9556732,chr2,ADAM17,chr2:9488486-9556732,68246
137255327,137273542,chr9,NELFB,chr9:137255327-137273542,18215
87000045,87000291,chr6,MTHFD2P2,chr6:87000045-87000291,246
53978549,54079726,chr6,MLIP-AS1,chr6:53978549-54079726,101177
137277726,137282641,chr9,TOR4A,chr9:137277726-137282641,4915
137299631,137302271,chr9,NRARP,chr9:137299631-137302271,2640
34838833,34899456,chr5,TTC23L,chr5:34838833-34899456,60623
27109141,27230174,chr9,TEK,chr9:27109141-27230174,121033
36677609,36678559,chr6,DINOL,chr6:36677609-36678559,950
138088505,138107419,chr6,PERP,chr6:138088505-138107419,18914
148747030,149076990,chr6,UST,chr6:148747030-149076990,329960
49909789,50796692,chr8,SNTG1,chr8:49909789-50796692,886903
96900697,96902698,chr12,EEF1A1P33,chr12:96900697-96902698,2001
89177504,89231278,chr6,GABRR1,chr6:89177504-89231278,53774
52424070,52434371,chr12,KRT75,chr12:52424070-52434371,10301
19167971,19268332,chr16,SYT17,chr16:19167971-19268332,100361
5912339,5916211,chr19,CAPS,chr19:5912339-5916211,3872
67443105,67590771,chr12,LINC02408,chr12:67443105-67590771,147666
22338381,22379503,chr11,SLC17A6,chr11:22338381-22379503,41122
20999104,21002196,chr22,THAP7,chr22:20999104-21002196,3092
32106835,32383633,chr12,BICD1,chr12:32106835-32383633,276798
31759795,31761385,chr17,GPR160P2,chr17:31759795-31761385,1590
23980587,23980938,chr5,ADH5P5,chr5:23980587-23980938,351
41212706,41213237,chr17,KRTAP9-12P,chr17:41212706-41213237,531
49085511,49086702,chr17,B4GALNT2P1,chr17:49085511-49086702,1191
38025568,38184717,chr5,LINC02119,chr5:38025568-38184717,159149
48185938,48204529,chr17,SKAP1-AS1,chr17:48185938-48204529,18591
42844580,42850707,chr17,AOC2,chr17:42844580-42850707,6127
176308268,176320458,chr4,SPCS3-AS1,chr4:176308268-176320458,12190
150061053,150069121,chr6,ULBP3,chr6:150061053-150069121,8068
2934045,2968475,chrX,ARSL,chrX:2934045-2968475,34430
42897262,42897832,chr5,PRELID3BP4,chr5:42897262-42897832,570
152779937,152918463,chr4,ARFIP1,chr4:152779937-152918463,138526
7112255,7294414,chr19,INSR,chr19:7112255-7294414,182159
91727159,91727324,chr6,MTND4LP19,chr6:91727159-91727324,165
663877,677406,chr2,TMEM18,chr2:663877-677406,13529
63556598,63562588,chr7,SLC29A4P2,chr7:63556598-63562588,5990
130285023,130285833,chr11,NDUFAF2P2,chr11:130285023-130285833,810
45620344,45835826,chr17,LINC02210-CRHR1,chr17:45620344-45835826,215482
65563236,65587549,chr5,PPWD1,chr5:65563236-65587549,24313
64105292,64105576,chr7,MTND4LP2,chr7:64105292-64105576,284
28020619,28108156,chr11,KIF18A,chr11:28020619-28108156,87537
111808516,111821773,chr7,DOCK4-AS1,chr7:111808516-111821773,13257
48575507,48578350,chr17,HOXB4,chr17:48575507-48578350,2843
21008193,21014292,chr22,TUBA3FP,chr22:21008193-21014292,6099
39665349,39666554,chr17,TCAP,chr17:39665349-39666554,1205
21220213,21221428,chr7,ASS1P11,chr7:21220213-21221428,1215
21028718,21032840,chr22,SLC7A4,chr22:21028718-21032840,4122
139435636,139474658,chr6,LINC01625,chr6:139435636-139474658,39022
97966090,97967074,chr7,OR7E38P,chr7:97966090-97967074,984
125033453,125035301,chr7,EEF1GP1,chr7:125033453-125035301,1848
30629680,30637466,chr17,LRRC37BP1,chr17:30629680-30637466,7786
53210567,53232980,chr12,RARG,chr12:53210567-53232980,22413
58463971,58464136,chr14,HSBP1P1,chr14:58463971-58464136,165
3575260,3580920,chr2,RPS7,chr2:3575260-3580920,5660
58521223,58521988,chr14,HNRNPCP1,chr14:58521223-58521988,765
134603564,134604698,chr6,FAM8A6P,chr6:134603564-134604698,1134
52985513,52987652,chr17,LINC02876,chr17:52985513-52987652,2139
14922802,14952060,chr16,NPIPA1,chr16:14922802-14952060,29258
58564146,58564616,chr14,RPL9P5,chr14:58564146-58564616,470
102785667,102786604,chrX,MTND1P32,chrX:102785667-102786604,937
20607268,20608131,chr13,SLC35E1P1,chr13:20607268-20608131,863
102786813,102788387,chrX,MTND2P2,chrX:102786813-102788387,1574
127580628,127593611,chr7,GCC1,chr7:127580628-127593611,12983
102796251,102797093,chrX,MTCO1P19,chrX:102796251-102797093,842
104579764,104590515,chr14,C14orf180,chr14:104579764-104590515,10751
20612161,20612338,chr13,RNU2-7P,chr13:20612161-20612338,177
92723003,92723829,chr6,LINC02531,chr6:92723003-92723829,826
50693198,50707914,chr17,ANKRD40,chr17:50693198-50707914,14716
78652829,79441030,chr11,TENM4,chr11:78652829-79441030,788201
102797531,102798128,chrX,MTCO2P19,chrX:102797531-102798128,597
21034176,21034272,chr22,MIR649,chr22:21034176-21034272,96
54365335,54369971,chr6,TINAG-AS1,chr6:54365335-54369971,4636
21035243,21045017,chr22,P2RX6P,chr22:21035243-21045017,9774
102798396,102799560,chrX,MTATP6P19,chrX:102798396-102799560,1164
138403531,138422197,chr6,HEBP2,chr6:138403531-138422197,18666
102799563,102799883,chrX,MTCO3P19,chrX:102799563-102799883,320
21045960,21064168,chr22,LRRC74B,chr22:21045960-21064168,18208
20728731,20773961,chr13,EEF1AKMT1,chr13:20728731-20773961,45230
102799942,102801399,chrX,MTND4P32,chrX:102799942-102801399,1457
102803041,102806138,chrX,MTND5P26,chrX:102803041-102806138,3097
102806164,102806646,chrX,MTND6P32,chrX:102806164-102806646,482
102806741,102807824,chrX,MTCYBP32,chrX:102806741-102807824,1083
82009177,82029955,chr7,CACNA2D1-AS1,chr7:82009177-82029955,20778
130310072,130310178,chrX,RNU6-1130P,chrX:130310072-130310178,106
127997597,128000077,chr7,SND1-IT1,chr7:127997597-128000077,2480
108883975,108884587,chr7,LINC02903,chr7:108883975-108884587,612
42865922,42874369,chr17,AOC4P,chr17:42865922-42874369,8447
130339888,130373361,chrX,SLC25A14,chrX:130339888-130373361,33473
112735166,112738693,chr7,MIPEPP1,chr7:112735166-112738693,3527
92887251,92888581,chr6,ATF1P1,chr6:92887251-92888581,1330
21065462,21070097,chr22,TUBA3GP,chr22:21065462-21070097,4635
134393142,134393900,chr6,CHCHD2P4,chr6:134393142-134393900,758
23381982,23408273,chr14,MYH6,chr14:23381982-23408273,26291
38295763,38296233,chr7,TRGVB,chr7:38295763-38296233,470
105849710,105851425,chr9,SLC25A6P5,chr9:105849710-105851425,1715
93844789,93845308,chr7,NDUFAF4P2,chr7:93844789-93845308,519
163413065,163413960,chr6,CAHM,chr6:163413065-163413960,895
147158925,147180992,chr6,LUADT1,chr6:147158925-147180992,22067
42160013,42343616,chr22,TCF20,chr22:42160013-42343616,183603
118214669,118496171,chr7,ANKRD7,chr7:118214669-118496171,281502
106600928,106601022,chr9,MIR8081,chr9:106600928-106601022,94
151239967,151358559,chr6,AKAP12,chr6:151239967-151358559,118592
106679977,106680329,chr9,RN7SKP77,chr9:106679977-106680329,352
20747035,20748057,chr13,RANP8,chr13:20747035-20748057,1022
106843749,106843866,chr9,RNA5SP292,chr9:106843749-106843866,117
106863166,107013634,chr9,ZNF462,chr9:106863166-107013634,150468
20921664,20923233,chr13,CNOT4P1,chr13:20921664-20923233,1569
78139771,78175323,chr11,KCTD21-AS1,chr11:78139771-78175323,35552
47967810,47981781,chr17,CDK5RAP3,chr17:47967810-47981781,13971
20938564,20949599,chr13,HNRNPA1P30,chr13:20938564-20949599,11035
23182745,23216883,chr16,SCNN1G,chr16:23182745-23216883,34138
71450834,71458874,chr6,LINC01626,chr6:71450834-71458874,8040
108023548,108130361,chr7,LAMB4,chr7:108023548-108130361,106813
20956179,20956443,chr13,PPIAP27,chr13:20956179-20956443,264
4969113,5153598,chr19,KDM4B,chr19:4969113-5153598,184485
114019621,114020483,chr6,NUDT19P3,chr6:114019621-114020483,862
108922976,108924103,chr6,ARMC2-AS1,chr6:108922976-108924103,1127
20961310,20962195,chr13,RPSAP54,chr13:20961310-20962195,885
150018334,150025532,chr6,RAET1L,chr6:150018334-150025532,7198
134412284,134505665,chr11,B3GAT1-DT,chr11:134412284-134505665,93381
20973036,21061586,chr13,LATS2,chr13:20973036-21061586,88550
17816460,17817798,chr2,MSGN1,chr2:17816460-17817798,1338
80003887,80042527,chr6,TTK,chr6:80003887-80042527,38640
36140330,36166177,chr22,APOL3,chr22:36140330-36166177,25847
163382179,163382516,chr4,RPL35AP12,chr4:163382179-163382516,337
39888576,39889059,chr5,GCSHP1,chr5:39888576-39889059,483
183097017,183099199,chr4,WWC2-AS2,chr4:183097017-183099199,2182
21005157,21018122,chr13,LATS2-AS1,chr13:21005157-21018122,12965
17663812,17800242,chr2,SMC6,chr2:17663812-17800242,136430
182143987,182803024,chr4,TENM3,chr4:182143987-182803024,659037
21038529,21038667,chr13,RNU4-9P,chr13:21038529-21038667,138
43571594,43603230,chr5,NNT-AS1,chr5:43571594-43603230,31636
21094315,21094714,chr13,RPS12P23,chr13:21094315-21094714,399
21103003,21104371,chr13,IPPKP1,chr13:21103003-21104371,1368
86821143,86821728,chr11,MOB4P2,chr11:86821143-86821728,585
21519830,21520365,chr16,SLC7A5P2,chr16:21519830-21520365,535
124954121,125041489,chr11,CCDC15,chr11:124954121-125041489,87368
24882279,24922889,chr13,CENPJ,chr13:24882279-24922889,40610
55551885,55552554,chr5,AK4P2,chr5:55551885-55552554,669
103715730,103733668,chr14,ZFYVE21,chr14:103715730-103733668,17938
10225507,10249897,chr5,ATPSCKMT,chr5:10225507-10249897,24390
95859904,95860016,chr9,RNU2-46P,chr9:95859904-95860016,112
95905005,95905141,chr9,RNA5SP289,chr9:95905005-95905141,136
95918136,95918704,chr9,PARK7P2,chr9:95918136-95918704,568
11819829,11828845,chr16,BCAR4,chr16:11819829-11828845,9016
183797692,184023526,chr4,STOX2,chr4:183797692-184023526,225834
11851649,11895611,chr16,RSL1D1-DT,chr16:11851649-11895611,43962
14911551,14935708,chr16,PKD1P3,chr16:14911551-14935708,24157
96146007,96147856,chr9,EIF4BP3,chr9:96146007-96147856,1849
108821697,108822004,chr9,RPL36AP35,chr9:108821697-108822004,307
119623408,119729200,chr11,NECTIN1,chr11:119623408-119729200,105792
25454339,25454647,chr16,CYCSP39,chr16:25454339-25454647,308
108854588,108855986,chr9,ACTL7B,chr9:108854588-108855986,1398
25215731,25228932,chr16,AQP8,chr16:25215731-25228932,13201
176319966,176332245,chr4,SPCS3,chr4:176319966-176332245,12279
108862266,108863756,chr9,ACTL7A,chr9:108862266-108863756,1490
41925254,41941743,chr5,FBXO4,chr5:41925254-41941743,16489
31639222,32855666,chr8,NRG1,chr8:31639222-32855666,1216444
190071232,190072506,chr4,DUX4L7,chr4:190071232-190072506,1274
108866898,108934328,chr9,ELP1,chr9:108866898-108934328,67430
20457681,20461465,chr14,PIP4P1,chr14:20457681-20461465,3784
188139441,188147743,chr4,TRIML1,chr4:188139441-188147743,8302
25236001,25257845,chr16,ZKSCAN2,chr16:25236001-25257845,21844
147480917,147544954,chr4,EDNRA,chr4:147480917-147544954,64037
69348381,69354234,chr12,LYZ,chr12:69348381-69354234,5853
22814162,22916338,chr16,HS3ST2,chr16:22814162-22916338,102176
130295641,130296946,chr11,DDX18P5,chr11:130295641-130296946,1305
129612116,129617269,chr11,LINC01395,chr11:129612116-129617269,5153
2199387,2199488,chr10,RNU6-576P,chr10:2199387-2199488,101
3991160,3991259,chr10,MIR6078,chr10:3991160-3991259,99
122655722,122814473,chr11,UBASH3B,chr11:122655722-122814473,158751
4514952,4515057,chr10,RNU6-163P,chr10:4514952-4515057,105
2098167,2098269,chr10,RNU6-889P,chr10:2098167-2098269,102
2076019,2076089,chr10,MIR6072,chr10:2076019-2076089,70
8656716,8656831,chr10,RNA5SP299,chr10:8656716-8656831,115
6149623,6149940,chr10,RN7SKP78,chr10:6149623-6149940,317
141811805,141812257,chr7,MYL6P4,chr7:141811805-141812257,452
6152196,6152277,chr10,MIR3155A,chr10:6152196-6152277,81
6152207,6152262,chr10,MIR3155B,chr10:6152207-6152262,55
127215127,127229927,chr7,GRM8-AS1,chr7:127215127-127229927,14800
32689070,32791724,chr5,NPR3,chr5:32689070-32791724,102654
11923181,11923288,chr10,RNU6-1095P,chr10:11923181-11923288,107
12328132,12328389,chr10,RN7SL198P,chr10:12328132-12328389,257
12924679,12924785,chr10,RNA5SP300,chr10:12924679-12924785,106
13217269,13217375,chr10,RNU6-6P,chr10:13217269-13217375,106
109998434,109999624,chr7,RPL3P8,chr7:109998434-109999624,1190
12130760,12130816,chr10,MIR548AK,chr10:12130760-12130816,56
16207821,16207927,chr10,RNU6-1075P,chr10:16207821-16207927,106
105439661,105522271,chr7,PUS7,chr7:105439661-105522271,82610
16476003,16476164,chr10,RNU2-18P,chr10:16476003-16476164,161
14663395,14663494,chr10,RNA5SP302,chr10:14663395-14663494,99
77324641,78213010,chr12,NAV3,chr12:77324641-78213010,888369
3224661,3297076,chr19,CELF5,chr19:3224661-3297076,72415
19792998,19793101,chr10,RNU6-1212P,chr10:19792998-19793101,103
19633683,19633812,chr10,RNA5SP303,chr10:19633683-19633812,129
36172422,36172779,chr22,MTCO1P20,chr22:36172422-36172779,357
17845107,17845193,chr10,MIR511,chr10:17845107-17845193,86
14383200,14383277,chr10,MIR4293,chr10:14383200-14383277,77
18983934,19063942,chr16,TMC7,chr16:18983934-19063942,80008
36172934,36173948,chr22,MTCO2P20,chr22:36172934-36173948,1014
14436576,14436661,chr10,MIR1265,chr10:14436576-14436661,85
21661635,21661741,chr10,RNU6-1141P,chr10:21661635-21661741,106
12456483,12456631,chr10,RNU6ATAC39P,chr10:12456483-12456631,148
12578753,12578823,chr10,MIR4480,chr10:12578753-12578823,70
12653138,12653197,chr10,MIR4481,chr10:12653138-12653197,59
36174261,36174822,chr22,MTATP6P20,chr22:36174261-36174822,561
12725254,12725353,chr10,MIR548Q,chr10:12725254-12725353,99
36175167,36175854,chr22,MTCO3P20,chr22:36175167-36175854,687
12116280,12116379,chr10,RNU6-88P,chr10:12116280-12116379,99
24275685,24275781,chr10,MIR603,chr10:24275685-24275781,96
21785292,21785587,chr10,RN7SKP219,chr10:21785292-21785587,295
36175857,36176526,chr22,MTCYBP34,chr22:36175857-36176526,669
21933143,21933438,chr10,RN7SKP37,chr10:21933143-21933438,295
36178554,36179385,chr22,MTND1P10,chr22:36178554-36179385,831
26509589,26509704,chr10,RNA5SP307,chr10:26509589-26509704,115
25813811,25813917,chr10,RNA5SP306,chr10:25813811-25813917,106
22787393,22787499,chr10,RNU6-413P,chr10:22787393-22787499,106
181260442,181265145,chr4,LINC02500,chr4:181260442-181265145,4703
22997255,22997358,chr10,RNA5SP304,chr10:22997255-22997358,103
102139503,102224847,chr14,WDR20,chr14:102139503-102224847,85344
27783846,27784053,chr10,RN7SKP132,chr10:27783846-27784053,207
36189124,36204840,chr22,APOL4,chr22:36189124-36204840,15716
29545004,29545097,chr10,MIR604,chr10:29545004-29545097,93
29575306,29575381,chr10,SNORD115,chr10:29575306-29575381,75
29602264,29602346,chr10,MIR938,chr10:29602264-29602346,82
170099818,170100104,chr4,APOBEC3AP1,chr4:170099818-170100104,286
29711915,29712008,chr10,RNU6-908P,chr10:29711915-29712008,93
28874393,28874507,chr10,RNA5SP308,chr10:28874393-28874507,114
170742469,170743718,chr4,LINC02382,chr4:170742469-170743718,1249
130546799,130547429,chr11,BAK1P2,chr11:130546799-130547429,630
25819363,25819426,chr10,RNU6-632P,chr10:25819363-25819426,63
31992087,31992381,chr10,RN7SL825P,chr10:31992087-31992381,294
25393557,25393844,chr10,RN7SKP220,chr10:25393557-25393844,287
32394558,32394665,chr10,RNU6-1244P,chr10:32394558-32394665,107
123340174,123340714,chr11,PHBP17,chr11:123340174-123340714,540
32173684,32173744,chr10,RNU7-22P,chr10:32173684-32173744,60
33288304,33288601,chr10,RN7SL398P,chr10:33288304-33288601,297
34942969,34943075,chr10,RNU6-193P,chr10:34942969-34943075,106
35641172,35641252,chr10,MIR4683,chr10:35641172-35641252,80
132859245,132860077,chr11,OPCML-IT2,chr11:132859245-132860077,832
34926775,34926882,chr10,RNU6-847P,chr10:34926775-34926882,107
123882920,123885670,chr11,TMEM225,chr11:123882920-123885670,2750
38423625,38423728,chr10,RNU6-1118P,chr10:38423625-38423728,103
38043873,38043975,chr10,RNU6-795P,chr10:38043873-38043975,102
42605158,42605263,chr10,RNU6-1170P,chr10:42605158-42605263,105
42832447,42832550,chr10,RNU6-885P,chr10:42832447-42832550,103
45164014,45164088,chr10,MIR3156-1,chr10:45164014-45164088,74
47532352,47532467,chr10,RNA5SP312,chr10:47532352-47532467,115
166733384,167234796,chr4,SPOCK3,chr4:166733384-167234796,501412
45188790,45188896,chr10,RNU6-1207P,chr10:45188790-45188896,106
51299573,51299655,chr10,MIR605,chr10:51299573-51299655,82
53458197,53458288,chr10,RNA5SP318,chr10:53458197-53458288,91
58869184,58869528,chr10,RN7SKP196,chr10:58869184-58869528,344
130379449,130385674,chrX,GPR119,chrX:130379449-130385674,6225
63110139,63110246,chr10,RNU6-543P,chr10:63110139-63110246,107
57304479,57304559,chr10,MIR3924,chr10:57304479-57304559,80
124747474,124752255,chr11,VSIG2,chr11:124747474-124752255,4781
48985512,48985587,chr10,MIR4294,chr10:48985512-48985587,75
21939461,21940160,chrX,CYTH1P1,chrX:21939461-21940160,699
60912765,60912927,chr10,RNU2-72P,chr10:60912765-60912927,162
63372957,63373048,chr10,MIR1296,chr10:63372957-63373048,91
21940709,21994837,chrX,SMS,chrX:21940709-21994837,54128
68461407,68461525,chr10,RNA5SP319,chr10:68461407-68461525,118
68755172,68755238,chr10,SNORD98,chr10:68755172-68755238,66
112206695,112343934,chr7,ZNF277,chr7:112206695-112343934,137239
72721029,72721100,chr10,MIR4676,chr10:72721029-72721100,71
77912271,77912545,chr10,RN7SL284P,chr10:77912271-77912545,274
75552458,75552553,chr10,MIR606,chr10:75552458-75552553,95
76242022,76242301,chr10,RN7SL518P,chr10:76242022-76242301,279
76260800,76260903,chr10,RNU6-673P,chr10:76260800-76260903,103
77776951,77777055,chr10,RNU6-1266P,chr10:77776951-77777055,104
3298341,3301465,chr2,EIPR1-IT1,chr2:3298341-3301465,3124
156776020,157210779,chr6,ARID1B,chr6:156776020-157210779,434759
134712539,134716250,chr11,LINC02706,chr11:134712539-134716250,3711
72582803,72583086,chr10,RN7SL840P,chr10:72582803-72583086,283
85537379,85537483,chr10,RNU6-325P,chr10:85537379-85537483,104
32947443,32962467,chr5,LINC02120,chr5:32947443-32962467,15024
83067962,83068071,chr10,RNU6-478P,chr10:83067962-83068071,109
85650012,85650260,chr10,RN7SKP238,chr10:85650012-85650260,248
86052448,86052566,chr10,RNA5SP322,chr10:86052448-86052566,118
86264694,86264788,chr10,MIR346,chr10:86264694-86264788,94
83764358,83764464,chr10,RNU6-129P,chr10:83764358-83764464,106
130404923,130428609,chr11,ADAMTS8,chr11:130404923-130428609,23686
90163651,90163960,chr10,RN7SKP143,chr10:90163651-90163960,309
82340771,82340876,chr10,RNU6-441P,chr10:82340771-82340876,105
87503881,87503954,chr10,MIR4678,chr10:87503881-87503954,73
60487713,60548813,chr5,PART1,chr5:60487713-60548813,61100
96619376,96619483,chr10,RNA5SP324,chr10:96619376-96619483,107
100237156,100237302,chr10,SNORA12,chr10:100237156-100237302,146
100258571,100258677,chr10,RNU6-422P,chr10:100258571-100258677,106
102803929,102804031,chr10,RNU6-1231P,chr10:102803929-102804031,102
101307529,101307718,chr10,RNU2-43P,chr10:101307529-101307718,189
22162733,22172983,chrX,PHEX-AS1,chrX:22162733-22172983,10250
98924499,98924568,chr10,MIR6507,chr10:98924499-98924568,69
22191895,22235358,chrX,PTCHD1-AS,chrX:22191895-22235358,43463
104268336,104268405,chr10,MIR4482,chr10:104268336-104268405,69
59188646,59371405,chr14,DAAM1,chr14:59188646-59371405,182759
108940969,108941310,chr10,RN7SKP278,chr10:108940969-108941310,341
6772708,6857366,chr19,VAV1,chr19:6772708-6857366,84658
107461560,107461669,chr10,RNA5SP326,chr10:107461560-107461669,109
22272913,22274461,chrX,CBLL2,chrX:22272913-22274461,1548
109184934,109185001,chr10,RNU5B-6P,chr10:109184934-109185001,67
105534659,105534765,chr10,RNU6-463P,chr10:105534659-105534765,106
22435598,22436818,chrX,METTL15P3,chrX:22435598-22436818,1220
109869858,109869992,chr10,RNU4-5P,chr10:109869858-109869992,134
22527835,22527941,chrX,RNU6-266P,chrX:22527835-22527941,106
634427,636366,chr16,METTL26,chr16:634427-636366,1939
113353425,113353484,chr10,RNU7-165P,chr10:113353425-113353484,59
112634170,112634254,chr10,MIR4295,chr10:112634170-112634254,84
101622859,101622965,chr10,RNU6-1165P,chr10:101622859-101622965,106
22032325,22494713,chrX,PHEX,chrX:22032325-22494713,462388
116538183,116538276,chr10,RNU6-1090P,chr10:116538183-116538276,93
104048089,104048186,chr10,MIR936,chr10:104048089-104048186,97
114969460,114969568,chr10,RNU6-1121P,chr10:114969460-114969568,108
101364845,101365035,chr10,RNU2-59P,chr10:101364845-101365035,190
17590364,17590960,chr5,TAF11L8,chr5:17590364-17590960,596
217730,266398,chr2,SH3YL1,chr2:217730-266398,48668
125591712,125625215,chr11,STT3A,chr11:125591712-125625215,33503
117167678,117167774,chr10,MIR3663,chr10:117167678-117167774,96
114423770,114424067,chr10,RN7SL384P,chr10:114423770-114424067,297
113777993,113778054,chr10,MIR4483,chr10:113777993-113778054,61
109239639,109239746,chr10,RNU6-839P,chr10:109239639-109239746,107
17593798,17594394,chr5,TAF11L9,chr5:17593798-17594394,596
106970021,106970150,chr10,RNA5SP325,chr10:106970021-106970150,129
66205120,66209893,chr5,LINC02065,chr5:66205120-66209893,4773
119768247,119768538,chr10,RN7SL846P,chr10:119768247-119768538,291
101601417,101601497,chr10,MIR3158-1,chr10:101601417-101601497,80
101601417,101601497,chr10,MIR3158-2,chr10:101601417-101601497,80
104218789,104218883,chr10,MIR609,chr10:104218789-104218883,94
54455699,54456377,chr5,HSPB3,chr5:54455699-54456377,678
125890566,125890678,chr10,RNU2-42P,chr10:125890566-125890678,112
119060011,119060138,chr10,SNORA19,chr10:119060011-119060138,127
125819740,125819822,chr10,MIR4484,chr10:125819740-125819822,82
125032783,125032870,chr10,MIR4296,chr10:125032783-125032870,87
119212857,119213146,chr10,RN7SL749P,chr10:119212857-119213146,289
122345690,122345793,chr10,RNU6-728P,chr10:122345690-122345793,103
10504996,10522084,chr5,LINC02213,chr5:10504996-10522084,17088
119377972,119378043,chr10,MIR4681,chr10:119377972-119378043,71
130962588,130962668,chr10,MIR378C,chr10:130962588-130962668,80
126145474,126145582,chr10,RNA5SP328,chr10:126145474-126145582,108
22580225,22580819,chr5,GCNT1P2,chr5:22580225-22580819,594
122416965,122417067,chr10,MIR3941,chr10:122416965-122417067,102
51372736,51383332,chr5,ISL1-DT,chr5:51372736-51383332,10596
132332154,132381508,chr10,LRRC27,chr10:132332154-132381508,49354
71132144,71713600,chr7,GALNT17,chr7:71132144-71713600,581456
17359949,17558151,chr22,CECR2,chr22:17359949-17558151,198202
53480626,53487134,chr5,FST,chr5:53480626-53487134,6508
17614781,17615111,chr5,H3P19,chr5:17614781-17615111,330
17585162,17585758,chr5,TAF11L7,chr5:17585162-17585758,596
14874400,14874711,chr5,UQCRBP3,chr5:14874400-14874711,311
14651941,14653329,chr5,EEF1A1P13,chr5:14651941-14653329,1388
101170496,101180293,chr7,NAT16,chr7:101170496-101180293,9797
34837549,34839278,chr5,TTC23L-AS1,chr5:34837549-34839278,1729
17424388,17424775,chr22,CLCP1,chr22:17424388-17424775,387
17498231,17498827,chr5,TAF11L2,chr5:17498231-17498827,596
20965108,20981360,chr22,AIFM3,chr22:20965108-20981360,16252
14301389,14331067,chr16,MIR193BHG,chr16:14301389-14331067,29678
44808947,44820428,chr5,MRPS30,chr5:44808947-44820428,11481
24943575,24944498,chr13,SLC25A15P3,chr13:24943575-24944498,923
120273175,120750337,chr7,KCND2,chr7:120273175-120750337,477162
24988577,24988925,chr13,RPL34P27,chr13:24988577-24988925,348
25365799,25366155,chr13,ELOBP1,chr13:25365799-25366155,356
25517119,25517225,chr13,RNU6-78P,chr13:25517119-25517225,106
132397168,132417859,chr10,PWWP2B,chr10:132397168-132417859,20691
110662644,111562517,chr7,IMMP2L,chr7:110662644-111562517,899873
25944478,25944766,chr13,RN7SL741P,chr13:25944478-25944766,288
25950704,25950821,chr13,RNY1P3,chr13:25950704-25950821,117
26044597,26052016,chr13,SHISA2,chr13:26044597-26052016,7419
49210411,49223225,chr17,ABI3,chr17:49210411-49223225,12814
26052276,26053385,chr13,LINC00415,chr13:26052276-26053385,1109
132444327,132449408,chr10,LINC02870,chr10:132444327-132449408,5081
57469300,57493867,chr14,CCDC198,chr14:57469300-57493867,24567
42423439,42721878,chr5,GHR,chr5:42423439-42721878,298439
14435700,14632728,chr16,PARN,chr16:14435700-14632728,197028
31739526,31803389,chr13,RXFP2,chr13:31739526-31803389,63863
132520827,132522449,chr10,LINC01165,chr10:132520827-132522449,1622
61452639,61481956,chr10,TMEM26-AS1,chr10:61452639-61481956,29317
30215563,30220089,chrX,MAGEB2,chrX:30215563-30220089,4526
61781745,61821246,chr10,LINC02625,chr10:61781745-61821246,39501
30242000,30244187,chrX,MAGEB4,chrX:30242000-30244187,2187
102394110,102402524,chr10,NFKB2,chr10:102394110-102402524,8414
30290047,30290351,chrX,PLCE1P1,chrX:30290047-30290351,304
151904431,151913968,chrX,MAGEA4-AS1,chrX:151904431-151913968,9537
140404058,140427974,chr7,RAB19,chr7:140404058-140427974,23916
151953124,151974680,chrX,GABRE,chrX:151953124-151974680,21556
53756989,53757870,chr17,RPS2P48,chr17:53756989-53757870,881
46916770,46923034,chr17,GOSR2-DT,chr17:46916770-46923034,6264
143851375,143902198,chr7,TCAF1,chr7:143851375-143902198,50823
50834650,50842353,chr17,WFIKKN2,chr17:50834650-50842353,7703
119729583,119739623,chr11,NECTIN1-DT,chr11:119729583-119739623,10040
121292681,121313410,chr11,SC5D,chr11:121292681-121313410,20729
55392622,55421924,chr17,MMD,chr17:55392622-55421924,29302
151958578,151958658,chrX,MIR224,chrX:151958578-151958658,80
151959628,151959712,chrX,MIR452,chrX:151959628-151959712,84
154379273,154381574,chrX,EMD,chrX:154379273-154381574,2301
48908407,48929056,chr17,UBE2Z,chr17:48908407-48929056,20649
127652194,128092609,chr7,SND1,chr7:127652194-128092609,440415
54428303,54429403,chr12,LINC01154,chr12:54428303-54429403,1100
68746125,68793964,chr12,SLC35E3,chr12:68746125-68793964,47839
113797874,113875570,chr11,USP28,chr11:113797874-113875570,77696
4679282,4685948,chr19,DPP9-AS1,chr19:4679282-4685948,6666
66507407,67181803,chr14,GPHN,chr14:66507407-67181803,674396
6952500,6997872,chr19,ADGRE4P,chr19:6952500-6997872,45372
76619386,76620043,chr12,YWHAQP7,chr12:76619386-76620043,657
101475336,101486997,chr12,SPIC,chr12:101475336-101486997,11661
41255384,41256364,chr17,KRTAP9-9,chr17:41255384-41256364,980
50847950,50849270,chr17,RPL5P33,chr17:50847950-50849270,1320
56573040,56573195,chr17,RPL39P33,chr17:56573040-56573195,155
79989014,79989218,chr12,SNRPGP20,chr12:79989014-79989218,204
107449652,107605255,chrX,FRMPD3,chrX:107449652-107605255,155603
31846713,32299125,chr13,FRY,chr13:31846713-32299125,452412
52205392,52213583,chr12,LINC02874,chr12:52205392-52213583,8191
59619689,59696956,chr17,CLTC,chr17:59619689-59696956,77267
2289784,2292024,chr19,LINGO3,chr19:2289784-2292024,2240
3870991,3872107,chr19,FTLP5,chr19:3870991-3872107,1116
79690144,79778451,chr12,PPP1R12A-AS2,chr12:79690144-79778451,88307
48442030,48442947,chr12,OR8T1P,chr12:48442030-48442947,917
73769248,73770423,chrX,SEPHS1P4,chrX:73769248-73770423,1175
68035767,68036853,chr12,HNRNPA1P70,chr12:68035767-68036853,1086
73792205,73829231,chrX,TSIX,chrX:73792205-73829231,37026
73820649,73852723,chrX,XIST,chrX:73820649-73852723,32074
3804024,3869038,chr19,ZFR2,chr19:3804024-3869038,65014
28180322,28243917,chr7,JAZF1-AS1,chr7:28180322-28243917,63595
61600067,61600843,chr12,DUX4L52,chr12:61600067-61600843,776
26880597,27121150,chr5,CDH9,chr5:26880597-27121150,240553
97020396,97024950,chr7,DLX5,chr7:97020396-97024950,4554
4628216,4656498,chr2,LINC01249,chr2:4628216-4656498,28282
50326230,50396622,chr12,FAM186A,chr12:50326230-50396622,70392
127588386,127591700,chr7,ARF5,chr7:127588386-127591700,3314
20590775,20592548,chr2,HS1BP3-IT1,chr2:20590775-20592548,1773
14632700,14650814,chr2,LRATD1,chr2:14632700-14650814,18114
96160692,96172126,chr12,LINC02452,chr12:96160692-96172126,11434
67989445,68234686,chr12,IFNG-AS1,chr12:67989445-68234686,245241
6887566,6940459,chr19,ADGRE1,chr19:6887566-6940459,52893
94521090,94521869,chr12,NSA2P2,chr12:94521090-94521869,779
26827169,26827520,chr2,CDKN2AIPNLP2,chr2:26827169-26827520,351
102402617,102421539,chr10,PSD,chr10:102402617-102421539,18922
10690344,10692099,chr2,RN7SL832P,chr2:10690344-10692099,1755
47826969,47827044,chr20,RNU7-173P,chr20:47826969-47827044,75
47859788,47860672,chr20,SRMP1,chr20:47859788-47860672,884
47873191,47873273,chr20,RNA5SP486,chr20:47873191-47873273,82
55233934,55295201,chr5,CCNO-DT,chr5:55233934-55295201,61267
47904348,47904423,chr20,RNU7-92P,chr20:47904348-47904423,75
9206765,9405683,chr2,ASAP2,chr2:9206765-9405683,198918
70462244,70479215,chr5,NAIPP1,chr5:70462244-70479215,16971
47656348,47786616,chr20,SULF2,chr20:47656348-47786616,130268
85280220,85301784,chr12,ALX1,chr12:85280220-85301784,21564
25087450,25190956,chr5,LINC02228,chr5:25087450-25190956,103506
143436216,143436710,chr6,TUBB8P2,chr6:143436216-143436710,494
18704433,18746173,chr5,LINC02100,chr5:18704433-18746173,41740
153938433,153938992,chr6,HMGB3P19,chr6:153938433-153938992,559
127438406,127459389,chr6,KIAA0408,chr6:127438406-127459389,20983
33523535,33892019,chr5,ADAMTS12,chr5:33523535-33892019,368484
90905622,90955176,chr12,CCER1,chr12:90905622-90955176,49554
50502949,50507702,chr22,LMF2,chr22:50502949-50507702,4753
52674736,52680407,chr12,KRT1,chr12:52674736-52680407,5671
64149685,64150432,chr7,VN1R37P,chr7:64149685-64150432,747
73875068,73875635,chrX,FXYD6P3,chrX:73875068-73875635,567
121348878,121396364,chr7,FAM3C,chr7:121348878-121396364,47486
73944182,74070408,chrX,JPX,chrX:73944182-74070408,126226
144200447,144200965,chr6,TPT1P4,chr6:144200447-144200965,518
132284302,132285081,chr11,NTM-IT,chr11:132284302-132285081,779
104455295,104762014,chr12,CHST11,chr12:104455295-104762014,306719
87298772,87300447,chr6,HSPD1P10,chr6:87298772-87300447,1675
91727282,91727505,chr6,MTCO1P56,chr6:91727282-91727505,223
109440724,109443919,chr6,SMPD2,chr6:109440724-109443919,3195
133840631,133845538,chr11,SPATA19,chr11:133840631-133845538,4907
102423245,102432584,chr10,CUEDC2,chr10:102423245-102432584,9339
124476371,124476955,chr7,SSU72P8,chr7:124476371-124476955,584
130672956,130717352,chr11,LINC02873,chr11:130672956-130717352,44396
155453049,155454803,chr4,MTND5P9,chr4:155453049-155454803,1754
49908882,49911863,chr12,LINC02396,chr12:49908882-49911863,2981
119709920,119713925,chr11,NECTIN1-AS1,chr11:119709920-119713925,4005
132814569,132817564,chr6,RPS12,chr6:132814569-132817564,2995
142587868,142588359,chr7,TRBV14,chr7:142587868-142588359,491
169986597,170033031,chr4,MFAP3L,chr4:169986597-170033031,46434
102436512,102436584,chr10,MIR146B,chr10:102436512-102436584,72
47844908,47855874,chr17,SP6,chr17:47844908-47855874,10966
102449816,102461106,chr10,C10orf95-AS1,chr10:102449816-102461106,11290
128458761,128587558,chr11,ETS1,chr11:128458761-128587558,128797
123113531,123199972,chr7,SLC13A1,chr7:123113531-123199972,86441
69284397,69285485,chr12,C1GALT1P1,chr12:69284397-69285485,1088
48543551,48551250,chr17,HOXB-AS1,chr17:48543551-48551250,7699
134296997,134298695,chr6,KRT8P42,chr6:134296997-134298695,1698
67424272,67424986,chr12,NTAN1P3,chr12:67424272-67424986,714
11665369,11665969,chr2,CDK8P1,chr2:11665369-11665969,600
80763151,80770717,chr12,LINC01490,chr12:80763151-80770717,7566
23951348,24178263,chr5,LINC02899,chr5:23951348-24178263,226915
87282980,87329278,chr6,GJB7,chr6:87282980-87329278,46298
46978481,47054569,chr17,LRRC37A17P,chr17:46978481-47054569,76088
57890327,57899162,chr5,LINC02225,chr5:57890327-57899162,8835
102449837,102451543,chr10,C10orf95,chr10:102449837-102451543,1706
17620533,17620939,chr5,H3P20,chr5:17620533-17620939,406
6495877,6496798,chr2,PIK3CDP1,chr2:6495877-6496798,921
149400262,149401278,chr6,SUMO4,chr6:149400262-149401278,1016
102461395,102477045,chr10,MFSD13A,chr10:102461395-102477045,15650
55219564,55227315,chr5,MCIDAS,chr5:55219564-55227315,7751
154387515,154510685,chr6,CNKSR3,chr6:154387515-154510685,123170
50508224,50524780,chr22,NCAPH2,chr22:50508224-50524780,16556
50504985,50748657,chr12,DIP2B,chr12:50504985-50748657,243672
50508384,50531501,chr17,MYCBPAP,chr17:50508384-50531501,23117
185051081,185115500,chr4,LINC02436,chr4:185051081-185115500,64419
88180103,88326907,chr14,KCNK10,chr14:88180103-88326907,146804
115136475,115137220,chr7,RAC1P6,chr7:115136475-115137220,745
37796058,37796888,chr7,GPR141BP,chr7:37796058-37796888,830
9583967,9630997,chr2,YWHAQ,chr2:9583967-9630997,47030
126438598,127253093,chr7,GRM8,chr7:126438598-127253093,814495
68854910,68855085,chr5,VWA8P1,chr5:68854910-68855085,175
102461881,102502712,chr10,ACTR1A,chr10:102461881-102502712,40831
35951006,36001028,chr5,UGT3A1,chr5:35951006-36001028,50022
108934400,108950744,chr9,ABITRAM,chr9:108934400-108950744,16344
61775923,61776400,chr12,RPL21P104,chr12:61775923-61776400,477
11658178,11670195,chr2,NTSR2,chr2:11658178-11670195,12017
102572757,102573225,chr10,RPL23AP58,chr10:102572757-102573225,468
102591524,102591630,chr10,RNU6-43P,chr10:102591524-102591630,106
21028999,21030792,chr10,EIF4BP2,chr10:21028999-21030792,1793
21110682,21113388,chr10,NPM1P30,chr10:21110682-21113388,2706
62260338,62417431,chr12,USP15,chr12:62260338-62417431,157093
21174014,21175048,chr10,NEBL-AS1,chr10:21174014-21175048,1034
74031462,74031820,chrX,RPSAP14,chrX:74031462-74031820,358
74066083,74066592,chrX,SHISA5P2,chrX:74066083-74066592,509
21247752,21248095,chr10,LUZP4P1,chr10:21247752-21248095,343
108942569,109013522,chr9,CTNNAL1,chr9:108942569-109013522,70953
74069276,74070832,chrX,AARSD1P1,chrX:74069276-74070832,1556
104724229,104747325,chr14,ADSS1,chr14:104724229-104747325,23096
21321961,21322067,chr10,RNU6-15P,chr10:21321961-21322067,106
74105572,74107958,chrX,UHRF2P1,chrX:74105572-74107958,2386
19868860,19885047,chr2,LINC00954,chr2:19868860-19885047,16187
74121012,74131923,chrX,DDX3P1,chrX:74121012-74131923,10911
133360029,133366080,chr11,OPCML-IT1,chr11:133360029-133366080,6051
1597169,1605473,chr19,UQCR11,chr19:1597169-1605473,8304
74133004,74133114,chrX,DDX3P2,chrX:74133004-74133114,110
74258689,74321255,chr5,LINC01335,chr5:74258689-74321255,62566
74161062,74162528,chrX,MKRN5P,chrX:74161062-74162528,1466
44292569,44294649,chr10,LINC02881,chr10:44292569-44294649,2080
124865432,124881471,chr11,ROBO3,chr11:124865432-124881471,16039
153517642,153582939,chrX,ATP2B3,chrX:153517642-153582939,65297
44414649,44415153,chr10,RPL9P21,chr10:44414649-44415153,504
73909177,73917496,chr10,PLAU,chr10:73909177-73917496,8319
137730170,137792835,chr6,LINC02539,chr6:137730170-137792835,62665
19471296,20575873,chr5,CDH18,chr5:19471296-20575873,1104577
2933218,2944971,chr19,ZNF77,chr19:2933218-2944971,11753
125151326,125153611,chr7,LINC02830,chr7:125151326-125153611,2285
108559835,108684774,chr6,FOXO3,chr6:108559835-108684774,124939
63567743,63585075,chr7,TNRC18P2,chr7:63567743-63585075,17332
21001429,21044073,chr2,APOB,chr2:21001429-21044073,42644
165207561,165323156,chr4,KLHL2,chr4:165207561-165323156,115595
24610209,24827632,chr16,TNRC6A,chr16:24610209-24827632,217423
113116718,113118560,chr7,SMIM30,chr7:113116718-113118560,1842
109046229,109046298,chr9,MIR32,chr9:109046229-109046298,69
3094362,3123999,chr19,GNA11,chr19:3094362-3123999,29637
130578965,130638352,chr9,FUBP3,chr9:130578965-130638352,59387
100483927,100494802,chr7,NYAP1,chr7:100483927-100494802,10875
60245288,60245647,chr17,RPL32P32,chr17:60245288-60245647,359
47323290,47441312,chr17,EFCAB13,chr17:47323290-47441312,118022
110180141,110254275,chr6,CDC40,chr6:110180141-110254275,74134
142345421,142345985,chr7,TRBV4-2,chr7:142345421-142345985,564
73909969,73922777,chr10,C10orf55,chr10:73909969-73922777,12808
71779491,72447151,chr7,CALN1,chr7:71779491-72447151,667660
130626297,130626363,chr9,MIR6856,chr9:130626297-130626363,66
90740823,90858039,chr10,HTR7,chr10:90740823-90858039,117216
130713016,130887675,chr9,ABL1,chr9:130713016-130887675,174659
58633967,58648321,chr14,DACT1,chr14:58633967-58648321,14354
1985438,2034881,chr19,BTBD2,chr19:1985438-2034881,49443
90912096,90921087,chr10,ANKRD1,chr10:90912096-90921087,8991
15112120,15266541,chr5,LINC02149,chr5:15112120-15266541,154421
105876796,106036432,chr7,CDHR3,chr7:105876796-106036432,159636
82519590,82526412,chr15,GOLGA6L17P,chr15:82519590-82526412,6822
90922731,90922835,chr10,RNU6-740P,chr10:90922731-90922835,104
34656328,34832612,chr5,RAI14,chr5:34656328-34832612,176284
50523568,50526461,chr22,SCO2,chr22:50523568-50526461,2893
91033157,91062164,chr10,LINC00502,chr10:91033157-91062164,29007
91053051,91055047,chr10,DDX18P6,chr10:91053051-91055047,1996
60981114,61083733,chr14,SLC38A6,chr14:60981114-61083733,102619
41136960,41196801,chr20,PLCG1,chr20:41136960-41196801,59841
49909613,49909942,chr10,RPL35AP24,chr10:49909613-49909942,329
49954214,49954414,chr10,SNORA74C-2,chr10:49954214-49954414,200
49979665,49979780,chr10,RNA5SP317,chr10:49979665-49979780,115
50021182,50067803,chr10,FAM21EP,chr10:50021182-50067803,46621
50025135,50027363,chr10,SLC9A3P3,chr10:50025135-50027363,2228
144094884,144095573,chr6,SF3B5,chr6:144094884-144095573,689
50525752,50530032,chr22,TYMP,chr22:50525752-50530032,4280
185143266,185150382,chr4,SLC25A4,chr4:185143266-185150382,7116
42537820,42548802,chr15,LRRC57,chr15:42537820-42548802,10982
50067888,50133509,chr10,WASHC2A,chr10:50067888-50133509,65621
130892707,130896812,chr9,QRFP,chr9:130892707-130896812,4105
361747,376026,chr19,THEG,chr19:361747-376026,14279
130902438,130939286,chr9,FIBCD1,chr9:130902438-130939286,36848
158636474,158644743,chr6,DYNLT1,chr6:158636474-158644743,8269
31952580,31953361,chr13,EEF1DP3,chr13:31952580-31953361,781
162521682,162522041,chr4,TOMM22P4,chr4:162521682-162522041,359
185399537,185425979,chr4,UFSP2,chr4:185399537-185425979,26442
32025314,32031639,chr13,FRY-AS1,chr13:32025314-32031639,6325
32586452,32778019,chr13,PDS5B,chr13:32586452-32778019,191567
55410525,55508234,chr15,DNAAF4,chr15:55410525-55508234,97709
64105654,64105995,chr7,MTND3P2,chr7:64105654-64105995,341
43170481,43211689,chr17,NBR1,chr17:43170481-43211689,41208
130664594,130682986,chr9,PRDM12,chr9:130664594-130682986,18392
14820792,14824702,chr16,ABCC6P2,chr16:14820792-14824702,3910
9019344,9019984,chr19,BOLA3P2,chr19:9019344-9019984,640
98291650,98401090,chr7,BAIAP2L1,chr7:98291650-98401090,109440
154010496,154246867,chr6,OPRM1,chr6:154010496-154246867,236371
20606280,20606654,chr2,RPS25P3,chr2:20606280-20606654,374
150692971,150765108,chrX,MTMR1,chrX:150692971-150765108,72137
49836043,49843106,chr12,BCDIN3D,chr12:49836043-49843106,7063
3777970,3802129,chr19,MATK,chr19:3777970-3802129,24159
25257952,25261066,chr16,ZKSCAN2-DT,chr16:25257952-25261066,3114
126423358,127003460,chr11,KIRREL3,chr11:126423358-127003460,580102
25069570,25070109,chr16,SCML2P2,chr16:25069570-25070109,539
19819504,19819628,chr16,LARP7P2,chr16:19819504-19819628,124
52164115,52223813,chr12,LINC00592,chr12:52164115-52223813,59698
129175552,129178261,chr9,IER5L,chr9:129175552-129178261,2709
129321016,129324905,chr9,LINC02913,chr9:129321016-129324905,3889
11976734,12574287,chr16,SNX29,chr16:11976734-12574287,597553
26190635,26244672,chr2,HADHA,chr2:26190635-26244672,54037
129370170,129370461,chr9,RN7SL159P,chr9:129370170-129370461,291
118184144,118204035,chr7,LSM8,chr7:118184144-118204035,19891
71938845,72186618,chr12,TPH2,chr12:71938845-72186618,247773
39016969,39039594,chr9,VN2R3P,chr9:39016969-39039594,22625
39154075,39155479,chr9,RBM17P1,chr9:39154075-39155479,1404
39191100,39191360,chr9,RN7SL640P,chr9:39191100-39191360,260
39355669,39361962,chr9,SPATA31A1,chr9:39355669-39361962,6293
30027404,30130483,chr7,PLEKHA8,chr7:30027404-30130483,103079
58152606,58154407,chr15,MTND5P32,chr15:58152606-58154407,1801
190077818,190079092,chr4,DUX4L5,chr4:190077818-190079092,1274
19701937,19718235,chr16,KNOP1,chr16:19701937-19718235,16298
74899992,74906883,chr15,FAM219B,chr15:74899992-74906883,6891
149789952,149790303,chr4,AKIRIN2P1,chr4:149789952-149790303,351
187370648,187371921,chr4,LINC02514,chr4:187370648-187371921,1273
68552995,68553882,chr12,RPSAP12,chr12:68552995-68553882,887
149147793,149154175,chr4,LINC02430,chr4:149147793-149154175,6382
121361854,121362865,chr11,BMPR1AP2,chr11:121361854-121362865,1011
82223681,82358805,chr12,CCDC59,chr12:82223681-82358805,135124
152337655,152338098,chr4,FBXW7-AS1,chr4:152337655-152338098,443
39371065,39376916,chr9,FAM74A1,chr9:39371065-39376916,5851
177430774,177442437,chr4,AGA,chr4:177430774-177442437,11663
39443815,39508885,chr9,ZNF658B,chr9:39443815-39508885,65070
39485379,39485865,chr9,SKP1P3,chr9:39485379-39485865,486
39631046,39632416,chr9,FKBP4P2,chr9:39631046-39632416,1370
125569280,125584684,chr11,EI24,chr11:125569280-125584684,15404
39651901,39652377,chr9,SDR42E1P1,chr9:39651901-39652377,476
39654241,39655531,chr9,ATP5F1AP8,chr9:39654241-39655531,1290
22297375,22335101,chr16,POLR3E,chr16:22297375-22335101,37726
39734670,39735628,chr9,RAB28P1,chr9:39734670-39735628,958
39739747,39741193,chr9,RBPJP5,chr9:39739747-39741193,1446
39816542,40106661,chr9,FGF7P3,chr9:39816542-40106661,290119
39886861,39887144,chr9,RN7SL763P,chr9:39886861-39887144,283
39983821,39984401,chr9,RPL7AP49,chr9:39983821-39984401,580
40121962,40122540,chr9,CDRT15P14,chr9:40121962-40122540,578
40187792,40193921,chr9,MEP1AP1,chr9:40187792-40193921,6129
76259836,76305969,chr12,LNCOG,chr12:76259836-76305969,46133
40223285,40266845,chr9,ANKRD20A2P,chr9:40223285-40266845,43560
53153272,53154484,chr12,EIF4A1P4,chr12:53153272-53154484,1212
152796063,152796831,chr4,NSA2P6,chr4:152796063-152796831,768
51391317,51515763,chr12,SLC4A8,chr12:51391317-51515763,124446
20989973,20997035,chr14,METTL17,chr14:20989973-20997035,7062
48628675,48634932,chr17,HOXB-AS4,chr17:48628675-48634932,6257
30063003,30083208,chr8,SARAF,chr8:30063003-30083208,20205
13712244,13734635,chrX,TRAPPC2,chrX:13712244-13734635,22391
37585500,37586329,chr7,NECAP1P1,chr7:37585500-37586329,829
139341360,139422599,chr7,FMC1-LUC7L2,chr7:139341360-139422599,81239
40233923,40234029,chr9,RNU6-1269P,chr9:40233923-40234029,106
40293082,40293955,chr9,SNX18P8,chr9:40293082-40293955,873
40321299,40329221,chr9,FAM95B1,chr9:40321299-40329221,7922
50542305,50542906,chr22,KLHDC7B-DT,chr22:50542305-50542906,601
24589115,24589407,chr7,SUMO2P14,chr7:24589115-24589407,292
160818422,160818869,chr4,RPS14P7,chr4:160818422-160818869,447
40735884,40755851,chr15,RMDN3,chr15:40735884-40755851,19967
50545899,50551023,chr22,KLHDC7B,chr22:50545899-50551023,5124
20859771,20861661,chr2,LINC02850,chr2:20859771-20861661,1890
145110838,145180589,chr4,OTUD4,chr4:145110838-145180589,69751
3703575,3848008,chr2,DCDC2C,chr2:3703575-3848008,144433
50551112,50562919,chr22,SYCE3,chr22:50551112-50562919,11807
32763438,32763552,chr13,RNY1P4,chr13:32763438-32763552,114
115935148,116159896,chr7,TFEC,chr7:115935148-116159896,224748
32877431,32911650,chr13,LINC00423,chr13:32877431-32911650,34219
50568861,50578465,chr22,CPT1B,chr22:50568861-50578465,9604
40346144,40347052,chr9,CNN2P2,chr9:40346144-40347052,908
40348599,40349791,chr9,GXYLT1P3,chr9:40348599-40349791,1192
24334512,24335152,chr2,RPL36AP13,chr2:24334512-24335152,640
40481558,40497592,chr9,AQP7P5,chr9:40481558-40497592,16034
43044295,43170245,chr17,BRCA1,chr17:43044295-43170245,125950
50081124,50153637,chr20,PEDS1-UBE2V1,chr20:50081124-50153637,72513
35185294,35186679,chr13,ZBED9P1,chr13:35185294-35186679,1385
5810641,5812670,chr2,LINC01810,chr2:5810641-5812670,2029
112878920,112890876,chr9,SLC46A2,chr9:112878920-112890876,11956
35251070,35251829,chr13,PHBP13,chr13:35251070-35251829,759
35473789,35476689,chr13,MAB21L1,chr13:35473789-35476689,2900
15920399,15936017,chr2,MYCNUT,chr2:15920399-15936017,15618
112959134,112962261,chr9,MUPP,chr9:112959134-112962261,3127
16013928,16087201,chr2,GACAT3,chr2:16013928-16087201,73273
33641581,33641939,chr8,BUD31P1,chr8:33641581-33641939,358
40890647,40891537,chrX,SDCBPP3,chrX:40890647-40891537,890
113102117,113111543,chr9,FAM225B,chr9:113102117-113111543,9426
40907987,40908391,chrX,RPL32P36,chrX:40907987-40908391,404
40934982,40935864,chrX,RPS2P55,chrX:40934982-40935864,882
5692384,5701385,chr2,SOX11,chr2:5692384-5701385,9001
35697487,35699938,chr13,LINC00445,chr13:35697487-35699938,2451
41076999,41077750,chrX,CLIC4P3,chrX:41076999-41077750,751
64587763,64798737,chr8,CYP7B1,chr8:64587763-64798737,210974
4514204,4515056,chr2,NPM1P48,chr2:4514204-4515056,852
41085445,41236579,chrX,USP9X,chrX:41085445-41236579,151134
31522480,31580938,chr2,SRD5A2,chr2:31522480-31580938,58458
113113042,113119928,chr9,FAM225A,chr9:113113042-113119928,6886
113150976,113164140,chr9,SLC31A2,chr9:113150976-113164140,13164
50118254,50153734,chr20,PEDS1,chr20:50118254-50153734,35480
49889634,49889728,chr13,RNY4P30,chr13:49889634-49889728,94
141836300,141841487,chr7,PRSS37,chr7:141836300-141841487,5187
19351485,19358623,chr2,OSR1,chr2:19351485-19358623,7138
49890591,49892998,chr13,CTAGE10P,chr13:49890591-49892998,2407
49908634,49908730,chr13,RNY4P9,chr13:49908634-49908730,96
122800123,122801073,chr9,OR1K1,chr9:122800123-122801073,950
37695782,37700019,chr8,ZNF703,chr8:37695782-37700019,4237
49912702,49936490,chr13,SPRYD7,chr13:49912702-49936490,23788
122837557,122838820,chr9,KRT18P67,chr9:122837557-122838820,1263
122844556,122905359,chr9,RC3H2,chr9:122844556-122905359,60803
21362292,21364025,chr2,NUTF2P8,chr2:21362292-21364025,1733
60185412,60281400,chr8,CA8,chr8:60185412-60281400,95988
13710531,14400963,chr2,LINC00276,chr2:13710531-14400963,690432
24029347,24049575,chr2,WDCP,chr2:24029347-24049575,20228
82536750,82540459,chr15,RPS17,chr15:82536750-82540459,3709
19896631,19901983,chr2,TTC32,chr2:19896631-19901983,5352
37784191,37844896,chr8,ADGRA2,chr8:37784191-37844896,60705
50171809,50176676,chr20,LINC01273,chr20:50171809-50176676,4867
4838341,4867694,chr19,PLIN3,chr19:4838341-4867694,29353
26847747,26950351,chr2,DPYSL5,chr2:26847747-26950351,102604
50184598,50191498,chr20,CEBPB-AS1,chr20:50184598-50191498,6900
32315086,32400268,chr13,BRCA2,chr13:32315086-32400268,85182
50190830,50192668,chr20,CEBPB,chr20:50190830-50192668,1838
50292709,50315488,chr20,LINC01270,chr20:50292709-50315488,22779
58865006,58865303,chr15,ZNF444P1,chr15:58865006-58865303,297
74957219,75021495,chr15,SCAMP5,chr15:74957219-75021495,64276
167648430,167648796,chr4,PHBP14,chr4:167648430-167648796,366
50429190,50429483,chr20,RN7SL636P,chr20:50429190-50429483,293
143559472,143561460,chr4,GUSBP5,chr4:143559472-143561460,1988
50479767,50479991,chr20,COX6CP2,chr20:50479767-50479991,224
50510321,50585241,chr20,PTPN1,chr20:50510321-50585241,74920
99896248,99946618,chr4,DNAJB14,chr4:99896248-99946618,50370
128526142,128530389,chr11,ETS1-AS1,chr11:128526142-128530389,4247
101043564,101094476,chrX,TRMT2B-AS1,chrX:101043564-101094476,50912
101078879,101096367,chrX,TMEM35A,chrX:101078879-101096367,17488
134735596,134763810,chr11,LINC02714,chr11:134735596-134763810,28214
15125242,15154564,chr16,PKD1P6,chr16:15125242-15154564,29322
127940913,127941654,chr11,DNAJB6P1,chr11:127940913-127941654,741
157854529,157863011,chr7,PTPRN2-AS1,chr7:157854529-157863011,8482
101098188,101166126,chrX,CENPI,chrX:101098188-101166126,67938
134994982,135007779,chr11,LINC02717,chr11:134994982-135007779,12797
50150603,50152287,chr10,SLC9A3P1,chr10:50150603-50152287,1684
129410113,129410370,chr7,CDC26P1,chr7:129410113-129410370,257
50264978,50266815,chr10,DYNC1I2P1,chr10:50264978-50266815,1837
62289521,62304033,chr10,LINC02621,chr10:62289521-62304033,14512
8520778,8577577,chr19,MYO1F,chr19:8520778-8577577,56799
130789231,130791025,chr11,PPP1R10P1,chr11:130789231-130791025,1794
62350006,62350297,chr10,RN7SL591P,chr10:62350006-62350297,291
42836674,42843325,chr8,THAP1,chr8:42836674-42843325,6651
105459055,105505681,chr13,DAOA-AS1,chr13:105459055-105505681,46626
128095758,128183671,chr11,LINC02725,chr11:128095758-128183671,87913
62374192,62480288,chr10,ZNF365,chr10:62374192-62480288,106096
4608883,4615027,chr16,UBALD1,chr16:4608883-4615027,6144
114678527,114707069,chr11,NXPE2,chr11:114678527-114707069,28542
52024691,52033600,chr13,UTP14C,chr13:52024691-52033600,8909
27525442,27662883,chr7,HIBADH,chr7:27525442-27662883,137441
101191115,101191409,chrX,YWHAQP8,chrX:101191115-101191409,294
122880213,122880323,chr9,SNORD90,chr9:122880213-122880323,110
50557682,50557998,chr20,RN7SL672P,chr20:50557682-50557998,316
122908056,122913323,chr9,ZBTB6,chr9:122908056-122913323,5267
93542022,93571768,chr12,SOCS2-AS1,chr12:93542022-93571768,29746
153447668,153495516,chrX,HAUS7,chrX:153447668-153495516,47848
50585786,50585879,chr20,MIR645,chr20:50585786-50585879,93
50614636,50614785,chr20,MIR1302-5,chr20:50614636-50614785,149
50620763,50621077,chr20,RPL36P2,chr20:50620763-50621077,314
50299876,50321486,chr20,LINC01271,chr20:50299876-50321486,21610
122915566,122931512,chr9,ZBTB26,chr9:122915566-122931512,15946
126211724,126262984,chr11,FAM118B,chr11:126211724-126262984,51260
37444733,37445534,chr20,RPL7AP14,chr20:37444733-37445534,801
47960185,47978160,chr8,MCM4,chr8:47960185-47978160,17975
37344685,37406050,chr20,SRC,chr20:37344685-37406050,61365
52132639,52159861,chr13,NEK3,chr13:52132639-52159861,27222
122940833,123104866,chr9,RABGAP1,chr9:122940833-123104866,164033
67269358,67319953,chr12,CAND1,chr12:67269358-67319953,50595
788046,800737,chr16,CHTF18,chr16:788046-800737,12691
75499705,75500136,chr6,RPL26P20,chr6:75499705-75500136,431
62741208,62741385,chr10,ALDH7A1P4,chr10:62741208-62741385,177
150384307,150385120,chr6,SSR1P1,chr6:150384307-150385120,813
62804720,62808479,chr10,ADO,chr10:62804720-62808479,3759
94768223,94770113,chr14,GSC,chr14:94768223-94770113,1890
148478693,148480763,chr6,CYP51A1P3,chr6:148478693-148480763,2070
129784983,129806971,chr10,LINC02666,chr10:129784983-129806971,21988
50568869,50582965,chr22,CHKB-CPT1B,chr22:50568869-50582965,14096
156760454,156971799,chr4,PDGFC,chr4:156760454-156971799,211345
148567378,148567654,chr6,SNRPEP6,chr6:148567378-148567654,276
49625174,49635244,chr14,DNAAF2,chr14:49625174-49635244,10070
129843299,129843374,chr10,MIR4297,chr10:129843299-129843374,75
170272474,170279887,chr6,LINC01624,chr6:170272474-170279887,7413
120354701,120355183,chr10,RPL21P16,chr10:120354701-120355183,482
15940550,15947007,chr2,MYCN,chr2:15940550-15947007,6457
120597949,120600124,chr10,LINC01561,chr10:120597949-120600124,2175
120457227,120592065,chr10,PLPP4,chr10:120457227-120592065,134838
21563819,21565084,chr14,RBBP4P5,chr14:21563819-21565084,1265
112107931,112254939,chr6,LAMA4,chr6:112107931-112254939,147008
21601882,21602825,chr14,OR10G1P,chr14:21601882-21602825,943
9271292,9271628,chr2,EIF1P7,chr2:9271292-9271628,336
122701668,122702922,chr7,RNF148,chr7:122701668-122702922,1254
21611924,21612381,chr14,UBE2NP1,chr14:21611924-21612381,457
21621838,21622567,chr14,TRAV1-1,chr14:21621838-21622567,729
25042076,25159135,chr2,EFR3B,chr2:25042076-25159135,117059
21633836,21634940,chr14,OR10G2,chr14:21633836-21634940,1104
20551970,20552046,chr10,MIR4675,chr10:20551970-20552046,76
20804293,20804577,chr10,MTND1P21,chr10:20804293-20804577,284
21642889,21643578,chr14,TRAV1-2,chr14:21642889-21643578,689
21340233,21372950,chr10,LINC02643,chr10:21340233-21372950,32717
21649728,21650337,chr14,ARL6IP1P1,chr14:21649728-21650337,609
21394033,21394592,chr10,MRM3P1,chr10:21394033-21394592,559
103074881,103099759,chr7,ARMC10,chr7:103074881-103099759,24878
50578959,50601455,chr22,CHKB,chr22:50578959-50601455,22496
21712321,21712843,chr14,TRAV2,chr14:21712321-21712843,522
21492658,21497260,chr10,MIR1915HG,chr10:21492658-21497260,4602
21723713,21724321,chr14,TRAV3,chr14:21723713-21724321,608
134796395,134854835,chrX,PABIR3,chrX:134796395-134854835,58440
21736152,21736982,chr14,TRAV4,chr14:21736152-21736982,830
21496562,21496641,chr10,MIR1915,chr10:21496562-21496641,79
21513475,21526368,chr10,SKIDA1,chr10:21513475-21526368,12893
21749178,21749705,chr14,TRAV5,chr14:21749178-21749705,527
21750269,21751546,chr14,RPL4P1,chr14:21750269-21751546,1277
21098811,21103724,chr14,TMEM253,chr14:21098811-21103724,4913
151277171,151291453,chr4,PRSS48,chr4:151277171-151291453,14282
21564471,21564577,chr10,RNU6-306P,chr10:21564471-21564577,106
23346941,23351486,chr20,NXT1-AS1,chr20:23346941-23351486,4545
127549309,127553540,chr10,NPS,chr10:127549309-127553540,4231
52585589,52601538,chr12,KRT72,chr12:52585589-52601538,15949
23350791,23354771,chr20,NXT1,chr20:23350791-23354771,3980
15032227,15073853,chr10,OLAH,chr10:15032227-15073853,41626
23362182,23373062,chr20,GZF1,chr20:23362182-23373062,10880
19743571,19749469,chr14,OR4Q3,chr14:19743571-19749469,5898
122977570,122981834,chr11,BSX,chr11:122977570-122981834,4264
58065225,58071043,chr15,ALDH1A2-AS1,chr15:58065225-58071043,5818
122945988,122946094,chr9,RNY1P15,chr9:122945988-122946094,106
23298790,23311751,chr14,BCL2L2,chr14:23298790-23311751,12961
917287,921005,chr19,KISS1R,chr19:917287-921005,3718
144831908,145098541,chr4,ANAPC10,chr4:144831908-145098541,266633
133783671,133810376,chr11,LINC02743,chr11:133783671-133810376,26705
123109494,123115477,chr9,MIR600HG,chr9:123109494-123115477,5983
130844191,130865561,chr11,LINC02551,chr11:130844191-130865561,21370
123109500,123268586,chr9,STRBP,chr9:123109500-123268586,159086
122613444,122614486,chr11,GLULP3,chr11:122613444-122614486,1042
23374519,23421519,chr20,NAPB,chr20:23374519-23421519,47000
57591904,57685364,chr15,MYZAP,chr15:57591904-57685364,93460
135061781,135075908,chr11,LINC02684,chr11:135061781-135075908,14127
52314301,52321398,chr12,KRT83,chr12:52314301-52321398,7097
23306833,23326175,chr14,BCL2L2-PABPN1,chr14:23306833-23326175,19342
135662496,135693418,chr7,STMP1,chr7:135662496-135693418,30922
86192787,86193482,chr11,LINC02695,chr11:86192787-86193482,695
127271029,127337033,chr11,LINC02712,chr11:127271029-127337033,66004
124611428,124620356,chr11,PANX3,chr11:124611428-124620356,8928
80822524,80822796,chr14,HMGN2P2,chr14:80822524-80822796,272
1009648,1021179,chr19,TMEM259,chr19:1009648-1021179,11531
131309469,131328312,chr7,MKLN1-AS,chr7:131309469-131328312,18843
49131154,49134021,chr10,FAM170B,chr10:49131154-49134021,2867
80954989,81146306,chr14,TSHR,chr14:80954989-81146306,191317
124883691,124898500,chr11,ROBO4,chr11:124883691-124898500,14809
23783173,23786210,chrX,SAT1,chrX:23783173-23786210,3037
113679162,113730907,chr10,CASP7,chr10:113679162-113730907,51745
27402174,27452042,chr16,IL21R,chr16:27402174-27452042,49868
49827913,49841143,chr12,BCDIN3D-AS1,chr12:49827913-49841143,13230
105019784,105107643,chr12,ALDH1L2,chr12:105019784-105107643,87859
121398452,121398767,chr7,CYCSP19,chr7:121398452-121398767,315
30243715,30252040,chrX,MAGEB1,chrX:30243715-30252040,8325
50583026,50595634,chr22,CHKB-DT,chr22:50583026-50595634,12608
131544074,131545000,chrX,OR13H1,chrX:131544074-131545000,926
127295620,127296203,chr7,PRELID3BP10,chr7:127295620-127296203,583
48130626,48132620,chrX,SPACA5B,chrX:48130626-48132620,1994
23380896,23381012,chr20,RNA5SP479,chr20:23380896-23381012,116
23426104,23444930,chr20,CSTL1,chr20:23426104-23444930,18826
50600793,50613981,chr22,MAPK8IP2,chr22:50600793-50613981,13188
140023749,140062951,chr7,PARP12,chr7:140023749-140062951,39202
68647666,68725842,chrX,STARD8,chrX:68647666-68725842,78176
23450403,23452876,chr20,CST11,chr20:23450403-23452876,2473
52167954,52168321,chr13,THSD1P1,chr13:52167954-52168321,367
63657810,63696253,chr20,RTEL1,chr20:63657810-63696253,38443
52012391,52079232,chr13,ALG11,chr13:52012391-52079232,66841
2177180,2196605,chr16,CASKIN1,chr16:2177180-2196605,19425
2997639,3047635,chr19,TLE2,chr19:2997639-3047635,49996
10249929,10266389,chr5,CCT5,chr5:10249929-10266389,16460
30230657,30237495,chrX,MAGEB3,chrX:30230657-30237495,6838
102304355,102463491,chr12,LINC02456,chr12:102304355-102463491,159136
11482341,11642788,chr2,GREB1,chr2:11482341-11642788,160447
73447053,73455171,chrX,CDX4,chrX:73447053-73455171,8118
71763349,71767204,chrX,CXorf49B,chrX:71763349-71767204,3855
50622754,50628173,chr22,ARSA,chr22:50622754-50628173,5419
63544247,63601589,chr15,USP3-AS1,chr15:63544247-63601589,57342
71578437,71613583,chrX,GCNA,chrX:71578437-71613583,35146
47734363,47771040,chr12,RAPGEF3,chr12:47734363-47771040,36677
113409605,113475691,chr11,DRD2,chr11:113409605-113475691,66086
119651380,119677819,chr10,BAG3,chr10:119651380-119677819,26439
9441294,9444985,chr16,LINC01177,chr16:9441294-9444985,3691
123111546,123111643,chr9,MIR600,chr9:123111546-123111643,97
68935873,68935979,chr9,RNU6-820P,chr9:68935873-68935979,106
131500262,131558217,chr7,PODXL,chr7:131500262-131558217,57955
15104312,15123498,chr16,NPIPP1,chr16:15104312-15123498,19186
50990888,52298423,chr10,PRKG1,chr10:50990888-52298423,1307535
154219756,154233286,chrX,OPN1MW2,chrX:154219756-154233286,13530
78565520,78595269,chr15,CHRNA5,chr15:78565520-78595269,29749
16409503,16870843,chr9,BNC2,chr9:16409503-16870843,461340
27268205,27290492,chr16,NSMCE1-DT,chr16:27268205-27290492,22287
51354077,51454264,chr13,INTS6,chr13:51354077-51454264,100187
150720981,150721478,chr4,ZBTB8OSP1,chr4:150720981-150721478,497
18791669,18801572,chr16,ARL6IP1,chr16:18791669-18801572,9903
149581653,149587459,chrX,MAGEA9B,chrX:149581653-149587459,5806
188387471,188389666,chr4,ICE2P1,chr4:188387471-188389666,2195
158315311,158653372,chr4,RXFP1,chr4:158315311-158653372,338061
72807425,72808210,chrX,FAM236D,chrX:72807425-72808210,785
128050962,128052403,chrX,ACTRT1,chrX:128050962-128052403,1441
71714371,71718285,chrX,CXorf49,chrX:71714371-71718285,3914
80981988,80983638,chr14,BHLHB9P1,chr14:80981988-80983638,1650
59638062,59657541,chr15,GTF2A2,chr15:59638062-59657541,19479
81001166,81001786,chr14,RPL17P3,chr14:81001166-81001786,620
67628022,67628349,chr7,MTCO3P41,chr7:67628022-67628349,327
154617609,154619282,chrX,CTAG1B,chrX:154617609-154619282,1673
158856558,158956747,chr7,DYNC2I1,chr7:158856558-158956747,100189
81032529,81033404,chr14,NMNAT1P1,chr14:81032529-81033404,875
154651972,154653579,chrX,CTAG2,chrX:154651972-154653579,1607
60906059,60906452,chr8,IFITM3P8,chr8:60906059-60906452,393
81175452,81221377,chr14,GTF2A1,chr14:81175452-81221377,45925
73995193,74121363,chr10,VCL,chr10:73995193-74121363,126170
27560274,27589073,chr8,GULOP,chr8:27560274-27589073,28799
53887008,53887244,chr8,RPS27AP13,chr8:53887008-53887244,236
112774503,112840831,chrX,AMOT,chrX:112774503-112840831,66328
16775573,16775845,chr9,LSM1P1,chr9:16775573-16775845,272
78171249,78188626,chr11,KCTD21,chr11:78171249-78188626,17377
56588385,56588787,chr8,RPL37P6,chr8:56588385-56588787,402
25419812,25433686,chr16,LINC02191,chr16:25419812-25433686,13874
46697630,46698688,chr8,ASNSP4,chr8:46697630-46698688,1058
7971661,7973253,chr8,USP17L8,chr8:7971661-7973253,1592
27313668,27364778,chr16,IL4R,chr16:27313668-27364778,51110
31219894,31220984,chr8,KCTD9P6,chr8:31219894-31220984,1090
86195132,86196266,chr11,FNTAP1,chr11:86195132-86196266,1134
120619934,120620267,chr11,ELOCP22,chr11:120619934-120620267,333
7778591,7781413,chr8,PRR23D2,chr8:7778591-7781413,2822
75081753,75096876,chr11,OR2AT4,chr11:75081753-75096876,15123
69035751,69079076,chr9,FXN,chr9:69035751-69079076,43325
31793823,31803980,chr2,LINC01946,chr2:31793823-31803980,10157
33547754,33567128,chr8,RNF122,chr8:33547754-33567128,19374
124919205,124936412,chr11,HEPACAM,chr11:124919205-124936412,17207
20155618,20156057,chr2,RPS16P2,chr2:20155618-20156057,439
21687430,21710656,chr2,LINC01822,chr2:21687430-21710656,23226
50944663,50945996,chr15,DCAF13P3,chr15:50944663-50945996,1333
65327127,65378002,chr15,IGDCC3,chr15:65327127-65378002,50875
37843268,37849861,chr8,BRF2,chr8:37843268-37849861,6593
17753858,17788946,chr2,GEN1,chr2:17753858-17788946,35088
81202695,81202834,chr14,SNORA79,chr14:81202695-81202834,139
81246295,81246563,chr14,DYNLL1P1,chr14:81246295-81246563,268
140453033,140479536,chr7,MKRN1,chr7:140453033-140479536,26503
69121264,69274615,chr9,TJP2,chr9:69121264-69274615,153351
81259565,81260239,chr14,UNGP3,chr14:81259565-81260239,674
81412970,81413239,chr14,DYNLL1P2,chr14:81412970-81413239,269
90200429,90223077,chr11,CHORDC1,chr11:90200429-90223077,22648
81441987,81450371,chr14,LINC02308,chr14:81441987-81450371,8384
21750673,22853344,chr5,CDH12,chr5:21750673-22853344,1102671
70258166,70260204,chrX,P2RY4,chrX:70258166-70260204,2038
19360056,19515508,chrX,MAP3K15,chrX:19360056-19515508,155452
100879753,100903722,chr14,RTL1,chr14:100879753-100903722,23969
21466423,21471269,chr22,TMEM191C,chr22:21466423-21471269,4846
67360328,67386516,chr14,EIF2S1,chr14:67360328-67386516,26188
27896116,27897195,chr2,MYG1P1,chr2:27896116-27897195,1079
17539126,17657018,chr2,VSNL1,chr2:17539126-17657018,117892
3762682,3768575,chr19,MRPL54,chr19:3762682-3768575,5893
102503972,102633535,chr10,SUFU,chr10:102503972-102633535,129563
4279266,4290722,chr19,SHD,chr19:4279266-4290722,11456
31053565,31054153,chr5,RPL19P11,chr5:31053565-31054153,588
39520398,39524726,chr5,LINC02104,chr5:39520398-39524726,4328
78277835,78299703,chr15,WDR61,chr15:78277835-78299703,21868
67386984,67412167,chr14,PLEK2,chr14:67386984-67412167,25183
17525235,17525831,chr5,TAF11L5,chr5:17525235-17525831,596
52926402,52995472,chrX,FAM156A,chrX:52926402-52995472,69070
75910565,75911867,chr5,BIN2P2,chr5:75910565-75911867,1302
51409617,51410205,chr5,HMGB1P47,chr5:51409617-51410205,588
23145366,23165663,chr22,RAB36,chr22:23145366-23165663,20297
134127299,134264591,chr7,LRGUK,chr7:134127299-134264591,137292
3490821,3500674,chr19,DOHH,chr19:3490821-3500674,9853
44300247,44389706,chr5,FGF10,chr5:44300247-44389706,89459
18562872,18589572,chr2,NT5C1B,chr2:18562872-18589572,26700
38225218,38275558,chr8,DDHD2,chr8:38225218-38275558,50340
56815549,56896152,chr5,MAP3K1,chr5:56815549-56896152,80603
8806170,8832314,chr19,ZNF558,chr19:8806170-8832314,26144
67441855,67441930,chr14,MIR5694,chr14:67441855-67441930,75
75522455,75546993,chr14,BATF,chr14:75522455-75546993,24538
125345825,125346197,chr7,PPIAP93,chr7:125345825-125346197,372
19062144,19067691,chr16,COQ7-DT,chr16:19062144-19067691,5547
75578620,75663214,chr14,FLVCR2,chr14:75578620-75663214,84594
37805229,37807432,chr22,H1-0,chr22:37805229-37807432,2203
139452690,139483673,chr7,KLRG2,chr7:139452690-139483673,30983
19523024,19527545,chr22,CLDN5,chr22:19523024-19527545,4521
9355588,9408093,chr16,LINC02177,chr16:9355588-9408093,52505
142592928,142593473,chr7,TRBV15,chr7:142592928-142593473,545
38578118,38656629,chr22,FAM227A,chr22:38578118-38656629,78511
99710868,99732127,chr10,COX15,chr10:99710868-99732127,21259
79768028,80226181,chr7,GNAI1,chr7:79768028-80226181,458153
12881170,12881493,chr16,RPL35AP34,chr16:12881170-12881493,323
34139189,34139543,chr16,PCMTD1P2,chr16:34139189-34139543,354
112534220,112555802,chr11,LINC02764,chr11:112534220-112555802,21582
58582221,58859394,chr5,RAB3C,chr5:58582221-58859394,277173
125164687,125433389,chr11,PKNOX2,chr11:125164687-125433389,268702
55258415,55264916,chrX,PAGE3,chrX:55258415-55264916,6501
48402082,48411960,chrX,SSX4B,chrX:48402082-48411960,9878
113588714,113664070,chr10,NRAP,chr10:113588714-113664070,75356
44742420,44808777,chr5,MRPS30-DT,chr5:44742420-44808777,66357
32978461,32978891,chr16,IGHV1OR16-2,chr16:32978461-32978891,430
23900693,23901149,chr2,RPS13P4,chr2:23900693-23901149,456
8580240,8610735,chr19,ADAMTS10,chr19:8580240-8610735,30495
189659605,189661486,chr4,LINC01262,chr4:189659605-189661486,1881
39736060,39779267,chr2,THUMPD2,chr2:39736060-39779267,43207
128027886,128085248,chr6,PTPRK-AS1,chr6:128027886-128085248,57362
157299045,157300126,chr6,LDHAL6FP,chr6:157299045-157300126,1081
187408232,187415748,chr4,LINC02515,chr4:187408232-187415748,7516
187201986,187209346,chr4,LINC02374,chr4:187201986-187209346,7360
23688136,23699176,chr22,RGL4,chr22:23688136-23699176,11040
165327667,165343164,chr4,MSMO1,chr4:165327667-165343164,15497
33459045,33462249,chr16,TP53TG3F,chr16:33459045-33462249,3204
43486709,43515148,chr5,C5orf34,chr5:43486709-43515148,28439
120982476,120985760,chrX,CT47A1,chrX:120982476-120985760,3284
40623428,40624136,chrX,MPC1L,chrX:40623428-40624136,708
72776890,72848803,chrX,DMRTC1B,chrX:72776890-72848803,71913
32869985,32873128,chr16,BCAP31P2,chr16:32869985-32873128,3143
35344091,35344559,chr16,RARRES2P9,chr16:35344091-35344559,468
35543279,35543645,chr16,RARRES2P8,chr16:35543279-35543645,366
35335277,35336889,chr16,FRG2HP,chr16:35335277-35336889,1612
14363109,14370266,chr16,LINC02130,chr16:14363109-14370266,7157
78340353,78348225,chr15,CRABP1,chr15:78340353-78348225,7872
35477414,35480481,chr16,FRG2DP,chr16:35477414-35480481,3067
32439069,32441159,chr16,PABPC1P13,chr16:32439069-32441159,2090
151027090,151027617,chr4,AK4P6,chr4:151027090-151027617,527
89519408,89526262,chr12,POC1B-GALNT4,chr12:89519408-89526262,6854
32174471,32175272,chr5,GOLPH3-DT,chr5:32174471-32175272,801
39892138,40053324,chr5,LINC00603,chr5:39892138-40053324,161186
150032769,150033566,chr6,RAET1M,chr6:150032769-150033566,797
35420291,35421209,chr16,AGGF1P5,chr16:35420291-35421209,918
34266041,34268649,chr16,BCLAF1P2,chr16:34266041-34268649,2608
166585604,166587594,chr6,RAMACL,chr6:166585604-166587594,1990
145757627,145938823,chr4,ZNF827,chr4:145757627-145938823,181196
75604173,75604278,chr14,RNA5SP387,chr14:75604173-75604278,105
10570754,10689987,chr2,NOL10,chr2:10570754-10689987,119233
35118238,35118956,chr16,VN1R68P,chr16:35118238-35118956,718
149446795,149485014,chr6,ZC3H12D,chr6:149446795-149485014,38219
7337115,7338707,chr8,USP17L4,chr8:7337115-7338707,1592
74111690,74536976,chr5,LINC01331,chr5:74111690-74536976,425286
35258630,35259629,chr16,AGGF1P8,chr16:35258630-35259629,999
33802764,33803217,chr16,IGHV3OR16-12,chr16:33802764-33803217,453
75633625,75955079,chr14,TTLL5,chr14:75633625-75955079,321454
135713639,135723539,chrX,CT45A1,chrX:135713639-135723539,9900
54085132,54125992,chr12,FAM242C,chr12:54085132-54125992,40860
70654554,70763558,chr15,UACA,chr15:70654554-70763558,109004
33844784,33845229,chr16,IGHV3OR16-17,chr16:33844784-33845229,445
50396192,50443248,chr5,EMB,chr5:50396192-50443248,47056
34141256,34142006,chr16,DUX4L46,chr16:34141256-34142006,750
83286120,83423516,chr11,CCDC90B-AS1,chr11:83286120-83423516,137396
68686951,68745809,chr12,NUP107,chr12:68686951-68745809,58858
33827214,33827661,chr16,IGHV3OR16-13,chr16:33827214-33827661,447
44694863,44696301,chr11,LINC02704,chr11:44694863-44696301,1438
124752583,124762290,chr11,ESAM,chr11:124752583-124762290,9707
39314591,39417378,chr8,ADAM5,chr8:39314591-39417378,102787
2486414,2500976,chrX,ZBED1,chrX:2486414-2500976,14562
35085896,35086119,chr16,NAMPTP3,chr16:35085896-35086119,223
2609191,2609254,chrX,MIR6089,chrX:2609191-2609254,63
2612988,2615347,chrX,LINC00102,chrX:2612988-2615347,2359
33687025,33707213,chr16,BMS1P8,chr16:33687025-33707213,20188
2691187,2741309,chrX,CD99,chrX:2691187-2741309,50122
115931149,116060891,chr6,FRK,chr6:115931149-116060891,129742
4641374,4670362,chr19,MYDGF,chr19:4641374-4670362,28988
23971365,23979828,chr22,DDT,chr22:23971365-23979828,8463
35169692,35170241,chr16,UBE2MP1,chr16:35169692-35170241,549
65333852,65354262,chr11,DPF2,chr11:65333852-65354262,20410
60751791,60844274,chr5,ELOVL7,chr5:60751791-60844274,92483
35221583,35222048,chr16,RARRES2P5,chr16:35221583-35222048,465
150567369,150573953,chr7,GIMAP4,chr7:150567369-150573953,6584
152750797,152759765,chr6,VIP,chr6:152750797-152759765,8968
49066567,49066729,chr16,MTND4LP25,chr16:49066567-49066729,162
21545666,21551461,chr22,RIMBP3C,chr22:21545666-21551461,5795
46689643,46698394,chr16,ORC6,chr16:46689643-46698394,8751
29058672,29061831,chr22,C22orf31,chr22:29058672-29061831,3159
21792434,21792524,chr22,RNA5SP493,chr22:21792434-21792524,90
51452364,51554678,chr13,INTS6-AS1,chr13:51452364-51554678,102314
21919425,21952848,chr22,PPM1F,chr22:21919425-21952848,33423
122697735,122699117,chr7,RNF133,chr7:122697735-122699117,1382
4903080,4962154,chr19,UHRF1,chr19:4903080-4962154,59074
119495024,119907397,chr7,LINC02476,chr7:119495024-119907397,412373
128580113,128580884,chr6,EEF1DP5,chr6:128580113-128580884,771
130070534,130135705,chr7,KLHDC10,chr7:130070534-130135705,65171
153668177,153668362,chr6,MTND3P20,chr6:153668177-153668362,185
108041409,108165854,chr6,OSTM1,chr6:108041409-108165854,124445
29001760,29003357,chr5,SUCLG2P4,chr5:29001760-29003357,1597
69068925,69069200,chr5,SUMO2P4,chr5:69068925-69069200,275
57279543,57286968,chr8,LINC00588,chr8:57279543-57286968,7425
7579644,7582653,chr8,FAM90A23P,chr8:7579644-7582653,3009
80033171,80033302,chr5,TRMT112P2,chr5:80033171-80033302,131
41951313,41952193,chr5,RPSAP38,chr5:41951313-41952193,880
142349152,142349664,chr7,TRBV6-2,chr7:142349152-142349664,512
52282567,52282859,chr5,RPS17P11,chr5:52282567-52282859,292
83363238,83649139,chr7,SEMA3E,chr7:83363238-83649139,285901
89254464,89315299,chr6,GABRR2,chr6:89254464-89315299,60835
52787916,52959209,chr5,ITGA1,chr5:52787916-52959209,171293
124919244,124920677,chr11,HEPN1,chr11:124919244-124920677,1433
16970034,16974497,chr2,LINC01866,chr2:16970034-16974497,4463
119602875,119604306,chr11,KRT8P7,chr11:119602875-119604306,1431
21742303,21743077,chr20,SLC25A6P1,chr20:21742303-21743077,774
21755270,21755350,chr20,RPL41P1,chr20:21755270-21755350,80
32673528,32676732,chr16,TP53TG3,chr16:32673528-32676732,3204
24294069,24359014,chr8,ADAM28,chr8:24294069-24359014,64945
24175053,24200849,chr2,FAM228A,chr2:24175053-24200849,25796
37251086,37261819,chr20,GHRH,chr20:37251086-37261819,10733
117836976,117877486,chr11,FXYD6,chr11:117836976-117877486,40510
21938269,21977632,chr22,PPM1F-AS1,chr22:21938269-21977632,39363
31870634,31945000,chr20,TTLL9,chr20:31870634-31945000,74366
132868218,132868859,chr6,HMGB1P13,chr6:132868218-132868859,641
21957025,21982813,chr22,TOP3B,chr22:21957025-21982813,25788
148647707,148648597,chr6,RPSAP40,chr6:148647707-148648597,890
120781220,120781512,chr6,COX6A1P3,chr6:120781220-120781512,292
51454164,51461315,chr13,RPS4XP16,chr13:51454164-51461315,7151
36673621,36675126,chr6,PANDAR,chr6:36673621-36675126,1505
46626404,46626992,chr16,RAB43P1,chr16:46626404-46626992,588
170282206,170306565,chr6,DLL1,chr6:170282206-170306565,24359
24077433,24085861,chr2,TP53I3,chr2:24077433-24085861,8428
51469753,51470047,chr13,RN7SL320P,chr13:51469753-51470047,294
32847713,32848156,chr16,IGHV2OR16-5,chr16:32847713-32848156,443
51496020,51496251,chr13,SNRPGP11,chr13:51496020-51496251,231
154231742,154491799,chr4,DCHS2,chr4:154231742-154491799,260057
51552589,51552667,chr13,MIR4703,chr13:51552589-51552667,78
51565412,51565509,chr13,RNU6-65P,chr13:51565412-51565509,97
51586424,51586532,chr13,RNY1P6,chr13:51586424-51586532,108
51593919,51594215,chr13,RN7SL413P,chr13:51593919-51594215,296
51598416,51599460,chr13,ATP5PBP1,chr13:51598416-51599460,1044
34142456,34142849,chr16,DUX4L47,chr16:34142456-34142849,393
25246222,25287488,chr13,MTMR6,chr13:25246222-25287488,41266
47077703,47143945,chr16,NETO2,chr16:47077703-47143945,66242
96924620,97140754,chr6,KLHL32,chr6:96924620-97140754,216134
153355365,153413985,chr7,LINC01287,chr7:153355365-153413985,58620
136546212,136549893,chr9,NALT1,chr9:136546212-136549893,3681
136658856,136672678,chr9,EGFL7,chr9:136658856-136672678,13822
75649791,75660876,chr14,ERG28,chr14:75649791-75660876,11085
33706886,34738231,chr2,LINC01320,chr2:33706886-34738231,1031345
4791734,4801273,chr19,FEM1A,chr19:4791734-4801273,9539
2752040,2816500,chrX,XG,chrX:2752040-2816500,64460
27435643,27450591,chr13,MTIF3,chr13:27435643-27450591,14948
53103486,53124535,chr12,SOAT2,chr12:53103486-53124535,21049
8848844,8981342,chr19,MUC16,chr19:8848844-8981342,132498
76151916,76254342,chr14,GPATCH2L,chr14:76151916-76254342,102426
151409176,151670503,chr4,FHIP1A,chr4:151409176-151670503,261327
35912120,35912516,chr16,PPP1R1AP2,chr16:35912120-35912516,396
33303739,33306935,chr16,TP53TG3E,chr16:33303739-33306935,3196
129434432,129488399,chr7,STRIP2,chr7:129434432-129488399,53967
9067825,9504593,chr20,PLCB4,chr20:9067825-9504593,436768
26790540,26790646,chr10,RNU6-946P,chr10:26790540-26790646,106
26931206,26944418,chr10,FAM238C,chr10:26931206-26944418,13212
96090107,96839562,chr13,HS6ST3,chr13:96090107-96839562,749455
51861969,51866232,chr13,CCDC70,chr13:51861969-51866232,4263
27088321,27088427,chr10,RNU6-490P,chr10:27088321-27088427,106
52570648,52572522,chr2,CRTC1P1,chr2:52570648-52572522,1874
33858896,33859352,chr16,IGHV3OR16-11,chr16:33858896-33859352,456
27154824,27187953,chr10,MASTL,chr10:27154824-27187953,33129
75336020,75343224,chr15,COMMD4,chr15:75336020-75343224,7204
56504635,56505072,chr5,RPL26P19,chr5:56504635-56505072,437
47565090,47566884,chr16,EIF4BP5,chr16:47565090-47566884,1794
40530590,40897833,chr8,ZMAT4,chr8:40530590-40897833,367243
11199295,11262524,chr19,DOCK6,chr19:11199295-11262524,63229
111360641,111361607,chr6,REV3L-IT1,chr6:111360641-111361607,966
99254732,99261744,chr13,GPR18,chr13:99254732-99261744,7012
47144323,47162749,chr16,ITFG1-AS1,chr16:47144323-47162749,18426
60596912,60700190,chr5,DEPDC1B,chr5:60596912-60700190,103278
38066973,38109902,chr2,CYP1B1,chr2:38066973-38109902,42929
183444635,183449064,chr4,CDKN2AIP,chr4:183444635-183449064,4429
32475051,32478250,chr16,ABCD1P3,chr16:32475051-32478250,3199
109444062,109465968,chr6,MICAL1,chr6:109444062-109465968,21906
150361422,150514178,chrX,MAMLD1,chrX:150361422-150514178,152756
48356364,48448402,chr16,SIAH1,chr16:48356364-48448402,92038
28820339,29505947,chr13,MTUS2,chr13:28820339-29505947,685608
187746094,187748199,chr4,ADAM20P3,chr4:187746094-187748199,2105
155455050,155456411,chr4,MTND4P8,chr4:155455050-155456411,1361
136670602,136670686,chr9,MIR126,chr9:136670602-136670686,84
136673143,136687457,chr9,AGPAT2,chr9:136673143-136687457,14314
39664982,39717963,chr2,TMEM178A,chr2:39664982-39717963,52981
144845625,144847344,chr4,HSPD1P5,chr4:144845625-144847344,1719
189881515,189884868,chr4,LINC01596,chr4:189881515-189884868,3353
53431258,53434370,chrX,HSD17B10,chrX:53431258-53434370,3112
145269810,145270558,chr4,RPS23P4,chr4:145269810-145270558,748
97005553,97011040,chr7,DLX6,chr7:97005553-97011040,5487
187995771,188005046,chr4,ZFP42,chr4:187995771-188005046,9275
46955362,46973674,chr16,DNAJA2,chr16:46955362-46973674,18312
74984505,75034558,chr8,CRISPLD1,chr8:74984505-75034558,50053
89347235,89352501,chr12,DUSP6,chr12:89347235-89352501,5266
27193358,27193500,chr10,RNU2-24P,chr10:27193358-27193500,142
27232255,27232316,chr10,RNU7-12P,chr10:27232255-27232316,61
155456638,155456981,chr4,MTND3P3,chr4:155456638-155456981,343
27246350,27259455,chr10,LRRC37A6P,chr10:27246350-27259455,13105
95162504,95549206,chr4,UNC5C,chr4:95162504-95549206,386702
93591573,93911265,chr7,GNGT1,chr7:93591573-93911265,319692
86630825,86631628,chr10,RPL7AP8,chr10:86630825-86631628,803
20684014,20823130,chr2,LDAH,chr2:20684014-20823130,139116
86854696,86856236,chr10,RPAP2P1,chr10:86854696-86856236,1540
53532096,53686728,chrX,HUWE1,chrX:53532096-53686728,154632
75902136,76084585,chr14,IFT43,chr14:75902136-76084585,182449
26973793,27100494,chr10,ANKRD26,chr10:26973793-27100494,126701
29600676,29600868,chr5,UBL5P1,chr5:29600676-29600868,192
52607570,52618559,chr12,KRT73,chr12:52607570-52618559,10989
136712572,136724742,chr9,DIPK1B,chr9:136712572-136724742,12170
23710203,23832513,chr7,STK31,chr7:23710203-23832513,122310
136726104,136726239,chr9,SNORA17B,chr9:136726104-136726239,135
136726747,136726879,chr9,SNORA17A,chr9:136726747-136726879,132
136738167,136743356,chr9,LCN10,chr9:136738167-136743356,5189
108251240,108308484,chr13,TNFSF13B,chr13:108251240-108308484,57244
134331874,134378341,chr11,GLB1L2,chr11:134331874-134378341,46467
68001394,68001548,chr12,RPL39P28,chr12:68001394-68001548,154
74640023,74722647,chr5,HEXB,chr5:74640023-74722647,82624
82358528,82479239,chr12,METTL25,chr12:82358528-82479239,120711
8621683,8649654,chr16,METTL22,chr16:8621683-8649654,27971
50719763,50831162,chr14,NIN,chr14:50719763-50831162,111399
96743167,96743273,chr10,RNU6-1274P,chr10:96743167-96743273,106
96750288,96750899,chr10,RPL13AP5,chr10:96750288-96750899,611
96828669,96828764,chr10,MIR607,chr10:96828669-96828764,95
96915633,96915902,chr10,HMGN2P35,chr10:96915633-96915902,269
21991099,22043934,chr22,PRAMENP,chr22:21991099-22043934,52835
96998038,97185959,chr10,SLIT1,chr10:96998038-97185959,187921
22026076,22026593,chr22,IGLVI-70,chr22:22026076-22026593,517
183099257,183320777,chr4,WWC2,chr4:183099257-183320777,221520
22030934,22031472,chr22,IGLV4-69,chr22:22030934-22031472,538
22032745,22033194,chr22,IGLVI-68,chr22:22032745-22033194,449
136744017,136748525,chr9,LCN6,chr9:136744017-136748525,4508
44719392,44736692,chr11,TSPAN18-AS1,chr11:44719392-44736692,17300
22214794,22215270,chr22,IGLV10-54,chr22:22214794-22215270,476
68684595,68686308,chr12,RPL7P42,chr12:68684595-68686308,1713
22043618,22043942,chr22,IGLV10-67,chr22:22043618-22043942,324
116639422,116658295,chr11,LINC02702,chr11:116639422-116658295,18873
22058433,22058892,chr22,IGLVIV-66-1,chr22:22058433-22058892,459
22061077,22061538,chr22,IGLVV-66,chr22:22061077-22061538,461
22070225,22070707,chr22,IGLVIV-65,chr22:22070225-22070707,482
96194375,96269824,chr12,ELK3,chr12:96194375-96269824,75449
22075366,22075666,chr22,IGLVIV-64,chr22:22075366-22075666,300
134378504,134412242,chr11,B3GAT1,chr11:134378504-134412242,33738
22079770,22080263,chr22,IGLVI-63,chr22:22079770-22080263,493
690353,691172,chr19,RPS2P52,chr19:690353-691172,819
22086561,22087110,chr22,IGLV1-62,chr22:22086561-22087110,549
22098700,22099212,chr22,IGLV8-61,chr22:22098700-22099212,512
19992052,20012668,chr2,MATN3,chr2:19992052-20012668,20616
22114844,22118005,chr22,ABHD17AP5,chr22:22114844-22118005,3161
9083112,9083398,chr19,OR1M4P,chr19:9083112-9083398,286
23270120,23296279,chr8,R3HCC1,chr8:23270120-23296279,26159
22162199,22162681,chr22,IGLV4-60,chr22:22162199-22162681,482
42795147,42798704,chr17,COA3,chr17:42795147-42798704,3557
22170983,22171556,chr22,SOCS2P2,chr22:22170983-22171556,573
22179228,22179477,chr22,IGLVIV-59,chr22:22179228-22179477,249
10416773,10469630,chr19,PDE4A,chr19:10416773-10469630,52857
22182582,22182885,chr22,IGLVV-58,chr22:22182582-22182885,303
22185941,22186619,chr22,BMP6P1,chr22:22185941-22186619,678
22195799,22196276,chr22,IGLV6-57,chr22:22195799-22196276,477
34135736,34136792,chr16,DUX4L45,chr16:34135736-34136792,1056
136746893,136746970,chr9,MIR6722,chr9:136746893-136746970,77
136759634,136766255,chr9,LCN15,chr9:136759634-136766255,6621
59885015,59885552,chr17,NDUFB8P2,chr17:59885015-59885552,537
22198560,22199011,chr22,IGLVI-56,chr22:22198560-22199011,451
22201663,22202161,chr22,IGLV11-55,chr22:22201663-22202161,498
100717526,101128641,chr12,ANO4,chr12:100717526-101128641,411115
49202791,49210574,chr17,GNGT2,chr17:49202791-49210574,7783
22219647,22220133,chr22,IGLVIV-53,chr22:22219647-22220133,486
22223187,22224566,chr22,TOP3BP1,chr22:22223187-22224566,1379
22244780,22245515,chr22,VPREB1,chr22:22244780-22245515,735
35173316,35174093,chr16,SLC25A1P4,chr16:35173316-35174093,777
11833926,12702913,chr2,MIR3681HG,chr2:11833926-12702913,868987
25096136,25099254,chr13,PABPC3,chr13:25096136-25099254,3118
33858576,33892076,chr11,LMO2,chr11:33858576-33892076,33500
35547917,35548829,chr16,AGGF1P7,chr16:35547917-35548829,912
136779939,136780218,chr9,ATP6V1G1P3,chr9:136779939-136780218,279
50519364,50843939,chr13,DLEU7,chr13:50519364-50843939,324575
136791344,136793317,chr9,TMEM141,chr9:136791344-136793317,1973
84570649,84580175,chr15,LINC00933,chr15:84570649-84580175,9526
22318727,22319226,chr22,IGLV5-52,chr22:22318727-22319226,499
80487969,80542563,chr5,FAM151B,chr5:80487969-80542563,54594
22322472,22322969,chr22,IGLV1-51,chr22:22322472-22322969,497
51056598,51105276,chr15,TNFAIP8L3,chr15:51056598-51105276,48678
22327300,22327814,chr22,IGLV1-50,chr22:22327300-22327814,514
25161679,25172288,chr13,AMER2,chr13:25161679-25172288,10609
46796603,46831180,chr16,C16orf87,chr16:46796603-46831180,34577
22339573,22341214,chr22,ASH2LP3,chr22:22339573-22341214,1641
44564427,44620358,chr11,CD82,chr11:44564427-44620358,55931
136796338,136807741,chr9,CCDC183,chr9:136796338-136807741,11403
20560448,20651130,chr2,HS1BP3,chr2:20560448-20651130,90682
22343187,22343732,chr22,IGLV9-49,chr22:22343187-22343732,545
22352940,22353433,chr22,IGLV5-48,chr22:22352940-22353433,493
22357739,22358260,chr22,IGLV1-47,chr22:22357739-22358260,521
22366210,22367770,chr22,ASH2LP2,chr22:22366210-22367770,1560
26094724,26154175,chr13,ATP8A2P3,chr13:26094724-26154175,59451
74843730,74873365,chr15,SCAMP2,chr15:74843730-74873365,29635
22369614,22370087,chr22,IGLV7-46,chr22:22369614-22370087,473
22375986,22376505,chr22,IGLV5-45,chr22:22375986-22376505,519
26117548,26118964,chr13,PRUNEP1,chr13:26117548-26118964,1416
48026167,48038030,chr17,COPZ2,chr17:48026167-48038030,11863
22380766,22381347,chr22,IGLV1-44,chr22:22380766-22381347,581
160991727,161117385,chr6,MAP3K4,chr6:160991727-161117385,125658
24913758,24919098,chr8,NEFM,chr8:24913758-24919098,5340
42756818,42802439,chr5,CCDC152,chr5:42756818-42802439,45621
22395018,22395489,chr22,IGLV7-43,chr22:22395018-22395489,471
26132115,26222314,chr13,RNF6,chr13:26132115-26222314,90199
22397032,22397524,chr22,IGLVI-42,chr22:22397032-22397524,492
22398849,22398999,chr22,IGLVVII-41-1,chr22:22398849-22398999,150
22404207,22404721,chr22,IGLV1-41,chr22:22404207-22404721,514
17094351,17094927,chr16,TCERG1P2,chr16:17094351-17094927,576
22409766,22410282,chr22,IGLV1-40,chr22:22409766-22410282,516
22420326,22421310,chr22,ASH2LP1,chr22:22420326-22421310,984
22425821,22426314,chr22,IGLVI-38,chr22:22425821-22426314,493
22427540,22428035,chr22,IGLV5-37,chr22:22427540-22428035,495
22431958,22432465,chr22,IGLV1-36,chr22:22431958-22432465,507
22450202,22450652,chr22,IGLV7-35,chr22:22450202-22450652,450
46656132,46689518,chr16,VPS35,chr16:46656132-46689518,33386
30356635,30378673,chr22,CCDC157,chr22:30356635-30378673,22038
23748664,23927123,chr2,ATAD2B,chr2:23748664-23927123,178459
136803927,136808848,chr9,CCDC183-AS1,chr9:136803927-136808848,4921
55307989,55425579,chr5,MTREX,chr5:55307989-55425579,117590
19579943,19596058,chr17,SLC47A1P1,chr17:19579943-19596058,16115
136807943,136841187,chr9,RABL6,chr9:136807943-136841187,33244
76980258,77001044,chr8,PEX2,chr8:76980258-77001044,20786
137545731,137603430,chr4,LINC02172,chr4:137545731-137603430,57699
174490175,174523154,chr4,HPGD,chr4:174490175-174523154,32979
60315834,60316215,chr17,H3P42,chr17:60315834-60316215,381
50529710,50532506,chr22,ODF3B,chr22:50529710-50532506,2796
50634777,50692253,chr17,ABCC3,chr17:50634777-50692253,57476
78666089,78719765,chr8,ZC2HC1A,chr8:78666089-78719765,53676
10391133,10420121,chr19,CDC37,chr19:10391133-10420121,28988
41909543,41915074,chr22,SHISA8,chr22:41909543-41915074,5531
124822386,124929983,chr7,POT1,chr7:124822386-124929983,107597
16783412,16825411,chr22,XKR3,chr22:16783412-16825411,41999
43569306,43570395,chr11,MIR670HG,chr11:43569306-43570395,1089
97102756,97104355,chr10,SLIT1-AS1,chr10:97102756-97104355,1599
95076749,95217482,chr12,FGD6,chr12:95076749-95217482,140733
43680680,43856617,chr11,HSD17B12,chr11:43680680-43856617,175937
33839782,33840678,chr2,SLC25A5P2,chr2:33839782-33840678,896
51319577,51809445,chr8,PXDNL,chr8:51319577-51809445,489868
62163535,62165285,chr15,C2CD4B,chr15:62163535-62165285,1750
5412557,5459056,chr10,NET1,chr10:5412557-5459056,46499
26678219,26678510,chr2,RPL37P11,chr2:26678219-26678510,291
38685543,38701556,chr22,JOSD1,chr22:38685543-38701556,16013
45388680,45612165,chr2,SRBD1,chr2:45388680-45612165,223485
33907419,33937167,chr16,ARHGAP23P1,chr16:33907419-33937167,29748
75598083,75626469,chr15,SNUPN,chr15:75598083-75626469,28386
26234213,26237129,chr13,THAP12P6,chr13:26234213-26237129,2916
136812788,136815536,chr9,NCLP1,chr9:136812788-136815536,2748
136830957,136831023,chr9,MIR4292,chr9:136830957-136831023,66
136848724,136851027,chr9,PHPT1,chr9:136848724-136851027,2303
35347385,35348297,chr16,AGGF1P9,chr16:35347385-35348297,912
25371974,26025851,chr13,ATP8A2,chr13:25371974-26025851,653877
33769421,33769679,chr16,ENPP7P13,chr16:33769421-33769679,258
11721265,11739009,chr19,ZNF823,chr19:11721265-11739009,17744
35134514,35135075,chr16,VN1R69P,chr16:35134514-35135075,561
35068211,35085060,chr16,CLUHP11,chr16:35068211-35085060,16849
83052846,83077863,chr5,TMEM167A,chr5:83052846-83077863,25017
33360274,33363478,chr16,TP53TG3B,chr16:33360274-33363478,3204
60387262,60387995,chr8,PDCL3P1,chr8:60387262-60387995,733
40679273,40682812,chr22,MCHR1,chr22:40679273-40682812,3539
11814273,11835216,chr19,ZNF440,chr19:11814273-11835216,20943
47202444,47202897,chr8,IGLV8OR8-1,chr8:47202444-47202897,453
78516340,78605267,chr8,PKIA,chr8:78516340-78605267,88927
186900540,186900838,chr4,MRPS36P2,chr4:186900540-186900838,298
190074525,190075799,chr4,DUX4L6,chr4:190074525-190075799,1274
32600299,32615639,chr16,FAM153DP,chr16:32600299-32615639,15340
43802544,43802772,chr22,HMGN2P9,chr22:43802544-43802772,228
151407551,151408835,chr4,FHIP1A-DT,chr4:151407551-151408835,1284
43812456,43817394,chr22,EFCAB6-DT,chr22:43812456-43817394,4938
136850943,136860799,chr9,MAMDC4,chr9:136850943-136860799,9856
33009175,33009620,chr16,IGHV3OR16-8,chr16:33009175-33009620,445
187532873,187672755,chr4,LINC02492,chr4:187532873-187672755,139882
81329996,81394179,chr5,ACOT12,chr5:81329996-81394179,64183
43824509,43862513,chr22,SULT4A1,chr22:43824509-43862513,38004
46842632,46844618,chr16,CKBP1,chr16:46842632-46844618,1986
43718676,43719146,chr11,RPL23AP63,chr11:43718676-43719146,470
30351873,30353518,chr8,TUBBP1,chr8:30351873-30353518,1645
19826249,19826575,chr2,CISD1P1,chr2:19826249-19826575,326
118657316,118679690,chr11,TREH,chr11:118657316-118679690,22374
10350529,10380572,chr19,TYK2,chr19:10350529-10380572,30043
79571153,79572335,chr8,RPL3P9,chr8:79571153-79572335,1182
30722771,30820542,chr2,CAPN13,chr2:30722771-30820542,97771
5498697,5499570,chr10,CALML5,chr10:5498697-5499570,873
35446898,35449411,chr16,ZNF971P,chr16:35446898-35449411,2513
5510036,5526246,chr10,CALML3-AS1,chr10:5510036-5526246,16210
33094204,33129090,chr16,HERC2P8,chr16:33094204-33129090,34886
76681239,76867281,chr8,ZFHX4,chr8:76681239-76867281,186042
5524961,5526771,chr10,CALML3,chr10:5524961-5526771,1810
89524594,89548005,chr12,POC1B-AS1,chr12:89524594-89548005,23411
183659267,183713594,chr4,TRAPPC11,chr4:183659267-183713594,54327
5631463,5631755,chr10,RN7SL445P,chr10:5631463-5631755,292
89500093,89502670,chr12,CENPCP1,chr12:89500093-89502670,2577
5638867,5666595,chr10,ASB13,chr10:5638867-5666595,27728
85318060,85342912,chr12,LINC02820,chr12:85318060-85342912,24852
32877469,32885501,chr16,SLC6A10P,chr16:32877469-32885501,8032
101568353,101686028,chr12,MYBPC1,chr12:101568353-101686028,117675
83637805,83720855,chr5,HAPLN1,chr5:83637805-83720855,83050
43879678,43892013,chr22,PNPLA5,chr22:43879678-43892013,12335
136862119,136866308,chr9,EDF1,chr9:136862119-136866308,4189
5684838,5763740,chr10,TASOR2,chr10:5684838-5763740,78902
41860155,41894050,chr2,LINC01913,chr2:41860155-41894050,33895
12901598,13240416,chr16,SHISA9,chr16:12901598-13240416,338818
53513741,53762878,chr15,WDR72,chr15:53513741-53762878,249137
27330827,27363234,chr11,CCDC34,chr11:27330827-27363234,32407
76603240,76603852,chr8,MRPL9P1,chr8:76603240-76603852,612
36281280,36388010,chr22,MYH9,chr22:36281280-36388010,106730
61057158,61501645,chr8,CLVS1,chr8:61057158-61501645,444487
136886733,136886803,chr9,MIR4479,chr9:136886733-136886803,70
76173629,76174183,chr5,RAP1BL,chr5:76173629-76174183,554
136359480,136363744,chr9,DNLZ,chr9:136359480-136363744,4264
32946953,33399509,chr2,LTBP1,chr2:32946953-33399509,452556
27133483,27135179,chr16,EEF1A1P38,chr16:27133483-27135179,1696
101890674,101916522,chr11,ANGPTL5,chr11:101890674-101916522,25848
136361903,136373681,chr9,CARD9,chr9:136361903-136373681,11778
33988406,33991551,chr16,BCAP31P1,chr16:33988406-33991551,3145
60630514,60630973,chr5,CAB39P1,chr5:60630514-60630973,459
35743268,35756515,chr16,LINC02167,chr16:35743268-35756515,13247
113733187,113773735,chr11,ZW10,chr11:113733187-113773735,40548
83471618,83582303,chr5,VCAN,chr5:83471618-83582303,110685
5765223,5842132,chr10,GDI2,chr10:5765223-5842132,76909
33193659,33196858,chr16,TP53TG3C,chr16:33193659-33196858,3199
10672628,10700590,chr8,C8orf74,chr8:10672628-10700590,27962
11767000,11784078,chr19,ZNF441,chr19:11767000-11784078,17078
11680944,11686259,chr19,ZNF833P,chr19:11680944-11686259,5315
169791221,169791702,chr4,PTGES3P3,chr4:169791221-169791702,481
11666069,11667030,chr19,HNRNPA1P10,chr19:11666069-11667030,961
181820019,181829973,chr4,TEMN3-AS1,chr4:181820019-181829973,9954
4292232,4302431,chr19,TMIGD2,chr19:4292232-4302431,10199
163471095,163473754,chr4,TKTL2,chr4:163471095-163473754,2659
19716456,19858467,chr16,IQCK,chr16:19716456-19858467,142011
65602458,65634217,chr8,ARMC1,chr8:65602458-65634217,31759
136401922,136410614,chr9,ENTR1,chr9:136401922-136410614,8692
188776657,188785511,chr4,LINC02508,chr4:188776657-188785511,8854
113751116,113751286,chr11,RPS29P19,chr11:113751116-113751286,170
190021407,190022665,chr4,DUX4L9,chr4:190021407-190022665,1258
115920248,115943181,chr11,LINC02703,chr11:115920248-115943181,22933
53807776,53808623,chrX,MRPL32P2,chrX:53807776-53808623,847
158170752,158202877,chr4,GASK1B-AS1,chr4:158170752-158202877,32125
153411472,153426481,chrX,ZFP92,chrX:153411472-153426481,15009
14621634,14622242,chr19,ITGB1P1,chr19:14621634-14622242,608
104011147,104013708,chrX,H2BW1,chrX:104011147-104013708,2561
72643237,72659407,chr11,PDE2A-AS1,chr11:72643237-72659407,16170
52811287,52818301,chrX,XAGE5,chrX:52811287-52818301,7014
101915010,102001062,chr11,CEP126,chr11:101915010-102001062,86052
14408798,14419383,chr19,DDX39A,chr19:14408798-14419383,10585
163932526,163933182,chr4,YWHAQP4,chr4:163932526-163933182,656
75935969,76059795,chr15,NRG4,chr15:75935969-76059795,123826
186286094,186500997,chr4,F11-AS1,chr4:186286094-186500997,214903
135881063,135893444,chrX,CT45A10,chrX:135881063-135893444,12381
80106647,80346270,chr6,BCKDHB,chr6:80106647-80346270,239623
153802166,153830565,chrX,PDZD4,chrX:153802166-153830565,28399
98995659,99062809,chr4,METAP1,chr4:98995659-99062809,67150
5776071,5776858,chr10,NRBF2P5,chr10:5776071-5776858,787
130938963,131110176,chr7,LINC-PINT,chr7:130938963-131110176,171213
5861805,5862594,chr10,RPL12P28,chr10:5861805-5862594,789
109422190,109429167,chr11,C11orf87,chr11:109422190-109429167,6977
19856691,19886167,chr16,GPRC5B,chr16:19856691-19886167,29476
5594984,5632566,chr10,LASTR,chr10:5594984-5632566,37582
60088261,60098467,chr11,MS4A2,chr11:60088261-60098467,10206
35540831,35553999,chr22,RASD2,chr22:35540831-35553999,13168
91779261,92623230,chrX,PCDH11X,chrX:91779261-92623230,843969
93496612,93529092,chr10,CEP55,chr10:93496612-93529092,32480
54457935,54460892,chr8,SOX17,chr8:54457935-54460892,2957
136410641,136423761,chr9,PMPCA,chr9:136410641-136423761,13120
149243299,149257551,chr6,TAB2-AS1,chr6:149243299-149257551,14252
93510548,93510680,chr10,RNA5SP323,chr10:93510548-93510680,132
54522799,54523297,chr8,SEC11B,chr8:54522799-54523297,498
93566665,93604480,chr10,FFAR4,chr10:93566665-93604480,37815
23288689,23433763,chr13,SACS,chr13:23288689-23433763,145074
35606764,35637951,chr22,MB,chr22:35606764-35637951,31187
107743949,107761667,chr7,CBLL1,chr7:107743949-107761667,17718
12178697,12182719,chr8,ALG1L11P,chr8:12178697-12182719,4022
60729304,60744212,chr11,MS4A18,chr11:60729304-60744212,14908
56593699,56595611,chr17,NOG,chr17:56593699-56595611,1912
130144315,130365425,chr6,SAMD3,chr6:130144315-130365425,221110
70669339,70790371,chr8,XKR9,chr8:70669339-70790371,121032
60756867,60776733,chr11,MS4A15,chr11:60756867-60776733,19866
35040164,35084313,chr16,CCNYL3,chr16:35040164-35084313,44149
158182825,158183393,chr4,NUDT19P5,chr4:158182825-158183393,568
50055968,50090481,chr17,ITGA3,chr17:50055968-50090481,34513
33140850,33143797,chr16,ABHD17AP9,chr16:33140850-33143797,2947
190064502,190067864,chr4,DBET,chr4:190064502-190067864,3362
93612537,93666010,chr10,PDE6C,chr10:93612537-93666010,53473
149154279,149278123,chr4,LINC02355,chr4:149154279-149278123,123844
29663279,29698699,chr16,QPRT,chr16:29663279-29698699,35420
74445136,74455005,chr4,AREG,chr4:74445136-74455005,9869
15664106,15669826,chr19,CYP4F10P,chr19:15664106-15669826,5720
47445178,47483222,chrX,ZNF41,chrX:47445178-47483222,38044
14891737,14897845,chr19,OR7A1P,chr19:14891737-14897845,6108
93667883,93702592,chr10,FRA10AC1,chr10:93667883-93702592,34709
139534240,139534549,chr7,ERHP1,chr7:139534240-139534549,309
14380501,14408725,chr19,ADGRE5,chr19:14380501-14408725,28224
35090501,35104834,chr16,VPS35P1,chr16:35090501-35104834,14333
135926760,135977359,chr7,MTPN,chr7:135926760-135977359,50599
74321293,74341236,chr5,LINC01333,chr5:74321293-74341236,19943
95549129,95552457,chr4,UNC5C-AS1,chr4:95549129-95552457,3328
2134134,2134209,chr11,MIR483,chr11:2134134-2134209,75
2173063,2173138,chr11,MIR4686,chr11:2173063-2173138,75
46579213,46638886,chr8,ASNSP1,chr8:46579213-46638886,59673
37244743,37449463,chr4,NWD2,chr4:37244743-37449463,204720
1256605,1256670,chr11,MIR6744,chr11:1256605-1256670,65
2321718,2321827,chr11,RNU6-878P,chr11:2321718-2321827,109
153056409,153060467,chrX,PNMA3,chrX:153056409-153060467,4058
11656651,11656722,chr11,MIR4299,chr11:11656651-11656722,71
11783135,11783222,chr11,MIR8070,chr11:11783135-11783222,87
13353208,13353523,chr11,RN7SKP151,chr11:13353208-13353523,315
14134986,14135100,chr11,RNA5SP332,chr11:14134986-14135100,114
13907484,13907590,chr11,RNA5SP331,chr11:13907484-13907590,106
35648446,35668404,chr22,APOL6,chr22:35648446-35668404,19958
7234766,7234837,chr11,MIR302E,chr11:7234766-7234837,71
14478892,14478953,chr11,RNU7-49P,chr11:14478892-14478953,61
18926863,18937043,chr16,SMG1-DT,chr16:18926863-18937043,10180
16576851,16577135,chr11,RN7SL188P,chr11:16576851-16577135,284
15969533,15969621,chr11,MIR6073,chr11:15969533-15969621,88
21000881,21000997,chr11,RNA5SP336,chr11:21000881-21000997,116
21383801,21383909,chr11,RNA5SP337,chr11:21383801-21383909,108
19401872,19401981,chr11,RNA5SP335,chr11:19401872-19401981,109
19575310,19575372,chr11,MIR4486,chr11:19575310-19575372,62
46497725,46545457,chrX,ZNF674,chrX:46497725-46545457,47732
19760004,19760083,chr11,MIR4694,chr11:19760004-19760083,79
23849778,23849882,chr11,RNU6-783P,chr11:23849778-23849882,104
27514970,27515047,chr11,MIR8087,chr11:27514970-27515047,77
27521605,27521726,chr11,RNA5SP339,chr11:27521605-27521726,121
28056815,28056910,chr11,MIR610,chr11:28056815-28056910,95
82472993,82513950,chr15,GOLGA2P10,chr15:82472993-82513950,40957
16842253,16842587,chr11,RN7SKP90,chr11:16842253-16842587,334
130206344,130216844,chr7,SSMEM1,chr7:130206344-130216844,10500
155457180,155457960,chr4,MTCO3P9,chr4:155457180-155457960,780
183483490,183484185,chr4,VTI1BP2,chr4:183483490-183484185,695
22688351,22688435,chr11,RNA5SP338,chr11:22688351-22688435,84
184503271,184537626,chr4,LINC02427,chr4:184503271-184537626,34355
35703803,35704176,chr22,MRPS16P3,chr22:35703803-35704176,373
29721399,29721684,chr11,RN7SL240P,chr11:29721399-29721684,285
35717872,35729483,chr22,APOL5,chr22:35717872-35729483,11611
185396021,185400628,chr4,ANKRD37,chr4:185396021-185400628,4607
23419105,23419190,chr11,MIR8054,chr11:23419105-23419190,85
41730065,41870425,chr5,OXCT1,chr5:41730065-41870425,140360
39261107,39261213,chr11,RNU6-99P,chr11:39261107-39261213,106
47461123,47701523,chr16,PHKB,chr16:47461123-47701523,240400
80967810,81112068,chr8,PAG1,chr8:80967810-81112068,144258
36010098,36010204,chr11,MIR3973,chr11:36010098-36010204,106
43435132,43435397,chr11,RN7SKP287,chr11:43435132-43435397,265
41122907,41123012,chr11,RNU6-365P,chr11:41122907-41123012,105
28261194,28261519,chr11,RN7SKP158,chr11:28261194-28261519,325
28477481,28477548,chr11,MIR8068,chr11:28477481-28477548,67
43559656,43559753,chr11,MIR670,chr11:43559656-43559753,97
43581394,43581483,chr11,MIR129-2,chr11:43581394-43581483,89
46451805,46451889,chr11,MIR3160-1,chr11:46451805-46451889,84
35738736,36028824,chr22,RBFOX2,chr22:35738736-36028824,290088
46451807,46451887,chr11,MIR3160-2,chr11:46451807-46451887,80
47179611,47179737,chr11,MIR6745,chr11:47179611-47179737,126
46753125,46753192,chr11,MIR5582,chr11:46753125-46753192,67
46762389,46762499,chr11,SNORD67,chr11:46762389-46762499,110
48096782,48096858,chr11,MIR3161,chr11:48096782-48096858,76
93757840,93806272,chr10,LGI1,chr10:93757840-93806272,48432
59595077,59595158,chr11,MIR3162,chr11:59595077-59595158,81
59706057,59706383,chr11,RN7SKP192,chr11:59706057-59706383,326
65147584,65147778,chr11,RNU2-23P,chr11:65147584-65147778,194
65129916,65129978,chr11,MIR6751,chr11:65129916-65129978,62
112819147,112939875,chr7,BMT2,chr7:112819147-112939875,120728
67895631,67895737,chr11,RNU6-46P,chr11:67895631-67895737,106
68032864,68032922,chr11,MIR7113,chr11:68032864-68032922,58
55484616,55489848,chrX,USP51,chrX:55484616-55489848,5232
68033897,68033981,chr11,MIR4691,chr11:68033897-68033981,84
66919762,66919823,chr11,RNU7-23P,chr11:66919762-66919823,61
67045643,67045708,chr11,MIR6860,chr11:67045643-67045708,65
66934434,66934506,chr11,MIR3163,chr11:66934434-66934506,72
74685224,74685505,chr11,RN7SKP297,chr11:74685224-74685505,281
74720268,74720337,chr11,MIR4696,chr11:74720268-74720337,69
68044794,68044957,chr11,MIR6753,chr11:68044794-68044957,163
74968189,74968292,chr11,RNU6-216P,chr11:74968189-74968292,103
75934936,75935039,chr11,RNA5SP344,chr11:75934936-75935039,103
72872025,72943837,chrX,DMRTC1,chrX:72872025-72943837,71812
60750575,60796103,chr4,LINC02496,chr4:60750575-60796103,45528
80527960,80528066,chr11,RNU6-544P,chr11:80527960-80528066,106
73651289,73651602,chr8,VENTXP6,chr8:73651289-73651602,313
78579255,78579356,chr11,RNU6-311P,chr11:78579255-78579356,101
82298553,82334609,chr15,ADAMTS7P1,chr15:82298553-82334609,36056
79402022,79402109,chr11,MIR708,chr11:79402022-79402109,87
72869544,72869650,chr11,RNU6-672P,chr11:72869544-72869650,106
77566934,77566994,chr11,RNU7-59P,chr11:77566934-77566994,60
79422169,79422226,chr11,MIR5579,chr11:79422169-79422226,57
99022311,99023131,chr4,ABT1P1,chr4:99022311-99023131,820
81890741,81890836,chr11,MIR4300,chr11:81890741-81890836,95
87606783,87606885,chr11,RNU6-1135P,chr11:87606783-87606885,102
72783530,72783592,chr11,MIR4692,chr11:72783530-72783592,62
88612805,88612911,chr11,RNU6-16P,chr11:88612805-88612911,106
130823205,130823511,chr7,H4P1,chr7:130823205-130823511,306
148703526,148703832,chr4,ATP5MGP4,chr4:148703526-148703832,306
72615063,72615130,chr11,MIR139,chr11:72615063-72615130,67
72621766,72621827,chr11,RNU7-105P,chr11:72621766-72621827,61
93556913,93557206,chr11,RN7SL223P,chr11:93556913-93557206,293
74845910,74846209,chr11,RN7SL239P,chr11:74845910-74846209,299
86153227,86153334,chr11,RNU6-560P,chr11:86153227-86153334,107
94466495,94466580,chr11,MIR548L,chr11:94466495-94466580,85
140292752,140293339,chr7,PPP1R2P6,chr7:140292752-140293339,587
97657464,97657582,chr11,RNA5SP347,chr11:97657464-97657582,118
95644952,95645293,chr4,RPL30P6,chr4:95644952-95645293,341
101519820,101519905,chr11,MIR3920,chr11:101519820-101519905,85
100641975,100642273,chr11,RN7SL222P,chr11:100641975-100642273,298
93731502,93731574,chr11,SNORD6,chr11:93731502-93731574,72
142352819,142353358,chr7,TRBV7-2,chr7:142352819-142353358,539
93730513,93730646,chr11,SNORA25,chr11:93730513-93730646,133
99120176,99120490,chr11,RN7SKP53,chr11:99120176-99120490,314
93730979,93731099,chr11,SNORA32,chr11:93730979-93731099,120
145098288,145129524,chr4,ABCE1,chr4:145098288-145129524,31236
93732004,93732133,chr11,SNORA1,chr11:93732004-93732133,129
63908966,63910453,chr7,NMD3P1,chr7:63908966-63910453,1487
93732361,93732499,chr11,SNORA8,chr11:93732361-93732499,138
93733228,93733300,chr11,SNORD5,chr11:93733228-93733300,72
93733466,93733597,chr11,SNORA18,chr11:93733466-93733597,131
93733674,93733764,chr11,MIR1304,chr11:93733674-93733764,90
101362875,101559024,chr7,COL26A1,chr7:101362875-101559024,196149
93735111,93735236,chr11,SNORA40,chr11:93735111-93735236,125
102313722,102313829,chr11,RNU6-952P,chr11:102313722-102313829,107
132369317,132489968,chrX,MBNL3,chrX:132369317-132489968,120651
102057854,102057960,chr11,RNA5SP535,chr11:102057854-102057960,106
76347904,76905444,chr15,SCAPER,chr15:76347904-76905444,557540
100839630,100839946,chr11,RN7SKP115,chr11:100839630-100839946,316
103849906,103849980,chr11,MIR4693,chr11:103849906-103849980,74
90555774,90555857,chr11,MIR4490,chr11:90555774-90555857,83
61500556,61714640,chr8,ASPH,chr8:61500556-61714640,214084
90869121,90869202,chr11,MIR1261,chr11:90869121-90869202,81
109120878,109120986,chr11,RNA5SP349,chr11:109120878-109120986,108
105824634,105824770,chr11,RNU4-55P,chr11:105824634-105824770,136
113859346,113859449,chr11,RNU6-1107P,chr11:113859346-113859449,103
112352556,112352662,chr11,RNU6-44P,chr11:112352556-112352662,106
136428619,136439845,chr9,INPP5E,chr9:136428619-136439845,11226
105974826,105974931,chr11,RNU6-277P,chr11:105974826-105974931,105
112977353,112977420,chr11,RNU7-187P,chr11:112977353-112977420,67
118702342,118702447,chr11,RNU6-376P,chr11:118702342-118702447,105
122579205,122579307,chr11,RNU6-592P,chr11:122579205-122579307,102
122004355,122004451,chr11,RNU6-256P,chr11:122004355-122004451,96
123381440,123381512,chr11,MIR4493,chr11:123381440-123381512,72
122927034,122927173,chr11,RNU4-23P,chr11:122927034-122927173,139
125277552,125277657,chr11,RNU6-321P,chr11:125277552-125277657,105
130666735,130666803,chr11,MIR8052,chr11:130666735-130666803,68
136483495,136486067,chr9,C9orf163,chr9:136483495-136486067,2572
131004128,131004429,chr11,RN7SL167P,chr11:131004128-131004429,301
125574719,125574818,chr11,RNU6-1156P,chr11:125574719-125574818,99
124636459,124636592,chr11,RNA5SP352,chr11:124636459-124636592,133
125649746,125649887,chr11,RNU2-35P,chr11:125649746-125649887,141
122099757,122099844,chr11,MIR125B1,chr11:122099757-122099844,87
122146522,122146593,chr11,MIRLET7A2,chr11:122146522-122146593,71
122152229,122152308,chr11,MIR100,chr11:122152229-122152308,79
122449210,122449331,chr11,RNU4ATAC10P,chr11:122449210-122449331,121
122451474,122451599,chr11,RNU4ATAC5P,chr11:122451474-122451599,125
133898504,133898581,chr11,MIR4697,chr11:133898504-133898581,77
105447796,105552433,chr9,FSD1L,chr9:105447796-105552433,104637
130310180,130310476,chr11,RN7SL778P,chr11:130310180-130310476,296
123058077,123058161,chr11,SNORD14E,chr11:123058077-123058161,84
123058909,123058995,chr11,SNORD14D,chr11:123058909-123058995,86
123059335,123059422,chr11,SNORD14C,chr11:123059335-123059422,87
127406028,127406332,chr11,RN7SKP121,chr11:127406028-127406332,304
128522390,128522449,chr11,MIR6090,chr11:128522390-128522449,59
113450023,113450088,chr11,MIR4301,chr11:113450023-113450088,65
119656311,119656416,chr11,RNU6-1123P,chr11:119656311-119656416,105
127407851,127408148,chr11,RN7SKP279,chr11:127407851-127408148,297
75335092,75335186,chr11,MIR326,chr11:75335092-75335186,94
11648364,11652877,chr19,ZNF887P,chr19:11648364-11652877,4513
75399515,75422280,chr11,RPS3,chr11:75399515-75422280,22765
15611657,15612122,chr19,RPL23AP2,chr19:15611657-15612122,465
31173056,31233858,chr2,CAPN14,chr2:31173056-31233858,60802
11797667,11809622,chr19,ZNF491,chr19:11797667-11809622,11955
163414000,163578592,chr6,QKI,chr6:163414000-163578592,164592
14789260,14835376,chr19,OR7C1,chr19:14789260-14835376,46116
67533290,67589612,chr14,PLEKHH1,chr14:67533290-67589612,56322
40624962,40648654,chr17,SMARCE1,chr17:40624962-40648654,23692
46144937,46145688,chr7,ZNF619P1,chr7:46144937-46145688,751
32531633,32604079,chr5,SUB1,chr5:32531633-32604079,72446
15107401,15114985,chr19,SYDE1,chr19:15107401-15114985,7584
149239651,149255606,chr7,ZNF212,chr7:149239651-149255606,15955
46256860,46257177,chr2,RPL36AP14,chr2:46256860-46257177,317
105520128,105526359,chr9,RALGAPA1P1,chr9:105520128-105526359,6231
142598016,142598469,chr7,TRBV16,chr7:142598016-142598469,453
28751640,28802940,chr2,PPP1CB,chr2:28751640-28802940,51300
158590629,158591120,chr7,LINC01022,chr7:158590629-158591120,491
80096600,80097215,chr7,RPL10P11,chr7:80096600-80097215,615
105662457,105663124,chr9,TAL2,chr9:105662457-105663124,667
106774955,106838480,chr7,LINC02577,chr7:106774955-106838480,63525
87966441,87974753,chr9,CDK20,chr9:87966441-87974753,8312
93881293,93881938,chr10,RAB11AP1,chr10:93881293-93881938,645
15010726,15023276,chr19,CCDC105,chr19:15010726-15023276,12550
14723171,14724055,chr10,RPSAP7,chr10:14723171-14724055,884
14819245,14838575,chr10,CDNF,chr10:14819245-14838575,19330
110894639,110899172,chr13,ANKRD10-IT1,chr13:110894639-110899172,4533
142656701,142657213,chr7,TRBV24-1,chr7:142656701-142657213,512
107765467,107803225,chr7,SLC26A3,chr7:107765467-107803225,37758
110936759,110939784,chr13,PARP1P1,chr13:110936759-110939784,3025
14838306,14871741,chr10,HSPA14,chr10:14838306-14871741,33435
14732392,14778560,chr19,ADGRE2,chr19:14732392-14778560,46168
93674013,93712274,chrX,FAM133A,chrX:93674013-93712274,38261
110965704,110990579,chr13,LINC00431,chr13:110965704-110990579,24875
139530739,139563459,chrX,F9,chrX:139530739-139563459,32720
111095838,111103097,chr13,LINC00368,chr13:111095838-111103097,7259
111113812,111115678,chr13,ARHGEF7-AS2,chr13:111113812-111115678,1866
37826660,37862937,chr4,PGM2,chr4:37826660-37862937,36277
67581955,67600286,chr14,PIGH,chr14:67581955-67600286,18331
40746481,40767452,chr2,LINC01794,chr2:40746481-40767452,20971
111114559,111305737,chr13,ARHGEF7,chr13:111114559-111305737,191178
35897270,35898404,chr22,NDUFA9P1,chr22:35897270-35898404,1134
47403067,47663146,chr2,MSH2,chr2:47403067-47663146,260079
36226209,36239954,chr22,APOL2,chr22:36226209-36239954,13745
129834698,129881828,chr9,USP20,chr9:129834698-129881828,47130
14877688,14878686,chr10,SUV39H2-DT,chr10:14877688-14878686,998
139581770,139708227,chrX,MCF2,chrX:139581770-139708227,126457
102918294,103090222,chr10,CNNM2,chr10:102918294-103090222,171928
80650000,80650086,chr5,MTRNR2L2,chr5:80650000-80650086,86
142391891,142392412,chr7,TRBV9,chr7:142391891-142392412,521
20305565,20347972,chr5,CDH18-AS1,chr5:20305565-20347972,42407
32726615,32729537,chr16,ABHD17AP7,chr16:32726615-32729537,2922
56101573,56106476,chr7,CHCHD2,chr7:56101573-56106476,4903
81892490,81892721,chr5,SEM1P1,chr5:81892490-81892721,231
35405747,35407349,chr16,FRG2IP,chr16:35405747-35407349,1602
35904288,35938779,chr5,CAPSL,chr5:35904288-35938779,34491
46702282,46790407,chr16,MYLK3,chr16:46702282-46790407,88125
75400391,75400538,chr11,SNORD15A,chr11:75400391-75400538,147
75404421,75404566,chr11,SNORD15B,chr11:75404421-75404566,145
66423405,66423893,chr7,SKP1P1,chr7:66423405-66423893,488
67619920,67651708,chr14,ARG2,chr14:67619920-67651708,31788
127591409,127602144,chr7,FSCN3,chr7:127591409-127602144,10735
75434640,75525941,chr11,GDPD5,chr11:75434640-75525941,91301
190081118,190082386,chr4,DUX4L4,chr4:190081118-190082386,1268
103125017,103125416,chr10,RPS15AP29,chr10:103125017-103125416,399
155208636,155217078,chr4,NPY2R,chr4:155208636-155217078,8442
103175554,103176094,chr10,MARCKSL1P1,chr10:103175554-103176094,540
103215709,103216800,chr10,ST13P13,chr10:103215709-103216800,1091
103245887,103248016,chr10,RPEL1,chr10:103245887-103248016,2129
103277138,103290346,chr10,INA,chr10:103277138-103290346,13208
143782667,143784284,chr7,PAICSP6,chr7:143782667-143784284,1617
120895494,120897083,chr4,SETP12,chr4:120895494-120897083,1589
142358639,142358917,chr7,TRBV8-1,chr7:142358639-142358917,278
142618849,142619532,chr7,TRBV19,chr7:142618849-142619532,683
36253071,36267530,chr22,APOL1,chr22:36253071-36267530,14459
130164713,130207770,chr7,TMEM209,chr7:130164713-130207770,43057
103302796,103351144,chr10,PCGF6,chr10:103302796-103351144,48348
43666766,43667232,chr5,RPL29P12,chr5:43666766-43667232,466
67647085,67674820,chr14,VTI1B,chr14:67647085-67674820,27735
65625004,65666233,chr5,TRAPPC13,chr5:65625004-65666233,41229
39951375,39951708,chr15,H3P38,chr15:39951375-39951708,333
164197007,164197711,chr4,ANP32C,chr4:164197007-164197711,704
148955628,148964684,chr6,UST-AS1,chr6:148955628-148964684,9056
189472965,189475192,chr4,HSP90AA4P,chr4:189472965-189475192,2227
78507564,78537372,chr15,HYKK,chr15:78507564-78537372,29808
116635618,116668794,chr6,ZUP1,chr6:116635618-116668794,33176
51017544,51035784,chr16,LINC02127,chr16:51017544-51035784,18240
128155389,128156204,chr4,FOSL1P1,chr4:128155389-128156204,815
186328716,186329601,chr4,SLC25A5P6,chr4:186328716-186329601,885
35802869,35803280,chr16,HMGN2P41,chr16:35802869-35803280,411
34978744,34979844,chr16,LINC02184,chr16:34978744-34979844,1100
35232412,35235984,chr16,FGFR3P5,chr16:35232412-35235984,3572
75586122,75586461,chr6,H3P27,chr6:75586122-75586461,339
33949976,33950420,chr16,IGHV3OR16-16,chr16:33949976-33950420,444
169369998,169388385,chr6,LINC02519,chr6:169369998-169388385,18387
189940870,189963202,chr4,FRG1,chr4:189940870-189963202,22332
67652300,67652614,chr14,COX7A2P1,chr14:67652300-67652614,314
67657105,67657211,chr14,RNA5SP386,chr14:67657105-67657211,106
75921114,76072678,chr6,IMPG1,chr6:75921114-76072678,151564
103312436,103312568,chr10,RNU11-3P,chr10:103312436-103312568,132
13458326,13458698,chr16,TMF1P1,chr16:13458326-13458698,372
103389041,103396492,chr10,ATP5MK,chr10:103389041-103396492,7451
35636687,35645180,chr16,KIF18BP1,chr16:35636687-35645180,8493
40765161,40807478,chr15,DNAJC17,chr15:40765161-40807478,42317
67676800,67695793,chr14,RDH11,chr14:67676800-67695793,18993
35552909,35554001,chr16,C2orf69P1,chr16:35552909-35554001,1092
25066937,25088618,chr16,LINC02175,chr16:25066937-25088618,21681
158623188,158623449,chr7,THAP5P1,chr7:158623188-158623449,261
138122202,138124595,chr7,RCC2P3,chr7:138122202-138124595,2393
184988997,185005186,chr4,LINC02437,chr4:184988997-185005186,16189
141708353,141731271,chr7,WEE2,chr7:141708353-141731271,22918
114334156,114394405,chr9,AKNA,chr9:114334156-114394405,60249
190041342,190043414,chr4,AGGF1P1,chr4:190041342-190043414,2072
92182477,92184052,chr4,PMPCAP1,chr4:92182477-92184052,1575
188159705,188161157,chr4,LINC02434,chr4:188159705-188161157,1452
34158585,34160036,chr16,LINC00273,chr16:34158585-34160036,1451
48244300,48363122,chr16,LONP2,chr16:48244300-48363122,118822
153887097,154894285,chr7,DPP6,chr7:153887097-154894285,1007188
165361194,165498547,chr4,CPE,chr4:165361194-165498547,137353
103394253,103394401,chr10,MIR1307,chr10:103394253-103394401,148
63615827,63616361,chr6,RPL9P18,chr6:63615827-63616361,534
138402585,138403560,chr6,MARCKSL1P2,chr6:138402585-138403560,975
103087185,103277605,chr10,NT5C2,chr10:103087185-103277605,190420
159383422,159401147,chr6,LINC02529,chr6:159383422-159401147,17725
165070608,165208549,chr4,TMEM192,chr4:165070608-165208549,137941
107229759,107230152,chr6,RPS24P12,chr6:107229759-107230152,393
116137058,116137572,chr6,NIP7P3,chr6:116137058-116137572,514
71343427,71420745,chr6,LINC00472,chr6:71343427-71420745,77318
67701886,67734451,chr14,RDH12,chr14:67701886-67734451,32565
66572057,66572546,chr5,PPIAP78,chr5:66572057-66572546,489
40066651,40067200,chr5,KRT18P56,chr5:40066651-40067200,549
89361579,89398487,chr15,MIR9-3HG,chr15:89361579-89398487,36908
26739753,26741183,chr5,CCNB3P1,chr5:26739753-26741183,1430
190057902,190063005,chr4,CLUHP4,chr4:190057902-190063005,5103
69189574,69210357,chr5,CENPH,chr5:69189574-69210357,20783
56530606,56603507,chr4,THEGL,chr4:56530606-56603507,72901
93893973,93956062,chr10,SLC35G1,chr10:93893973-93956062,62089
108123457,108159392,chr6,OSTM1-AS1,chr6:108123457-108159392,35935
36286847,36286907,chr22,MIR6819,chr22:36286847-36286907,60
67705954,67706252,chr14,RN7SL369P,chr14:67705954-67706252,298
152987362,153002709,chr6,MTRF1L,chr6:152987362-153002709,15347
67714545,67715204,chr14,RPL21P9,chr14:67714545-67715204,659
36421273,36421644,chr22,RPS15AP38,chr22:36421273-36421644,371
30522799,30546741,chr22,SEC14L6,chr22:30522799-30546741,23942
67751228,67751544,chr14,RN7SL213P,chr14:67751228-67751544,316
64430909,64433215,chr4,DPP3P1,chr4:64430909-64433215,2306
34939324,34940332,chr14,IGBP1P1,chr14:34939324-34940332,1008
75717838,75732958,chr11,MOGAT2,chr11:75717838-75732958,15120
88709298,88730103,chr4,FAM13A-AS1,chr4:88709298-88730103,20805
93958191,93961540,chr10,PIPSL,chr10:93958191-93961540,3349
36371165,36372383,chr14,DPPA3P2,chr14:36371165-36372383,1218
94081950,94108814,chr10,PLCE1-AS2,chr10:94081950-94108814,26864
36405214,36405274,chr14,RNU7-93P,chr14:36405214-36405274,60
74917822,74918138,chr4,HSPE1P23,chr4:74917822-74918138,316
36473207,36521149,chr14,SFTA3,chr14:36473207-36521149,47942
98976800,98977117,chr4,NDUFS5P4,chr4:98976800-98977117,317
136034553,136034886,chr6,COX5BP2,chr6:136034553-136034886,333
55024256,55034570,chr5,GZMK,chr5:55024256-55034570,10314
85546539,85742029,chr9,AGTPBP1,chr9:85546539-85742029,195490
132594398,132595436,chr6,TAAR4P,chr6:132594398-132595436,1038
147567606,147594589,chr4,LINC02507,chr4:147567606-147594589,26983
89080751,89085160,chr6,PNRC1,chr6:89080751-89085160,4409
75742129,75742426,chr11,RN7SL786P,chr11:75742129-75742426,297
75758455,75768647,chr11,DGAT2-DT,chr11:75758455-75768647,10192
69875271,69920867,chr5,GUSBP13,chr5:69875271-69920867,45596
94137748,94139500,chr10,HDAC1P1,chr10:94137748-94139500,1752
24935098,24946695,chr22,TMEM211,chr22:24935098-24946695,11597
94155639,94155745,chr10,RNU6-657P,chr10:94155639-94155745,106
94278681,94287478,chr10,PLCE1-AS1,chr10:94278681-94287478,8797
129771596,129975329,chr4,LINC02465,chr4:129771596-129975329,203733
75759512,75801535,chr11,DGAT2,chr11:75759512-75801535,42023
139240061,139291998,chr6,TXLNB,chr6:139240061-139291998,51937
36519278,36523016,chr14,NKX2-1-AS1,chr14:36519278-36523016,3738
86282460,86296463,chr5,NBPF22P,chr5:86282460-86296463,14003
46469341,46569097,chr16,ANKRD26P1,chr16:46469341-46569097,99756
24952716,25197448,chr22,KIAA1671,chr22:24952716-25197448,244732
36533506,36534538,chr14,PHKBP2,chr14:36533506-36534538,1032
94333226,94362959,chr10,NOC3L,chr10:94333226-94362959,29733
36577543,36578005,chr14,RPL29P3,chr14:36577543-36578005,462
36580004,36582614,chr14,NKX2-8,chr14:36580004-36582614,2610
87048858,87138397,chr5,MIR4280HG,chr5:87048858-87138397,89539
36593839,36594147,chr14,RN7SKP257,chr14:36593839-36594147,308
78777209,78986087,chr5,ARSB,chr5:78777209-78986087,208878
36657568,36679362,chr14,PAX9,chr14:36657568-36679362,21794
134428239,134520585,chr6,CT69,chr6:134428239-134520585,92346
14477760,14496149,chr19,GIPC1,chr19:14477760-14496149,18389
20667144,20679243,chr2,GDF7,chr2:20667144-20679243,12099
67189393,67228550,chr14,FAM71D,chr14:67189393-67228550,39157
47724568,47908431,chr16,LINC02133,chr16:47724568-47908431,183863
25102433,25112692,chr22,KIAA1671-AS1,chr22:25102433-25112692,10259
35245916,35247534,chr16,FRG2JP,chr16:35245916-35247534,1618
31334321,31414742,chr2,XDH,chr2:31334321-31414742,80421
25199858,25207359,chr22,CRYBB3,chr22:25199858-25207359,7501
32995048,32995505,chr16,IGHV3OR16-10,chr16:32995048-32995505,457
146027646,146437601,chr6,GRM1,chr6:146027646-146437601,409955
139726346,139945276,chrX,ATP11C,chrX:139726346-139945276,218930
35574834,35575494,chr16,C1QL1P1,chr16:35574834-35575494,660
94402541,94536332,chr10,TBC1D12,chr10:94402541-94536332,133791
35352482,35353022,chr16,C2orf69P4,chr16:35352482-35353022,540
175790307,175812189,chr4,GPM6A-DT,chr4:175790307-175812189,21882
47150132,47150566,chr16,RPL23AP72,chr16:47150132-47150566,434
65517766,65563168,chr5,CENPK,chr5:65517766-65563168,45402
147609552,147617245,chr4,TMEM184C-DT,chr4:147609552-147617245,7693
75562056,75572783,chr11,SERPINH1,chr11:75562056-75572783,10727
11903923,11904137,chr16,COX6CP1,chr16:11903923-11904137,214
131857343,131857913,chr4,RPL7AP28,chr4:131857343-131857913,570
350157,350252,chr4,MIR571,chr4:350157-350252,95
25212564,25231870,chr22,CRYBB2,chr22:25212564-25231870,19306
2250077,2250156,chr4,MIR4800,chr4:2250077-2250156,79
2316197,2316506,chr4,RN7SL589P,chr4:2316197-2316506,309
15037854,15056079,chr16,NTAN1,chr16:15037854-15056079,18225
4920770,4921064,chr4,RN7SKP113,chr4:4920770-4921064,294
5923275,5923328,chr4,MIR378D1,chr4:5923275-5923328,53
7112088,7112399,chr4,RN7SKP36,chr4:7112088-7112399,311
7310450,7310524,chr4,MIR4798,chr4:7310450-7310524,74
6997012,6997328,chr4,RN7SKP292,chr4:6997012-6997328,316
9556168,9556316,chr4,MIR548I2,chr4:9556168-9556316,148
8393015,8393124,chr4,RNA5SP152,chr4:8393015-8393124,109
10078611,10078692,chr4,MIR3138,chr4:10078611-10078692,81
10115756,10115884,chr4,RNA5SP155,chr4:10115756-10115884,128
9792751,9792861,chr4,RNA5SP154,chr4:9792751-9792861,110
11414051,11414160,chr4,RNA5SP156,chr4:11414051-11414160,109
12312588,12312690,chr4,RNU6-578P,chr4:12312588-12312690,102
13627865,13627957,chr4,MIR5091,chr4:13627865-13627957,92
14690710,14690832,chr4,SNORA63,chr4:14690710-14690832,122
15093767,15094094,chr4,RN7SKP170,chr4:15093767-15094094,327
11368827,11368921,chr4,MIR572,chr4:11368827-11368921,94
17320746,17320882,chr4,SNORA75B,chr4:17320746-17320882,136
24520192,24520290,chr4,MIR573,chr4:24520192-24520290,98
24563193,24563461,chr4,RN7SL16P,chr4:24563193-24563461,268
22118983,22119089,chr4,RNU6-420P,chr4:22118983-22119089,106
20528275,20528384,chr4,MIR218-1,chr4:20528275-20528384,109
21464700,21464758,chr4,MIR7978,chr4:21464700-21464758,58
19181814,19181856,chr4,RNA5SP157,chr4:19181814-19181856,42
94501434,94613905,chr10,HELLS,chr10:94501434-94613905,112471
28711198,28711476,chr4,RN7SL101P,chr4:28711198-28711476,278
28819582,28819668,chr4,MIR4275,chr4:28819582-28819668,86
25598564,25598625,chr4,RNU7-126P,chr4:25598564-25598625,61
106865278,106908980,chr7,PIK3CG,chr7:106865278-106908980,43702
36426366,36426428,chr4,MIR1255B1,chr4:36426366-36426428,62
38758791,38758892,chr4,RNA5SP158,chr4:38758791-38758892,101
35495898,35496003,chr4,RNU6-573P,chr4:35495898-35496003,105
38868032,38868127,chr4,MIR574,chr4:38868032-38868127,95
39519695,39522683,chr22,ATF4,chr22:39519695-39522683,2988
39761000,39761298,chr4,RN7SL558P,chr4:39761000-39761298,298
40077884,40077982,chr4,RNU6-1112P,chr4:40077884-40077982,98
24542952,24545946,chr9,IZUMO3,chr9:24542952-24545946,2994
40502040,40502119,chr4,MIR4802,chr4:40502040-40502119,79
40377452,40377513,chr4,RNU7-74P,chr4:40377452-40377513,61
40990154,40990273,chr4,RNA5SP160,chr4:40990154-40990273,119
41084607,41084713,chr4,RNU6-836P,chr4:41084607-41084713,106
41113942,41114045,chr4,RNU6-1195P,chr4:41113942-41114045,103
67199062,67200327,chr14,SF3B4P1,chr14:67199062-67200327,1265
41771945,41772103,chr4,RNU1-49P,chr4:41771945-41772103,158
39936753,39936855,chr4,RNA5SP159,chr4:39936753-39936855,102
37241910,37241991,chr4,MIR4801,chr4:37241910-37241991,81
67240713,67336061,chr14,PALS1,chr14:67240713-67336061,95348
42892396,42892618,chr4,RN7SKP82,chr4:42892396-42892618,222
39621012,39621073,chr4,RNU7-11P,chr4:39621012-39621073,61
45480030,45480136,chr4,RNU6-931P,chr4:45480030-45480136,106
46531237,46531342,chr4,RNU6-412P,chr4:46531237-46531342,105
39297605,39297711,chr4,RNU6-32P,chr4:39297605-39297711,106
43863274,43863549,chr4,RN7SL193P,chr4:43863274-43863549,275
45995119,45995423,chr4,RN7SKP199,chr4:45995119-45995423,304
48932755,48932854,chr4,RNU6-158P,chr4:48932755-48932854,99
43598544,43598844,chr4,RN7SL691P,chr4:43598544-43598844,300
48574453,48574520,chr4,RNU5E-3P,chr4:48574453-48574520,67
47652669,47652743,chr4,MIR8053,chr4:47652669-47652743,74
55798636,55798731,chr4,RNU6-276P,chr4:55798636-55798731,95
14941489,14942448,chr19,OR7C2,chr19:14941489-14942448,959
36913628,36940439,chr22,CSF2RB,chr22:36913628-36940439,26811
55540502,55540835,chr4,RN7SKP30,chr4:55540502-55540835,333
52494849,52494952,chr4,RNU6-1252P,chr4:52494849-52494952,103
53265461,53265567,chr4,RNU6-310P,chr4:53265461-53265567,106
112486827,112669397,chr9,KIAA1958,chr9:112486827-112669397,182570
60922619,60922684,chr4,MIR548AG1,chr4:60922619-60922684,65
59834063,59834167,chr4,RNU6-1325P,chr4:59834063-59834167,104
15878023,15898077,chr19,CYP4F2,chr19:15878023-15898077,20054
55885595,55885701,chr4,RNU6-652P,chr4:55885595-55885701,106
66897262,66897371,chr4,RNU6-699P,chr4:66897262-66897371,109
66276824,66276928,chr4,MIR1269A,chr4:66276824-66276928,104
64397694,64397787,chr4,RNU6-191P,chr4:64397694-64397787,93
67429591,67429754,chr4,RNU1-63P,chr4:67429591-67429754,163
67439992,67440118,chr4,RNA5SP527,chr4:67439992-67440118,126
68003895,68004001,chr4,RNU6-95P,chr4:68003895-68004001,106
73026748,73026873,chr4,RNU6ATAC5P,chr4:73026748-73026873,125
71759518,71759616,chr4,RNA5SP163,chr4:71759518-71759616,98
72965178,72965303,chr4,RNU4ATAC9P,chr4:72965178-72965303,125
81334303,81334418,chr4,RNU5A-2P,chr4:81334303-81334418,115
82174547,82174653,chr4,RNU6-499P,chr4:82174547-82174653,106
84233657,84233763,chr4,RNU6-774P,chr4:84233657-84233763,106
85100496,85100823,chr4,RN7SKP48,chr4:85100496-85100823,327
82753337,82753430,chr4,MIR575,chr4:82753337-82753430,93
93820171,93820280,chr4,RNA5SP164,chr4:93820171-93820280,109
67294371,67360265,chr14,ATP6V1D,chr14:67294371-67360265,65894
84687725,84688000,chr4,RN7SL552P,chr4:84687725-84688000,275
113038377,113056759,chr9,ZFP37,chr9:113038377-113056759,18382
84886386,84886486,chr4,RNU6-469P,chr4:84886386-84886486,100
83003412,83003517,chr4,RNU6-615P,chr4:83003412-83003517,105
88684848,88684954,chr4,RNU6-33P,chr4:88684848-88684954,106
54330034,54383742,chr2,C2orf73,chr2:54330034-54383742,53708
95868667,95868764,chr4,RNU6-1059P,chr4:95868667-95868764,97
85722468,85722533,chr4,MIR4451,chr4:85722468-85722533,65
96348734,96349038,chr4,RN7SKP28,chr4:96348734-96349038,304
98966815,98966873,chr4,RNU7-149P,chr4:98966815-98966873,58
98997387,98997460,chr4,MIR3684,chr4:98997387-98997460,73
101723876,101723980,chr4,RNU6-462P,chr4:101723876-101723980,104
107435118,107435220,chr4,RNU6-551P,chr4:107435118-107435220,102
32741314,32776196,chr16,HERC2P5,chr16:32741314-32776196,34882
96152297,96152403,chr4,RNU6-34P,chr4:96152297-96152403,106
103924540,103924641,chr4,RNU6-635P,chr4:103924540-103924641,101
108652150,108652256,chr4,RNU6-431P,chr4:108652150-108652256,106
131661952,131662624,chr7,EEF1B2P6,chr7:131661952-131662624,672
116299725,116299768,chr4,MIR1973,chr4:116299725-116299768,43
90370123,90370427,chr4,RN7SKP248,chr4:90370123-90370427,304
118279190,118279320,chr4,SNORA24,chr4:118279190-118279320,130
114656759,114656854,chr4,MIR577,chr4:114656759-114656854,95
109450772,109451068,chr4,RN7SL55P,chr4:109450772-109451068,296
109488698,109488795,chr4,MIR576,chr4:109488698-109488795,97
101240795,101240872,chr4,MIR8066,chr4:101240795-101240872,77
129608884,129636135,chr9,NTMT1,chr9:129608884-129636135,27251
101330302,101330414,chr4,MIR1255A,chr4:101330302-101330414,112
118606450,118606553,chr4,RNU6-1054P,chr4:118606450-118606553,103
102748971,102809225,chr7,FAM185A,chr7:102748971-102809225,60254
121061172,121061478,chr4,RN7SKP137,chr4:121061172-121061478,306
121192797,121192903,chr4,RNU6-948P,chr4:121192797-121192903,106
119434005,119434108,chr4,RNU6-1217P,chr4:119434005-119434108,103
116839279,116839385,chr4,RNU6-119P,chr4:116839279-116839385,106
120810469,120810569,chr4,RNU6-550P,chr4:120810469-120810569,100
131720260,131720543,chr4,RN7SL205P,chr4:131720260-131720543,283
127891991,127892082,chr4,RNU6-583P,chr4:127891991-127892082,91
135995929,135996092,chr4,RNU1-89P,chr4:135995929-135996092,163
131273242,131273348,chr4,RNU6-224P,chr4:131273242-131273348,106
114799331,114799629,chr4,RN7SL808P,chr4:114799331-114799629,298
140700835,140700942,chr4,RNY1P14,chr4:140700835-140700942,107
60378485,60395951,chr11,MS4A7,chr11:60378485-60395951,17466
41921417,41929286,chr15,EHD4-AS1,chr15:41921417-41929286,7869
14619117,14690027,chr19,ADGRE3,chr19:14619117-14690027,70910
33938337,33938799,chr16,IGHV3OR16-7,chr16:33938337-33938799,462
145035132,145035436,chr4,RN7SKP235,chr4:145035132-145035436,304
26032539,26032811,chr16,HMGN2P3,chr16:26032539-26032811,272
148557947,148558048,chr4,RNA5SP166,chr4:148557947-148558048,101
148991572,148991633,chr4,RNU7-197P,chr4:148991572-148991633,61
153668589,153668858,chr6,MTND4LP20,chr6:153668589-153668858,269
149934376,149934483,chr4,RNU6-1230P,chr4:149934376-149934483,107
15395754,15413271,chr16,MPV17L,chr16:15395754-15413271,17517
149907560,149907675,chr4,RNA5SP167,chr4:149907560-149907675,115
127118671,127199481,chr6,RSPO3,chr6:127118671-127199481,80810
150209706,150209768,chr4,RNU7-194P,chr4:150209706-150209768,62
147745303,147745417,chr4,RNA5SP165,chr4:147745303-147745417,114
139794125,139794433,chr4,RN7SKP253,chr4:139794125-139794433,308
147782595,147782668,chr4,MIR4799,chr4:147782595-147782668,73
150970671,150970782,chr4,RNA5SP168,chr4:150970671-150970782,111
147808926,147809209,chr4,RN7SL254P,chr4:147808926-147809209,283
151576766,151576916,chr4,RN7SKP35,chr4:151576766-151576916,150
58150275,58150563,chr15,MTCO3P23,chr15:58150275-58150563,288
151102057,151102128,chr4,SNORD73B,chr4:151102057-151102128,71
147344629,147344717,chr4,MIR548G,chr4:147344629-147344717,88
151300518,151300613,chr4,RNU6-1282P,chr4:151300518-151300613,95
151971497,151971613,chr4,RNA5SP169,chr4:151971497-151971613,116
40410281,40636719,chr22,MRTFA,chr22:40410281-40636719,226438
151103827,151103891,chr4,SNORD73A,chr4:151103827-151103891,64
154543933,154544037,chr4,RNU6-1285P,chr4:154543933-154544037,104
157201562,157201668,chr4,RNU6-582P,chr4:157201562-157201668,106
52629743,52630078,chr2,FTH1P6,chr2:52629743-52630078,335
154928460,154952188,chr7,PAXIP1-AS2,chr7:154928460-154952188,23728
152489327,152489416,chr4,MIR3140,chr4:152489327-152489416,89
156986372,156986693,chr4,RPPH1-3P,chr4:156986372-156986693,321
158395394,158395534,chr4,RNU4-79P,chr4:158395394-158395534,140
35485766,35486225,chr16,RARRES2P10,chr16:35485766-35486225,459
153665707,153666390,chr6,MTCO2P31,chr6:153665707-153666390,683
63504511,63594640,chr15,USP3,chr15:63504511-63594640,90129
165252580,165252661,chr4,RNU4-87P,chr4:165252580-165252661,81
79631329,79703655,chr6,SH3BGRL2,chr6:79631329-79703655,72326
45651345,46187990,chr2,PRKCE,chr2:45651345-46187990,536645
164620732,164620837,chr4,RNU6-284P,chr4:164620732-164620837,105
152264150,152264445,chr4,RN7SL446P,chr4:152264150-152264445,295
167662986,167663302,chr4,RN7SKP188,chr4:167662986-167663302,316
166053187,166053287,chr4,RNA5SP170,chr4:166053187-166053287,100
170891467,170891597,chr4,RNU6ATAC13P,chr4:170891467-170891597,130
165386242,165386337,chr4,MIR578,chr4:165386242-165386337,95
163828800,163829113,chr4,RN7SKP105,chr4:163828800-163829113,313
35384144,35385086,chr16,FRG2GP,chr16:35384144-35385086,942
154549517,154550242,chr6,MTRES1P1,chr6:154549517-154550242,725
168686608,168686716,chr4,RNU6-1336P,chr4:168686608-168686716,108
168885355,168885461,chr4,RNU6-853P,chr4:168885355-168885461,106
138161939,138344663,chr6,ARFGEF3,chr6:138161939-138344663,182724
169005249,169005344,chr4,RNY4P17,chr4:169005249-169005344,95
171186184,171186292,chr4,MIR6082,chr4:171186184-171186292,108
152536428,152536516,chr4,MIR4453,chr4:152536428-152536516,88
167400495,167400762,chr4,RN7SL776P,chr4:167400495-167400762,267
157335381,157417439,chr7,DNAJB6,chr7:157335381-157417439,82058
173141643,173141938,chr4,RN7SL253P,chr4:173141643-173141938,295
177457111,177457228,chr4,RNA5SP172,chr4:177457111-177457228,117
178116721,178116861,chr4,RNU1-45P,chr4:178116721-178116861,140
177181442,177181741,chr4,RN7SKP136,chr4:177181442-177181741,299
46884362,46931289,chr16,GPT2,chr16:46884362-46931289,46927
166918364,166918478,chr4,RNA5SP171,chr4:166918364-166918478,114
60378530,60417756,chr11,MS4A14,chr11:60378530-60417756,39226
178406695,178406830,chr4,RNA5SP173,chr4:178406695-178406830,135
163093574,163093628,chr4,MIR4454,chr4:163093574-163093628,54
181834865,181835108,chr4,RN7SKP13,chr4:181834865-181835108,243
183675603,183675715,chr4,RNU6-335P,chr4:183675603-183675715,112
183705931,183706031,chr4,RNU6-1053P,chr4:183705931-183706031,100
184431966,184432049,chr4,SNORD79,chr4:184431966-184432049,83
183653572,183653676,chr4,RNU6-479P,chr4:183653572-183653676,104
184278936,184279233,chr4,RN7SL28P,chr4:184278936-184279233,297
182169293,182169378,chr4,MIR1305,chr4:182169293-182169378,85
182548659,182548779,chr4,RNU2-34P,chr4:182548659-182548779,120
154787118,154787278,chr4,RNU2-66P,chr4:154787118-154787278,160
182631454,182631688,chr4,RN7SKP67,chr4:182631454-182631688,234
154790291,154790484,chr4,RNU2-44P,chr4:154790291-154790484,193
174423795,174423864,chr4,MIR4276,chr4:174423795-174423864,69
31639131,32110932,chr5,PDZD2,chr5:31639131-32110932,471801
190017696,190017814,chr4,RNA5SP175,chr4:190017696-190017814,118
124257606,124353307,chr9,NEK6,chr9:124257606-124353307,95701
188121531,188121634,chr4,RNU6-173P,chr4:188121531-188121634,103
189709539,189709714,chr4,RNU1-51P,chr4:189709539-189709714,175
186501109,186501215,chr4,RNU6-1055P,chr4:186501109-186501215,106
190015138,190015255,chr4,RNA5SP174,chr4:190015138-190015255,117
139885481,139885603,chrX,RNU6ATAC23P,chrX:139885481-139885603,122
188716665,188716725,chr4,RNU7-192P,chr4:188716665-188716725,60
151716035,151723194,chrX,FATE1,chrX:151716035-151723194,7159
47847233,47914667,chr4,NFXL1,chr4:47847233-47914667,67434
151912495,151925171,chrX,MAGEA4,chrX:151912495-151925171,12676
60429572,60455214,chr11,MS4A5,chr11:60429572-60455214,25642
27158451,27176587,chr16,LINC02129,chr16:27158451-27176587,18136
48538726,48620148,chr16,N4BP1,chr16:48538726-48620148,81422
15760241,15779909,chr19,CYP4F24P,chr19:15760241-15779909,19668
28015777,28016482,chr2,FAM133EP,chr2:28015777-28016482,705
34981957,35029686,chr14,SRP54,chr14:34981957-35029686,47729
149027700,149032573,chr6,UST-AS2,chr6:149027700-149032573,4873
48686774,48755730,chr2,LHCGR,chr2:48686774-48755730,68956
57967687,57968661,chr6,GAPDHP15,chr6:57967687-57968661,974
143494812,143511720,chr6,FUCA2,chr6:143494812-143511720,16908
120211032,120230334,chr11,OAF,chr11:120211032-120230334,19302
152045314,152046193,chrX,RPSAP60,chrX:152045314-152046193,879
51979223,51980012,chrX,TPMTP3,chrX:51979223-51980012,789
36673817,36675270,chr6,LAP3P2,chr6:36673817-36675270,1453
15673018,15697174,chr19,CYP4F12,chr19:15673018-15697174,24156
43586918,43588223,chr5,AMD1P3,chr5:43586918-43588223,1305
132131888,132169374,chr6,LINC01013,chr6:132131888-132169374,37486
52063347,52063474,chrX,SNORA11E,chrX:52063347-52063474,127
28809331,29217115,chr5,LINC02109,chr5:28809331-29217115,407784
52184876,52192268,chrX,MAGED4,chrX:52184876-52192268,7392
120236640,120319945,chr11,POU2F3,chr11:120236640-120319945,83305
681670,684528,chr16,JMJD8,chr16:681670-684528,2858
52190621,52190748,chrX,SNORA11D,chrX:52190621-52190748,127
133300103,133415489,chrX,GPC4,chrX:133300103-133415489,115386
38399814,38403471,chr5,EGFLAM-AS2,chr5:38399814-38403471,3657
78760142,78762431,chr8,THAP12P7,chr8:78760142-78762431,2289
64331927,64332152,chr8,COX6CP8,chr8:64331927-64332152,225
7793716,7795870,chr8,PRR23D3P,chr8:7793716-7795870,2154
87318416,87412930,chr5,CCNH,chr5:87318416-87412930,94514
133531723,133531826,chrX,RNU6-203P,chrX:133531723-133531826,103
133670971,133671386,chrX,RPS24P19,chrX:133670971-133671386,415
133762796,133763683,chrX,RPSAP63,chrX:133762796-133763683,887
54485169,54485850,chr6,CLNS1AP1,chr6:54485169-54485850,681
133897443,133897934,chrX,GPC3-AS1,chrX:133897443-133897934,491
134166682,134166932,chrX,TIMM8BP2,chrX:134166682-134166932,250
100427143,100451734,chr9,MSANTD3,chr9:100427143-100451734,24591
61803143,61803388,chr2,RPS24P7,chr2:61803143-61803388,245
134169378,134169452,chrX,MIR363,chrX:134169378-134169452,74
22508129,22548800,chr2,LINC01884,chr2:22508129-22548800,40671
134169538,134169612,chrX,MIR92A2,chrX:134169538-134169612,74
134169671,134169766,chrX,MIR19B2,chrX:134169671-134169766,95
134169809,134169877,chrX,MIR20B,chrX:134169809-134169877,68
134170041,134170111,chrX,MIR18B,chrX:134170041-134170111,70
134170198,134170278,chrX,MIR106A,chrX:134170198-134170278,80
134204353,134205916,chrX,LARP1BP3,chrX:134204353-134205916,1563
48611377,48615292,chr17,HOXB8,chr17:48611377-48615292,3915
134237047,134246207,chrX,CCDC160,chrX:134237047-134246207,9160
120365666,120365963,chr11,7SK,chr11:120365666-120365963,297
53998890,54007152,chr6,MLIP-IT1,chr6:53998890-54007152,8262
49250438,49270477,chrX,FOXP3,chrX:49250438-49270477,20039
42874670,42898704,chr17,LINC00671,chr17:42874670-42898704,24034
69466624,69660915,chr8,SULF1,chr8:69466624-69660915,194291
156662050,156662437,chr6,H3P28,chr6:156662050-156662437,387
73593379,73653992,chr6,SLC17A5,chr6:73593379-73653992,60613
64244479,64246943,chr11,PPP1R14B,chr11:64244479-64246943,2464
28392448,28417317,chr2,FOSL2,chr2:28392448-28417317,24869
41712331,41715969,chr17,GAST,chr17:41712331-41715969,3638
48713730,48713959,chr17,COX6B1P2,chr17:48713730-48713959,229
160348378,160452577,chr6,SLC22A3,chr6:160348378-160452577,104199
135075422,135121180,chr9,OLFM1,chr9:135075422-135121180,45758
138706294,138799560,chr7,ATP6V0A4,chr7:138706294-138799560,93266
146171315,146171847,chr6,FUNDC2P3,chr6:146171315-146171847,532
51260546,51297936,chr17,UTP18,chr17:51260546-51297936,37390
34067226,34069550,chr2,LINC01318,chr2:34067226-34069550,2324
64291302,64300031,chr11,KCNK4,chr11:64291302-64300031,8729
154576309,154577079,chr6,RPS4XP8,chr6:154576309-154577079,770
80374015,80374569,chr6,RPL17P25,chr6:80374015-80374569,554
18986451,19348067,chr2,LINC01376,chr2:18986451-19348067,361616
14472466,14475354,chr19,PTGER1,chr19:14472466-14475354,2888
132538290,132539336,chr6,TAAR9,chr6:132538290-132539336,1046
153668879,153669901,chr6,MTND4P13,chr6:153668879-153669901,1022
110099819,110180004,chr6,WASF1,chr6:110099819-110180004,80185
15124160,15126174,chr19,ILVBL-AS1,chr19:15124160-15126174,2014
14916428,14917380,chr19,OR7A11P,chr19:14916428-14917380,952
37820498,37876274,chr2,LINC00211,chr2:37820498-37876274,55776
16111889,16134234,chr19,RAB8A,chr19:16111889-16134234,22345
62146413,62147153,chr2,RPSAP26,chr2:62146413-62147153,740
17284292,17284895,chr2,ZFYVE9P2,chr2:17284292-17284895,603
64960053,64960634,chr2,RPL11P1,chr2:64960053-64960634,581
42442017,42493982,chr2,KCNG3,chr2:42442017-42493982,51965
33002333,33002621,chr16,IGHV1OR16-4,chr16:33002333-33002621,288
14632931,14669236,chr16,BFAR,chr16:14632931-14669236,36305
64291722,64304769,chr11,KCNK4-TEX40,chr11:64291722-64304769,13047
61856695,61857055,chr2,RPL31P30,chr2:61856695-61857055,360
37949911,38067041,chr2,RMDN2-AS1,chr2:37949911-38067041,117130
64300358,64304770,chr11,CATSPERZ,chr11:64300358-64304770,4412
48874860,48908983,chr17,SUMO2P17,chr17:48874860-48908983,34123
15869939,15870243,chr2,RPLP1P5,chr2:15869939-15870243,304
55448433,55511444,chr17,SMIM36,chr17:55448433-55511444,63011
64318121,64321811,chr11,PRDX5,chr11:64318121-64321811,3690
36837698,36966536,chr2,STRN,chr2:36837698-36966536,128838
37120574,37358149,chr9,ZCCHC7,chr9:37120574-37358149,237575
43718314,43720436,chr17,WHSC1L2P,chr17:43718314-43720436,2122
47914142,48040173,chr4,NIPAL1,chr4:47914142-48040173,126031
59962363,60018975,chr17,TBC1D3P1-DHX40P1,chr17:59962363-60018975,56612
62808500,62836371,chr17,MARCHF10-DT,chr17:62808500-62836371,27871
77545397,77546266,chr5,RPS2P24,chr5:77545397-77546266,869
64404512,64486615,chr5,NT5ELP,chr5:64404512-64486615,82103
16067021,16103002,chr19,TPM4,chr19:16067021-16103002,35981
68591796,68763882,chr17,LINC01482,chr17:68591796-68763882,172086
31104772,31120069,chr22,SELENOM,chr22:31104772-31120069,15297
14708944,14726338,chr16,NPIPA3,chr16:14708944-14726338,17394
77072072,77087285,chr5,ZBED3,chr5:77072072-77087285,15213
48066393,48134250,chr4,TXK,chr4:48066393-48134250,67857
64340204,64357534,chr11,CCDC88B,chr11:64340204-64357534,17330
55738017,55817157,chr5,DDX4,chr5:55738017-55817157,79140
94646364,94647996,chr10,CTBP2P2,chr10:94646364-94647996,1632
32903442,32903894,chr16,IGHV3OR16-15,chr16:32903442-32903894,452
26764289,26801067,chr2,CENPA,chr2:26764289-26801067,36778
46888,74163,chr10,TUBB8,chr10:46888-74163,27275
128027071,128032107,chr7,LRRC4,chr7:128027071-128032107,5036
46923075,46975524,chr17,GOSR2,chr17:46923075-46975524,52449
106421711,106422218,chr14,IGHV4-39,chr14:106421711-106422218,507
35489237,35490212,chr16,AGGF1P6,chr16:35489237-35490212,975
27851669,27920134,chr22,PITPNB,chr22:27851669-27920134,68465
106425359,106425654,chr14,IGHV7-40,chr14:106425359-106425654,295
134289332,134316930,chr7,SLC35B4,chr7:134289332-134316930,27598
47154387,47464149,chr16,ITFG1,chr16:47154387-47464149,309762
106440950,106441007,chr14,IGHVII-40-1,chr14:106440950-106441007,57
106443133,106443583,chr14,IGHV3-41,chr14:106443133-106443583,450
106460092,106461055,chr14,HOMER2P1,chr14:106460092-106461055,963
106463256,106463691,chr14,IGHV3-42,chr14:106463256-106463691,435
106470264,106470800,chr14,IGHV3-43,chr14:106470264-106470800,536
106472791,106473000,chr14,IGHVII-43-1,chr14:106472791-106473000,209
106478006,106478393,chr14,IGHVIII-44,chr14:106478006-106478393,387
80394,86265,chr10,IL9RP2,chr10:80394-86265,5871
106482435,106521073,chr14,LINC00221,chr14:106482435-106521073,38638
48106081,48106188,chr4,RNU6-838P,chr4:48106081-48106188,107
53048789,53080615,chrX,GPR173,chrX:53048789-53080615,31826
152970519,152983579,chr6,FBXO5,chr6:152970519-152983579,13060
154831,154943,chr10,RNA5SP297,chr10:154831-154943,112
282015,282125,chr10,RNA5SP298,chr10:282015-282125,110
430239,430504,chr10,RN7SL754P,chr10:430239-430504,265
52590960,52659301,chr4,USP46,chr4:52590960-52659301,68341
134465,254637,chr10,ZMYND11,chr10:134465-254637,120172
53082367,53088540,chrX,TSPYL2,chrX:53082367-53088540,6173
106489345,106489756,chr14,IGHVIV-44-1,chr14:106489345-106489756,411
149504495,149546043,chr6,PPIL4,chr6:149504495-149546043,41548
106494134,106494383,chr14,IGHVII-44-2,chr14:106494134-106494383,249
106506996,106507491,chr14,IGHV1-45,chr14:106506996-106507491,495
68266319,68266859,chr7,MTND4P3,chr7:68266319-68266859,540
106511117,106511856,chr14,IGHV1-46,chr14:106511117-106511856,739
142372640,142372912,chr7,TRBV5-2,chr7:142372640-142372912,272
143979121,143980225,chr7,CAPZA1P5,chr7:143979121-143980225,1104
64631621,64751005,chr2,SERTAD2,chr2:64631621-64751005,119384
106515818,106515854,chr14,IGHVII-46-1,chr14:106515818-106515854,36
106518582,106519027,chr14,IGHV3-47,chr14:106518582-106519027,445
47026128,47026570,chr7,MRPL42P4,chr7:47026128-47026570,442
106531141,106531471,chr14,IGHVIII-47-1,chr14:106531141-106531471,330
106537810,106538344,chr14,IGHV3-48,chr14:106537810-106538344,534
79571773,79726882,chr9,TLE4,chr9:79571773-79726882,155109
106556936,106557477,chr14,IGHV3-49,chr14:106556936-106557477,541
47335315,47335514,chr2,BCYRN1,chr2:47335315-47335514,199
63117851,63119542,chr2,DBIL5P2,chr2:63117851-63119542,1691
158631169,158704804,chr7,NCAPG2,chr7:158631169-158704804,73635
106564375,106564598,chr14,IGHVII-49-1,chr14:106564375-106564598,223
106566117,106566555,chr14,IGHV3-50,chr14:106566117-106566555,438
106578744,106579236,chr14,IGHV5-51,chr14:106578744-106579236,492
68023694,68024766,chr2,FBXL12P1,chr2:68023694-68024766,1072
106584718,106584976,chr14,IGHVII-51-2,chr14:106584718-106584976,258
106586376,106586826,chr14,IGHV3-52,chr14:106586376-106586826,450
42797225,42798712,chr2,FTOP1,chr2:42797225-42798712,1487
106592676,106593347,chr14,IGHV3-53,chr14:106592676-106593347,671
106599670,106599924,chr14,IGHVII-53-1,chr14:106599670-106599924,254
169751622,169781600,chr6,ERMARD,chr6:169751622-169781600,29978
106601346,106601792,chr14,IGHV3-54,chr14:106601346-106601792,446
106606101,106606551,chr14,IGHV4-55,chr14:106606101-106606551,450
106609762,106610196,chr14,IGHV7-56,chr14:106609762-106610196,434
106618894,106619173,chr14,IGHV3-57,chr14:106618894-106619173,279
106622357,106622855,chr14,IGHV1-58,chr14:106622357-106622855,498
66439088,66444221,chr2,MEIS1-AS2,chr2:66439088-66444221,5133
106627249,106627825,chr14,IGHV4-59,chr14:106627249-106627825,576
106631197,106631653,chr14,IGHV3-60,chr14:106631197-106631653,456
106583501,106583807,chr14,IGHV8-51-1,chr14:106583501-106583807,306
55865967,55924139,chr2,EFEMP1,chr2:55865967-55924139,58172
75079353,75127344,chr14,NEK9,chr14:75079353-75127344,47991
64341849,64341904,chr11,MIR7155,chr11:64341849-64341904,55
64359148,64372215,chr11,RPS6KA4,chr11:64359148-64372215,13067
53176283,53225422,chrX,KDM5C,chrX:53176283-53225422,49139
52659406,52661668,chr4,USP46-DT,chr4:52659406-52661668,2262
52712394,52866821,chr4,LINC01618,chr4:52712394-52866821,154427
80679684,80755621,chr15,ABHD17C,chr15:80679684-80755621,75937
52712682,52712747,chr4,MIR4449,chr4:52712682-52712747,65
52713249,52713370,chr4,SNORA26,chr4:52713249-52713370,121
52722618,52751586,chr4,ERVMER34-1,chr4:52722618-52751586,28968
52862317,52866835,chr4,RASL11B,chr4:52862317-52866835,4518
79311112,79427432,chr15,TMED3,chr15:79311112-79427432,116320
35389203,35390003,chr16,AGGF1P4,chr16:35389203-35390003,800
5458581,5458881,chr4,RN7SKP275,chr4:5458581-5458881,300
5524569,5527801,chr4,LINC01587,chr4:5524569-5527801,3232
56730118,56850286,chr16,NUP93,chr16:56730118-56850286,120168
15690026,15721631,chr22,POTEH,chr22:15690026-15721631,31605
40760597,40760874,chr15,SUMO2P15,chr15:40760597-40760874,277
122087508,122087811,chr4,RN7SL335P,chr4:122087508-122087811,303
122378966,122429802,chr4,ADAD1,chr4:122378966-122429802,50836
51037488,51293912,chr15,MIR4713HG,chr15:51037488-51293912,256424
20004797,20004815,chr15,IGHD4OR15-4A,chr15:20004797-20004815,18
60681564,60687248,chr15,RORA-AS2,chr15:60681564-60687248,5684
80263068,80341805,chr15,LINC00927,chr15:80263068-80341805,78737
25564675,25729294,chr22,GRK3,chr22:25564675-25729294,164619
63409064,63409457,chr8,IFITM8P,chr8:63409064-63409457,393
64368602,64368703,chr11,MIR1237,chr11:64368602-64368703,101
64394342,64395831,chr11,LINC02723,chr11:64394342-64395831,1489
59528861,59529251,chr5,NDUFB4P2,chr5:59528861-59529251,390
64449074,64451657,chr11,LINC02724,chr11:64449074-64451657,2583
80779343,80951776,chr15,CEMIP,chr15:80779343-80951776,172433
61332258,61546172,chr5,ZSWIM6,chr5:61332258-61546172,213914
68330955,68819023,chr8,C8orf34,chr8:68330955-68819023,488068
64555690,64572875,chr11,SLC22A11,chr11:64555690-64572875,17185
48962157,49154527,chr2,FSHR,chr2:48962157-49154527,192370
37948491,37951055,chr5,LINC02110,chr5:37948491-37951055,2564
58822503,58823714,chr5,RPL5P15,chr5:58822503-58823714,1211
15114984,15125786,chr19,ILVBL,chr19:15114984-15125786,10802
52989340,53094779,chr5,ITGA2,chr5:52989340-53094779,105439
38518948,38570204,chr22,DMC1,chr22:38518948-38570204,51256
64590641,64602353,chr11,SLC22A12,chr11:64590641-64602353,11712
164754064,164803795,chr4,SMIM31,chr4:164754064-164803795,49731
164787290,164787396,chr4,RNU6-668P,chr4:164787290-164787396,106
164877178,164898965,chr4,APELA,chr4:164877178-164898965,21787
143864436,143938343,chr6,ZC2HC1B,chr6:143864436-143938343,73907
164915565,164916983,chr4,TRIM60P14,chr4:164915565-164916983,1418
164929494,164929951,chr4,FAM218BP,chr4:164929494-164929951,457
164943290,164943937,chr4,NACA3P,chr4:164943290-164943937,647
104821201,104823718,chr14,LINC00638,chr14:104821201-104823718,2517
47773111,47960178,chr8,PRKDC,chr8:47773111-47960178,187067
104830838,104831171,chr14,RPS26P49,chr14:104830838-104831171,333
164954446,164977668,chr4,TRIM61,chr4:164954446-164977668,23222
104835997,104836852,chr14,RPS2P4,chr14:104835997-104836852,855
164956948,164959122,chr4,FAM218A,chr4:164956948-164959122,2174
42469817,42470266,chr2,RPS13P3,chr2:42469817-42470266,449
31234152,31269451,chr2,EHD3,chr2:31234152-31269451,35299
149566294,149591748,chr6,GINM1,chr6:149566294-149591748,25454
165016458,165041749,chr4,TRIM60,chr4:165016458-165041749,25291
147508690,147737547,chr6,SAMD5,chr6:147508690-147737547,228857
111122652,111144264,chr13,ARHGEF7-IT1,chr13:111122652-111144264,21612
103385377,103503831,chr14,MARK3,chr14:103385377-103503831,118454
111144305,111144733,chr13,ARHGEF7-AS1,chr13:111144305-111144733,428
165053864,165060554,chr4,TRIM75P,chr4:165053864-165060554,6690
70518569,70532743,chr4,AMTN,chr4:70518569-70532743,14174
111316184,111344249,chr13,TEX29,chr13:111316184-111344249,28065
131470832,131584332,chr6,ARG1,chr6:131470832-131584332,113500
149262171,149297302,chr7,ZNF783,chr7:149262171-149297302,35131
64646399,64659681,chr11,NRXN2-AS1,chr11:64646399-64659681,13282
60756253,60802086,chr2,PAPOLG,chr2:60756253-60802086,45833
40824535,40856639,chr22,ST13,chr22:40824535-40856639,32104
15615218,15630639,chr19,CYP4F8,chr19:15615218-15630639,15421
64726911,64745456,chr11,RASGRP2,chr11:64726911-64745456,18545
105565120,105600875,chr7,EFCAB10,chr7:105565120-105600875,35755
35207903,35208236,chr16,TP53TG3GP,chr16:35207903-35208236,333
76880175,76886405,chr13,KCTD12,chr13:76880175-76886405,6230
61647242,62037035,chr16,CDH8,chr16:61647242-62037035,389793
70628744,70646824,chr4,ENAM,chr4:70628744-70646824,18080
76928066,76928836,chr13,BTF3P11,chr13:76928066-76928836,770
76948511,76958638,chr13,ACOD1,chr13:76948511-76958638,10127
139523685,139544985,chr7,CLEC2L,chr7:139523685-139544985,21300
76981175,76981916,chr13,RPL7P44,chr13:76981175-76981916,741
76984868,76987943,chr13,DHX9P1,chr13:76984868-76987943,3075
70688532,70690551,chr4,UTP3,chr4:70688532-70690551,2019
70701755,70701858,chr4,RNU6-520P,chr4:70701755-70701858,103
70703018,70703123,chr4,RNU6-784P,chr4:70703018-70703123,105
76990660,77019143,chr13,CLN5,chr13:76990660-77019143,28483
142601628,142602360,chr7,TRBV17,chr7:142601628-142602360,732
142380806,142381261,chr7,TRBV6-4,chr7:142380806-142381261,455
70704204,70808619,chr4,RUFY3,chr4:70704204-70808619,104415
16034776,16036537,chr19,SNX33P1,chr19:16034776-16036537,1761
14903232,14904138,chr19,OR7A3P,chr19:14903232-14904138,906
107642765,107643023,chr7,BANF1P5,chr7:107642765-107643023,258
142313184,142313666,chr7,TRBV4-1,chr7:142313184-142313666,482
142626649,142627399,chr7,TRBV20-1,chr7:142626649-142627399,750
15468645,15498956,chr19,PGLYRP2,chr19:15468645-15498956,30311
150625375,150632648,chr7,GIMAP6,chr7:150625375-150632648,7273
61069871,61070341,chr17,RPL23AP74,chr17:61069871-61070341,470
39799008,39920266,chr15,GPR176,chr15:39799008-39920266,121258
58301228,58328795,chr17,TSPOAP1,chr17:58301228-58328795,27567
170535120,170553307,chr6,PSMB1,chr6:170535120-170553307,18187
142666272,142667718,chr7,MTRNR2L6,chr7:142666272-142667718,1446
11559374,11619161,chr19,ZNF627,chr19:11559374-11619161,59787
84491480,84500599,chr15,UBE2Q2P12,chr15:84491480-84500599,9119
133987581,134052624,chr6,SLC2A12,chr6:133987581-134052624,65043
141738334,141787922,chr7,SSBP1,chr7:141738334-141787922,49588
78624111,78727754,chr15,CHRNB4,chr15:78624111-78727754,103643
66696190,66703252,chr2,LINC01797,chr2:66696190-66703252,7062
71862452,71911193,chr9,ABHD17B,chr9:71862452-71911193,48741
132559024,132559265,chr6,TAAR7P,chr6:132559024-132559265,241
14689801,14733746,chr19,ZNF333,chr19:14689801-14733746,43945
24399003,24419283,chr14,NYNRIN,chr14:24399003-24419283,20280
122443351,122471807,chr6,SERINC1,chr6:122443351-122471807,28456
23872268,23873014,chr2,PGAM1P6,chr2:23872268-23873014,746
55617909,55618373,chr2,PPP4R3B-DT,chr2:55617909-55618373,464
45674701,45675476,chr2,PRKCE-AS1,chr2:45674701-45675476,775
149963943,149973715,chr6,ULBP1,chr6:149963943-149973715,9772
69012504,69014113,chr9,PRKACG,chr9:69012504-69014113,1609
6495651,6511839,chr2,LINC01824,chr2:6495651-6511839,16188
25111731,25178231,chr16,LCMT1,chr16:25111731-25178231,66500
114329869,114333251,chr9,ORM2,chr9:114329869-114333251,3382
24426545,24430954,chr14,CBLN3,chr14:24426545-24430954,4409
107490106,107661306,chr6,SOBP,chr6:107490106-107661306,171200
50201011,50217616,chr22,SELENOO,chr22:50201011-50217616,16605
24429286,24441843,chr14,KHNYN,chr14:24429286-24441843,12557
38231568,38232317,chr2,RPL7P12,chr2:38231568-38232317,749
38431294,38433573,chr2,LINC01883,chr2:38431294-38433573,2279
147909431,147911817,chrX,FMR1-AS1,chrX:147909431-147911817,2386
132764660,132765458,chr6,RBM11P1,chr6:132764660-132765458,798
170639606,170640536,chr6,OR4F7P,chr6:170639606-170640536,930
6720863,7175648,chr9,KDM4C,chr9:6720863-7175648,454785
147946941,147947583,chrX,FMR1-IT1,chrX:147946941-147947583,642
161129967,161274061,chr6,AGPAT4,chr6:161129967-161274061,144094
92393881,92468728,chr15,ST8SIA2,chr15:92393881-92468728,74847
147981337,148026665,chrX,FMR1NB,chrX:147981337-148026665,45328
26243170,26290465,chr2,HADHB,chr2:26243170-26290465,47295
148008100,148008215,chrX,RNA5SP524,chrX:148008100-148008215,115
148052233,148052746,chrX,FTH1P8,chrX:148052233-148052746,513
30827442,30975084,chrX,TAB3,chrX:30827442-30975084,147642
76992598,77027195,chr13,FBXL3,chr13:76992598-77027195,34597
43197280,43343372,chr22,SCUBE1,chr22:43197280-43343372,146092
24505353,24508265,chr14,CMA1,chr14:24505353-24508265,2912
16283359,16324514,chr19,KLF2-DT,chr19:16283359-16324514,41155
2274631,2282175,chr19,PEAK3,chr19:2274631-2282175,7544
66192093,66197315,chr8,LINC00967,chr8:66192093-66197315,5222
16065737,16066312,chr19,LINC01855,chr19:16065737-16066312,575
169457212,169702067,chr6,WDR27,chr6:169457212-169702067,244855
152114994,152138556,chrX,MAGEA10-MAGEA5,chrX:152114994-152138556,23562
16161368,16173525,chr19,CIB3,chr19:16161368-16173525,12157
35836886,35837732,chr16,VN1R70P,chr16:35836886-35837732,846
77026767,77129717,chr13,MYCBP2-AS1,chr13:77026767-77129717,102950
85373436,85449040,chr8,CA3,chr8:85373436-85449040,75604
46578591,46621379,chr16,SHCBP1,chr16:46578591-46621379,42788
152133310,152138578,chrX,MAGEA10,chrX:152133310-152138578,5268
79236131,79327211,chr5,JMY,chr5:79236131-79327211,91080
39921042,39925880,chr15,GPR176-DT,chr15:39921042-39925880,4838
24606480,24609699,chr14,GZMH,chr14:24606480-24609699,3219
70852130,70852240,chr4,RNU6-891P,chr4:70852130-70852240,110
88252730,88271066,chr15,NTRK3-AS1,chr15:88252730-88271066,18336
9153296,9165451,chr4,FAM86KP,chr4:9153296-9165451,12155
58138169,58185911,chr15,AQP9,chr15:58138169-58185911,47742
80812142,80812581,chr8,HMGB1P41,chr8:80812142-80812581,439
85814767,85818783,chr8,REXO1L5P,chr8:85814767-85818783,4016
157539056,158587823,chr7,PTPRN2,chr7:157539056-158587823,1048767
9166297,9170270,chr4,ALG1L14P,chr4:9166297-9170270,3973
80498534,80498971,chr5,RPS27AP9,chr5:80498534-80498971,437
9170409,9176730,chr4,FAM90A26,chr4:9170409-9176730,6321
62110524,62119898,chr8,NARS1P2,chr8:62110524-62119898,9374
60459848,60460739,chr5,SETP21,chr5:60459848-60460739,891
9210657,9212249,chr4,USP17L10,chr4:9210657-9212249,1592
31160182,31207019,chr22,RNF185,chr22:31160182-31207019,46837
9215405,9216997,chr4,USP17L11,chr4:9215405-9216997,1592
9220152,9221744,chr4,USP17L12,chr4:9220152-9221744,1592
75674124,75717448,chr5,POC5,chr5:75674124-75717448,43324
17226213,17229219,chr19,OCEL1,chr19:17226213-17229219,3006
77042474,77327094,chr13,MYCBP2,chr13:77042474-77327094,284620
24573518,24576250,chr14,CTSG,chr14:24573518-24576250,2732
71118543,71144103,chrX,MED12,chrX:71118543-71144103,25560
9224896,9226488,chr4,USP17L13,chr4:9224896-9226488,1592
81953719,81993136,chr12,LINC02426,chr12:81953719-81993136,39417
9243879,9245471,chr4,USP17L17,chr4:9243879-9245471,1592
9248630,9250222,chr4,USP17L18,chr4:9248630-9250222,1592
94548241,94549536,chr12,SUCLG2P2,chr12:94548241-94549536,1295
7355517,7385558,chr8,ZNF705G,chr8:7355517-7385558,30041
9272364,9272914,chr4,USP17L23,chr4:9272364-9272914,550
19067614,19080095,chr16,COQ7,chr16:19067614-19080095,12481
9339403,9340995,chr4,USP17L5,chr4:9339403-9340995,1592
67440998,67442559,chr12,LINC02420,chr12:67440998-67442559,1561
9344148,9345740,chr4,USP17L27,chr4:9344148-9345740,1592
85181210,85182083,chr15,NIFKP8,chr15:85181210-85182083,873
57144620,57147619,chr12,LRP1-AS,chr12:57144620-57147619,2999
9348893,9350485,chr4,USP17L28,chr4:9348893-9350485,1592
78059942,78060278,chr14,FXNP1,chr14:78059942-78060278,336
9353638,9355230,chr4,USP17L29,chr4:9353638-9355230,1592
76836568,76836861,chr10,ATP5MC1P8,chr10:76836568-76836861,293
9363129,9364721,chr4,USP17L30,chr4:9363129-9364721,1592
106901283,106901984,chr12,EEF1B2P4,chr12:106901283-106901984,701
76888044,76980624,chr10,KCNMA1-AS1,chr10:76888044-76980624,92580
80628451,80874781,chr8,ZNF704,chr8:80628451-80874781,246330
78170373,79868291,chr14,NRXN3,chr14:78170373-79868291,1697918
9399204,9403565,chr4,DEFB108F,chr4:9399204-9403565,4361
76993359,77037475,chr15,PSTPIP1,chr15:76993359-77037475,44116
96278261,96400480,chr12,CDK17,chr12:96278261-96400480,122219
9411178,9411253,chr4,RNA5SP153,chr4:9411178-9411253,75
9422313,9429702,chr4,DEFB130D,chr4:9422313-9429702,7389
77147652,77150100,chr10,KCNMA1-AS2,chr10:77147652-77150100,2448
9258124,9259716,chr4,USP17L20,chr4:9258124-9259716,1592
9262872,9264464,chr4,USP17L21,chr4:9262872-9264464,1592
77433572,77433782,chr10,COX6CP15,chr10:77433572-77433782,210
77587049,77587159,chr10,RNA5SP321,chr10:77587049-77587159,110
9267619,9269211,chr4,USP17L22,chr4:9267619-9269211,1592
9325165,9326757,chr4,USP17L24,chr4:9325165-9326757,1592
9329911,9331503,chr4,USP17L25,chr4:9329911-9331503,1592
9334658,9336250,chr4,USP17L26,chr4:9334658-9336250,1592
9229641,9231233,chr4,USP17L14P,chr4:9229641-9231233,1592
20424584,20437826,chr22,SCARF2,chr22:20424584-20437826,13242
9239130,9240722,chr4,USP17L16P,chr4:9239130-9240722,1592
9253378,9254970,chr4,USP17L19,chr4:9253378-9254970,1592
9358383,9359975,chr4,USP17L9P,chr4:9358383-9359975,1592
9367874,9369070,chr4,USP17L6P,chr4:9367874-9369070,1196
106433489,106453449,chr4,LINC02173,chr4:106433489-106453449,19960
76869601,77638369,chr10,KCNMA1,chr10:76869601-77638369,768768
106357392,106368778,chr4,GIMD1,chr4:106357392-106368778,11386
59859479,59892945,chr17,TUBD1,chr17:59859479-59892945,33466
75407914,75566834,chr8,HNF4G,chr8:75407914-75566834,158920
52712325,52723623,chr4,DANCR,chr4:52712325-52723623,11298
157138916,157269370,chr7,UBE3C,chr7:157138916-157269370,130454
64746389,64759974,chr11,PYGM,chr11:64746389-64759974,13585
68232003,68300035,chr9,CBWD3,chr9:68232003-68300035,68032
17292131,17310236,chr19,ABHD8,chr19:17292131-17310236,18105
122888697,122922968,chr4,NUDT6,chr4:122888697-122922968,34271
160453428,160520269,chr6,LPAL2,chr6:160453428-160520269,66841
78177803,78177921,chr14,RNA5SP388,chr14:78177803-78177921,118
78231281,78231619,chr14,RPS26P48,chr14:78231281-78231619,338
27787528,28063714,chr16,GSG1L,chr16:27787528-28063714,276186
77080511,77081190,chr13,MYCBP2-AS2,chr13:77080511-77081190,679
143554325,143562031,chr6,PHACTR2-AS1,chr6:143554325-143562031,7706
37970686,37987422,chr22,SOX10,chr22:37970686-37987422,16736
129800908,129802214,chr6,B3GALNT2P1,chr6:129800908-129802214,1306
15979835,15999020,chr19,CYP4F9P,chr19:15979835-15999020,19185
76404058,76407138,chr8,LINC01109,chr8:76404058-76407138,3080
160171061,160277638,chr6,SLC22A2,chr6:160171061-160277638,106577
54073114,54073566,chr8,TDGF1P5,chr8:54073114-54073566,452
122826708,122898236,chr4,FGF2,chr4:122826708-122898236,71528
51767993,51804163,chr13,DHRS12,chr13:51767993-51804163,36170
56957931,56993867,chr8,BPNT2,chr8:56957931-56993867,35936
68735922,68736028,chr14,RNU6-921P,chr14:68735922-68736028,106
68861762,68862525,chr14,MAGOH3P,chr14:68861762-68862525,763
143980905,143981820,chr7,OR2Q1P,chr7:143980905-143981820,915
68867857,68869951,chr14,BLZF2P,chr14:68867857-68869951,2094
139561570,139777998,chr7,HIPK2,chr7:139561570-139777998,216428
153265662,153265755,chr4,RNU6-1196P,chr4:153265662-153265755,93
68887785,68888084,chr14,HMGN1P3,chr14:68887785-68888084,299
64778954,64779405,chr11,SF1-DT,chr11:64778954-64779405,451
139614438,139615204,chr6,ATP5PBP6,chr6:139614438-139615204,766
153307792,153308717,chr4,ANXA2P1,chr4:153307792-153308717,925
68936602,68936864,chr14,BANF1P1,chr14:68936602-68936864,262
153381729,153382015,chr4,RN7SL419P,chr4:153381729-153382015,286
85733419,85737278,chr8,REXO1L11P,chr8:85733419-85737278,3859
52020706,52038299,chr4,SGCB,chr4:52020706-52038299,17593
67929235,67970017,chr12,LINC01479,chr12:67929235-67970017,40782
170651012,170651338,chr6,WBP1LP8,chr6:170651012-170651338,326
68979682,68987463,chr14,ACTN1-DT,chr14:68979682-68987463,7781
64784918,64803241,chr11,MAP4K2,chr11:64784918-64803241,18323
77013751,77014028,chr8,HIGD1AP18,chr8:77013751-77014028,277
69023150,69023308,chr14,RPS29P1,chr14:69023150-69023308,158
54602487,54603150,chr6,RPL10P10,chr6:54602487-54603150,663
85851446,85861562,chr8,LINC02849,chr8:85851446-85861562,10116
80077729,80078362,chr6,AK4P5,chr6:80077729-80078362,633
36531805,36646087,chr2,FEZ2,chr2:36531805-36646087,114282
69050881,69153150,chr14,DCAF5,chr14:69050881-69153150,102269
15528192,15529139,chr22,OR11H1,chr22:15528192-15529139,947
37812677,37840041,chr5,GDNF,chr5:37812677-37840041,27364
100028455,100142874,chr12,UHRF1BP1L,chr12:100028455-100142874,114419
147911919,147951125,chrX,FMR1,chrX:147911919-147951125,39206
157381133,157678157,chr6,ZDHHC14,chr6:157381133-157678157,297024
85214048,85220421,chr8,RBIS,chr8:85214048-85220421,6373
16355239,16472085,chr19,EPS15L1,chr19:16355239-16472085,116846
23856703,23886312,chr22,SLC2A11,chr22:23856703-23886312,29609
35363412,35390584,chr16,LINC01566,chr16:35363412-35390584,27172
51553436,51647132,chr16,HNRNPA1P48,chr16:51553436-51647132,93696
89700345,89838315,chr4,SNCA,chr4:89700345-89838315,137970
52083064,52085109,chr16,LINC00919,chr16:52083064-52085109,2045
85762559,85763138,chr5,RPS2P25,chr5:85762559-85763138,579
68970692,69030165,chr5,LINC02198,chr5:68970692-69030165,59473
11927259,11976643,chr16,NPIPB2,chr16:11927259-11976643,49384
112647044,112684497,chr13,ATP11AUN,chr13:112647044-112684497,37453
56136979,56137531,chr5,RPL17P22,chr5:56136979-56137531,552
53822927,53825193,chr17,KIF2B,chr17:53822927-53825193,2266
77029251,77065234,chr5,AGGF1,chr5:77029251-77065234,35983
48549630,48606414,chr17,HOXB-AS3,chr17:48549630-48606414,56784
112745449,112754693,chr13,ATP11A-AS1,chr13:112745449-112754693,9244
101613330,101629296,chr7,MYL10,chr7:101613330-101629296,15966
112967484,112968824,chr13,MCF2L-AS1,chr13:112967484-112968824,1340
48334471,48334854,chr16,UBA52P8,chr16:48334471-48334854,383
11750586,11797258,chr16,ZC3H7A,chr16:11750586-11797258,46672
142133090,142135151,chr6,GJE1,chr6:142133090-142135151,2061
51335773,51364735,chr13,SERPINE3,chr13:51335773-51364735,28962
59893046,59950574,chr17,RPS6KB1,chr17:59893046-59950574,57528
63495799,63502536,chr7,SEPTIN7P5,chr7:63495799-63502536,6737
138701607,138703062,chr7,UQCRFS1P2,chr7:138701607-138703062,1455
149069641,149090782,chr7,ZNF786,chr7:149069641-149090782,21141
127519455,127591820,chr6,C6orf58,chr6:127519455-127591820,72365
95751319,95822726,chr5,GLRX,chr5:95751319-95822726,71407
135636086,135636713,chr6,HMGB1P17,chr6:135636086-135636713,627
61202350,61203220,chr8,NPM1P6,chr8:61202350-61203220,870
130538954,130546900,chr7,COPG2IT1,chr7:130538954-130546900,7946
78835307,78840525,chr8,LINC02605,chr8:78835307-78840525,5218
80594815,80595703,chr8,SLC25A51P3,chr8:80594815-80595703,888
76979245,76980451,chr15,KRT8P23,chr15:76979245-76980451,1206
89901849,89927888,chr8,OSGIN2,chr8:89901849-89927888,26039
162568379,162569728,chr6,KRT8P44,chr6:162568379-162569728,1349
122994704,122995700,chr7,TAS2R16,chr7:122994704-122995700,996
82988441,83011641,chr15,C15orf40,chr15:82988441-83011641,23200
132698783,132699667,chr6,CCNG1P1,chr6:132698783-132699667,884
101239458,101252316,chr7,FIS1,chr7:101239458-101252316,12858
135851701,136195574,chr6,PDE7B,chr6:135851701-136195574,343873
69083398,69085389,chr14,DDX18P1,chr14:69083398-69085389,1991
108288044,108339317,chr12,CMKLR1,chr12:108288044-108339317,51273
80111651,80256048,chr5,SERINC5,chr5:80111651-80256048,144397
30541776,30542188,chr14,SYF2P1,chr14:30541776-30542188,412
33056333,33063113,chr2,H2ACP2,chr2:33056333-33063113,6780
143800732,143817973,chr7,TCAF2P1,chr7:143800732-143817973,17241
30559158,30620064,chr14,G2E3,chr14:30559158-30620064,60906
42762481,42764261,chr2,OXER1,chr2:42762481-42764261,1780
27251362,27256691,chr13,RPL21,chr13:27251362-27256691,5329
78661047,78661576,chr15,RPL18P11,chr15:78661047-78661576,529
142636924,142637384,chr7,TRBV21-1,chr7:142636924-142637384,460
73420369,73747708,chr8,STAU2,chr8:73420369-73747708,327339
169702190,169704856,chr6,C6orf120,chr6:169702190-169704856,2666
150512559,150513839,chr7,STRADBP1,chr7:150512559-150513839,1280
143985142,143986651,chr7,SLC16A1P1,chr7:143985142-143986651,1509
65205108,65205988,chr2,VDAC2P5,chr2:65205108-65205988,880
89095959,89118071,chr6,SRSF12,chr6:89095959-89118071,22112
42463139,42463997,chr2,VDAC1P13,chr2:42463139-42463997,858
141656728,141702166,chr7,DENND11,chr7:141656728-141702166,45438
82130233,82262734,chr15,EFL1,chr15:82130233-82262734,132501
102012840,102062149,chr12,WASHC3,chr12:102012840-102062149,49309
44275458,44321494,chr2,SLC3A1,chr2:44275458-44321494,46036
141764097,141765197,chr7,TAS2R3,chr7:141764097-141765197,1100
158515605,158516229,chr6,CACYBPP3,chr6:158515605-158516229,624
142670740,142671244,chr7,TRBV25-1,chr7:142670740-142671244,504
158232236,158511828,chr6,TULP4,chr6:158232236-158511828,279592
55389700,55506691,chr16,MMP2,chr16:55389700-55506691,116991
97984684,97991169,chr7,OCM2,chr7:97984684-97991169,6485
144647186,144648575,chr7,EEF1A1P10,chr7:144647186-144648575,1389
142641746,142642196,chr7,TRBV22-1,chr7:142641746-142642196,450
64851642,64888296,chr11,EHD1,chr11:64851642-64888296,36654
142615716,142616415,chr7,TRBV18,chr7:142615716-142616415,699
149776042,149833979,chr7,SSPOP,chr7:149776042-149833979,57937
75025346,75052558,chr5,GCNT4,chr5:75025346-75052558,27212
36876769,37066413,chr5,NIPBL,chr5:36876769-37066413,189644
59565558,59608345,chr17,DHX40,chr17:59565558-59608345,42787
9986088,10007116,chr20,PARAL1,chr20:9986088-10007116,21028
9986126,10058303,chr20,ANKEF1,chr20:9986126-10058303,72177
132997551,132998040,chr6,RPL23AP46,chr6:132997551-132998040,489
136713871,136715188,chr7,PSMC1P3,chr7:136713871-136715188,1317
130853720,130930682,chr7,LINC00513,chr7:130853720-130930682,76962
168286905,168289350,chr6,CTAGE13P,chr6:168286905-168289350,2445
67737118,67754388,chr4,GNRHR,chr4:67737118-67754388,17270
54016479,54016777,chr6,ERHP2,chr6:54016479-54016777,298
74537835,74545430,chr12,ATXN7L3B,chr12:74537835-74545430,7595
64891137,64891246,chr11,MIR192,chr11:64891137-64891246,109
64891355,64891439,chr11,MIR194-2,chr11:64891355-64891439,84
34249481,34249958,chr12,AK6P1,chr12:34249481-34249958,477
169703902,169725566,chr6,PHF10,chr6:169703902-169725566,21664
120787320,120858402,chr7,TSPAN12,chr7:120787320-120858402,71082
122451470,122456725,chr4,IL2,chr4:122451470-122456725,5255
32104117,32107528,chr12,BICD1-AS1,chr12:32104117-32107528,3411
64894546,64917211,chr11,ATG2A,chr11:64894546-64917211,22665
101745499,101830959,chr12,GNPTAB,chr12:101745499-101830959,85460
90902218,90922584,chr15,MAN2A2,chr15:90902218-90922584,20366
102685747,102695044,chr13,METTL21C,chr13:102685747-102695044,9297
10172395,10308258,chr20,SNAP25,chr20:10172395-10308258,135863
102845831,102875995,chr13,ERCC5,chr13:102845831-102875995,30164
30683045,30683598,chr14,UBE2CP1,chr14:30683045-30683598,553
30791098,30791489,chr14,RPL12P5,chr14:30791098-30791489,391
98261384,98443858,chr4,RAP1GDS1,chr4:98261384-98443858,182474
51630313,52160017,chr17,CA10,chr17:51630313-52160017,529704
142308542,142309048,chr7,TRBV3-1,chr7:142308542-142309048,506
107044705,107161811,chr7,PRKAR2B,chr7:107044705-107161811,117106
30622291,30737694,chr14,SCFD1,chr14:30622291-30737694,115403
95972662,95996365,chr12,HAL,chr12:95972662-95996365,23703
64898363,64898437,chr11,MIR6750,chr11:64898363-64898437,74
64902387,64902455,chr11,MIR6749,chr11:64902387-64902455,68
64917553,64934475,chr11,PPP2R5B,chr11:64917553-64934475,16922
52552084,52652132,chr16,CASC16,chr16:52552084-52652132,100048
55846154,55956031,chr16,CES5A,chr16:55846154-55956031,109877
142384329,142384841,chr7,TRBV7-3,chr7:142384329-142384841,512
66383306,66392450,chr2,LINC01873,chr2:66383306-66392450,9144
142681415,142681869,chr7,TRBVA,chr7:142681415-142681869,454
149764182,149773588,chr7,ZNF467,chr7:149764182-149773588,9406
143060496,143341058,chr6,AIG1,chr6:143060496-143341058,280562
70810798,70811474,chr2,MOB4P1,chr2:70810798-70811474,676
69644425,69827112,chr2,ANXA4,chr2:69644425-69827112,182687
46414228,46459276,chr20,ZNF663P,chr20:46414228-46459276,45048
64934471,64935893,chr11,GPHA2,chr11:64934471-64935893,1422
46463719,46477232,chr20,MKRN7P,chr20:46463719-46477232,13513
46484461,46492640,chr20,ZNF840P,chr20:46484461-46492640,8179
46540946,46550654,chr20,OCSTAMP,chr20:46540946-46550654,9708
64937517,64972108,chr11,MAJIN,chr11:64937517-64972108,34591
46557823,46684467,chr20,SLC13A3,chr20:46557823-46684467,126644
129830732,129952960,chr7,UBE2H,chr7:129830732-129952960,122228
149594873,149648972,chr6,KATNA1,chr6:149594873-149648972,54099
64987945,64997018,chr11,BATF2,chr11:64987945-64997018,9073
65014160,65022184,chr11,ARL2,chr11:65014160-65022184,8024
16961936,17008222,chr22,GAB4,chr22:16961936-17008222,46286
66835117,66894751,chr17,CACNG5,chr17:66835117-66894751,59634
65018505,65018570,chr11,MIR6879,chr11:65018505-65018570,65
14333743,14343916,chr19,LINC01842,chr19:14333743-14343916,10173
64823052,64844653,chr11,CDC42BPG,chr11:64823052-64844653,21601
51153590,51171744,chr17,NME1-NME2,chr17:51153590-51171744,18154
52008031,52080987,chr5,LINC02118,chr5:52008031-52080987,72956
27978014,28679840,chr22,TTC28,chr22:27978014-28679840,701826
50969217,50970167,chr5,LINC02106,chr5:50969217-50970167,950
16031170,16042142,chr19,LINC00905,chr19:16031170-16042142,10972
81233320,81266398,chr5,CKMT2,chr5:81233320-81266398,33078
82836946,82986153,chr15,HOMER2,chr15:82836946-82986153,149207
142240740,142247067,chr7,MOXD2P,chr7:142240740-142247067,6327
79201245,79234738,chr6,HMGN3,chr6:79201245-79234738,33493
94280460,94293268,chr14,SERPINA10,chr14:94280460-94293268,12808
121873089,122062036,chr7,PTPRZ1,chr7:121873089-122062036,188947
4709569,4712421,chr11,OR51F5P,chr11:4709569-4712421,2852
4718612,4719559,chr11,OR51C4P,chr11:4718612-4719559,947
59952240,59964761,chr17,RNFT1,chr17:59952240-59964761,12521
4722740,4724171,chr11,KRT8P49,chr11:4722740-4724171,1431
23998401,24005453,chr22,GSTT4,chr22:23998401-24005453,7052
4736178,4737078,chr11,OR51F3P,chr11:4736178-4737078,900
4752046,4752944,chr11,OR51F4P,chr11:4752046-4752944,898
43041193,43043782,chr2,LINC02590,chr2:43041193-43043782,2589
4786754,4787705,chr11,OR51N1P,chr11:4786754-4787705,951
4793778,4795284,chr11,OR52Y1P,chr11:4793778-4795284,1506
4803433,4804380,chr11,OR52R1,chr11:4803433-4804380,947
94304248,94323389,chr14,SERPINA6,chr14:94304248-94323389,19141
9423651,9473101,chr2,CPSF3,chr2:9423651-9473101,49450
4830175,4833072,chr11,OR51A8P,chr11:4830175-4833072,2897
52487176,52493257,chr12,KRT6A,chr12:52487176-52493257,6081
112070663,112087529,chr6,TUBE1,chr6:112070663-112087529,16866
4859610,4863652,chr11,OR51H1,chr11:4859610-4863652,4042
41969443,41998221,chr22,SEPTIN3,chr22:41969443-41998221,28778
4871717,4878117,chr11,OR51H2P,chr11:4871717-4878117,6400
4889593,4890596,chr11,OR51A6P,chr11:4889593-4890596,1003
103043998,103066417,chr13,SLC10A2,chr13:103043998-103066417,22419
4923374,4924339,chr11,OR51G1,chr11:4923374-4924339,965
4937371,4938294,chr11,OR51A3P,chr11:4937371-4938294,923
4954772,4955713,chr11,OR51A2,chr11:4954772-4955713,941
4972943,4973884,chr11,OR51A5P,chr11:4972943-4973884,941
19523811,19553408,chr16,CCP110,chr16:19523811-19553408,29597
5015138,5016079,chr11,OR51P1P,chr11:5015138-5016079,941
5037013,5037951,chr11,OR52J2P,chr11:5037013-5037951,938
5046526,5047461,chr11,OR52J3,chr11:5046526-5047461,935
5058650,5059627,chr11,OR52E2,chr11:5058650-5059627,977
94364313,94366698,chr14,SERPINA2,chr14:94364313-94366698,2385
5069572,5070497,chr11,OR52E1,chr11:5069572-5070497,925
5076130,5077066,chr11,OR52S1P,chr11:5076130-5077066,936
5092676,5093611,chr11,OR52E3P,chr11:5092676-5093611,935
5104153,5105084,chr11,OR52J1P,chr11:5104153-5105084,931
5120621,5124513,chr11,OR52A4P,chr11:5120621-5124513,3892
94376747,94390693,chr14,SERPINA1,chr14:94376747-94390693,13946
14305458,14370196,chr19,LINC01841,chr19:14305458-14370196,64738
5170351,5171296,chr11,OR51A1P,chr11:5170351-5171296,945
61399843,61409466,chr17,TBX2,chr17:61399843-61409466,9623
17351450,17377342,chr19,PLVAP,chr19:17351450-17377342,25892
5225464,5229395,chr11,HBB,chr11:5225464-5229395,3931
111381867,111385638,chr12,HSPA8P14,chr12:111381867-111385638,3771
60479152,60630637,chr15,RORA-AS1,chr15:60479152-60630637,151485
20702127,20723098,chr13,IL17D,chr13:20702127-20723098,20971
61879318,61880772,chr12,KRT8P19,chr12:61879318-61880772,1454
72574120,72660669,chr5,LINC02056,chr5:72574120-72660669,86549
111766887,111817532,chr12,ALDH2,chr12:111766887-111817532,50645
163042557,163054161,chr6,PACRG-AS2,chr6:163042557-163054161,11604
60914407,60920653,chr9,SPATA31A5,chr9:60914407-60920653,6246
73052362,73069755,chr4,COX18,chr4:73052362-73069755,17393
118589070,118589634,chr6,SSXP10,chr6:118589070-118589634,564
37811589,37953827,chr5,GDNF-AS1,chr5:37811589-37953827,142238
56491492,56525925,chr20,GCNT7,chr20:56491492-56525925,34433
14927052,14928060,chr19,OR7A15P,chr19:14927052-14928060,1008
132552693,132553721,chr6,TAAR8,chr6:132552693-132553721,1028
69414697,69553865,chr17,MAP2K6,chr17:69414697-69553865,139168
40686183,40695107,chr15,RAD51-AS1,chr15:40686183-40695107,8924
5232678,5243657,chr11,HBD,chr11:5232678-5243657,10979
136249973,136306901,chr9,CCDC187,chr9:136249973-136306901,56928
62214960,62220278,chr20,HRH3,chr20:62214960-62220278,5318
15049480,15058293,chr19,CASP14,chr19:15049480-15058293,8813
163163830,163192038,chr6,PACRG-AS3,chr6:163163830-163192038,28208
69217760,69230158,chr5,MRPS36,chr5:69217760-69230158,12398
100530164,100589528,chr13,GGACT,chr13:100530164-100589528,59364
84980440,85139145,chr15,PDE8A,chr15:84980440-85139145,158705
17502043,17502363,chr5,H3P17,chr5:17502043-17502363,320
5241105,5243537,chr11,HBBP1,chr11:5241105-5243537,2432
43495073,43496454,chr5,EEF1A1P19,chr5:43495073-43496454,1381
5244554,5245546,chr11,BGLT3,chr11:5244554-5245546,992
56505209,56524959,chr4,ARL9,chr4:56505209-56524959,19750
17281645,17287646,chr19,ANKLE1,chr19:17281645-17287646,6001
5253188,5505605,chr11,HBG2,chr11:5253188-5505605,252417
20389530,20712644,chr20,RALGAPA2,chr20:20389530-20712644,323114
38845858,38945596,chr5,OSMR,chr5:38845858-38945596,99738
45192853,45201045,chr13,KCTD4,chr13:45192853-45201045,8192
42767089,42792593,chr2,HAAO,chr2:42767089-42792593,25504
112217716,112333664,chr9,PTBP3,chr9:112217716-112333664,115948
87671371,87696272,chr13,SLITRK5,chr13:87671371-87696272,24901
5268345,5505652,chr11,HBE1,chr11:5268345-5505652,237307
143843338,143863812,chr6,LTV1,chr6:143843338-143863812,20474
127917799,127966034,chr4,MFSD8,chr4:127917799-127966034,48235
47598654,47598996,chr16,NDUFA5P11,chr16:47598654-47598996,342
26062750,26063097,chr16,HSPE1P16,chr16:26062750-26063097,347
112690038,112887168,chr13,ATP11A,chr13:112690038-112887168,197130
112355841,112356714,chr6,RPSAP45,chr6:112355841-112356714,873
32413845,32464484,chr22,BPIFC,chr22:32413845-32464484,50639
5291761,5292380,chr11,OR51AB1P,chr11:5291761-5292380,619
94442464,94452800,chr14,SERPINA11,chr14:94442464-94452800,10336
52689626,52703524,chr12,KRT77,chr12:52689626-52703524,13898
10944564,11182186,chr16,CLEC16A,chr16:10944564-11182186,237622
5301014,5301946,chr11,OR51B4,chr11:5301014-5301946,932
159169400,159272108,chr6,FNDC1,chr6:159169400-159272108,102708
5303444,5505652,chr11,OR51B5,chr11:5303444-5505652,202208
91209494,91398155,chr8,SLC26A7,chr8:91209494-91398155,188661
94462717,94479689,chr14,SERPINA9,chr14:94462717-94479689,16972
53970838,54305300,chr2,ACYP2,chr2:53970838-54305300,334462
5314772,5315684,chr11,OR51B3P,chr11:5314772-5315684,912
5330592,5331360,chr11,OR51B8P,chr11:5330592-5331360,768
5351508,5352446,chr11,OR51B6,chr11:5351508-5352446,938
22644614,22647898,chr22,GGTLC2,chr22:22644614-22647898,3284
5402597,5403547,chr11,OR51J1,chr11:5402597-5403547,950
5422111,5423206,chr11,OR51Q1,chr11:5422111-5423206,1095
100573683,100628288,chr12,GAS2L3,chr12:100573683-100628288,54605
5430653,5431602,chr11,OR51K1P,chr11:5430653-5431602,949
5468486,5469422,chr11,OR51A10P,chr11:5468486-5469422,936
5488685,5489749,chr11,OR52D1,chr11:5488685-5489749,1064
5507300,5509958,chr11,UBQLN3,chr11:5507300-5509958,2658
66302613,66810743,chr17,PRKCA,chr17:66302613-66810743,508130
5514393,5518431,chr11,UBQLNL,chr11:5514393-5518431,4038
5518441,5524955,chr11,OLFM5P,chr11:5518441-5524955,6514
37051739,37063390,chr22,KCTD17,chr22:37051739-37063390,11651
5527277,5528174,chr11,OR52V1P,chr11:5527277-5528174,897
5551662,5552563,chr11,OR52H2P,chr11:5551662-5552563,901
5557096,5564327,chr11,OR52B5P,chr11:5557096-5564327,7231
5566678,5567616,chr11,OR52T1P,chr11:5566678-5567616,938
33104082,33167356,chr9,B4GALT1,chr9:33104082-33167356,63274
5571247,5572192,chr11,HNRNPA1P53,chr11:5571247-5572192,945
5580877,5581884,chr11,OR52B6,chr11:5580877-5581884,1007
52862525,52868083,chrX,XAGE3,chrX:52862525-52868083,5558
65625027,65630928,chr5,SHLD3,chr5:65625027-65630928,5901
5596109,5612958,chr11,TRIM6,chr11:5596109-5612958,16849
81270669,81312422,chr12,PPFIA2-AS1,chr12:81270669-81312422,41753
71055527,71056003,chr2,OR7E62P,chr2:71055527-71056003,476
17202274,17203145,chr5,DCAF13P2,chr5:17202274-17203145,871
1730070,1730474,chr3,RPL23AP39,chr3:1730070-1730474,404
132076990,132128020,chrX,FRMD7,chrX:132076990-132128020,51030
35542038,35557634,chr20,ERGIC3,chr20:35542038-35557634,15596
363370,385795,chr3,CHL1-AS1,chr3:363370-385795,22425
81972023,82276857,chr5,ATG10,chr5:81972023-82276857,304834
65500993,65502138,chr2,DNAJB12P1,chr2:65500993-65502138,1145
16051929,16052689,chr19,OR1AB1P,chr19:16051929-16052689,760
15141105,15142062,chr19,OR10B1P,chr19:15141105-15142062,957
13476982,13480053,chr3,HDAC11-AS1,chr3:13476982-13480053,3071
105558122,105653820,chr9,FKTN,chr9:105558122-105653820,95698
108294991,108526796,chr6,AFG1L,chr6:108294991-108526796,231805
94487274,94517844,chr14,SERPINA12,chr14:94487274-94517844,30570
60256720,60258411,chr17,SEPTIN7P12,chr17:60256720-60258411,1691
54245544,54270879,chr16,LINC02169,chr16:54245544-54270879,25335
63119559,63827843,chr2,WDPCP,chr2:63119559-63827843,708284
13816258,13880071,chr3,WNT7A,chr3:13816258-13880071,63813
19192229,19201869,chr19,RFXANK,chr19:19192229-19201869,9640
67927640,67932365,chr16,CTRL,chr16:67927640-67932365,4725
102712445,102717733,chrX,GPRASP2,chrX:102712445-102717733,5288
73067870,73068288,chr17,ATG12P1,chr17:73067870-73068288,418
51336646,51521401,chr17,LINC02073,chr17:51336646-51521401,184755
26971579,27014434,chr12,TM7SF3,chr12:26971579-27014434,42855
20343615,20357904,chr14,PARP2,chr14:20343615-20357904,14289
43654907,43746817,chrX,MAOA,chrX:43654907-43746817,91910
50481543,50486440,chr22,ADM2,chr22:50481543-50486440,4897
50543058,50555852,chr17,SPATA20,chr17:50543058-50555852,12794
196763,409417,chr3,CHL1,chr3:196763-409417,212654
3308565,3346652,chrX,MXRA5,chrX:3308565-3346652,38087
50486784,50490648,chr22,MIOX,chr22:50486784-50490648,3864
169740109,169751587,chr6,DYNLT2,chr6:169740109-169751587,11478
52579555,52581106,chr5,MFSD4BP1,chr5:52579555-52581106,1551
80960363,81230162,chr5,RASGRF2,chr5:80960363-81230162,269799
3367149,3368382,chrX,ASS1P4,chrX:3367149-3368382,1233
3271544,3290158,chrX,LINC01546,chrX:3271544-3290158,18614
82892390,83065841,chr6,UBE3D,chr6:82892390-83065841,173451
32915074,32915536,chr16,IGHV3OR16-6,chr16:32915074-32915536,462
49532177,49539538,chrX,GAGE12C,chrX:49532177-49539538,7361
19285731,19322145,chr16,CLEC19A,chr16:19285731-19322145,36414
49541733,49549094,chrX,GAGE12D,chrX:49541733-49549094,7361
5596725,5644398,chr11,TRIM6-TRIM34,chr11:5596725-5644398,47673
50390916,50395133,chr16,LINC02178,chr16:50390916-50395133,4217
35492324,35493446,chr16,C2orf69P2,chr16:35492324-35493446,1122
49551278,49568218,chrX,GAGE12F,chrX:49551278-49568218,16940
57404767,57416063,chr16,CCL17,chr16:57404767-57416063,11296
49551289,49558645,chrX,GAGE12E,chrX:49551289-49558645,7356
142695699,142696183,chr7,TRBV26,chr7:142695699-142696183,484
142320677,142321544,chr7,TRBV5-1,chr7:142320677-142321544,867
49539030,49558337,chr12,KCNH3,chr12:49539030-49558337,19307
98252379,98310441,chr7,BRI3,chr7:98252379-98310441,58062
65284496,65576345,chr16,LINC00922,chr16:65284496-65576345,291849
5689697,5737089,chr11,TRIM22,chr11:5689697-5737089,47392
49570400,49577754,chrX,GAGE12G,chrX:49570400-49577754,7354
73686089,74133929,chr13,KLF12,chr13:73686089-74133929,447840
105582258,105583256,chr7,YBX1P2,chr7:105582258-105583256,998
54542808,54559100,chr16,LINC02183,chr16:54542808-54559100,16292
134549110,134579875,chr7,AKR1B15,chr7:134549110-134579875,30765
49579949,49587301,chrX,GAGE12H,chrX:49579949-49587301,7352
79236332,79237206,chr15,HNRNPCP3,chr15:79236332-79237206,874
4734344,4749396,chr16,DNAAF8,chr16:4734344-4749396,15052
92281484,92282084,chr15,DUXAP6,chr15:92281484-92282084,600
49589496,49596824,chrX,GAGE2A,chrX:49589496-49596824,7328
37510892,37576380,chr9,FBXO10,chr9:37510892-37576380,65488
49599020,49608538,chrX,GAGE1,chrX:49599020-49608538,9518
132743870,132763459,chr6,VNN2,chr6:132743870-132763459,19589
48653711,48711226,chr13,CYSLTR2,chr13:48653711-48711226,57515
142386378,142386647,chr7,TRBV8-2,chr7:142386378-142386647,269
75346955,75357115,chr15,NEIL1,chr15:75346955-75357115,10160
150514872,150521073,chr7,GIMAP7,chr7:150514872-150521073,6201
50443219,50483923,chr22,SBF1,chr22:50443219-50483923,40704
49303646,49319841,chrX,GAGE10,chrX:49303646-49319841,16195
49636499,49708165,chr12,FMNL3,chr12:49636499-49708165,71666
49322037,49329384,chrX,GAGE12J,chrX:49322037-49329384,7347
91060333,91225632,chr14,DGLUCY,chr14:91060333-91225632,165299
140293693,140404433,chr7,SLC37A3,chr7:140293693-140404433,110740
61017225,61051990,chr2,PEX13,chr2:61017225-61051990,34765
35425364,35426483,chr16,C2orf69P3,chr16:35425364-35426483,1119
96985713,96994730,chr13,OXGR1,chr13:96985713-96994730,9017
36605779,36612557,chr20,RAB5IF,chr20:36605779-36612557,6778
48496990,48498601,chr16,MOCS1P1,chr16:48496990-48498601,1611
57471922,57487327,chr16,DOK4,chr16:57471922-57487327,15405
5719290,5720212,chr11,OR52U1P,chr11:5719290-5720212,922
49331582,49338949,chrX,GAGE13,chrX:49331582-49338949,7367
5736448,5738523,chr11,OR56B1,chr11:5736448-5738523,2075
5800364,5801297,chr11,OR52N3P,chr11:5800364-5801297,933
37582646,37592604,chr9,TOMM5,chr9:37582646-37592604,9958
5840928,5841952,chr11,OR52E6,chr11:5840928-5841952,1024
5873960,5874892,chr11,OR52E7P,chr11:5873960-5874892,932
99532628,99534611,chr5,GUSBP8,chr5:99532628-99534611,1983
5248269,5249857,chr11,HBG1,chr11:5248269-5249857,1588
77825747,77899271,chrX,MAGT1,chrX:77825747-77899271,73524
83531352,83581320,chr5,VCAN-AS1,chr5:83531352-83581320,49968
42333546,42425088,chr2,COX7A2L,chr2:42333546-42425088,91542
15944299,15950350,chr19,OR10H4,chr19:15944299-15950350,6051
3217944,3218813,chr11,MRGPRG,chr11:3217944-3218813,869
76075531,76075920,chr5,SAP18P1,chr5:76075531-76075920,389
3218332,3223131,chr11,MRGPRG-AS1,chr11:3218332-3223131,4799
19710472,19733112,chr19,ZNF14,chr19:19710472-19733112,22640
95838245,95860133,chr5,LINC01554,chr5:95838245-95860133,21888
75525214,75549439,chr13,COMMD6,chr13:75525214-75549439,24225
37636688,37637293,chr9,RAB1C,chr9:37636688-37637293,605
3225030,3232417,chr11,MRGPRE,chr11:3225030-3232417,7387
37650954,37746904,chr9,FRMPD1,chr9:37650954-37746904,95950
78675743,78805523,chr8,IL7,chr8:78675743-78805523,129780
3276045,3276390,chr11,NDUFA5P8,chr11:3276045-3276390,345
50081124,50115959,chr20,UBE2V1,chr20:50081124-50115959,34835
3321862,3322202,chr11,NDUFA5P1,chr11:3321862-3322202,340
65665928,65723035,chr5,SGTB,chr5:65665928-65723035,57107
3339261,3379222,chr11,ZNF195,chr11:3339261-3379222,39961
17334920,17342731,chr19,GTPBP3,chr19:17334920-17342731,7811
61824848,61854143,chr2,FAM161A,chr2:61824848-61854143,29295
8733802,8841808,chr3,CAV3,chr3:8733802-8841808,108006
41972763,41999094,chr15,PLA2G4E-AS1,chr15:41972763-41999094,26331
14877667,14877919,chr5,HNRNPKP5,chr5:14877667-14877919,252
34883057,34883520,chr5,RPL21P54,chr5:34883057-34883520,463
79432336,79472304,chr15,MINAR1,chr15:79432336-79472304,39968
100046977,100048785,chr5,MTND5P10,chr5:100046977-100048785,1808
32124716,32174319,chr5,GOLPH3,chr5:32124716-32174319,49603
28427963,28428444,chr3,CIAO2AP1,chr3:28427963-28428444,481
87598462,87601634,chr8,IARS2P1,chr8:87598462-87601634,3172
24430748,24431107,chr3,RPL31P20,chr3:24430748-24431107,359
7951263,8611924,chr3,LMCD1-AS1,chr3:7951263-8611924,660661
37661747,37662049,chr9,RN7SKP171,chr9:37661747-37662049,302
37753803,37778972,chr9,TRMT10B,chr9:37753803-37778972,25169
152637895,152657542,chrX,GABRQ,chrX:152637895-152657542,19647
98213402,98214121,chr5,PSME2P1,chr5:98213402-98214121,719
79762371,79767857,chr8,HEY1,chr8:79762371-79767857,5486
70803157,70803426,chr2,HMGN2P21,chr2:70803157-70803426,269
40825262,40835222,chr5,RPL37,chr5:40825262-40835222,9960
62507545,62507823,chr2,RPL37P13,chr2:62507545-62507823,278
84669538,84716460,chr15,SEC11A,chr15:84669538-84716460,46922
32525974,32570858,chr3,DYNC1LI1,chr3:32525974-32570858,44884
58251440,58252525,chr2,EIF3FP3,chr2:58251440-58252525,1085
152698767,152702347,chrX,MAGEA3,chrX:152698767-152702347,3580
70935900,70965431,chr2,ATP6V1B1,chr2:70935900-70965431,29531
52601467,52615305,chr12,KRT73-AS1,chr12:52601467-52615305,13838
80556755,80570280,chr5,ANKRD34B,chr5:80556755-80570280,13525
152714586,152718607,chrX,MAGEA2B,chrX:152714586-152718607,4021
170575295,170584692,chr6,PDCD2,chr6:170575295-170584692,9397
87169985,87170429,chr12,RPL23AP68,chr12:87169985-87170429,444
69585426,69601570,chr12,CCT2,chr12:69585426-69601570,16144
107195156,107195332,chr5,PSMC1P5,chr5:107195156-107195332,176
52377167,52416373,chr13,THSD1,chr13:52377167-52416373,39206
68944531,69042784,chr17,ABCA9-AS1,chr17:68944531-69042784,98253
77784881,77786003,chr5,ACTBP2,chr5:77784881-77786003,1122
57480018,57482811,chr5,ACTBL2,chr5:57480018-57482811,2793
81991995,81992481,chr5,ATG10-IT1,chr5:81991995-81992481,486
32358330,32439319,chr20,ASXL1,chr20:32358330-32439319,80989
103548855,103562790,chr5,NUDT12,chr5:103548855-103562790,13935
57758217,57863053,chr16,KIFC3,chr16:57758217-57863053,104836
152727484,152733735,chrX,CSAG1,chrX:152727484-152733735,6251
108994031,108995029,chr7,BUB3P1,chr7:108994031-108995029,998
108510233,108510976,chr7,RPL7P32,chr7:108510233-108510976,743
29087396,29088599,chr3,MESTP4,chr3:29087396-29088599,1203
54899387,54961956,chr17,TOM1L1,chr17:54899387-54961956,62569
152733757,152737669,chrX,MAGEA12,chrX:152733757-152737669,3912
141787815,141788640,chr7,TAS2R6P,chr7:141787815-141788640,825
52400004,52400099,chr13,RNY4P24,chr13:52400004-52400099,95
14144637,14165978,chr3,XPC-AS1,chr3:14144637-14165978,21341
37759234,37832117,chr9,EXOSC3,chr9:37759234-37832117,72883
39371675,39462300,chr5,DAB2,chr5:39371675-39462300,90625
52412602,52450634,chr13,VPS36,chr13:52412602-52450634,38032
152733827,152740985,chrX,CSAG4,chrX:152733827-152740985,7158
153449429,153449875,chr7,PAXBP1P1,chr7:153449429-153449875,446
107066591,107133733,chr7,PRKAR2B-AS1,chr7:107066591-107133733,67142
72942036,73075619,chr2,SFXN5,chr2:72942036-73075619,133583
152749863,152753884,chrX,MAGEA2,chrX:152749863-152753884,4021
27712910,27714005,chr3,LINC02084,chr3:27712910-27714005,1095
66114604,66154568,chr7,CRCP,chr7:66114604-66154568,39964
37800554,37867666,chr9,DCAF10,chr9:37800554-37867666,67112
32190747,32191627,chr3,RPSAP11,chr3:32190747-32191627,880
37143512,37143958,chr3,UBE2FP1,chr3:37143512-37143958,446
78268637,78558503,chr8,PKIA-AS1,chr8:78268637-78558503,289866
617789,618314,chr3,RPSAP32,chr3:617789-618314,525
37016523,37017014,chr3,RPL29P11,chr3:37016523-37017014,491
68293446,68293818,chr8,RPL31P40,chr8:68293446-68293818,372
27869883,27992673,chr8,SCARA5,chr8:27869883-27992673,122790
3390780,3391752,chr11,OR7E12P,chr11:3390780-3391752,972
3410352,3422496,chr11,FAM86GP,chr11:3410352-3422496,12144
152753921,152760222,chrX,CSAG3,chrX:152753921-152760222,6301
88467453,88480776,chr15,MRPS11,chr15:88467453-88480776,13323
3531420,3531608,chr11,SNRPCP5,chr11:3531420-3531608,188
3549745,3550519,chr11,RPS3AP39,chr11:3549745-3550519,774
37878116,37879493,chr9,PAICSP1,chr9:37878116-37879493,1377
152769764,152792268,chrX,MAGEA6-DT,chrX:152769764-152792268,22504
37879400,37904353,chr9,SLC25A51,chr9:37879400-37904353,24953
142088233,142089219,chr6,NMBR-AS1,chr6:142088233-142089219,986
3559657,3560022,chr11,RPS24P14,chr11:3559657-3560022,365
86086415,86087134,chr6,RPL7P27,chr6:86086415-86087134,719
10992186,11039247,chr3,SLC6A1,chr3:10992186-11039247,47061
152826994,152830757,chrX,CETN2,chrX:152826994-152830757,3763
114349483,114350648,chr6,DNAJA1P4,chr6:114349483-114350648,1165
37885683,37886390,chr9,TMX2P1,chr9:37885683-37886390,707
37915898,38069227,chr9,SHB,chr9:37915898-38069227,153329
120988697,121297442,chr7,CPED1,chr7:120988697-121297442,308745
152830967,152869729,chrX,NSDHL,chrX:152830967-152869729,38762
58978787,58994120,chr11,GLYATL1P1,chr11:58978787-58994120,15333
59042737,59050971,chr11,GLYATL1P4,chr11:59042737-59050971,8234
37936707,37936768,chr9,RNU7-124P,chr9:37936707-37936768,61
59086307,59094786,chr11,GLYATL1B,chr11:59086307-59094786,8479
90058608,90095475,chr8,CALB1,chr8:90058608-90095475,36867
131096476,131123152,chr9,AIF1L,chr9:131096476-131123152,26676
59107185,59127412,chr11,FAM111B,chr11:59107185-59127412,20227
153666627,153667318,chr6,MTATP6P31,chr6:153666627-153667318,691
34587288,34696859,chr6,ILRUN,chr6:34587288-34696859,109571
84507885,84516814,chr15,GOLGA6L5P,chr15:84507885-84516814,8929
59130133,59143015,chr11,FAM111A-DT,chr11:59130133-59143015,12882
152988824,152994116,chrX,PNMA5,chrX:152988824-152994116,5292
57172326,57189833,chr6,BAG2,chr6:57172326-57189833,17507
59171430,59208588,chr11,DTX4,chr11:59171430-59208588,37158
19668796,19683509,chr19,ZNF101,chr19:19668796-19683509,14713
112361437,112362722,chr6,KRT18P65,chr6:112361437-112362722,1285
152914442,152973481,chrX,ZNF185,chrX:152914442-152973481,59039
90966340,90988625,chr15,PRC1-AS1,chr15:90966340-90988625,22285
130013699,130141449,chr6,L3MBTL3,chr6:130013699-130141449,127750
17871945,17895174,chr19,SLC5A5,chr19:17871945-17895174,23229
64739891,64775589,chr15,RBPMS2,chr15:64739891-64775589,35698
59208510,59212927,chr11,MPEG1,chr11:59208510-59212927,4417
59214406,59214699,chr11,RN7SL42P,chr11:59214406-59214699,293
59255360,59259486,chr11,WARS1P1,chr11:59255360-59259486,4126
59263389,59263802,chr11,SLC25A47P1,chr11:59263389-59263802,413
52455429,52476628,chr13,CKAP2,chr13:52455429-52476628,21199
131126990,131127091,chr9,RNU6-881P,chr9:131126990-131127091,101
59291052,59291333,chr11,RN7SL435P,chr11:59291052-59291333,281
59309681,59310576,chr11,OR5AN2P,chr11:59309681-59310576,895
82686880,83134870,chr12,TMTC2,chr12:82686880-83134870,447990
59332757,59334086,chr11,OR5BR1P,chr11:59332757-59334086,1329
124104965,124111092,chr11,OR10N1P,chr11:124104965-124111092,6127
57173948,57264679,chr5,GPBP1,chr5:57173948-57264679,90731
90791741,90959393,chr8,NECAB1,chr8:90791741-90959393,167652
124115404,124147721,chr11,VWA5A,chr11:124115404-124147721,32317
131258076,131276510,chr9,FAM78A,chr9:131258076-131276510,18434
139340359,139423457,chr7,LUC7L2,chr7:139340359-139423457,83098
58150635,58150962,chr15,MTND3P12,chr15:58150635-58150962,327
91022619,91036611,chr15,VPS33B-DT,chr15:91022619-91036611,13992
71276561,71435069,chr2,ZNF638,chr2:71276561-71435069,158508
3667965,3682246,chr20,ADAM33,chr20:3667965-3682246,14281
17323223,17334855,chr19,ANO8,chr19:17323223-17334855,11632
12972843,12973438,chr9,PRDX1P1,chr9:12972843-12973438,595
77041404,77083984,chr15,TSPAN3,chr15:77041404-77083984,42580
13406380,13488125,chr9,LINC01235,chr9:13406380-13488125,81745
131009174,131094473,chr9,LAMC3,chr9:131009174-131094473,85299
86333274,86343429,chr8,WWP1-AS1,chr8:86333274-86343429,10155
85642777,85646325,chr8,REXO1L8P,chr8:85642777-85646325,3548
82291624,82292379,chr8,HNRNPA1P4,chr8:82291624-82292379,755
116482073,116521047,chr12,LINC02457,chr12:116482073-116521047,38974
105173297,105236203,chr12,APPL2,chr12:105173297-105236203,62906
142715346,142715861,chr7,TRBV27,chr7:142715346-142715861,515
93828753,93830964,chr4,ATOH1,chr4:93828753-93830964,2211
142645961,142646467,chr7,TRBV23-1,chr7:142645961-142646467,506
119135832,119187789,chr4,MYOZ2,chr4:119135832-119187789,51957
60141821,60142142,chr8,SLC2A13P1,chr8:60141821-60142142,321
142252143,142258058,chr7,PRSS58,chr7:142252143-142258058,5915
20267817,20268391,chr19,BNIP3P18,chr19:20267817-20268391,574
85656442,85663497,chr8,REXO1L1P,chr8:85656442-85663497,7055
84948585,84949674,chr8,ACTBP6,chr8:84948585-84949674,1089
94249253,94262350,chr8,GEM,chr8:94249253-94262350,13097
2269582,2418651,chr4,ZFYVE28,chr4:2269582-2418651,149069
133253073,134066589,chr7,EXOC4,chr7:133253073-134066589,813516
16185380,16192046,chr19,FAM32A,chr19:16185380-16192046,6666
131485665,131485750,chr9,SNORD62A,chr9:131485665-131485750,85
131490486,131490571,chr9,SNORD62B,chr9:131490486-131490571,85
131523801,131531264,chr9,UCK1,chr9:131523801-131531264,7463
91101832,91219236,chr8,LRRC69,chr8:91101832-91219236,117404
70829130,70854157,chr15,LARP6,chr15:70829130-70854157,25027
48691116,48691694,chr17,RPL9P28,chr17:48691116-48691694,578
52390515,52535701,chr17,LINC01982,chr17:52390515-52535701,145186
62841101,62841645,chr17,PRELID3BP3,chr17:62841101-62841645,544
66197693,66198238,chr17,PSMD7P1,chr17:66197693-66198238,545
80485619,80526265,chr8,ZBTB10,chr8:80485619-80526265,40646
17267376,17281249,chr19,BABAM1,chr19:17267376-17281249,13873
59964832,59996972,chr17,RNFT1-DT,chr17:59964832-59996972,32140
64761912,64762710,chr17,BPTFP1,chr17:64761912-64762710,798
90930180,90954093,chr15,UNC45A,chr15:90930180-90954093,23913
49495293,49515008,chr17,NGFR,chr17:49495293-49515008,19715
124158421,124159356,chr11,OR10D1P,chr11:124158421-124159356,935
124207183,124208112,chr11,OR8F1P,chr11:124207183-124208112,929
124238420,124239486,chr11,OR8G7P,chr11:124238420-124239486,1066
124273970,124274581,chr11,SLC5A4P1,chr11:124273970-124274581,611
24054946,24078810,chrX,EIF2S3,chrX:24054946-24078810,23864
747415,765012,chr11,TALDO1,chr11:747415-765012,17597
112365704,112367444,chr6,FEM1AP3,chr6:112365704-112367444,1740
111900305,111909420,chr6,LINC02527,chr6:111900305-111909420,9115
58660424,58692018,chr17,IGBP1P2,chr17:58660424-58692018,31594
137492199,137494394,chr6,OLIG3,chr6:137492199-137494394,2195
59976009,60002384,chr17,DHX40P1,chr17:59976009-60002384,26375
38675925,38703145,chr6,GLO1,chr6:38675925-38703145,27220
88032011,88328025,chr8,MMP16,chr8:88032011-88328025,296014
23983716,24027186,chrX,KLHL15,chrX:23983716-24027186,43470
72627231,72627624,chr17,RPL32P33,chr17:72627231-72627624,393
46021690,46060150,chr20,SLC12A5,chr20:46021690-46060150,38460
70902326,71022449,chr4,MOB1B,chr4:70902326-71022449,120123
131753746,131754252,chr7,NDUFB9P2,chr7:131753746-131754252,506
64631205,64631682,chr6,HNRNPDP2,chr6:64631205-64631682,477
66976520,66976991,chr9,FAM74A3,chr9:66976520-66976991,471
138404195,138404523,chr7,PTMAP10,chr7:138404195-138404523,328
151466012,151520120,chr7,RHEB,chr7:151466012-151520120,54108
57186992,57222307,chr6,RAB23,chr6:57186992-57222307,35315
66986304,66992583,chr9,SPATA31A3,chr9:66986304-66992583,6279
50862223,50867978,chr17,TOB1,chr17:50862223-50867978,5755
52482804,52489216,chr13,LINC00345,chr13:52482804-52489216,6412
10445310,10833654,chrX,MID1,chrX:10445310-10833654,388344
51312609,51335165,chr17,LINC02071,chr17:51312609-51335165,22556
87665345,87733269,chr5,LINC02144,chr5:87665345-87733269,67924
56451627,56481946,chr5,LINC01948,chr5:56451627-56481946,30319
767220,777488,chr11,GATD1,chr11:767220-777488,10268
111669852,111670362,chr12,PCNPP1,chr12:111669852-111670362,510
74694311,74712978,chr17,CD300LF,chr17:74694311-74712978,18667
94809962,94810057,chr9,MIR2278,chr9:94809962-94810057,95
53990624,54030823,chr12,HOXC6,chr12:53990624-54030823,40199
75556048,75565871,chr4,ODAPH,chr4:75556048-75565871,9823
95065350,95065446,chr9,MIR6081,chr9:95065350-95065446,96
95085208,95085304,chr9,MIR23B,chr9:95085208-95085304,96
80654652,80876815,chr5,MSH3,chr5:80654652-80876815,222163
95085445,95085541,chr9,MIR27B,chr9:95085445-95085541,96
95086014,95086094,chr9,MIR3074,chr9:95086014-95086094,80
90958471,90985238,chr8,C8orf88,chr8:90958471-90985238,26767
95086021,95086088,chr9,MIR24-1,chr9:95086021-95086088,67
27459555,27549913,chr16,GTF3C1,chr16:27459555-27549913,90358
95142449,95142541,chr9,RNA5SP288,chr9:95142449-95142541,92
173268160,173268233,chr4,MIR548T,chr4:173268160-173268233,73
127815013,127854658,chr9,ENG,chr9:127815013-127854658,39645
84162118,84162471,chr8,TPM3P3,chr8:84162118-84162471,353
54479597,54479963,chr8,TRMT112P7,chr8:54479597-54479963,366
173331376,173334432,chr4,HMGB2,chr4:173331376-173334432,3056
29956596,29958570,chr6,HLA-W,chr6:29956596-29958570,1974
86170447,86171018,chr6,RAB1AP2,chr6:86170447-86171018,571
52600119,52637446,chr13,MRPS31P4,chr13:52600119-52637446,37327
94567122,94650557,chr12,TMCC3,chr12:94567122-94650557,83435
86047109,86088621,chr8,PSKH2,chr8:86047109-86088621,41512
44962662,44979088,chr7,MYO1G,chr7:44962662-44979088,16426
149658153,149718105,chr6,LATS1,chr6:149658153-149718105,59952
52651305,52652279,chr13,SUGT1-DT,chr13:52651305-52652279,974
67571197,67589987,chr12,LINC02442,chr12:67571197-67589987,18790
52652709,52700909,chr13,SUGT1,chr13:52652709-52700909,48200
70051651,70071693,chr8,PRDM14,chr8:70051651-70071693,20042
67265842,67266966,chr12,GGTA2P,chr12:67265842-67266966,1124
24318349,24335093,chr14,ADCY4,chr14:24318349-24335093,16744
116548105,116576606,chr12,MAP1LC3B2,chr12:116548105-116576606,28501
55193882,55194786,chr12,OR10U1P,chr12:55193882-55194786,904
42081845,42144874,chr12,GXYLT1,chr12:42081845-42144874,63029
91070196,91087095,chr8,OTUD6B,chr8:91070196-91087095,16899
173369969,173377532,chr4,SAP30,chr4:173369969-173377532,7563
24076526,24169640,chr2,FAM228B,chr2:24076526-24169640,93114
50674415,50733298,chr22,SHANK3,chr22:50674415-50733298,58883
173384701,173406380,chr4,SCRG1,chr4:173384701-173406380,21679
53708517,53727745,chr12,CALCOCO1,chr12:53708517-53727745,19228
42826322,42827617,chr2,CHORDC1P1,chr2:42826322-42827617,1295
34616538,34617258,chr6,RPL7P25,chr6:34616538-34617258,720
147406889,147408281,chr6,YAP1P1,chr6:147406889-147408281,1392
173419245,173420137,chr4,RPL5P11,chr4:173419245-173420137,892
80470071,80470428,chr6,RPSAP72,chr6:80470071-80470428,357
173446603,173446704,chr4,RNU6-1096P,chr4:173446603-173446704,101
38587323,38588529,chr6,TFGP1,chr6:38587323-38588529,1206
173524969,173530229,chr4,HAND2,chr4:173524969-173530229,5260
153004459,153131282,chr6,RGS17,chr6:153004459-153131282,126823
50767501,50783667,chr22,RABL2B,chr22:50767501-50783667,16166
81280536,81284777,chr8,FABP5,chr8:81280536-81284777,4241
787115,790113,chr11,CEND1,chr11:787115-790113,2998
173615936,173616906,chr4,MORF4,chr4:173615936-173616906,970
173633728,173634371,chr4,RANP6,chr4:173633728-173634371,643
38293954,38377285,chr2,ATL2,chr2:38293954-38377285,83331
17552117,17552752,chr4,NACAP5,chr4:17552117-17552752,635
60488284,61229302,chr15,RORA,chr15:60488284-61229302,741018
168292830,168319777,chr6,DACT2,chr6:168292830-168319777,26947
17586267,17614585,chr4,MED28-DT,chr4:17586267-17614585,28318
17614641,17634105,chr4,MED28,chr4:17614641-17634105,19464
85172077,85177062,chr8,E2F5-DT,chr8:85172077-85177062,4985
58420167,58488408,chr17,HSF5,chr17:58420167-58488408,68241
19512418,19515548,chr19,TSSK6,chr19:19512418-19515548,3130
85826865,85828467,chr8,REXO1L6P,chr8:85826865-85828467,1602
790475,798281,chr11,SLC25A22,chr11:790475-798281,7806
19515736,19529054,chr19,NDUFA13,chr19:19515736-19529054,13318
52642431,52643773,chr13,HNRNPA1L2,chr13:52642431-52643773,1342
76406654,76524356,chr8,LINC01111,chr8:76406654-76524356,117702
117907264,118317676,chr6,SLC35F1,chr6:117907264-118317676,410412
67244837,67245806,chr17,HELZ-AS1,chr17:67244837-67245806,969
17629306,17781621,chr4,FAM184B,chr4:17629306-17781621,152315
138002324,138118305,chr7,AKR1D1,chr7:138002324-138118305,115981
65100812,65227703,chr17,RGS9,chr17:65100812-65227703,126891
68525517,68525906,chr8,RPS15AP25,chr8:68525517-68525906,389
105465867,105491034,chr13,DAOA,chr13:105465867-105491034,25167
72618722,72619383,chr8,HAUS1P3,chr8:72618722-72619383,661
29906543,29906909,chr6,DDX39BP1,chr6:29906543-29906909,366
127841112,127841222,chr9,RNA5SP296,chr9:127841112-127841222,110
127866486,127877675,chr9,AK1,chr9:127866486-127877675,11189
139371807,139374648,chr6,CITED2,chr6:139371807-139374648,2841
17800655,17810758,chr4,DCAF16,chr4:17800655-17810758,10103
19211958,19252233,chr19,NCAN,chr19:19211958-19252233,40275
17810979,17844865,chr4,NCAPG,chr4:17810979-17844865,33886
111660332,111873452,chr6,FYN,chr6:111660332-111873452,213120
120950763,120977216,chr7,ING3,chr7:120950763-120977216,26453
17613678,17682295,chr20,RRBP1,chr20:17613678-17682295,68617
33033863,33034810,chr3,SEC13P1,chr3:33033863-33034810,947
36767117,36784167,chr3,HSPD1P6,chr3:36767117-36784167,17050
68880139,69104242,chr8,LINC01592,chr8:68880139-69104242,224103
32620903,32621902,chr3,IGBP1P3,chr3:32620903-32621902,999
19276018,19320509,chr19,SUGP1,chr19:19276018-19320509,44491
14675141,14773036,chr3,C3orf20,chr3:14675141-14773036,97895
97221434,97394120,chr13,MBNL2,chr13:97221434-97394120,172686
85440596,85464915,chr8,CA3-AS1,chr8:85440596-85464915,24319
96039362,96093971,chr14,C14orf132,chr14:96039362-96093971,54609
91476382,91477018,chr5,RAB5CP2,chr5:91476382-91477018,636
80319625,80321842,chr5,SPZ1,chr5:80319625-80321842,2217
93213302,93700433,chr8,CIBAR1-DT,chr8:93213302-93700433,487131
76310712,76501837,chr14,ESRRB,chr14:76310712-76501837,191125
17841199,18021876,chr4,LCORL,chr4:17841199-18021876,180677
61889839,61894206,chr8,LINC02155,chr8:61889839-61894206,4367
1612337,1677908,chr16,CRAMP1,chr16:1612337-1677908,65571
67179613,67196799,chr5,CD180,chr5:67179613-67196799,17186
127869415,127869495,chr9,MIR4672,chr9:127869415-127869495,80
127907886,127917041,chr9,ST6GALNAC4,chr9:127907886-127917041,9155
93857807,93926068,chr8,PDP1,chr8:93857807-93926068,68261
80500332,80501400,chr5,RPL7P24,chr5:80500332-80501400,1068
35852695,35879603,chr5,IL7R,chr5:35852695-35879603,26908
17911674,17912976,chr4,KRT18P63,chr4:17911674-17912976,1302
150568417,150673143,chrX,MTM1,chrX:150568417-150673143,104726
84980073,84980547,chr8,JCHAINP1,chr8:84980073-84980547,474
64665607,64666064,chr2,RPS10P9,chr2:64665607-64666064,457
139015781,139045939,chr4,NOCT,chr4:139015781-139045939,30158
96204679,96244166,chr14,BDKRB2,chr14:96204679-96244166,39487
72019917,72075584,chr8,TRPA1,chr8:72019917-72075584,55667
70257386,70281185,chr2,PCYOX1,chr2:70257386-70281185,23799
139055475,139055578,chr4,RNU6-531P,chr4:139055475-139055578,103
139100377,139100658,chr4,RN7SL382P,chr4:139100377-139100658,281
34872641,34873854,chr3,FECHP1,chr3:34872641-34873854,1213
139114930,139115374,chr4,PPP1R14BP3,chr4:139114930-139115374,444
129502531,129512918,chr7,SMKR1,chr7:129502531-129512918,10387
23117306,23119255,chr14,CEBPE,chr14:23117306-23119255,1949
139185441,139185746,chr4,RN7SL311P,chr4:139185441-139185746,305
139231026,139231119,chr4,RNU6-506P,chr4:139231026-139231119,93
61729765,61731389,chr15,LINC02349,chr15:61729765-61731389,1624
33793644,33798539,chr3,PDCD6IP-DT,chr3:33793644-33798539,4895
127920881,127930785,chr9,PIP5KL1,chr9:127920881-127930785,9904
139256657,139256760,chr4,RNU6-1074P,chr4:139256657-139256760,103
142711384,142711924,chr7,TRBVB,chr7:142711384-142711924,540
139266165,139280225,chr4,MGARP,chr4:139266165-139280225,14060
89124871,89619149,chr14,FOXN3,chr14:89124871-89619149,494278
28348721,28538122,chr3,ZCWPW2,chr3:28348721-28538122,189401
142389202,142389668,chr7,TRBV5-3,chr7:142389202-142389668,466
136485656,136488317,chr7,ZP3P2,chr7:136485656-136488317,2661
40035690,40039181,chr15,SRP14,chr15:40035690-40039181,3491
107660828,107717809,chr7,SLC26A4,chr7:107660828-107717809,56981
139266880,139302551,chr4,NDUFC1,chr4:139266880-139302551,35671
116169045,116169258,chr12,SNRPGP18,chr12:116169045-116169258,213
86617928,86620962,chr5,COX7C,chr5:86617928-86620962,3034
52862121,52899588,chr17,LINC02089,chr17:52862121-52899588,37467
52168996,52192014,chr12,KRT80,chr12:52168996-52192014,23018
66964707,67033398,chr17,CACNG4,chr17:66964707-67033398,68691
59709993,59755026,chr16,APOOP5,chr16:59709993-59755026,45033
68002432,68004952,chr16,KARS1P3,chr16:68002432-68004952,2520
15166914,15561334,chr2,NBAS,chr2:15166914-15561334,394420
109707,197341,chr3,CHL1-AS2,chr3:109707-197341,87634
19501693,19522123,chr16,GDE1,chr16:19501693-19522123,20430
48929316,48944842,chr17,SNF8,chr17:48929316-48944842,15526
10566255,10570375,chr3,ATP2B2-IT1,chr3:10566255-10570375,4120
1905651,1906125,chr3,RPL21P17,chr3:1905651-1906125,474
68159218,68159893,chr5,EEF1B2P2,chr5:68159218-68159893,675
65442463,65517704,chr15,DPP8,chr15:65442463-65517704,75241
10816201,10940714,chr3,SLC6A11,chr3:10816201-10940714,124513
71828167,72118393,chr8,MSC-AS1,chr8:71828167-72118393,290226
127935099,127937854,chr9,DPM2,chr9:127935099-127937854,2755
152644776,152676141,chr7,XRCC2,chr7:152644776-152676141,31365
19145569,19192158,chr19,BORCS8-MEF2B,chr19:19145569-19192158,46589
64449106,64505213,chr14,ZBTB25,chr14:64449106-64505213,56107
32646564,32651976,chr5,LINC02061,chr5:32646564-32651976,5412
95768999,95770700,chr5,HSPD1P11,chr5:95768999-95770700,1701
86746818,86749777,chr5,LINC02059,chr5:86746818-86749777,2959
151556124,151877125,chr7,PRKAG2,chr7:151556124-151877125,321001
35044907,35113130,chr14,FAM177A1,chr14:35044907-35113130,68223
64506015,64612319,chr5,RGS7BP,chr5:64506015-64612319,106304
139301505,139420033,chr4,NAA15,chr4:139301505-139420033,118528
127940582,127980989,chr9,FAM102A,chr9:127940582-127980989,40407
2110409,2144241,chr3,CNTN4-AS2,chr3:2110409-2144241,33832
29797652,29797825,chr3,MTND4LP9,chr3:29797652-29797825,173
35650197,35651961,chr3,ARPP21-AS1,chr3:35650197-35651961,1764
106910757,106911109,chr12,RPL30P12,chr12:106910757-106911109,352
94127162,94217303,chr8,CDH17,chr8:94127162-94217303,90141
425649,523011,chr16,RAB11FIP3,chr16:425649-523011,97362
71754863,71800286,chr12,RAB21,chr12:71754863-71800286,45423
84999812,85000315,chr5,PPIAP79,chr5:84999812-85000315,503
80947694,80960907,chr5,RASGRF2-AS1,chr5:80947694-80960907,13213
31532638,31637616,chr3,STT3B,chr3:31532638-31637616,104978
40240167,40267657,chr5,LINC00604,chr5:40240167-40267657,27490
14797125,14798400,chr5,RBBP4P1,chr5:14797125-14798400,1275
99981784,99986765,chr13,ZIC2,chr13:99981784-99986765,4981
150766336,150898816,chrX,CD99L2,chrX:150766336-150898816,132480
43558968,43588237,chr20,SGK2,chr20:43558968-43588237,29269
55935095,55995022,chr5,IL6ST,chr5:55935095-55995022,59927
42140203,42149455,chr22,CYP2D7,chr22:42140203-42149455,9252
96639577,96655317,chr9,PRXL2C,chr9:96639577-96655317,15740
99994899,99997909,chr13,LINC00554,chr13:99994899-99997909,3010
15451624,15464544,chr19,RASAL3,chr19:15451624-15464544,12920
52543909,52553145,chr12,KRT71,chr12:52543909-52553145,9236
22773222,22829820,chr14,SLC7A7,chr14:22773222-22829820,56598
100027769,100028174,chr13,NDUFA12P1,chr13:100027769-100028174,405
100062296,100063601,chr13,ASNSP3,chr13:100062296-100063601,1305
100150481,100151092,chr13,RPL15P18,chr13:100150481-100151092,611
66212033,66256525,chr17,APOH,chr17:66212033-66256525,44492
99962964,99971767,chr13,ZIC5,chr13:99962964-99971767,8803
131628442,131747418,chr6,ENPP3,chr6:131628442-131747418,118976
103843749,103930211,chr12,TTC41P,chr12:103843749-103930211,86462
96816269,96875623,chr9,ZNF782,chr9:96816269-96875623,59354
27545913,27620529,chr13,LNX2,chr13:27545913-27620529,74616
7519741,7560333,chr3,GRM7-AS1,chr3:7519741-7560333,40592
54365996,54370794,chr16,LINC02140,chr16:54365996-54370794,4798
73334384,73644445,chr17,SDK2,chr17:73334384-73644445,310061
16257061,16264969,chr3,DPH3,chr3:16257061-16264969,7908
96910076,96910405,chr9,PTMAP11,chr9:96910076-96910405,329
27224994,27268772,chr16,NSMCE1,chr16:27224994-27268772,43778
96928310,96940253,chr9,NUTM2G,chr9:96928310-96940253,11943
95867048,95942635,chr12,CCDC38,chr12:95867048-95942635,75587
27916774,28059268,chr3,LINC01967,chr3:27916774-28059268,142494
27696393,27697204,chr13,NPM1P4,chr13:27696393-27697204,811
308714,309322,chr3,RPS8P6,chr3:308714-309322,608
20923222,20950697,chr19,ZNF85,chr19:20923222-20950697,27475
28794555,28800597,chr22,XBP1,chr22:28794555-28800597,6042
27792483,27794768,chr13,GSX1,chr13:27792483-27794768,2285
33150043,33218810,chr3,SUSD5,chr3:33150043-33218810,68767
27819376,27917298,chr13,PLUT,chr13:27819376-27917298,97922
27828763,27828869,chr13,RNU6-73P,chr13:27828763-27828869,106
96954820,96955461,chr9,YRDCP2,chr9:96954820-96955461,641
116285829,116288769,chr9,PAPPA-AS2,chr9:116285829-116288769,2940
27920000,27926313,chr13,PDX1,chr13:27920000-27926313,6313
27830886,27834136,chr3,LINC01981,chr3:27830886-27834136,3250
116398157,116400606,chr9,PAPPA-AS1,chr9:116398157-116400606,2449
139318378,139318486,chr4,RNU6-1214P,chr4:139318378-139318486,108
116504283,116562293,chr9,ASTN2-AS1,chr9:116504283-116562293,58010
23134372,23134824,chr3,RPL24P7,chr3:23134372-23134824,452
139453232,139476609,chr4,RAB33B,chr4:139453232-139476609,23377
16802651,17090604,chr3,PLCL2,chr3:16802651-17090604,287953
65842752,65843331,chr8,PDE7A-DT,chr8:65842752-65843331,579
150818753,150819246,chrX,PPIAP91,chrX:150818753-150819246,493
46112749,46112822,chr22,MIRLET7A3,chr22:46112749-46112822,73
46113566,46113657,chr22,MIR4763,chr22:46113566-46113657,91
46113686,46113768,chr22,MIRLET7B,chr22:46113686-46113768,82
57216794,57226449,chr12,NXPH4,chr12:57216794-57226449,9655
117180628,117181095,chr9,RPL10P3,chr9:117180628-117181095,467
46150521,46243755,chr22,PPARA,chr22:46150521-46243755,93234
71144821,71175255,chrX,NLGN3,chrX:71144821-71175255,30434
95066808,95073182,chr8,MIR3150BHG,chr8:95066808-95073182,6374
117181066,117181200,chr9,SNORA70C,chr9:117181066-117181200,134
117197118,117197420,chr9,RN7SKP128,chr9:117197118-117197420,302
117276985,117277286,chr9,RN7SKP125,chr9:117276985-117277286,301
122120082,122120167,chr9,MIR4478,chr9:122120082-122120167,85
122144058,122159779,chr9,NDUFA8,chr9:122144058-122159779,15721
85802574,85806435,chr8,REXO1L4P,chr8:85802574-85806435,3861
1692731,1712344,chr4,SLBP,chr4:1692731-1712344,19613
91917507,91917918,chr8,MRPS16P1,chr8:91917507-91917918,411
27620742,27744237,chr13,POLR1D,chr13:27620742-27744237,123495
111405923,111451623,chr12,SH2B3,chr12:111405923-111451623,45700
20776304,20809995,chr19,ZNF66,chr19:20776304-20809995,33691
58583508,58659853,chr8,NSMAF,chr8:58583508-58659853,76345
122159908,122200088,chr9,MORN5,chr9:122159908-122200088,40180
50450179,50450725,chr17,MRPS21P9,chr17:50450179-50450725,546
69577251,69903000,chr17,LINC01483,chr17:69577251-69903000,325749
48577524,48578369,chr16,RPS2P44,chr16:48577524-48578369,845
16496394,16521352,chr19,C19orf44,chr19:16496394-16521352,24958
21412218,22373321,chr3,ZNF385D,chr3:21412218-22373321,961103
57358783,57366189,chr16,CCL22,chr16:57358783-57366189,7406
122237622,122264840,chr9,RBM18,chr9:122237622-122264840,27218
45293445,45308529,chr20,MATN4,chr20:45293445-45308529,15084
46244011,46250311,chr22,CDPF1,chr22:46244011-46250311,6300
55566684,55567687,chr16,CAPNS2,chr16:55566684-55567687,1003
122264603,122331337,chr9,MRRF,chr9:122264603-122331337,66734
1507322,1507598,chr6,RN7SL352P,chr6:1507322-1507598,276
1390314,1390411,chr6,MIR6720,chr6:1390314-1390411,97
63730205,63755884,chr16,LINC02165,chr16:63730205-63755884,25679
4427963,4428081,chr6,RNA5SP202,chr6:4427963-4428081,118
5148233,5148322,chr6,MIR3691,chr6:5148233-5148322,89
10222036,10222161,chr6,RNU6ATAC21P,chr6:10222036-10222161,125
6938606,6938897,chr6,RN7SL554P,chr6:6938606-6938897,291
67044554,67056797,chr17,CACNG1,chr17:67044554-67056797,12243
89419718,89526047,chr12,POC1B,chr12:89419718-89526047,106329
14646535,14646638,chr6,RNU6-793P,chr6:14646535-14646638,103
11503509,11503671,chr6,RNU1-64P,chr6:11503509-11503671,162
15314920,15315026,chr6,RNU6-522P,chr6:15314920-15315026,106
10439717,10439794,chr6,MIR5689,chr6:10439717-10439794,77
52005487,52078474,chr16,LINC02911,chr16:52005487-52078474,72987
16141556,16141624,chr6,MIR4639,chr6:16141556-16141624,68
15324367,15324472,chr6,RNU6-645P,chr6:15324367-15324472,105
74748628,74769353,chr17,SLC9A3R1,chr17:74748628-74769353,20725
18571784,18571880,chr6,MIR548A1,chr6:18571784-18571880,96
14156462,14156523,chr6,RNU7-133P,chr6:14156462-14156523,61
15112968,15113221,chr6,RN7SL332P,chr6:15112968-15113221,253
12406486,12406781,chr6,RN7SKP293,chr6:12406486-12406781,295
17721786,17721903,chr6,RNA5SP204,chr6:17721786-17721903,117
33956972,34677247,chr3,LINC01811,chr3:33956972-34677247,720275
18306973,18307079,chr6,RNU6-263P,chr6:18306973-18307079,106
25383599,25383702,chr6,RNU6-987P,chr6:25383599-25383702,103
16205014,16205120,chr6,RNU6-1114P,chr6:16205014-16205120,106
20421583,20421887,chr6,RN7SL128P,chr6:20421583-20421887,304
42553617,42574382,chr22,SERHL2,chr22:42553617-42574382,20765
20452369,20452473,chr6,RNU6-141P,chr6:20452369-20452473,104
23124981,23125087,chr6,RNU6-1060P,chr6:23124981-23125087,106
28977475,28977773,chr6,RN7SL471P,chr6:28977475-28977773,298
22085544,22085918,chr6,RN7SKP240,chr6:22085544-22085918,374
28410270,28410456,chr6,RNU2-45P,chr6:28410270-28410456,186
19438283,19438418,chr6,RNA5SP205,chr6:19438283-19438418,135
25031009,25031287,chr6,RN7SL334P,chr6:25031009-25031287,278
46698940,46822804,chr2,LINC01118,chr2:46698940-46822804,123864
60358455,60359480,chr16,NPAP1L,chr16:60358455-60359480,1025
19642425,19642529,chr6,RNU6-801P,chr6:19642425-19642529,104
20993474,20993568,chr6,RNU6-150P,chr6:20993474-20993568,94
65327988,65331233,chrX,MORF4L1P5,chrX:65327988-65331233,3245
28915645,28915744,chr6,RNU6-930P,chr6:28915645-28915744,99
33899135,33899200,chr6,MIR7159,chr6:33899135-33899200,65
65356890,65357547,chrX,PRXL2CP1,chrX:65356890-65357547,657
34240673,34240736,chr6,MIR6835,chr6:34240673-34240736,63
47965620,47971693,chr16,LINC02134,chr16:47965620-47971693,6073
33698128,33698234,chr6,MIR3934,chr6:33698128-33698234,106
65366638,65507887,chrX,ZC3H12B,chrX:65366638-65507887,141249
36622436,36622512,chr6,MIR3925,chr6:36622436-36622512,76
36450912,36451201,chr6,RN7SL502P,chr6:36450912-36451201,289
34685355,34685642,chr6,RN7SL200P,chr6:34685355-34685642,287
1715952,1721358,chr4,TMEM129,chr4:1715952-1721358,5406
36639545,36639672,chr6,RNU1-88P,chr6:36639545-36639672,127
150541754,150542098,chr7,ALDH7A1P3,chr7:150541754-150542098,344
33540694,33541000,chr6,RN7SL26P,chr6:33540694-33541000,306
59088837,59089091,chr16,RPS27P27,chr16:59088837-59089091,254
133727368,133727734,chr7,COX5BP3,chr7:133727368-133727734,366
37361185,37361483,chr6,RN7SL273P,chr6:37361185-37361483,298
33999972,34000051,chr6,MIR1275,chr6:33999972-34000051,79
21063924,21064261,chr19,VN1R80P,chr19:21063924-21064261,337
37832922,37833185,chr6,RN7SL285P,chr6:37832922-37833185,263
64735925,64737283,chr16,PPIAP48,chr16:64735925-64737283,1358
151501878,151503463,chr7,ETF1P2,chr7:151501878-151503463,1585
41239520,41239626,chr6,RNA5SP207,chr6:41239520-41239626,106
15508525,15552317,chr19,CYP4F22,chr19:15508525-15552317,43792
37915573,37915742,chr6,RNVU1-33,chr6:37915573-37915742,169
67337916,67366605,chr17,PSMD12,chr17:67337916-67366605,28689
51755325,51788208,chr16,LINC01571,chr16:51755325-51788208,32883
41302466,41302572,chr6,RNU6-643P,chr6:41302466-41302572,106
141704003,141738346,chr7,WEE2-AS1,chr7:141704003-141738346,34343
55547292,55618880,chr2,PPP4R3B,chr2:55547292-55618880,71588
39620345,39620464,chr6,RNU1-54P,chr6:39620345-39620464,119
36522191,36522501,chr6,RN7SL748P,chr6:36522191-36522501,310
43434542,43434620,chr6,MIR6780B,chr6:43434542-43434620,78
44209766,44210063,chr6,RN7SL811P,chr6:44209766-44210063,297
46018745,46018851,chr6,RNU6-754P,chr6:46018745-46018851,106
38744086,38744386,chr6,RN7SL465P,chr6:38744086-38744386,300
44254206,44254285,chr6,MIR4647,chr6:44254206-44254285,79
65438549,65534810,chrX,LAS1L,chrX:65438549-65534810,96261
40407853,40407955,chr6,RNU6-250P,chr6:40407853-40407955,102
44435641,44435722,chr6,MIR4642,chr6:44435641-44435722,81
51277852,51279112,chr16,UNGP1,chr16:51277852-51279112,1260
43474186,43474292,chr6,RNU6-1113P,chr6:43474186-43474292,106
52144349,52144434,chr6,MIR206,chr6:52144349-52144434,85
45197674,45197770,chr6,MIR586,chr6:45197674-45197770,96
52148923,52149041,chr6,MIR133B,chr6:52148923-52149041,118
53276993,53277071,chr6,MIR5685,chr6:53276993-53277071,78
49344800,49344861,chr6,RNU7-65P,chr6:49344800-49344861,61
67846923,67872567,chr16,NUTF2,chr16:67846923-67872567,25644
53219261,53219424,chr6,RNU1-136P,chr6:53219261-53219424,163
51975673,51975959,chr6,RN7SL580P,chr6:51975673-51975959,286
67467231,67467308,chr6,RNA5SP208,chr6:67467231-67467308,77
54786387,54786492,chr6,RNU6-1023P,chr6:54786387-54786492,105
66728843,66728904,chr6,RNU7-66P,chr6:66728843-66728904,61
3981981,3984295,chr3,PNPT1P1,chr3:3981981-3984295,2314
76446988,76447089,chr6,RNU6-261P,chr6:76446988-76447089,101
57390132,57390212,chr6,MIR548U,chr6:57390132-57390212,80
71403551,71403621,chr6,MIR30A,chr6:71403551-71403621,70
71376960,71377031,chr6,MIR30C2,chr6:71376960-71377031,71
76557653,76557754,chr6,RNU6-84P,chr6:76557653-76557754,101
108207439,108218368,chr13,LIG4,chr13:108207439-108218368,10929
75768059,75768158,chr6,RNU6-155P,chr6:75768059-75768158,99
1811479,1856156,chr4,LETM1,chr4:1811479-1856156,44677
75593055,75593145,chr6,RNU6-1338P,chr6:75593055-75593145,90
75865239,75865335,chr6,RNA5SP209,chr6:75865239-75865335,96
67546651,67546754,chr6,RNU6-280P,chr6:67546651-67546754,103
18137228,18188387,chr20,KAT14,chr20:18137228-18188387,51159
8775402,8963773,chr3,RAD18,chr3:8775402-8963773,188371
82210338,82210440,chr6,RNU6-130P,chr6:82210338-82210440,102
53415294,53415607,chr6,RN7SKP256,chr6:53415294-53415607,313
81622200,81622319,chr6,RNA5SP210,chr6:81622200-81622319,119
89063500,89063690,chr6,RNU2-61P,chr6:89063500-89063690,190
71182612,71182718,chr6,RNU6-411P,chr6:71182612-71182718,106
19528861,19537581,chr19,YJEFN3,chr19:19528861-19537581,8720
76092834,76092940,chr6,RNU6-248P,chr6:76092834-76092940,106
86435848,86436138,chr6,RN7SL643P,chr6:86435848-86436138,290
91739609,91739897,chr6,RN7SL415P,chr6:91739609-91739897,288
91521660,91521737,chr6,MIR4643,chr6:91521660-91521737,77
99124609,99124696,chr6,MIR548AI,chr6:99124609-99124696,87
87083233,87083536,chr6,RN7SKP209,chr6:87083233-87083536,303
96914699,96914995,chr6,RN7SL509P,chr6:96914699-96914995,296
141790217,141791367,chr7,TAS2R5,chr7:141790217-141791367,1150
809965,812880,chr11,RPLP2,chr11:809965-812880,2915
71652474,71652611,chr6,RNU4-66P,chr6:71652474-71652611,137
96282567,96282863,chr6,RN7SL797P,chr6:96282567-96282863,296
142328297,142328786,chr7,TRBV6-1,chr7:142328297-142328786,489
70513294,70513356,chr6,RNU7-48P,chr6:70513294-70513356,62
107133071,107133170,chr6,RNU6-1299P,chr6:107133071-107133170,99
142300924,142301432,chr7,TRBV2,chr7:142300924-142301432,508
98024531,98024621,chr6,MIR2113,chr6:98024531-98024621,90
105045562,105045668,chr6,RNU6-1106P,chr6:105045562-105045668,106
108252401,108252507,chr6,RNA5SP212,chr6:108252401-108252507,106
133732493,133733595,chr7,RPS3AP27,chr7:133732493-133733595,1102
90312742,90312833,chr6,MIR4464,chr6:90312742-90312833,91
106271634,106271720,chr6,U4,chr6:106271634-106271720,86
106283413,106283711,chr6,RN7SL47P,chr6:106283413-106283711,298
106304176,106304286,chr6,RNU6-344P,chr6:106304176-106304286,110
110722250,110722348,chr6,RNU6-957P,chr6:110722250-110722348,98
121325367,121341104,chr7,WNT16,chr7:121325367-121341104,15737
107930088,107930182,chr6,RNU6-437P,chr6:107930088-107930182,94
112971493,112971599,chr6,RNU6-1163P,chr6:112971493-112971599,106
120526294,120526400,chr6,RNU6-214P,chr6:120526294-120526400,106
111091213,111091332,chr6,RNU6-960P,chr6:111091213-111091332,119
15778275,15853232,chr4,CD38,chr4:15778275-15853232,74957
75644084,75644177,chr6,RNU6-1016P,chr6:75644084-75644177,93
53180704,53195142,chr12,ZNF740,chr12:53180704-53195142,14438
117299364,117299638,chr6,RN7SKP18,chr6:117299364-117299638,274
104766822,104766926,chr6,RNU6-897P,chr6:104766822-104766926,104
75654970,75655299,chr6,RN7SKP163,chr6:75654970-75655299,329
85191438,85213905,chr15,CSPG4P12,chr15:85191438-85213905,22467
120686621,120686742,chr6,RNA5SP215,chr6:120686621-120686742,121
112196440,112196546,chr6,RNU6-1226P,chr6:112196440-112196546,106
117301455,117301758,chr6,RN7SKP51,chr6:117301455-117301758,303
109305494,109305595,chr6,RNY3P11,chr6:109305494-109305595,101
13105706,13279692,chr9,MPDZ,chr9:13105706-13279692,173986
89478141,89478433,chr6,RN7SL11P,chr6:89478141-89478433,292
74770529,74776367,chr17,NAT9,chr17:74770529-74776367,5838
125875168,125875498,chr6,RN7SKP56,chr6:125875168-125875498,330
117457734,117457838,chr6,RNU6-253P,chr6:117457734-117457838,104
126484631,126484713,chr6,MIR588,chr6:126484631-126484713,82
126590287,126590393,chr6,RNU6-200P,chr6:126590287-126590393,106
121542486,121542626,chr6,RNU4-76P,chr6:121542486-121542626,140
121354354,121354460,chr6,RNU6-1286P,chr6:121354354-121354460,106
120015179,120015257,chr6,MIR3144,chr6:120015179-120015257,78
125979812,125979934,chr6,RNA5SP216,chr6:125979812-125979934,122
97644184,97730260,chr8,MTDH,chr8:97644184-97730260,86076
114866873,114866976,chr6,RNU6-475P,chr6:114866873-114866976,103
109059509,109059614,chr6,RNU6-653P,chr6:109059509-109059614,105
59855353,60053973,chr16,LINC02141,chr16:59855353-60053973,198620
152749079,152749735,chr7,ATP5PBP3,chr7:152749079-152749735,656
131642818,131642966,chr6,RNU4-18P,chr6:131642818-131642966,148
108292766,108292869,chr6,RNU6-1144P,chr6:108292766-108292869,103
99486962,99499306,chr13,LINC01232,chr13:99486962-99499306,12344
118758217,118761739,chr12,LINC02423,chr12:118758217-118761739,3522
122211648,122211811,chr6,RNU1-18P,chr6:122211648-122211811,163
63350763,63351149,chr16,RPS15AP34,chr16:63350763-63351149,386
121453981,121454121,chr6,RNU4-35P,chr6:121453981-121454121,140
811681,811814,chr11,SNORA52,chr11:811681-811814,133
103430406,103526618,chr5,PDZPH1P,chr5:103430406-103526618,96212
134133573,134133868,chr6,RN7SL408P,chr6:134133573-134133868,295
149838375,149867479,chr7,ZNF862,chr7:149838375-149867479,29104
132815307,132815379,chr6,SNORD101,chr6:132815307-132815379,72
818914,825573,chr11,PNPLA2,chr11:818914-825573,6659
18940235,18947452,chr19,HOMER3-AS1,chr19:18940235-18947452,7217
108392073,108392177,chr6,RNU6-770P,chr6:108392073-108392177,104
134979338,134979432,chr6,MIR3662,chr6:134979338-134979432,94
67662945,67667265,chr16,ENKD1,chr16:67662945-67667265,4320
138435213,138435294,chr6,MIR3145,chr6:138435213-138435294,81
100578744,100580197,chr12,PIGAP1,chr12:100578744-100580197,1453
148278672,148278778,chr6,RNU6-1222P,chr6:148278672-148278778,106
132816802,132816877,chr6,SNORD100,chr6:132816802-132816877,75
119069047,119069143,chr6,MIR548B,chr6:119069047-119069143,96
119327281,119327385,chr6,RNU6-194P,chr6:119327281-119327385,104
90918023,90948669,chr12,LINC00615,chr12:90918023-90948669,30646
132817219,132817348,chr6,SNORA33,chr6:132817219-132817348,129
134257035,134257143,chr6,RNA5SP218,chr6:134257035-134257143,108
92795647,92796439,chr15,ASB9P1,chr15:92795647-92796439,792
21940820,21941533,chr19,MTDHP2,chr19:21940820-21941533,713
132115192,132115263,chr6,MIR548AJ1,chr6:132115192-132115263,71
20323992,20324568,chr19,BNIP3P19,chr19:20323992-20324568,576
149291352,149291646,chr6,RN7SL234P,chr6:149291352-149291646,294
99499727,99501052,chr13,LINC00449,chr13:99499727-99501052,1325
155654963,155655026,chr6,RNU7-152P,chr6:155654963-155655026,63
100053686,100055045,chr5,MTCO1P22,chr5:100053686-100055045,1359
105904373,105904687,chr6,RN7SKP211,chr6:105904373-105904687,314
153681447,153681553,chr6,RNU6-896P,chr6:153681447-153681553,106
153420438,153420572,chr6,RNA5SP225,chr6:153420438-153420572,134
99577112,99580368,chr13,LINC01039,chr13:99577112-99580368,3256
58672296,58672933,chr15,HMGB1P51,chr15:58672296-58672933,637
121580332,121580521,chr6,RNU2-8P,chr6:121580332-121580521,189
150326623,150326763,chr6,RNU4-7P,chr6:150326623-150326763,140
17249171,17282786,chr19,USHBP1,chr19:17249171-17282786,33615
150939222,150939328,chr6,RNU6-302P,chr6:150939222-150939328,106
149516956,149517017,chr6,RNU7-3P,chr6:149516956-149517017,61
99582706,99583180,chr13,CFL1P8,chr13:99582706-99583180,474
151201341,151201444,chr6,RNU6-300P,chr6:151201341-151201444,103
56192530,56193633,chr5,C1GALT1P2,chr5:56192530-56193633,1103
100473708,100564414,chr12,NR1H4,chr12:100473708-100564414,90706
48878134,48880173,chr15,EID1,chr15:48878134-48880173,2039
156779678,156779731,chr6,MIR4466,chr6:156779678-156779731,53
153159220,153159345,chr6,RNA5SP224,chr6:153159220-153159345,125
141486141,141486412,chr6,RN7SKP106,chr6:141486141-141486412,271
137227341,137343774,chr7,PTN,chr7:137227341-137343774,116433
94618669,94739436,chr5,SLF1,chr5:94618669-94739436,120767
155946797,155946879,chr6,MIR1202,chr6:155946797-155946879,82
122745280,122745529,chr6,RN7SL564P,chr6:122745280-122745529,249
37452115,37823507,chr3,ITGA9,chr3:37452115-37823507,371392
146340420,146340524,chr6,RNA5SP222,chr6:146340420-146340524,104
99643059,99643149,chr13,MIR4306,chr13:99643059-99643149,90
170330761,170330844,chr6,MIR4644,chr6:170330761-170330844,83
22836560,22849041,chr14,MMP14,chr14:22836560-22849041,12481
156378750,156378824,chr6,SNORD28B,chr6:156378750-156378824,74
99690081,99690971,chr13,CLYBL-AS2,chr13:99690081-99690971,890
17375200,17735994,chrX,NHS,chrX:17375200-17735994,360794
158926466,158926571,chr6,RNU6-293P,chr6:158926466-158926571,105
89090946,89091242,chr6,RN7SL336P,chr6:89090946-89091242,296
24985053,24988232,chr15,PWAR5,chr15:24985053-24988232,3179
143449809,143449911,chr6,RNA5SP221,chr6:143449809-143449911,102
99726245,99728971,chr13,CLYBL-AS1,chr13:99726245-99728971,2726
93939364,93942877,chr8,PSMA2P2,chr8:93939364-93942877,3513
17385091,17386417,chr2,PSMC1P10,chr2:17385091-17386417,1326
89797598,89797877,chr6,DNAJC19P6,chr6:89797598-89797877,279
30209995,30210307,chr2,H3P5,chr2:30209995-30210307,312
42723544,42737128,chr15,CDAN1,chr15:42723544-42737128,13584
89814709,89815463,chr6,PIMREGP3,chr6:89814709-89815463,754
89876544,89876878,chr6,RPL22P14,chr6:89876544-89876878,334
142720660,142721160,chr7,TRBV28,chr7:142720660-142721160,500
64988477,65023865,chr2,SLC1A4,chr2:64988477-65023865,35388
89894469,89921760,chr6,GJA10,chr6:89894469-89921760,27291
124030921,124033067,chr7,TMEM229A,chr7:124030921-124033067,2146
121050927,121051203,chr7,HMGN1P18,chr7:121050927-121051203,276
15864938,15865940,chr4,HPRT1P1,chr4:15864938-15865940,1002
99606669,99909459,chr13,CLYBL,chr13:99606669-99909459,302790
90001222,90001506,chr6,RN7SKP110,chr6:90001222-90001506,284
15935577,15938740,chr4,FGFBP1,chr4:15935577-15938740,3163
61055399,61055964,chr16,RPS27AP16,chr16:61055399-61055964,565
142722358,142722764,chr7,PGBD4P1,chr7:142722358-142722764,406
89829894,89874436,chr6,CASP8AP2,chr6:89829894-89874436,44542
141801315,141802059,chr7,MTCO1P55,chr7:141801315-141802059,744
91779746,91867536,chr14,TC2N,chr14:91779746-91867536,87790
78763226,78763899,chrX,RPL7P54,chrX:78763226-78763899,673
66720893,66751609,chr16,DYNC1LI2,chr16:66720893-66751609,30716
78747709,78758714,chrX,LPAR4,chrX:78747709-78758714,11005
91954967,92103286,chr8,RUNX1T1,chr8:91954967-92103286,148319
15960245,15969309,chr4,FGFBP2,chr4:15960245-15969309,9064
2296001,2341079,chr20,TGM3,chr20:2296001-2341079,45078
134646811,134679816,chr7,BPGM,chr7:134646811-134679816,33005
15963076,16084378,chr4,PROM1,chr4:15963076-16084378,121302
2380901,2432753,chr20,TGM6,chr20:2380901-2432753,51852
154541199,154565046,chrX,IKBKG,chrX:154541199-154565046,23847
826144,831991,chr11,CRACR2B,chr11:826144-831991,5847
141551278,141655244,chr7,AGK,chr7:141551278-141655244,103966
112452703,112452989,chr5,HMGB3P16,chr5:112452703-112452989,286
55231152,55233608,chr5,CCNO,chr5:55231152-55233608,2456
145463238,145463399,chr6,RNU1-33P,chr6:145463238-145463399,161
75651288,75651627,chr2,SUPT4H1P1,chr2:75651288-75651627,339
74918148,74938418,chr2,LINC01291,chr2:74918148-74938418,20270
98793429,99086625,chr13,DOCK9,chr13:98793429-99086625,293196
42565048,42565330,chr22,RN7SKP80,chr22:42565048-42565330,282
42569147,42569250,chr22,RNU6-513P,chr22:42569147-42569250,103
38406527,38515934,chr2,LINC02613,chr2:38406527-38515934,109407
20167214,20200488,chr19,ZNF486,chr19:20167214-20200488,33274
2461634,2470853,chr20,SNRPB,chr20:2461634-2470853,9219
42615244,42615393,chr22,RNU12,chr22:42615244-42615393,149
13926813,13927778,chr3,VN1R20P,chr3:13926813-13927778,965
42639803,42640601,chr22,ATP5MGL,chr22:42639803-42640601,798
24455136,24459434,chr3,THRB-IT1,chr3:24455136-24459434,4298
145793502,145814795,chr6,FBXO30,chr6:145793502-145814795,21293
33771963,33772295,chr3,SDAD1P3,chr3:33771963-33772295,332
133821147,133872922,chr6,LINC01312,chr6:133821147-133872922,51775
77425970,77620611,chr5,WDR41,chr5:77425970-77620611,194641
42079691,42084284,chr22,SMDT1,chr22:42079691-42084284,4593
11006098,11019224,chr3,SLC6A1-AS1,chr3:11006098-11019224,13126
13933056,13937477,chr3,FGD5P1,chr3:13933056-13937477,4421
19997058,20039505,chr19,ZNF682,chr19:19997058-20039505,42447
133952170,133990432,chr6,TBPL1,chr6:133952170-133990432,38262
9216895,9219508,chr3,SRGAP3-AS3,chr3:9216895-9219508,2613
42692121,42721298,chr22,A4GALT,chr22:42692121-42721298,29177
14799331,14811414,chr3,LINC02011,chr3:14799331-14811414,12083
61187463,61471087,chr2,USP34,chr2:61187463-61471087,283624
19879472,19947025,chr3,EFHB,chr3:19879472-19947025,67553
91965991,92040896,chr14,TRIP11,chr14:91965991-92040896,74905
832887,839831,chr11,CD151,chr11:832887-839831,6944
133889113,133895553,chr6,TCF21,chr6:133889113-133895553,6440
42776406,42777296,chr22,RPL5P34,chr22:42776406-42777296,890
60008437,60017498,chr17,TBC1D3P1,chr17:60008437-60017498,9061
42784462,42787100,chr22,GOLGA2P4,chr22:42784462-42787100,2638
52896639,52909698,chr6,GSTA3,chr6:52896639-52909698,13059
73786675,73800966,chr17,LINC02092,chr17:73786675-73800966,14291
82041778,82046119,chr15,MEX3B,chr15:82041778-82046119,4341
42796502,42858106,chr22,ARFGAP3,chr22:42796502-42858106,61604
83654088,84039842,chr15,ADAMTSL3,chr15:83654088-84039842,385754
73749270,73828520,chr17,LINC00469,chr17:73749270-73828520,79250
67842320,67844195,chr16,THAP11,chr16:67842320-67844195,1875
20784596,20785152,chr19,BNIP3P24,chr19:20784596-20785152,556
19588091,19588415,chr19,PHF5CP,chr19:19588091-19588415,324
52258564,52280638,chr16,CASC22,chr16:52258564-52280638,22074
16517894,16542437,chr19,CHERP,chr19:16517894-16542437,24543
52939726,52957521,chr6,GSTA9P,chr6:52939726-52957521,17795
50556207,50562108,chr17,CACNA1G-AS1,chr17:50556207-50562108,5901
33090421,33097146,chr3,TMPPE,chr3:33090421-33097146,6725
74043452,74154212,chr17,LINC02074,chr17:74043452-74154212,110760
38448084,38448215,chr20,SNORA71E,chr20:38448084-38448215,131
52977948,52995304,chr6,GSTA4,chr6:52977948-52995304,17356
38449370,38449503,chr20,SNORA60,chr20:38449370-38449503,133
17877455,17878169,chr3,PDCL3P3,chr3:17877455-17878169,714
38472816,38578859,chr20,RALGAPB,chr20:38472816-38578859,106043
67644988,67657569,chr16,CARMIL2,chr16:67644988-67657569,12581
48607232,48633572,chr17,HOXB7,chr17:48607232-48633572,26340
54754165,54754649,chr17,ARL2BPP8,chr17:54754165-54754649,484
20160593,20186206,chr3,SGO1,chr3:20160593-20186206,25613
74842023,74861504,chr17,GRIN2C,chr17:74842023-74861504,19481
134272287,134273658,chrX,NT5DC1P2,chrX:134272287-134273658,1371
52995621,52995948,chr6,RN7SK,chr6:52995621-52995948,327
53090961,53091257,chr6,RN7SL244P,chr6:53090961-53091257,296
134373288,134428791,chrX,PHF6,chrX:134373288-134428791,55503
53126961,53148841,chr6,GCM1,chr6:53126961-53148841,21880
53153795,53153898,chr6,RNU6-464P,chr6:53153795-53153898,103
53196720,53197159,chr6,SOD1P1,chr6:53196720-53197159,439
28010723,28012355,chr6,IQCB2P,chr6:28010723-28012355,1632
28033947,28034855,chr6,OR2W2P,chr6:28033947-28034855,908
28046434,28047367,chr6,OR2B7P,chr6:28046434-28047367,933
28073316,28074260,chr6,OR1F12,chr6:28073316-28074260,944
92116122,92121917,chr14,NDUFB1,chr14:92116122-92121917,5795
28053228,28054165,chr6,OR2B8P,chr6:28053228-28054165,937
27937465,27938403,chr6,OR2W6P,chr6:27937465-27938403,938
27957241,27958182,chr6,OR2B6,chr6:27957241-27958182,941
27965175,27965514,chr6,RPLP2P1,chr6:27965175-27965514,339
27977150,27978075,chr6,OR2W4P,chr6:27977150-27978075,925
158609706,158621636,chr6,TATDN2P2,chr6:158609706-158621636,11930
158609707,158609790,chr6,MIR7161,chr6:158609707-158609790,83
92168400,92168877,chr12,RPL21P106,chr12:92168400-92168877,477
65457541,65458408,chr17,LINC02563,chr17:65457541-65458408,867
166997807,166997912,chr6,MIR3939,chr6:166997807-166997912,105
101066734,101069232,chr12,SNX5P2,chr12:101066734-101069232,2498
166999317,167094789,chr6,CEP43,chr6:166999317-167094789,95472
48646923,48707346,chr17,LINC02086,chr17:48646923-48707346,60423
92121969,92172145,chr14,CPSF2,chr14:92121969-92172145,50176
52630339,52634456,chr12,KRT128P,chr12:52630339-52634456,4117
42583721,42614962,chr22,POLDIP3,chr22:42583721-42614962,31241
55550931,55551649,chr17,GARS1P1,chr17:55550931-55551649,718
100156357,100173659,chr12,GOLGA2P5,chr12:100156357-100173659,17302
19645198,19663676,chr19,ATP13A1,chr19:19645198-19663676,18478
51502488,51503233,chr17,RPL7P48,chr17:51502488-51503233,745
74747319,74748912,chr17,SLC9A3R1-AS1,chr17:74747319-74748912,1593
75032575,75065889,chr17,KCTD2,chr17:75032575-75065889,33314
155297776,155310235,chr7,INSIG1,chr7:155297776-155310235,12459
837356,842529,chr11,POLR2L,chr11:837356-842529,5173
106955719,106978778,chr12,TMEM263,chr12:106955719-106978778,23059
134460165,134520513,chrX,HPRT1,chrX:134460165-134520513,60348
167146414,167196913,chr6,TCP10L2,chr6:167146414-167196913,50499
73386771,73504954,chr16,LINC01568,chr16:73386771-73504954,118183
867859,915058,chr11,CHID1,chr11:867859-915058,47199
91869411,91947987,chr14,FBLN5,chr14:91869411-91947987,78576
50241947,50265965,chr15,HDC,chr15:50241947-50265965,24018
58218548,58268518,chr17,LPO,chr17:58218548-58268518,49970
138440690,138442238,chr7,IMPDH1P3,chr7:138440690-138442238,1548
134522702,134522990,chrX,RPL36AP54,chrX:134522702-134522990,288
134540185,134540262,chrX,MIR450B,chrX:134540185-134540262,77
134540341,134540431,chrX,MIR450A1,chrX:134540341-134540431,90
134540508,134540607,chrX,MIR450A2,chrX:134540508-134540607,99
134541341,134541437,chrX,MIR542,chrX:134541341-134541437,96
134543119,134546642,chrX,MIR503HG,chrX:134543119-134546642,3523
107563971,107623317,chr7,DUS4L-BCAP29,chr7:107563971-107623317,59346
35506592,35507170,chr16,TP53TG3HP,chr16:35506592-35507170,578
90280894,90300974,chr12,LINC02392,chr12:90280894-90300974,20080
167271169,167316014,chr6,UNC93A,chr6:167271169-167316014,44845
52436417,52547802,chr16,TOX3,chr16:52436417-52547802,111385
114097682,114098223,chr12,HAUS8P1,chr12:114097682-114098223,541
134546328,134546398,chrX,MIR503,chrX:134546328-134546398,70
134546614,134546711,chrX,MIR424,chrX:134546614-134546711,97
134549770,134560399,chrX,LINC00629,chrX:134549770-134560399,10629
145039999,145040941,chr7,RPL7P59,chr7:145039999-145040941,942
70900576,70965373,chr2,VAX2,chr2:70900576-70965373,64797
115503367,115504081,chr7,POLR2DP2,chr7:115503367-115504081,714
134565838,134764322,chrX,PLAC1,chrX:134565838-134764322,198484
76351797,76559809,chr12,OSBPL8,chr12:76351797-76559809,208012
131892616,131893615,chr7,CAPZA1P4,chr7:131892616-131893615,999
134607157,134607632,chrX,RPL21P133,chrX:134607157-134607632,475
134650830,134651411,chrX,RPS7P12,chrX:134650830-134651411,581
134760208,134760348,chrX,RNU4-44P,chrX:134760208-134760348,140
152759749,152855378,chr7,ACTR3B,chr7:152759749-152855378,95629
134769566,134797232,chrX,PABIR2,chrX:134769566-134797232,27666
46003942,46004309,chr2,RPL26P15,chr2:46003942-46004309,367
35048756,35230487,chr5,PRLR,chr5:35048756-35230487,181731
167325071,167359503,chr6,TTLL2,chr6:167325071-167359503,34432
62939916,62940282,chr2,RPS20P9,chr2:62939916-62940282,366
70955899,70956234,chr2,ELOCP21,chr2:70955899-70956234,335
67939750,67944131,chr16,LCAT,chr16:67939750-67944131,4381
67397322,67412089,chr2,ETAA1,chr2:67397322-67412089,14767
36676460,36687337,chr6,CDKN1A,chr6:36676460-36687337,10877
42615730,42720870,chr22,CYB5R3,chr22:42615730-42720870,105140
21082159,21125270,chr19,ZNF714,chr19:21082159-21125270,43111
82459472,82477258,chr15,CSPG4P10,chr15:82459472-82477258,17786
43222402,43226606,chr2,ZFP36L2,chr2:43222402-43226606,4204
137197485,137219449,chr6,IFNGR1,chr6:137197485-137219449,21964
71984182,71984434,chr2,RPS20P10,chr2:71984182-71984434,252
67070444,67245989,chr17,HELZ,chr17:67070444-67245989,175545
21476597,21499175,chr14,TOX4,chr14:21476597-21499175,22578
92285841,92286678,chr15,NPM1P5,chr15:92285841-92286678,837
32379071,32380049,chr16,ACTR3BP3,chr16:32379071-32380049,978
82814984,82815516,chr2,MTND4P25,chr2:82814984-82815516,532
65511771,65512076,chr2,RPS15AP15,chr2:65511771-65512076,305
20758440,20758952,chr19,VN1R79P,chr19:20758440-20758952,512
33077204,33077491,chr3,SUMO2P10,chr3:33077204-33077491,287
63108118,63108429,chr2,RPL27P5,chr2:63108118-63108429,311
97960703,97973833,chr15,ARRDC4,chr15:97960703-97973833,13130
67873052,67884499,chr16,EDC4,chr16:67873052-67884499,11447
107628553,107629550,chr7,WBP1LP2,chr7:107628553-107629550,997
76260755,76261661,chr2,USP21P2,chr2:76260755-76261661,906
21188598,21188953,chr19,VN1R82P,chr19:21188598-21188953,355
16524771,16541903,chr3,LINC00690,chr3:16524771-16541903,17132
141802482,141803487,chr7,MTND2P5,chr7:141802482-141803487,1005
19870723,19871299,chr19,BNIP3P10,chr19:19870723-19871299,576
30231534,30323730,chr2,LBH,chr2:30231534-30323730,92196
121842368,121845131,chr7,PNPT1P2,chr7:121842368-121845131,2763
19538248,19546659,chr19,CILP2,chr19:19538248-19546659,8411
142287251,142291597,chr7,PRSS3P3,chr7:142287251-142291597,4346
27703129,27703568,chr3,KIAA1143P2,chr3:27703129-27703568,439
9192493,9194453,chr3,SRGAP3-AS2,chr3:9192493-9194453,1960
92420860,92422735,chr15,ENO1P2,chr15:92420860-92422735,1875
154943687,155003124,chr7,PAXIP1,chr7:154943687-155003124,59437
85754941,85756237,chr15,LINC02883,chr15:85754941-85756237,1296
91742841,91743955,chr15,THRAP3P2,chr15:91742841-91743955,1114
38516563,38516632,chr20,MIR548O2,chr20:38516563-38516632,69
38537758,38538458,chr20,RPS3P2,chr20:38537758-38538458,700
80644939,80645173,chr8,CKS1BP7,chr8:80644939-80645173,234
84678798,84679842,chr8,PSMC2P2,chr8:84678798-84679842,1044
38724486,38729372,chr20,SLC32A1,chr20:38724486-38729372,4886
60823069,60881317,chr2,LINC01185,chr2:60823069-60881317,58248
98117293,98159835,chr8,POP1,chr8:98117293-98159835,42542
38748460,38772520,chr20,ACTR5,chr20:38748460-38772520,24060
78167468,78245688,chr15,ACSBG1,chr15:78167468-78245688,78220
37052626,37183689,chr3,LRRFIP2,chr3:37052626-37183689,131063
19561707,19618693,chr19,PBX4,chr19:19561707-19618693,56986
28849821,28870309,chr2,TRMT61B,chr2:28849821-28870309,20488
53825887,53826309,chrX,MRPS18CP7,chrX:53825887-53826309,422
53909054,53909161,chrX,RNA5SP505,chrX:53909054-53909161,107
53936676,54048958,chrX,PHF8,chrX:53936676-54048958,112282
77460924,77463491,chr6,HTR1B,chr6:77460924-77463491,2567
5085341,5089487,chr6,PPP1R3G,chr6:5085341-5089487,4146
101452593,101720856,chr13,ITGBL1,chr13:101452593-101720856,268263
38761528,38761842,chr20,RN7SKP173,chr20:38761528-38761842,314
24804282,25042170,chr6,RIPOR2,chr6:24804282-25042170,237888
32858923,32961845,chr20,EFCAB8,chr20:32858923-32961845,102922
18683678,18782333,chr19,CRTC1,chr19:18683678-18782333,98655
70830211,70835816,chr2,CD207,chr2:70830211-70835816,5605
35954564,36030700,chr20,CNBD2,chr20:35954564-36030700,76136
21498133,21511342,chr14,METTL3,chr14:21498133-21511342,13209
68122936,68157549,chr2,DNAAF10,chr2:68122936-68157549,34613
73420004,73441526,chr8,STAU2-AS1,chr8:73420004-73441526,21522
98064522,98093610,chr8,ERICH5,chr8:98064522-98093610,29088
128686535,128813267,chr11,FLI1,chr11:128686535-128813267,126732
46792065,46793064,chr8,TRIM60P15,chr8:46792065-46793064,999
92972575,92974738,chr8,IRF5P1,chr8:92972575-92974738,2163
134442356,134459284,chr7,AKR1B1,chr7:134442356-134459284,16928
66426735,66433470,chr2,MEIS1-AS3,chr2:66426735-66433470,6735
62532583,62533059,chr2,RPL21P37,chr2:62532583-62533059,476
89823548,89823802,chr8,COX6B1P6,chr8:89823548-89823802,254
60940222,61018259,chr2,PUS10,chr2:60940222-61018259,78037
97865054,97865485,chr8,RPS23P1,chr8:97865054-97865485,431
61578220,61579668,chr8,KRT8P3,chr8:61578220-61579668,1448
68302246,68331689,chr8,C8orf34-AS1,chr8:68302246-68331689,29443
84655129,84658563,chr15,NMB,chr15:84655129-84658563,3434
19900913,19963464,chr19,ZNF93,chr19:19900913-19963464,62551
69131291,69231130,chr16,UTP4,chr16:69131291-69231130,99839
63293186,63334851,chr20,COL20A1,chr20:63293186-63334851,41665
82986210,82991057,chr15,RAMAC,chr15:82986210-82991057,4847
79918717,80030289,chr8,MRPS28,chr8:79918717-80030289,111572
21826513,21827279,chr19,BNIP3P27,chr19:21826513-21827279,766
21521080,21537216,chr14,SALL2,chr14:21521080-21537216,16136
20583084,20583647,chr19,VN1R78P,chr19:20583084-20583647,563
19856975,19857527,chr19,BNIP3P9,chr19:19856975-19857527,552
20136933,20137233,chr19,BNIP3P15,chr19:20136933-20137233,300
20221869,20222463,chr19,BNIP3P17,chr19:20221869-20222463,594
20062755,20063320,chr19,BNIP3P13,chr19:20062755-20063320,565
38176533,38213301,chr8,BAG4,chr8:38176533-38213301,36768
22052430,22091480,chr19,ZNF257,chr19:22052430-22091480,39050
128891356,128921163,chr11,KCNJ5,chr11:128891356-128921163,29807
79932343,80035872,chr17,TBC1D16,chr17:79932343-80035872,103529
88585566,88605110,chr15,LINC01586,chr15:88585566-88605110,19544
50068568,50068873,chr14,RN7SKP193,chr14:50068568-50068873,305
50108632,50116600,chr14,VCPKMT,chr14:50108632-50116600,7968
128993237,128993340,chr11,RNU6-876P,chr11:128993237-128993340,103
87870747,87874015,chr8,DCAF4L2,chr8:87870747-87874015,3268
16160505,16227410,chr4,TAPT1,chr4:16160505-16227410,66905
22286441,22317176,chr19,ZNF729,chr19:22286441-22317176,30735
108157215,108222638,chr11,NPAT,chr11:108157215-108222638,65423
22634324,22667671,chr19,ZNF492,chr19:22634324-22667671,33347
69667046,69834978,chr8,SLCO5A1,chr8:69667046-69834978,167932
85759326,85794925,chr15,KLHL25,chr15:85759326-85794925,35599
46901870,46941855,chr2,MCFD2,chr2:46901870-46941855,39985
37009312,37059713,chr13,SUPT20H,chr13:37009312-37059713,50401
53776048,53819722,chr5,LINC02105,chr5:53776048-53819722,43674
50117130,50231578,chr14,SOS2,chr14:50117130-50231578,114448
77641764,77652292,chr15,LINGO1-AS1,chr15:77641764-77652292,10528
149867697,149880610,chr7,ATP6V0E2-AS1,chr7:149867697-149880610,12913
80603383,80603644,chr5,DBIP2,chr5:80603383-80603644,261
145005058,145006135,chr7,EI24P4,chr7:145005058-145006135,1077
138797952,138838101,chr7,TMEM213,chr7:138797952-138838101,40149
99948295,99949583,chr5,CRLF3P2,chr5:99948295-99949583,1288
21719801,21720035,chr19,VN1R84P,chr19:21719801-21720035,234
96235785,96237010,chr15,LINC02157,chr15:96235785-96237010,1225
18637025,18671721,chr19,KLHL26,chr19:18637025-18671721,34696
100051133,100051916,chr5,MTCO3P22,chr5:100051133-100051916,783
90952239,90955225,chr15,RCCD1-AS1,chr15:90952239-90955225,2986
62776877,62777263,chr5,ISCA1P1,chr5:62776877-62777263,386
122681315,122681662,chr7,RPS26P31,chr7:122681315-122681662,347
91853708,92172435,chr15,SLCO3A1,chr15:91853708-92172435,318727
111223653,111494886,chr5,CAMK4,chr5:111223653-111494886,271233
142299177,142299460,chr7,TRBV1,chr7:142299177-142299460,283
138460259,138589996,chr7,TRIM24,chr7:138460259-138589996,129737
131289459,131359022,chr9,PLPP7,chr9:131289459-131359022,69563
108308519,108467531,chr11,C11orf65,chr11:108308519-108467531,159012
16549831,16572415,chr19,SLC35E1,chr19:16549831-16572415,22584
131545514,131558620,chr9,PRRT1B,chr9:131545514-131558620,13106
38483438,38507660,chr22,DDX17,chr22:38483438-38507660,24222
114402080,114505473,chr9,WHRN,chr9:114402080-114505473,103393
67224728,67225041,chr17,RPL36AP48,chr17:67224728-67225041,313
54951902,54968703,chr17,COX11,chr17:54951902-54968703,16801
125507259,125507307,chr4,MIR2054,chr4:125507259-125507307,48
125681177,125683668,chr4,NUP58P1,chr4:125681177-125683668,2491
122923070,123319433,chr4,SPATA5,chr4:122923070-123319433,396363
55773446,55826445,chr8,TGS1,chr8:55773446-55826445,52999
55352721,55353088,chr16,RPL31P56,chr16:55352721-55353088,367
45684651,45705019,chr20,WFDC10B,chr20:45684651-45705019,20368
21997648,21998840,chr19,BNIP3P28,chr19:21997648-21998840,1192
27771717,27988087,chr2,MRPL33,chr2:27771717-27988087,216370
73943078,74296762,chr16,PSMD7-DT,chr16:73943078-74296762,353684
82088569,82097694,chr15,LINC01583,chr15:82088569-82097694,9125
19119169,19138513,chr19,TMEM161A,chr19:19119169-19138513,19344
54068324,54183281,chrX,FAM120C,chrX:54068324-54183281,114957
124093592,124094532,chr11,OR10D4P,chr11:124093592-124094532,940
90001405,90053633,chr8,DECR1,chr8:90001405-90053633,52228
99014526,99031054,chr15,LUNAR1,chr15:99014526-99031054,16528
55509072,55586666,chr16,LPCAT2,chr16:55509072-55586666,77594
21705659,21718481,chr20,PAX1,chr20:21705659-21718481,12822
111908564,111923722,chr11,CRYAB,chr11:111908564-111923722,15158
142332182,142332701,chr7,TRBV7-1,chr7:142332182-142332701,519
20012452,20012606,chr3,RPL39P18,chr3:20012452-20012606,154
101875964,101876901,chr15,OR4F28P,chr15:101875964-101876901,937
61953546,61953662,chr20,MIR1257,chr20:61953546-61953662,116
99284625,99285576,chr15,HNRNPA1P62,chr15:99284625-99285576,951
140084746,140176983,chr7,KDM7A,chr7:140084746-140176983,92237
123396795,123403760,chr4,SPRY1,chr4:123396795-123403760,6965
62064802,62064885,chr20,MIR3195,chr20:62064802-62064885,83
84821650,84907008,chr2,TRABD2A,chr2:84821650-84907008,85358
88621337,88632281,chr15,AEN,chr15:88621337-88632281,10944
93405673,93441947,chr12,UBE2N,chr12:93405673-93441947,36274
61953469,62065881,chr20,TAF4,chr20:61953469-62065881,112412
12897043,13283281,chr3,IQSEC1,chr3:12897043-13283281,386238
54147372,54147659,chrX,RPL37P24,chrX:54147372-54147659,287
95834424,95835046,chr5,GGCTP1,chr5:95834424-95835046,622
54223324,54224062,chrX,RPL7AP71,chrX:54223324-54224062,738
38425036,38427376,chr5,EGFLAM-AS1,chr5:38425036-38427376,2340
41447343,41475710,chrX,NYX,chrX:41447343-41475710,28367
40998017,41071342,chr5,MROH2B,chr5:40998017-41071342,73325
117453817,117569858,chr6,DCBLD1,chr6:117453817-117569858,116041
123505279,123527525,chr4,LINC02435,chr4:123505279-123527525,22246
47217860,47229997,chrX,CDK16,chrX:47217860-47229997,12137
56710060,56710614,chr4,RPL17P20,chr4:56710060-56710614,554
56794348,56794642,chr4,RN7SL492P,chr4:56794348-56794642,294
56805834,56806131,chr4,RN7SL357P,chr4:56805834-56806131,297
50237563,50312229,chr14,L2HGDH,chr14:50237563-50312229,74666
114611206,114646422,chr9,TMEM268,chr9:114611206-114646422,35216
151956379,152019929,chr7,GALNTL5,chr7:151956379-152019929,63550
56963350,56977606,chr4,NOA1,chr4:56963350-56977606,14256
96441566,96442313,chr15,PGAM1P12,chr15:96441566-96442313,747
55760566,55793960,chr16,CES1P1,chr16:55760566-55793960,33394
36467046,36481640,chr22,TXN2,chr22:36467046-36481640,14594
54948015,54984762,chr12,TESPA1,chr12:54948015-54984762,36747
93905405,94107938,chr15,LINC01581,chr15:93905405-94107938,202533
38481851,38482804,chr2,RPLP0P6,chr2:38481851-38482804,953
84039885,84040720,chr2,ST6GALNAC2P1,chr2:84039885-84040720,835
24114809,24123464,chr2,PFN4,chr2:24114809-24123464,8655
48070052,48101478,chr17,CBX1,chr17:48070052-48101478,31426
83739784,83740199,chr15,TUBAP4,chr15:83739784-83740199,415
56977722,57031158,chr4,POLR2B,chr4:56977722-57031158,53436
114656304,114662374,chr9,TEX53,chr9:114656304-114662374,6070
114666434,114682192,chr9,TEX48,chr9:114666434-114682192,15758
1203454,1209076,chr20,C20orf202,chr20:1203454-1209076,5622
82445719,82454837,chr15,UBE2Q2P6,chr15:82445719-82454837,9118
65141751,65176713,chr16,LINC02126,chr16:65141751-65176713,34962
38601809,38651035,chr20,ARHGAP40,chr20:38601809-38651035,49226
114784652,114806039,chr9,TNFSF15,chr9:114784652-114806039,21387
39786453,40255209,chr2,SLC8A1-AS1,chr2:39786453-40255209,468756
75204103,75207161,chr16,CTRB2,chr16:75204103-75207161,3058
78810487,78898139,chr15,MORF4L1,chr15:78810487-78898139,87652
114587706,114598915,chr9,ATP6V1G1,chr9:114587706-114598915,11209
45551153,45579326,chr20,WFDC8,chr20:45551153-45579326,28173
111912734,111914093,chr11,HSPB2,chr11:111912734-111914093,1359
120815496,120842951,chr9,PSMD5,chr9:120815496-120842951,27455
63635802,63779336,chr6,PHF3,chr6:63635802-63779336,143534
50299855,50299946,chr14,MIR4504,chr14:50299855-50299946,91
111912736,111926871,chr11,HSPB2-C11orf52,chr11:111912736-111926871,14135
61942605,62065278,chr17,MED13,chr17:61942605-62065278,122673
111918032,111926871,chr11,C11orf52,chr11:111918032-111926871,8839
50326265,50416461,chr14,CDKL1,chr14:50326265-50416461,90196
36487190,36507221,chr22,FOXRED2,chr22:36487190-36507221,20031
45567990,45568807,chr20,CCNB1IP1P2,chr20:45567990-45568807,817
66754640,66801620,chr16,TERB1,chr16:66754640-66801620,46980
111927144,112022653,chr11,DIXDC1,chr11:111927144-112022653,95509
82815809,82817528,chr2,MTND5P27,chr2:82815809-82817528,1719
120855651,120894896,chr9,PHF19,chr9:120855651-120894896,39245
45416084,45456934,chr20,PIGT,chr20:45416084-45456934,40850
21318161,21318719,chr19,BNIP3P25,chr19:21318161-21318719,558
75469302,75569722,chr2,EVA1A,chr2:75469302-75569722,100420
20134655,20217404,chr7,MACC1,chr7:20134655-20217404,82749
87788562,87789688,chr8,SOX5P1,chr8:87788562-87789688,1126
81841952,81924348,chr8,LINC02235,chr8:81841952-81924348,82396
82363206,82367420,chr6,TPBG,chr6:82363206-82367420,4214
536062,846561,chr3,LINC01266,chr3:536062-846561,310499
108166022,108188805,chr6,NR2E1,chr6:108166022-108188805,22783
21280083,21351301,chr14,RPGRIP1,chr14:21280083-21351301,71218
140177184,140179640,chr7,KDM7A-DT,chr7:140177184-140179640,2456
19033575,19060311,chr19,ARMC6,chr19:19033575-19060311,26736
134527567,134541412,chr7,AKR1B10,chr7:134527567-134541412,13845
27715949,27722711,chr3,EOMES,chr3:27715949-27722711,6762
101177878,101206193,chr8,ZNF706,chr8:101177878-101206193,28315
50866679,50910774,chr17,TOB1-AS1,chr17:50866679-50910774,44095
74712955,74774831,chr16,FA2H,chr16:74712955-74774831,61876
38561969,38603586,chr2,HNRNPLL,chr2:38561969-38603586,41617
111846050,111846566,chr5,HMGN1P14,chr5:111846050-111846566,516
121839527,121863596,chr12,HPD,chr12:121839527-121863596,24069
48048329,48061545,chr17,NFE2L1,chr17:48048329-48061545,13216
42799880,42887392,chr5,SELENOP,chr5:42799880-42887392,87512
35215705,35217149,chr3,KRT8P18,chr3:35215705-35217149,1444
149102784,149126324,chr7,ZNF425,chr7:149102784-149126324,23540
15878047,15879571,chr3,IMPDH1P8,chr3:15878047-15879571,1524
67893254,67929676,chr16,PSKH1,chr16:67893254-67929676,36422
116267760,116279930,chr6,TSPYL1,chr6:116267760-116279930,12170
100385009,100464921,chr6,SIM1,chr6:100385009-100464921,79912
20007852,20008247,chr3,SAP18P3,chr3:20007852-20008247,395
19979961,20012267,chr3,PP2D1,chr3:19979961-20012267,32306
111928400,111928508,chr11,RNA5SP351,chr11:111928400-111928508,108
112029858,112030367,chr11,PPIHP1,chr11:112029858-112030367,509
112032499,112032598,chr11,RNU6-893P,chr11:112032499-112032598,99
52085210,52099120,chr16,LINC02180,chr16:52085210-52099120,13910
81463036,81463613,chr7,EIF4EP4,chr7:81463036-81463613,577
12877522,12885211,chr3,LINC02022,chr3:12877522-12885211,7689
133169416,133170514,chr7,ST13P7,chr7:133169416-133170514,1098
155295918,155297541,chr7,INSIG1-DT,chr7:155295918-155297541,1623
112074086,112085150,chr11,NKAPD1,chr11:112074086-112085150,11064
85654684,85658514,chr8,REXO1L3P,chr8:85654684-85658514,3830
36819276,36822498,chr3,LINC02033,chr3:36819276-36822498,3222
57002692,57002792,chr4,RNU6-998P,chr4:57002692-57002792,100
10626015,10629307,chr3,ATP2B2-IT2,chr3:10626015-10629307,3292
57030773,57110385,chr4,IGFBP7,chr4:57030773-57110385,79612
29926811,29934156,chr3,RBMS3-AS1,chr3:29926811-29934156,7345
130018287,130051451,chr7,ZC3HC1,chr7:130018287-130051451,33164
17615035,17706925,chr6,NUP153,chr6:17615035-17706925,91890
2362258,2362738,chr3,HINT2P1,chr3:2362258-2362738,480
55426797,55462297,chr16,MMP2-AS1,chr16:55426797-55462297,35500
32481312,32502852,chr3,CMTM6,chr3:32481312-32502852,21540
100916523,100953388,chr8,YWHAZ,chr8:100916523-100953388,36865
68013436,68015911,chr16,DPEP2NB,chr16:68013436-68015911,2475
77590806,77610681,chr16,LINC02131,chr16:77590806-77610681,19875
57072683,57073132,chr4,UBE2CP3,chr4:57072683-57073132,449
6773037,6773343,chr3,MRPS36P1,chr3:6773037-6773343,306
29054570,29290726,chr3,RBMS3-AS3,chr3:29054570-29290726,236156
67987394,68000586,chr16,DPEP2,chr16:67987394-68000586,13192
56907876,56966808,chr4,REST,chr4:56907876-56966808,58932
11859674,11891172,chr3,FANCD2P2,chr3:11859674-11891172,31498
32444379,32483319,chr17,PSMD11,chr17:32444379-32483319,38940
112084800,112086798,chr11,TIMM8B,chr11:112084800-112086798,1998
116687305,116701300,chr9,TRIM32,chr9:116687305-116701300,13995
36510855,36529184,chr22,EIF3D,chr22:36510855-36529184,18329
149596556,149631912,chrX,TMEM185A,chrX:149596556-149631912,35356
15151833,15205959,chr3,COL6A4P1,chr3:15151833-15205959,54126
121207794,121332843,chr9,GSN,chr9:121207794-121332843,125049
112086824,112120016,chr11,SDHD,chr11:112086824-112120016,33192
32030196,32030678,chr3,RPL21P40,chr3:32030196-32030678,482
14178817,14201122,chr3,LSM3,chr3:14178817-14201122,22305
34022468,34029694,chr12,ALG10,chr12:34022468-34029694,7226
145583197,145584817,chr7,DPY19L4P2,chr7:145583197-145584817,1620
82009602,82010094,chr5,PPIAP11,chr5:82009602-82010094,492
69607099,69624049,chr5,NAIPP3,chr5:69607099-69624049,16950
139339457,139346328,chr7,FMC1,chr7:139339457-139346328,6871
100048988,100050362,chr5,MTND4P35,chr5:100048988-100050362,1374
17042742,17044192,chr3,PLCL2-AS1,chr3:17042742-17044192,1450
142265833,142272235,chr7,PRSS59P,chr7:142265833-142272235,6402
130401987,130413656,chrX,RBMX2,chrX:130401987-130413656,11669
12004388,12192032,chr3,SYN2,chr3:12004388-12192032,187644
141500079,141551304,chr7,AGK-DT,chr7:141500079-141551304,51225
22463922,22473036,chr19,ZNF209P,chr19:22463922-22473036,9114
67975663,67980549,chr16,DPEP3,chr16:67975663-67980549,4886
70325081,70416984,chr14,COX16,chr14:70325081-70416984,91903
88492793,88580851,chr12,KITLG,chr12:88492793-88580851,88058
167155247,167157980,chr6,GPR31,chr6:167155247-167157980,2733
57574027,57619816,chr5,LINCR-0003,chr5:57574027-57619816,45789
160531482,160664275,chr6,LPA,chr6:160531482-160664275,132793
67086446,67311439,chr2,LINC01828,chr2:67086446-67311439,224993
186533655,186555567,chr4,MTNR1A,chr4:186533655-186555567,21912
132784870,133082090,chr7,CHCHD3,chr7:132784870-133082090,297220
22447934,22448777,chr19,BNIP3P32,chr19:22447934-22448777,843
20443215,20443725,chr19,BNIP3P23,chr19:20443215-20443725,510
121667946,121696995,chr4,ANXA5,chr4:121667946-121696995,29049
20077994,20127076,chr19,ZNF90,chr19:20077994-20127076,49082
75752570,75753479,chr5,SLC25A5P9,chr5:75752570-75753479,909
135889205,135913062,chrX,SAGE1,chrX:135889205-135913062,23857
5261044,5829192,chr6,FARS2,chr6:5261044-5829192,568148
47045538,47155308,chr2,STPG4,chr2:47045538-47155308,109770
70326064,70417074,chr14,SYNJ2BP-COX16,chr14:70326064-70417074,91010
112143253,112164096,chr11,IL18,chr11:112143253-112164096,20843
41688973,41697275,chrX,GPR34,chrX:41688973-41697275,8302
34905260,34918989,chr5,RAD1,chr5:34905260-34918989,13729
50478860,50485974,chr17,RSAD1,chr17:50478860-50485974,7114
129611720,129757082,chr7,NRF1,chr7:129611720-129757082,145362
61868085,61888671,chr2,CCT4,chr2:61868085-61888671,20586
86148451,86832604,chrX,DACH2,chrX:86148451-86832604,684153
21020634,21060050,chr19,ZNF430,chr19:21020634-21060050,39416
69565094,69704666,chr16,NFAT5,chr16:69565094-69704666,139572
45919131,45992120,chr12,SCAF11,chr12:45919131-45992120,72989
70360892,70361088,chr14,RNU2-51P,chr14:70360892-70361088,196
70366499,70417090,chr14,SYNJ2BP,chr14:70366499-70417090,50591
109462594,109483219,chr6,ZBTB24,chr6:109462594-109483219,20625
70417107,70460427,chr14,ADAM21,chr14:70417107-70460427,43320
99606774,99615578,chr6,PRDM13,chr6:99606774-99615578,8804
20961057,20965140,chr19,KRT18P40,chr19:20961057-20965140,4083
48595751,48604992,chr17,HOXB6,chr17:48595751-48604992,9241
70453541,70483775,chr14,ADAM20P1,chr14:70453541-70483775,30234
112167372,112172556,chr11,TEX12,chr11:112167372-112172556,5184
22179089,22215801,chr19,ZNF676,chr19:22179089-22215801,36712
40841308,40860175,chr5,CARD6,chr5:40841308-40860175,18867
15522807,15663058,chr6,DTNBP1,chr6:15522807-15663058,140251
23304991,23395471,chr19,ZNF91,chr19:23304991-23395471,90480
70496107,70496210,chr14,RNU6-659P,chr14:70496107-70496210,103
48528526,48531011,chr17,HOXB1,chr17:48528526-48531011,2485
70522358,70535015,chr14,ADAM20,chr14:70522358-70535015,12657
112175510,112224699,chr11,BCO2,chr11:112175510-112224699,49189
15141380,15142157,chr3,RPS3AP53,chr3:15141380-15142157,777
59674636,59707626,chr17,PTRH2,chr17:59674636-59707626,32990
23804024,23806905,chr3,UBE2E1-AS1,chr3:23804024-23806905,2881
70581257,70600690,chr14,MED6,chr14:70581257-70600690,19433
11878830,11879129,chr3,CYCSP12,chr3:11878830-11879129,299
53560633,53683338,chr5,NDUFS4,chr5:53560633-53683338,122705
130063955,130110716,chrX,ELF4,chrX:130063955-130110716,46761
36985043,36993131,chr3,EPM2AIP1,chr3:36985043-36993131,8088
16692745,16694202,chr3,CDYLP1,chr3:16692745-16694202,1457
80542203,80542605,chr17,RPL32P31,chr17:80542203-80542605,402
21942566,21979828,chr3,ZNF385D-AS2,chr3:21942566-21979828,37262
8682943,8693701,chr3,OR7E122P,chr3:8682943-8693701,10758
13650696,13746638,chr3,LINC00620,chr3:13650696-13746638,95942
18782773,18791305,chr19,COMP,chr19:18782773-18791305,8532
96684712,97604997,chrX,DIAPH2,chrX:96684712-97604997,920285
80415165,80438086,chr17,ENDOV,chr17:80415165-80438086,22921
36976316,36976840,chr3,PRADC1P1,chr3:36976316-36976840,524
108784098,108785552,chr5,RACK1P1,chr5:108784098-108785552,1454
141351977,141352768,chr7,NDUFB10P2,chr7:141351977-141352768,791
68157888,68176238,chr2,PNO1,chr2:68157888-68176238,18350
27797552,27931579,chr3,LINC01980,chr3:27797552-27931579,134027
70094659,70128434,chr5,NAIPP2,chr5:70094659-70128434,33775
60743563,60744970,chr5,KRT8P31,chr5:60743563-60744970,1407
92840807,92841628,chr5,LDHBP3,chr5:92840807-92841628,821
8254527,8308855,chr12,ENPP7P5,chr12:8254527-8308855,54328
111496033,111512590,chr5,STARD4,chr5:111496033-111512590,16557
73758657,73846188,chr12,LINC02445,chr12:73758657-73846188,87531
106954029,106955497,chr12,TMEM263-DT,chr12:106954029-106955497,1468
108155607,108439497,chrX,COL4A6,chrX:108155607-108439497,283890
101218165,101224190,chr7,ZNHIT1,chr7:101218165-101224190,6025
19404045,19720801,chr12,AEBP2,chr12:19404045-19720801,316756
71064344,71079808,chr2,NAGK,chr2:71064344-71079808,15464
37134658,37135102,chr3,UBE2D3P2,chr3:37134658-37135102,444
142740206,142740894,chr7,TRBV29-1,chr7:142740206-142740894,688
31033788,31176138,chr8,WRN,chr8:31033788-31176138,142350
69330698,69331378,chr7,MTCO2P25,chr7:69330698-69331378,680
14489107,14556075,chr3,GRIP2,chr3:14489107-14556075,66968
149195546,149226238,chr7,ZNF282,chr7:149195546-149226238,30692
25726777,25727345,chr6,H2BC1,chr6:25726777-25727345,568
25726063,25726562,chr6,H2AC1,chr6:25726063-25726562,499
50713526,50773033,chr6,TFAP2D,chr6:50713526-50773033,59507
112180773,112183191,chr11,KCTD9P4,chr11:112180773-112183191,2418
112208601,112208898,chr11,MRPS36P4,chr11:112208601-112208898,297
112218326,112218720,chr11,RPS12P21,chr11:112218326-112218720,394
112226367,112269955,chr11,PTS,chr11:112226367-112269955,43588
121764585,121766814,chr4,PP12613,chr4:121764585-121766814,2229
18387350,18468870,chr6,RNF144B,chr6:18387350-18468870,81520
121801318,121817021,chr4,EXOSC9,chr4:121801318-121817021,15703
140518420,140673993,chr7,DENND2A,chr7:140518420-140673993,155573
3722614,3751713,chr6,PXDC1,chr6:3722614-3751713,29099
70594552,70595770,chr14,KRT18P7,chr14:70594552-70595770,1218
70608798,70641298,chr14,TTC9-DT,chr14:70608798-70641298,32500
70610086,70610379,chr14,RN7SL77P,chr14:70610086-70610379,293
70641916,70675366,chr14,TTC9,chr14:70641916-70675366,33450
150368892,150405969,chr6,IYD,chr6:150368892-150405969,37077
31847271,31848148,chr5,RPL5P14,chr5:31847271-31848148,877
38733290,38794143,chr22,SUN2,chr22:38733290-38794143,60853
118282575,118284782,chr5,LINC02148,chr5:118282575-118284782,2207
22994968,22995847,chr19,BNIP3P36,chr19:22994968-22995847,879
70698698,70712153,chr14,LINC01269,chr14:70698698-70712153,13455
17444010,17486829,chr5,LINC02218,chr5:17444010-17486829,42819
8501807,8574668,chr3,LMCD1,chr3:8501807-8574668,72861
57422464,57424391,chr5,SALL4P1,chr5:57422464-57424391,1927
112235371,112236025,chr11,RPS6P16,chr11:112235371-112236025,654
76242024,76242404,chr5,HMGN2P4,chr5:76242024-76242404,380
112248153,112260860,chr11,PLET1,chr11:112248153-112260860,12707
32934396,33820863,chr14,NPAS3,chr14:32934396-33820863,886467
77146568,77147165,chr5,HMGB1P35,chr5:77146568-77147165,597
15640897,15662825,chr19,CYP4F3,chr19:15640897-15662825,21928
58588809,58749791,chr15,ADAM10,chr15:58588809-58749791,160982
103528434,103541985,chr5,LINC02115,chr5:103528434-103541985,13551
112267290,112268371,chr11,ST13P10,chr11:112267290-112268371,1081
948421,948524,chr11,RNU6-1025P,chr11:948421-948524,103
94148577,94307675,chr12,PLXNC1,chr12:94148577-94307675,159098
1012823,1036718,chr11,MUC6,chr11:1012823-1036718,23895
115770586,115770989,chr5,H3P24,chr5:115770586-115770989,403
118596188,118628092,chr5,LINC02215,chr5:118596188-118628092,31904
96390333,96434143,chr5,PCSK1,chr5:96390333-96434143,43810
68125265,68125747,chr2,PPIAP64,chr2:68125265-68125747,482
74776499,74839753,chr17,TMEM104,chr17:74776499-74839753,63254
98024851,98046469,chr8,RPL30,chr8:98024851-98046469,21618
1049880,1055749,chr11,LINC02688,chr11:1049880-1055749,5869
55634061,55693863,chr2,PNPT1,chr2:55634061-55693863,59802
1074875,1110511,chr11,MUC2,chr11:1074875-1110511,35636
26622806,26717537,chr3,LRRC3B,chr3:26622806-26717537,94731
149126416,149183042,chr7,ZNF398,chr7:149126416-149183042,56626
110424687,110476641,chr6,SLC22A16,chr6:110424687-110476641,51954
30518833,30527193,chr3,LINC01985,chr3:30518833-30527193,8360
110439996,110440303,chr6,RN7SL617P,chr6:110439996-110440303,307
6892632,6894022,chr3,GRM7-AS2,chr3:6892632-6894022,1390
110391771,110415575,chr6,DDO,chr6:110391771-110415575,23804
36169767,36170448,chr3,RFC3P1,chr3:36169767-36170448,681
55264960,55325187,chr17,HLF,chr17:55264960-55325187,60227
99238829,99311130,chr7,MYH16,chr7:99238829-99311130,72301
86214063,86321146,chr8,SLC7A13,chr8:86214063-86321146,107083
90966040,90995629,chr15,PRC1,chr15:90966040-90995629,29589
21542789,21579959,chr3,ZNF385D-AS1,chr3:21542789-21579959,37170
1792553,1792870,chr11,RPL36AP39,chr11:1792553-1792870,317
2765393,2786952,chr6,WRNIP1,chr6:2765393-2786952,21559
23203020,23591794,chr3,UBE2E2,chr3:23203020-23591794,388774
1859464,1859536,chr11,MIR4298,chr11:1859464-1859536,72
1880045,1880147,chr11,MIR7847,chr11:1880045-1880147,102
1897015,1908656,chr11,LINC01150,chr11:1897015-1908656,11641
93617725,94111699,chr5,FAM172A,chr5:93617725-94111699,493974
85220587,85284073,chr8,CA13,chr8:85220587-85284073,63486
21750747,21753438,chr19,CCNYL6,chr19:21750747-21753438,2691
1919703,1938706,chr11,TNNT3,chr11:1919703-1938706,19003
23288620,23289345,chr19,VN1R90P,chr19:23288620-23289345,725
22609606,22610601,chr19,RAD54L2P1,chr19:22609606-22610601,995
2832332,2841959,chr6,SERPINB1,chr6:2832332-2841959,9627
14593577,14594200,chr9,CDCA4P1,chr9:14593577-14594200,623
14719724,14722733,chr9,CER1,chr9:14719724-14722733,3009
11745,24849,chr3,LINC01986,chr3:11745-24849,13104
54283304,54286787,chr16,IRX3,chr16:54283304-54286787,3483
21284672,21315232,chr17,MAP2K3,chr17:21284672-21315232,30560
14850429,14850535,chr9,RNU6-1260P,chr9:14850429-14850535,106
14921337,14922334,chr9,LDHAP4,chr9:14921337-14922334,997
2854031,2854107,chr6,MIR4645,chr6:2854031-2854107,76
44737661,44761619,chr3,KIAA1143,chr3:44737661-44761619,23958
2887270,2903309,chr6,SERPINB9,chr6:2887270-2903309,16039
94352923,94353653,chr8,RPS4XP10,chr8:94352923-94353653,730
15055057,15056052,chr9,PSIP1P1,chr9:15055057-15056052,995
138594285,138701362,chr7,SVOPL,chr7:138594285-138701362,107077
105304867,105327017,chr12,KCCAT198,chr12:105304867-105327017,22150
85159682,85159950,chr9,UBE2V1P10,chr9:85159682-85159950,268
47341614,47342089,chr12,PPIAP45,chr12:47341614-47342089,475
93849561,93850075,chr8,MYL12AP1,chr8:93849561-93850075,514
87782163,87784568,chr12,MKRN9P,chr12:87782163-87784568,2405
80558870,80559757,chr8,RPSAP47,chr8:80558870-80559757,887
20040446,20154404,chr3,KAT2B,chr3:20040446-20154404,113958
87772453,87786884,chr9,CTSL3P,chr9:87772453-87786884,14431
80707634,80709474,chr12,MYF6,chr12:80707634-80709474,1840
92699742,92879502,chr8,FLJ46284,chr8:92699742-92879502,179760
33503655,33510711,chr9,SUGT1P1,chr9:33503655-33510711,7056
69741871,69754926,chr16,NOB1,chr16:69741871-69754926,13055
33576380,33577014,chr9,SNX18P7,chr9:33576380-33577014,634
94378377,94436952,chr8,FSBP,chr8:94378377-94436952,58575
33580695,33607874,chr9,CYP4F26P,chr9:33580695-33607874,27179
121816444,121823883,chr4,CCNA2,chr4:121816444-121823883,7439
106977277,106987160,chr12,MTERF2,chr12:106977277-106987160,9883
2948159,2972165,chr6,SERPINB6,chr6:2948159-2972165,24006
33613848,33614009,chr9,PRSS3P4,chr9:33613848-33614009,161
101366417,101367005,chr8,DUXAP2,chr8:101366417-101367005,588
33617762,33618506,chr9,TRBV20OR9-2,chr9:33617762-33618506,744
90621995,90791632,chr8,TMEM64,chr8:90621995-90791632,169637
33624274,33625293,chr9,ANXA2P2,chr9:33624274-33625293,1019
33629121,33629586,chr9,TRBV21OR9-2,chr9:33629121-33629586,465
23046958,23063705,chr19,LINC01858,chr19:23046958-23063705,16747
33634111,33634246,chr9,TRBV22OR9-2,chr9:33634111-33634246,135
33638035,33638494,chr9,TRBV23OR9-2,chr9:33638035-33638494,459
80331573,80332541,chr5,RBMX2P5,chr5:80331573-80332541,968
33649047,33649614,chr9,TRBV24OR9-2,chr9:33649047-33649614,567
98085866,98161352,chr5,LINC01846,chr5:98085866-98161352,75486
121824329,121870487,chr4,BBS7,chr4:121824329-121870487,46158
33662166,33662663,chr9,TRBV25OR9-2,chr9:33662166-33662663,497
95473520,95515839,chr12,METAP2,chr12:95473520-95515839,42319
23525631,23687220,chr19,ZNF675,chr19:23525631-23687220,161589
33673504,33677499,chr9,PTENP1,chr9:33673504-33677499,3995
78997564,79236038,chr5,DMGDH,chr5:78997564-79236038,238474
33676785,33688011,chr9,PTENP1-AS,chr9:33676785-33688011,11226
33695767,33696059,chr9,TRBV26OR9-2,chr9:33695767-33696059,292
85714922,85715833,chr8,REXO1L12P,chr8:85714922-85715833,911
28241584,28325142,chr3,CMC1,chr3:28241584-28325142,83558
34040097,34059300,chr14,EGLN3-AS1,chr14:34040097-34059300,19203
82098451,82160577,chr8,LINC02839,chr8:82098451-82160577,62126
96638187,96638514,chr14,RN7SKP108,chr14:96638187-96638514,327
33775183,33818795,chr9,UBE2R2-AS1,chr9:33775183-33818795,43612
96738021,96793084,chr14,LINC02299,chr14:96738021-96793084,55063
91157285,91158748,chr8,CPP,chr8:91157285-91158748,1463
33732975,33738416,chr9,LINC01251,chr9:33732975-33738416,5441
129477875,129478101,chr7,SNRPGP3,chr7:129477875-129478101,226
33786221,33786828,chr9,TRBV29OR9-2,chr9:33786221-33786828,607
33817160,33920399,chr9,UBE2R2,chr9:33817160-33920399,103239
98189826,98294393,chr8,NIPAL2,chr8:98189826-98294393,104567
131110096,131496632,chr7,MKLN1,chr7:131110096-131496632,386536
33868540,33868665,chr9,RNU4ATAC11P,chr9:33868540-33868665,125
33934296,33934376,chr9,SNORD121B,chr9:33934296-33934376,80
76235055,76235623,chr16,RPL18P13,chr16:76235055-76235623,568
33952769,33952850,chr9,SNORD121A,chr9:33952769-33952850,81
33968071,33968518,chr9,OSTCP8,chr9:33968071-33968518,447
17309518,17323298,chr19,DDA1,chr19:17309518-17323298,13780
34049966,34050244,chr9,RN7SKP114,chr9:34049966-34050244,278
72112157,72176878,chr16,PMFBP1,chr16:72112157-72176878,64721
34086387,34127399,chr9,DCAF12,chr9:34086387-34127399,41012
70722526,70809534,chr14,MAP3K9,chr14:70722526-70809534,87008
47345158,47387601,chr2,EPCAM,chr2:47345158-47387601,42443
34109171,34109968,chr9,TUBB4BP2,chr9:34109171-34109968,797
17157162,18444817,chr3,TBC1D5,chr3:17157162-18444817,1287655
19264364,19273391,chr19,TM6SF2,chr19:19264364-19273391,9027
87724051,87731469,chr9,CTSL,chr9:87724051-87731469,7418
24719034,24774720,chr22,PIWIL3,chr22:24719034-24774720,55686
41271431,41271566,chr8,RPS29P2,chr8:41271431-41271566,135
85463968,85481493,chr8,CA2,chr8:85463968-85481493,17525
86087526,86087847,chr5,PTP4A1P4,chr5:86087526-86087847,321
93718542,94070898,chr15,LINC01579,chr15:93718542-94070898,352356
58107631,58122375,chr5,LINC02101,chr5:58107631-58122375,14744
121870583,121872848,chr4,BBS7-DT,chr4:121870583-121872848,2265
77582376,77583122,chr5,RPL7P23,chr5:77582376-77583122,746
121874481,121952060,chr4,TRPC3,chr4:121874481-121952060,77579
18990888,19034023,chr19,SUGP2,chr19:18990888-19034023,43135
114576041,114579970,chr5,LINC01957,chr5:114576041-114579970,3929
111912508,112017309,chr5,NREP-AS1,chr5:111912508-112017309,104801
79689836,79800240,chr5,CMYA5,chr5:79689836-79800240,110404
49773283,49827873,chr22,BRD1,chr22:49773283-49827873,54590
83447228,83618743,chr15,SH3GL3,chr15:83447228-83618743,171515
70516387,70555266,chr5,GUSBP15,chr5:70516387-70555266,38879
66398069,66416854,chr17,PRKCA-AS1,chr17:66398069-66416854,18785
27830573,28180795,chr7,JAZF1,chr7:27830573-28180795,350222
76985965,77009791,chr2,LRRTM4-AS1,chr2:76985965-77009791,23826
100051920,100052597,chr5,MTATP6P2,chr5:100051920-100052597,677
14737152,14910995,chr9,FREM1,chr9:14737152-14910995,173843
83875166,83875821,chr5,ZP3P1,chr5:83875166-83875821,655
42465400,42468868,chr5,SERBP1P6,chr5:42465400-42468868,3468
48780602,48780895,chr2,ELOBP3,chr2:48780602-48780895,293
92247697,92363832,chr12,LINC02391,chr12:92247697-92363832,116135
90993802,91040872,chr8,PIP4P2,chr8:90993802-91040872,47070
117245551,117246164,chr12,ELOCP32,chr12:117245551-117246164,613
82031678,82034204,chr17,RAC3,chr17:82031678-82034204,2526
55424854,55534969,chr5,PLPP1,chr5:55424854-55534969,110115
28782517,28850611,chr2,SPDYA,chr2:28782517-28850611,68094
54455950,54473602,chr12,GTSF1,chr12:54455950-54473602,17652
39031919,39109646,chr14,SEC23A,chr14:39031919-39109646,77727
77788564,77980107,chr16,VAT1L,chr16:77788564-77980107,191543
138490581,138491361,chr7,RPS3AP28,chr7:138490581-138491361,780
130506238,130668748,chr7,COPG2,chr7:130506238-130668748,162510
96235427,96239149,chr8,UQCRB-AS1,chr8:96235427-96239149,3722
13318647,13320053,chrX,ATXN3L,chrX:13318647-13320053,1406
8464830,8466510,chrX,VCX3B,chrX:8464830-8466510,1680
93134095,93166850,chr8,LINC02906,chr8:93134095-93166850,32755
80608623,80622524,chr5,LINC01337,chr5:80608623-80622524,13901
58087892,58093362,chr12,LINC02403,chr12:58087892-58093362,5470
67657512,67660815,chr16,ACD,chr16:67657512-67660815,3303
98769618,98773469,chr5,RGMB-AS1,chr5:98769618-98773469,3851
39584489,39730065,chr8,ADAM18,chr8:39584489-39730065,145576
70268305,70281840,chrX,ARR3,chrX:70268305-70281840,13535
31618491,31662221,chr22,PISD,chr22:31618491-31662221,43730
48133442,48430275,chr17,SKAP1,chr17:48133442-48430275,296833
96783389,96785615,chr15,SPATA8,chr15:96783389-96785615,2226
62466817,62600476,chr12,MON2,chr12:62466817-62600476,133659
37899363,37920869,chr5,LINC02117,chr5:37899363-37920869,21506
115828200,115841837,chr5,ATG12,chr5:115828200-115841837,13637
22840432,22840921,chr19,BNIP3P35,chr19:22840432-22840921,489
20175013,20177063,chr19,BNIP3P16,chr19:20175013-20177063,2050
121494519,121494821,chr9,RN7SL187P,chr9:121494519-121494821,302
45005182,45009452,chr2,SIX2,chr2:45005182-45009452,4270
121519816,121520424,chr9,HMGB1P37,chr9:121519816-121520424,608
1947278,1984522,chr11,MRPL23,chr11:1947278-1984522,37244
15604381,15681679,chr4,FBXL5,chr4:15604381-15681679,77298
128120693,128128462,chr9,PTGES2,chr9:128120693-128128462,7769
23380317,23380876,chr19,BNIP3P8,chr19:23380317-23380876,559
22699352,22699685,chr19,RPL34P33,chr19:22699352-22699685,333
81461358,81467468,chr2,LINC01815,chr2:81461358-81467468,6110
48458537,48470260,chrX,SLC38A5,chrX:48458537-48470260,11723
23015059,23031818,chr19,LINC01859,chr19:23015059-23031818,16759
44941702,44946071,chr2,SIX3,chr2:44941702-44946071,4369
78250502,78264156,chr15,DNAJA4-DT,chr15:78250502-78264156,13654
71130632,71150101,chr2,MPHOSPH10,chr2:71130632-71150101,19469
22137931,22138981,chr19,PCGF7P,chr19:22137931-22138981,1050
2987967,2991173,chr6,LINC01011,chr6:2987967-2991173,3206
23384530,23385293,chr19,CDC42EP3P1,chr19:23384530-23385293,763
1991096,1993670,chr11,LINC01219,chr11:1991096-1993670,2574
2989335,2999604,chr6,NQO2-AS1,chr6:2989335-2999604,10269
84600986,84627796,chr15,ZSCAN2,chr15:84600986-84627796,26810
22298977,22299868,chr19,BNIP3P31,chr19:22298977-22299868,891
1996759,1996831,chr11,MIR675,chr11:1996759-1996831,72
54591480,54592409,chr11,OR4C50P,chr11:54591480-54592409,929
3023142,3023772,chr6,HTATSF1P2,chr6:3023142-3023772,630
79585843,79600737,chr16,MAF,chr16:79585843-79600737,14894
54603069,54603998,chr11,OR4C46,chr11:54603069-54603998,929
54635037,54635955,chr11,OR4C7P,chr11:54635037-54635955,918
3045384,3045800,chr6,FAM136BP,chr6:3045384-3045800,416
21149648,21150438,chr19,RPL7AP10,chr19:21149648-21150438,790
54657120,54657716,chr11,OR4R2P,chr11:54657120-54657716,596
54659667,54660596,chr11,OR4A4P,chr11:54659667-54660596,929
54662580,54663450,chr11,OR4A3P,chr11:54662580-54663450,870
3048835,3049211,chr6,SERPINB8P1,chr6:3048835-3049211,376
54667298,54668210,chr11,OR4A2P,chr11:54667298-54668210,912
5985892,5986985,chr11,OR52L1,chr11:5985892-5986985,1093
3088686,3088809,chr6,RNA5SP201,chr6:3088686-3088809,123
5993876,5994995,chr11,KRT18P58,chr11:5993876-5994995,1119
68843531,69085182,chr16,TANGO6,chr16:68843531-69085182,241651
6016996,6017114,chr11,RNA5SP329,chr11:6016996-6017114,118
6045807,6046747,chr11,OR56A7P,chr11:6045807-6046747,940
6066873,6067786,chr11,OR52X1P,chr11:6066873-6067786,913
3118374,3153578,chr6,BPHL,chr6:3118374-3153578,35204
19145567,19192131,chr19,MEF2B,chr19:19145567-19192131,46564
6107684,6108835,chr11,OR56B4,chr11:6107684-6108835,1151
155003448,155005703,chr7,PAXIP1-DT,chr7:155003448-155005703,2255
6128610,6129556,chr11,OR56B3P,chr11:6128610-6129556,946
6057286,6058275,chr11,OR52L2P,chr11:6057286-6058275,989
5726502,5727464,chr11,OR52P1P,chr11:5726502-5727464,962
135728348,135748813,chr7,FAM180A,chr7:135728348-135748813,20465
5177714,5178664,chr11,OR52Z1,chr11:5177714-5178664,950
56971050,56971979,chr11,OR5AK3P,chr11:56971050-56971979,929
57018100,57019021,chr11,OR5AK1P,chr11:57018100-57019021,921
57029408,57029722,chr11,OR5BQ1P,chr11:57029408-57029722,314
131385249,131385363,chr11,RNU6ATAC12P,chr11:131385249-131385363,114
48632856,48633353,chr2,TPT1P11,chr2:48632856-48633353,497
26764284,26781231,chr2,SLC35F6,chr2:26764284-26781231,16947
102913000,102945111,chr7,LRRC17,chr7:102913000-102945111,32111
103258763,103278660,chr5,MACIR,chr5:103258763-103278660,19897
131622451,131663583,chr11,NTM-AS1,chr11:131622451-131663583,41132
124324871,124325789,chr11,OR8B7P,chr11:124324871-124325789,918
39103140,39103812,chr14,SEC23A-AS1,chr14:39103140-39103812,672
124338783,124339662,chr11,OR8B6P,chr11:124338783-124339662,879
39108342,39108707,chr14,PPIAP4,chr14:39108342-39108707,365
124357560,124358469,chr11,OR8B5P,chr11:124357560-124358469,909
124365465,124367298,chr11,OR8B1P,chr11:124365465-124367298,1833
32190435,32205073,chr22,RFPL2,chr22:32190435-32205073,14638
39147811,39170532,chr14,TRAPPC6B,chr14:39147811-39170532,22721
124376877,124377801,chr11,OR8C1P,chr11:124376877-124377801,924
124404234,124405102,chr11,OR8X1P,chr11:124404234-124405102,868
124460534,124461485,chr11,OR8A2P,chr11:124460534-124461485,951
88408982,88439090,chr5,LINC02060,chr5:88408982-88439090,30108
124476963,124482870,chr11,OR8B9P,chr11:124476963-124482870,5907
6533618,6535118,chrX,VCX3A,chrX:6533618-6535118,1500
124516311,124517242,chr11,OR8B10P,chr11:124516311-124517242,931
48718083,48719143,chr16,KLF8P1,chr16:48718083-48719143,1060
55838801,55840025,chr5,HNRNPH1P3,chr5:55838801-55840025,1224
124531625,124531910,chr11,OR8A3P,chr11:124531625-124531910,285
99549432,99577957,chr5,LINC02113,chr5:99549432-99577957,28525
124566660,124582942,chr11,OR8A1,chr11:124566660-124582942,16282
19940269,19943310,chr3,HSPA8P18,chr3:19940269-19943310,3041
139777051,140020325,chr7,TBXAS1,chr7:139777051-140020325,243274
124601584,124602238,chr11,OR8Q1P,chr11:124601584-124602238,654
60682873,60683244,chr2,IFITM3P9,chr2:60682873-60683244,371
21009808,21028013,chr22,P2RX6,chr22:21009808-21028013,18205
124224732,124225666,chr11,OR8G2P,chr11:124224732-124225666,934
152708261,152714549,chrX,CSAG2,chrX:152708261-152714549,6288
34941837,34941920,chr11,MIR1343,chr11:34941837-34941920,83
35210343,35214985,chr11,CD44-AS1,chr11:35210343-35214985,4642
76277278,76560757,chr16,CNTNAP4,chr16:76277278-76560757,283479
31452832,31455894,chr3,THRAP3P1,chr3:31452832-31455894,3062
95801580,96053482,chr13,UGGT2,chr13:95801580-96053482,251902
88459477,88467390,chr15,MRPL46,chr15:88459477-88467390,7913
54029552,54030682,chr2,RPL21P30,chr2:54029552-54030682,1130
28926816,28927023,chr5,LSP1P3,chr5:28926816-28927023,207
100062275,100067954,chr5,GUSBP7,chr5:100062275-100067954,5679
74958643,74970128,chr2,POLE4,chr2:74958643-74970128,11485
30237382,30240997,chr8,HSPA8P11,chr8:30237382-30240997,3615
103576231,103587729,chrX,TCEAL4,chrX:103576231-103587729,11498
3177044,3179764,chr6,TUBB2BP1,chr6:3177044-3179764,2720
126631705,126636284,chr5,TEX43,chr5:126631705-126636284,4579
24356903,24358285,chr6,KAAG1,chr6:24356903-24358285,1382
70258978,70354873,chr9,SMC5,chr9:70258978-70354873,95895
10324023,10708007,chr3,ATP2B2,chr3:10324023-10708007,383984
24365651,24365754,chr6,RNU6-391P,chr6:24365651-24365754,103
91909738,91910167,chr8,PRR13P7,chr8:91909738-91910167,429
24424565,24495205,chr6,GPLD1,chr6:24424565-24495205,70640
101751032,101794302,chr15,DNM1P47,chr15:101751032-101794302,43270
35251205,35420063,chr11,SLC1A2,chr11:35251205-35420063,168858
99996547,99997932,chr5,EEF1A1P20,chr5:99996547-99997932,1385
73290929,73293701,chr2,EGR4,chr2:73290929-73293701,2772
39156742,39157852,chr14,RPL7AP2,chr14:39156742-39157852,1110
52889666,52889954,chr5,B3GNTL1P1,chr5:52889666-52889954,288
39175183,39183220,chr14,PNN,chr14:39175183-39183220,8037
21709522,21710191,chr19,MTDHP4,chr19:21709522-21710191,669
100849831,100876836,chr15,GCAWKR,chr15:100849831-100876836,27005
56275304,56276630,chr5,PSMC1P4,chr5:56275304-56276630,1326
84290683,84292202,chr2,FUNDC2P2,chr2:84290683-84292202,1519
38728186,38853028,chr8,TACC1,chr8:38728186-38853028,124842
21142024,21196053,chr19,ZNF431,chr19:21142024-21196053,54029
101887354,101887767,chr15,WBP1LP5,chr15:101887354-101887767,413
15681662,15690447,chr4,FAM200B,chr4:15681662-15690447,8785
70985942,70994873,chr2,TEX261,chr2:70985942-70994873,8931
54192823,54358642,chrX,WNK3,chrX:54192823-54358642,165819
87576929,87579866,chr15,LINC00052,chr15:87576929-87579866,2937
101842119,101850324,chr15,OR4F13P,chr15:101842119-101850324,8205
111572102,111572239,chr5,HMGN1P13,chr5:111572102-111572239,137
100919327,101078257,chr15,LRRK1,chr15:100919327-101078257,158930
90529344,91164437,chr5,ADGRV1,chr5:90529344-91164437,635093
22203128,22204003,chr19,BNIP3P30,chr19:22203128-22204003,875
27638483,27646483,chr19,ERVK-28,chr19:27638483-27646483,8000
39215065,39216335,chr14,YTHDF2P1,chr14:39215065-39216335,1270
22457329,22458212,chr19,BNIP3P33,chr19:22457329-22458212,883
39265703,39267061,chr14,MIA2-AS1,chr14:39265703-39267061,1358
79025686,79028505,chr2,REG3G,chr2:79025686-79028505,2819
20351502,20352079,chr19,BNIP3P20,chr19:20351502-20352079,577
22532626,22533494,chr19,LINC01233,chr19:22532626-22533494,868
70579163,70579461,chr9,RN7SL726P,chr9:70579163-70579461,298
70809975,70810084,chr9,MIR204,chr9:70809975-70810084,109
23290849,23291017,chr19,VN1R91P,chr19:23290849-23291017,168
70916997,70917501,chr9,PIGUP1,chr9:70916997-70917501,504
22065828,22066398,chr19,BNIP3P29,chr19:22065828-22066398,570
71589601,71589933,chr9,RPL35AP21,chr9:71589601-71589933,332
104504263,104505222,chr9,OR13F1,chr9:104504263-104505222,959
96797304,96954846,chr14,VRK1,chr14:96797304-96954846,157542
22391019,22532485,chr19,ZNF98,chr19:22391019-22532485,141466
104526253,104527209,chr9,OR13C4,chr9:104526253-104527209,956
104569168,104570130,chr9,OR13C8,chr9:104569168-104570130,962
104590044,104590950,chr9,OR13D2P,chr9:104590044-104590950,906
104598457,104599413,chr9,OR13C5,chr9:104598457-104599413,956
104604671,104605627,chr9,OR13C2,chr9:104604671-104605627,956
104617248,104618204,chr9,OR13C9,chr9:104617248-104618204,956
104629754,104631017,chr9,OR13I1P,chr9:104629754-104631017,1263
104655363,104659055,chr9,OR13C1P,chr9:104655363-104659055,3692
15703065,15738313,chr4,BST1,chr4:15703065-15738313,35248
21291160,21329425,chr19,ZNF708,chr19:21291160-21329425,38265
104722335,104723271,chr9,OR13D3P,chr9:104722335-104723271,936
104747683,104760120,chr9,NIPSNAP3A,chr9:104747683-104760120,12437
24494867,24537207,chr6,ALDH5A1,chr6:24494867-24537207,42340
79120362,79123409,chr2,REG1A,chr2:79120362-79123409,3047
155071420,155123077,chrX,BRCC3,chrX:155071420-155123077,51657
104764129,104777764,chr9,NIPSNAP3B,chr9:104764129-104777764,13635
20416514,20417069,chr19,BNIP3P22,chr19:20416514-20417069,555
22140532,22141117,chr19,MTDHP5,chr19:22140532-22141117,585
24098425,24098980,chr19,BNIP3P40,chr19:24098425-24098980,555
16015287,16027462,chr19,LINC00661,chr19:16015287-16027462,12175
38078134,38084184,chr22,SLC16A8,chr22:38078134-38084184,6050
104970593,104991818,chr9,CT70,chr9:104970593-104991818,21225
88915081,88915378,chr2,IGKV7-3,chr2:88915081-88915378,297
38751534,38785002,chr2,GEMIN6,chr2:38751534-38785002,33468
104781006,104928155,chr9,ABCA1,chr9:104781006-104928155,147149
38656636,38673850,chr22,CBY1,chr22:38656636-38673850,17214
50560715,50627474,chr17,CACNA1G,chr17:50560715-50627474,66759
22174766,22175191,chr19,VN1R85P,chr19:22174766-22175191,425
83522814,83523502,chr2,LINC01809,chr2:83522814-83523502,688
35219377,35219604,chr2,SMIM7P1,chr2:35219377-35219604,227
19629476,19643657,chr19,GMIP,chr19:19629476-19643657,14181
84633874,84634635,chr15,EGLN1P1,chr15:84633874-84634635,761
66802875,66873256,chr16,NAE1,chr16:66802875-66873256,70381
43227210,43228855,chr2,LINC01126,chr2:43227210-43228855,1645
70808643,70820599,chr2,CLEC4F,chr2:70808643-70820599,11956
48971803,48973361,chr15,KRT8P24,chr15:48971803-48973361,1558
99098217,99135593,chr15,SYNM,chr15:99098217-99135593,37376
153785766,153794512,chrX,IDH3G,chrX:153785766-153794512,8746
54509812,54539292,chr14,CGRRF1,chr14:54509812-54539292,29480
53532672,53860160,chr2,ASB3,chr2:53532672-53860160,327488
69791872,69813888,chr4,SULT1D1P,chr4:69791872-69813888,22016
159006522,159030195,chr7,LINC00689,chr7:159006522-159030195,23673
69841212,69860145,chr4,SULT1E1,chr4:69841212-69860145,18933
98437162,98547728,chr15,FAM169B,chr15:98437162-98547728,110566
155067034,155072450,chr7,HTR5A-AS1,chr7:155067034-155072450,5416
24598012,24599790,chr6,KRT8P43,chr6:24598012-24599790,1778
24649979,24666930,chr6,TDP2,chr6:24649979-24666930,16951
42500553,42512562,chr22,SERHL,chr22:42500553-42512562,12009
159028175,159144867,chr7,VIPR2,chr7:159028175-159144867,116692
96388214,96389056,chr15,TUBAP12,chr15:96388214-96389056,842
74653437,74713117,chr14,AREL1,chr14:74653437-74713117,59680
51082119,51200252,chr13,C13orf42,chr13:51082119-51200252,118133
92900189,93027996,chr15,CHD2,chr15:92900189-93027996,127807
69931068,69946574,chr4,CSN1S1,chr4:69931068-69946574,15506
24667035,24705065,chr6,ACOT13,chr6:24667035-24705065,38030
13214056,13214219,chr6,RNU1-11P,chr6:13214056-13214219,163
13266542,13328583,chr6,TBC1D7,chr6:13266542-13328583,62041
27221349,27225134,chr22,LINC01638,chr22:27221349-27225134,3785
34129752,34132314,chrX,FAM47A,chrX:34129752-34132314,2562
85003877,85093315,chrX,APOOL,chrX:85003877-85093315,89438
18029385,18037970,chr22,LINC01634,chr22:18029385-18037970,8585
34942270,35673022,chr13,NBEA,chr13:34942270-35673022,730752
26646411,26676475,chr22,MIAT,chr22:26646411-26676475,30064
22128627,22130318,chr19,ZNF92P2,chr19:22128627-22130318,1691
115561174,115650861,chrX,PLS3,chrX:115561174-115650861,89687
23236308,23236851,chr19,BNIP3P38,chr19:23236308-23236851,543
17962079,17963029,chr7,MRM3P2,chr7:17962079-17963029,950
23075210,23147221,chr19,ZNF730,chr19:23075210-23147221,72011
22685167,22686732,chr19,ZNF849P,chr19:22685167-22686732,1565
15602189,15619109,chr5,CTD-2350J17.1,chr5:15602189-15619109,16920
23255053,23257939,chr19,IPO5P1,chr19:23255053-23257939,2886
98392070,98393530,chr5,KRT8P32,chr5:98392070-98393530,1460
19785839,19821751,chr19,ZNF506,chr19:19785839-19821751,35912
68679601,68826833,chr2,ARHGAP25,chr2:68679601-68826833,147232
126663337,126663568,chr5,BOLA3P3,chr5:126663337-126663568,231
7356203,7535873,chr7,COL28A1,chr7:7356203-7535873,179670
109334713,109409974,chr5,PJA2,chr5:109334713-109409974,75261
69639459,69679259,chr5,GUSBP3,chr5:69639459-69679259,39800
19254756,19262804,chr19,HAPLN4,chr19:19254756-19262804,8048
94637285,94639467,chr8,LINC02894,chr8:94637285-94639467,2182
98102344,98117171,chr8,RIDA,chr8:98102344-98117171,14827
22368599,22368952,chr19,RPL34P34,chr19:22368599-22368952,353
116716243,116716650,chr5,RPS17P2,chr5:116716243-116716650,407
22596257,22603550,chr19,GOLGA2P9,chr19:22596257-22603550,7293
72956041,73090522,chr5,FCHO2,chr5:72956041-73090522,134481
32390050,32405560,chr19,DPY19L3-DT,chr19:32390050-32405560,15510
21677550,21678221,chr19,MTDHP3,chr19:21677550-21678221,671
13479724,13506424,chr3,HDAC11,chr3:13479724-13506424,26700
29213235,29216604,chr19,UQCRFS1-DT,chr19:29213235-29216604,3369
23492428,23512656,chr19,ZNF725P,chr19:23492428-23512656,20228
23390605,23402726,chr22,ZDHHC8P1,chr22:23390605-23402726,12121
159231435,159233377,chr7,PIP5K1P2,chr7:159231435-159233377,1942
22974883,23003176,chr19,ZNF728,chr19:22974883-23003176,28293
100150623,100154003,chr8,POLR2K,chr8:100150623-100154003,3380
1022933,1023026,chr7,MIR339,chr7:1022933-1023026,93
5180061,5180162,chr7,RNU6-215P,chr7:5180061-5180162,101
124853417,124857890,chr9,WDR38,chr9:124853417-124857890,4473
6016877,6017011,chr7,SNORA80D,chr7:6016877-6017011,134
6047721,6048023,chr7,RN7SL851P,chr7:6047721-6048023,302
6057500,6057604,chr7,RNU6-218P,chr7:6057500-6057604,104
4788565,4788639,chr7,MIR4656,chr7:4788565-4788639,74
7066964,7067045,chr7,MIR3683,chr7:7066964-7067045,81
21289554,21289998,chr19,VN1R83P,chr19:21289554-21289998,444
12582915,12585404,chr6,LINC02530,chr6:12582915-12585404,2489
123872626,123873932,chrX,XIAP-AS1,chrX:123872626-123873932,1306
7906519,7906624,chr7,RNU6-534P,chr7:7906519-7906624,105
123874459,123874565,chrX,RNU6-122P,chrX:123874459-123874565,106
17121530,17132105,chr22,LINC01664,chr22:17121530-17132105,10575
123878590,123879296,chrX,PARD6BP1,chrX:123878590-123879296,706
69995966,70002570,chr4,STATH,chr4:69995966-70002570,6604
12876684,12876946,chr7,RN7SKP228,chr7:12876684-12876946,262
29002319,29015160,chr19,LINC01532,chr19:29002319-29015160,12841
19705358,19705436,chr7,MIR3146,chr7:19705358-19705436,78
21381363,21381506,chr7,RNU1-15P,chr7:21381363-21381506,143
145382535,145736023,chr6,EPM2A,chr6:145382535-145736023,353488
21471058,21471146,chr7,MIR1183,chr7:21471058-21471146,88
21215537,21215830,chr7,RN7SL542P,chr7:21215537-21215830,293
24132705,24132837,chr7,RNA5SP228,chr7:24132705-24132837,132
23396446,23396516,chr7,SNORD65C,chr7:23396446-23396516,70
123960212,124422664,chrX,STAG2,chrX:123960212-124422664,462452
42555212,42582039,chr22,RRP7BP,chr22:42555212-42582039,26827
24537332,24537438,chr7,RNU6-1103P,chr7:24537332-24537438,106
132410043,132573319,chr9,CFAP77,chr9:132410043-132573319,163276
85744543,85748373,chr8,REXO1L10P,chr8:85744543-85748373,3830
30289794,30289890,chr7,MIR550A1,chr7:30289794-30289890,96
30289794,30289890,chr7,MIR550B1,chr7:30289794-30289890,96
28118113,28118219,chr7,RNU6-979P,chr7:28118113-28118219,106
25949919,25949986,chr7,MIR148A,chr7:25949919-25949986,67
34297496,34297598,chr7,RNU6-438P,chr7:34297496-34297598,102
32732981,32733077,chr7,MIR550A2,chr7:32732981-32733077,96
86342547,86478420,chr8,WWP1,chr8:86342547-86478420,135873
32732981,32733077,chr7,MIR550B2,chr7:32732981-32733077,96
38531042,38531338,chr7,RN7SL83P,chr7:38531042-38531338,296
34753424,34753719,chr7,RN7SL132P,chr7:34753424-34753719,295
39329003,39329134,chr7,SNORA20B,chr7:39329003-39329134,131
36919357,36919432,chr7,MIR1200,chr7:36919357-36919432,75
23123188,23124088,chr19,BNIP3P37,chr19:23123188-23124088,900
37351143,37351242,chr7,RNU6-565P,chr7:37351143-37351242,99
44503773,44503879,chr7,RNU6-1097P,chr7:44503773-44503879,106
21233335,21233652,chr19,RPL36AP51,chr19:21233335-21233652,317
43150895,43150994,chr7,MIR3943,chr7:43150895-43150994,99
43194421,43194482,chr7,RNU7-35P,chr7:43194421-43194482,61
43207762,43207866,chr7,RNU6-575P,chr7:43207762-43207866,104
45104349,45104482,chr7,SNORA5A,chr7:45104349-45104482,133
74713144,74738620,chr14,FCF1,chr14:74713144-74738620,25476
45104906,45105042,chr7,SNORA5C,chr7:45104906-45105042,136
45105968,45106099,chr7,SNORA5B,chr7:45105968-45106099,131
44985378,44985510,chr7,SNORA9,chr7:44985378-44985510,132
53490148,53490439,chr7,RN7SKP218,chr7:53490148-53490439,291
33373685,33382686,chr19,CEBPG,chr19:33373685-33382686,9001
51716657,51716922,chr7,RN7SL292P,chr7:51716657-51716922,265
70050438,70058848,chr4,HTN1,chr4:70050438-70058848,8410
55685977,55686081,chr7,RNU6-389P,chr7:55685977-55686081,104
135521438,135526540,chr9,LCN1,chr9:135521438-135526540,5102
53776136,53776324,chr7,RNU2-29P,chr7:53776136-53776324,188
53366058,53366209,chr7,RNU1-14P,chr7:53366058-53366209,151
56055365,56055502,chr7,SNORA22B,chr7:56055365-56055502,137
82817538,82818061,chr2,MTND6P7,chr2:82817538-82818061,523
71102898,71128753,chr5,NAIPP4,chr5:71102898-71128753,25855
56060470,56060602,chr7,SNORA15,chr7:56060470-56060602,132
50435380,50435486,chr7,RNU6-1091P,chr7:50435380-50435486,106
55789368,55789474,chr7,RNU6-1126P,chr7:55789368-55789474,106
54621025,54621131,chr7,RNU6-1125P,chr7:54621025-54621131,106
56402070,56402173,chr7,RNU6-1052P,chr7:56402070-56402173,103
56340231,56340337,chr7,RNU6-1335P,chr7:56340231-56340337,106
63011463,63011569,chr7,RNU6-417P,chr7:63011463-63011569,106
100050359,100050650,chr5,MTND4LP5,chr5:100050359-100050650,291
66820684,66822570,chr2,DNMT3AP1,chr2:66820684-66822570,1886
65755526,65755659,chr7,SNORA22,chr7:65755526-65755659,133
32972209,32978229,chr19,FAAP24,chr19:32972209-32978229,6020
65760052,65760186,chr7,SNORA15B-2,chr7:65760052-65760186,134
63621090,63621169,chr7,MIR4283-2,chr7:63621090-63621169,79
24330402,24330674,chr2,HMGN2P20,chr2:24330402-24330674,272
65814672,65814775,chr7,RNU6-912P,chr7:65814672-65814775,103
69401202,69401303,chr7,RNU6-229P,chr7:69401202-69401303,101
68723911,68724048,chr7,RNA5SP231,chr7:68723911-68724048,137
67114322,67114397,chr7,MIR4650-1,chr7:67114322-67114397,75
71913738,71913856,chr7,RNA5SP232,chr7:71913738-71913856,118
65859660,65859766,chr7,RNU6-973P,chr7:65859660-65859766,106
46293667,46386697,chr2,EPAS1,chr2:46293667-46386697,93030
69125270,69125376,chr7,RNU6-832P,chr7:69125270-69125376,106
66344303,66344414,chr7,RNU6-313P,chr7:66344303-66344414,111
112707498,112846239,chr5,APC,chr5:112707498-112846239,138741
71307672,71307770,chr7,MIR3914-1,chr7:71307672-71307770,98
71307674,71307768,chr7,MIR3914-2,chr7:71307674-71307768,94
71685452,71685747,chr7,RN7SKP75,chr7:71685452-71685747,295
66980120,66980410,chr7,RN7SL43P,chr7:66980120-66980410,290
79654109,79654227,chr7,RNA5SP234,chr7:79654109-79654227,118
80245926,80246225,chr7,RN7SL869P,chr7:80245926-80246225,299
79912104,79912208,chr7,RNU6-849P,chr7:79912104-79912208,104
70067386,70085290,chr4,CSN1S2AP,chr4:70067386-70085290,17904
80318253,80318544,chr7,RN7SL35P,chr7:80318253-80318544,291
89754620,89754726,chr7,RNU6-274P,chr7:89754620-89754726,106
92701708,92701814,chr7,RNU6-10P,chr7:92701708-92701814,106
123033667,123035665,chr9,GPR21,chr9:123033667-123035665,1998
94801514,94801812,chr7,RN7SKP129,chr7:94801514-94801812,298
93716928,93717005,chr7,MIR4652,chr7:93716928-93717005,77
94495299,94495404,chr7,RNU6-1328P,chr7:94495299-94495404,105
95098227,95098367,chr7,RNU4-16P,chr7:95098227-95098367,140
109130293,109167249,chr9,FRRS1L,chr9:109130293-109167249,36956
94712409,94712511,chr7,RNU6-956P,chr7:94712409-94712511,102
97598933,97599260,chr7,RN7SKP104,chr7:97598933-97599260,327
97963658,97963726,chr7,MIR5692A1,chr7:97963658-97963726,68
97964405,97964481,chr7,MIR5692C2,chr7:97964405-97964481,76
83017898,83018011,chr7,RNA5SP235,chr7:83017898-83018011,113
96330638,96330744,chr7,RNU6-532P,chr7:96330638-96330744,106
96341140,96341246,chr7,RNU6-364P,chr7:96341140-96341246,106
92971002,92971299,chr7,RN7SL7P,chr7:92971002-92971299,297
97998325,97998622,chr7,RN7SL478P,chr7:97998325-97998622,297
96377857,96377920,chr7,RNU7-188P,chr7:96377857-96377920,63
96219662,96219756,chr7,MIR591,chr7:96219662-96219756,94
42364387,42369284,chr22,LINC01315,chr22:42364387-42369284,4897
70133616,70176799,chr4,PRR27,chr4:70133616-70176799,43183
100530362,100530659,chr7,RN7SL416P,chr7:100530362-100530659,297
96940068,96940364,chr7,RN7SL252P,chr7:96940068-96940364,296
101269938,101270041,chr7,RNU6-1104P,chr7:101269938-101270041,103
21800480,21801266,chr19,BRI3BPP1,chr19:21800480-21801266,786
135546126,135549969,chr9,OBP2A,chr9:135546126-135549969,3843
106781600,106781715,chr7,RNA5SP236,chr7:106781600-106781715,115
31149979,31349436,chr19,TSHZ3,chr19:31149979-31349436,199457
102834605,102834708,chr7,RNU6-1136P,chr7:102834605-102834708,103
102857450,102857755,chr7,RN7SKP198,chr7:102857450-102857755,305
115581315,115581442,chr7,SNORA25B,chr7:115581315-115581442,127
49444274,49495003,chr13,SETDB2,chr13:49444274-49495003,50729
120672871,120672975,chr7,RNU6-581P,chr7:120672871-120672975,104
121736443,121736725,chr7,RN7SKP277,chr7:121736443-121736725,282
121083700,121083813,chr7,RNA5SP241,chr7:121083700-121083813,113
128207872,128207943,chr7,MIR129-1,chr7:128207872-128207943,71
121194948,121195057,chr7,RNU6-517P,chr7:121194948-121195057,109
101159473,101159555,chr7,MIR4653,chr7:101159473-101159555,82
128081861,128081960,chr7,MIR593,chr7:128081861-128081960,99
111953653,111953765,chr7,RNA5SP237,chr7:111953653-111953765,112
127058088,127058184,chr7,MIR592,chr7:127058088-127058184,96
129774905,129775014,chr7,MIR183,chr7:129774905-129775014,109
129770383,129770492,chr7,MIR182,chr7:129770383-129770492,109
120005976,120006101,chr7,RNU1-29P,chr7:120005976-120006101,125
74763316,74859435,chr14,YLPM1,chr14:74763316-74859435,96119
129774692,129774769,chr7,MIR96,chr7:129774692-129774769,77
120981426,120981553,chr7,RNA5SP240,chr7:120981426-120981553,127
25448080,25520856,chr22,CRYBB2P1,chr22:25448080-25520856,72776
17468769,17506168,chr19,SLC27A1,chr19:17468769-17506168,37399
130027277,130027397,chr7,RNA5SP245,chr7:130027277-130027397,120
131054886,131054992,chr7,RNU6-1010P,chr7:131054886-131054992,106
130876747,130876810,chr7,MIR29A,chr7:130876747-130876810,63
130877459,130877539,chr7,MIR29B1,chr7:130877459-130877539,80
129756266,129756377,chr7,RNA5SP244,chr7:129756266-129756377,111
133290881,133290988,chr7,MIR6133,chr7:133290881-133290988,107
133034860,133034915,chr7,MIR3654,chr7:133034860-133034915,55
135960703,135960809,chr7,RNU6-223P,chr7:135960703-135960809,106
133082829,133082932,chr7,RNU6-92P,chr7:133082829-133082932,103
135665599,135665702,chr7,RNU6-1154P,chr7:135665599-135665702,103
130602795,130602913,chr7,RNA5SP246,chr7:130602795-130602913,118
140209563,140209671,chr7,RNU6-797P,chr7:140209563-140209671,108
138091254,138091315,chr7,RN7SKP223,chr7:138091254-138091315,61
70028455,70036538,chr4,HTN3,chr4:70028455-70036538,8083
138123758,138123821,chr7,MIR4468,chr7:138123758-138123821,63
139448740,139448843,chr7,RNU6-911P,chr7:139448740-139448843,103
129484504,129484656,chr7,RNU1-72P,chr7:129484504-129484656,152
109690609,109878098,chr6,FIG4,chr6:109690609-109878098,187489
141727984,141728148,chr7,RNU1-82P,chr7:141727984-141728148,164
140241870,140242032,chr7,RNU1-58P,chr7:140241870-140242032,162
141052249,141052409,chr7,RNU4-74P,chr7:141052249-141052409,160
140370441,140370545,chr7,RNA5SP247,chr7:140370441-140370545,104
140386781,140386907,chr7,RNA5SP248,chr7:140386781-140386907,126
44361947,44772592,chr2,CAMKMT,chr2:44361947-44772592,410645
151464650,151464938,chr7,RN7SL76P,chr7:151464650-151464938,288
155181881,155182184,chr7,RN7SKP280,chr7:155181881-155182184,303
49488970,49489364,chr13,SNRPGP14,chr13:49488970-49489364,394
143754628,143754730,chr7,RNU6-267P,chr7:143754628-143754730,102
92883532,93017673,chr8,TRIQK,chr8:92883532-93017673,134141
152757662,152757951,chr7,RN7SL845P,chr7:152757662-152757951,289
158591616,158591696,chr7,MIR5707,chr7:158591616-158591696,80
144849755,144850084,chr7,RN7SKP174,chr7:144849755-144850084,329
130053426,130140169,chr9,GPR107,chr9:130053426-130140169,86743
151433489,151433639,chr7,MIR3907,chr7:151433489-151433639,150
151900275,151900374,chr7,RNU6-604P,chr7:151900275-151900374,99
149125690,149125986,chr7,RN7SL521P,chr7:149125690-149125986,296
157574336,157574422,chr7,MIR153-2,chr7:157574336-157574422,86
158532718,158532813,chr7,MIR595,chr7:158532718-158532813,95
70655541,70681817,chr4,JCHAIN,chr4:70655541-70681817,26276
40126027,40134622,chr7,MPLKIP,chr7:40126027-40134622,8595
49495610,49528981,chr13,PHF11,chr13:49495610-49528981,33371
40151613,40154151,chr7,THUMPD3P1,chr7:40151613-40154151,2538
27919376,28008581,chr22,TTC28-AS1,chr22:27919376-28008581,89205
40538127,40546928,chr7,SUGCT-AS1,chr7:40538127-40546928,8801
34022656,34023427,chr19,RPS4XP20,chr19:34022656-34023427,771
107168961,107202522,chr7,HBP1,chr7:107168961-107202522,33561
38581195,38588463,chr20,ADIG,chr20:38581195-38588463,7268
72728616,72729894,chr16,KRT18P18,chr16:72728616-72729894,1278
73073382,73156721,chr2,RAB11FIP5,chr2:73073382-73156721,83339
76894152,76898144,chr4,SOWAHB,chr4:76894152-76898144,3992
53875252,53875557,chr20,SUMO1P1,chr20:53875252-53875557,305
76958860,76959169,chr4,TXNP6,chr4:76958860-76959169,309
67666814,67668757,chr16,C16orf86,chr16:67666814-67668757,1943
54068408,54068485,chr20,MIR4756,chr20:54068408-54068485,77
77047155,77076309,chr4,CCNI,chr4:77047155-77076309,29154
54153446,54173986,chr20,CYP24A1,chr20:54153446-54173986,20540
34404399,34426168,chr19,PDCD2L,chr19:34404399-34426168,21769
57447425,57461270,chr16,COQ9,chr16:57447425-57461270,13845
39334979,39335939,chr3,HNRNPA1P21,chr3:39334979-39335939,960
46698952,46780245,chr2,SOCS5,chr2:46698952-46780245,81293
6631008,6805479,chr3,GRM7-AS3,chr3:6631008-6805479,174471
15564074,15584709,chr19,CYP4F23P,chr19:15564074-15584709,20635
87031815,87052992,chr2,ANAPC1P2,chr2:87031815-87052992,21177
96756987,96758596,chr15,FAM149B1P1,chr15:96756987-96758596,1609
55051647,55070194,chr14,MAPK1IP1L,chr14:55051647-55070194,18547
77082403,77083126,chr4,RPL7P17,chr4:77082403-77083126,723
77150328,77150437,chr4,RNU6-1187P,chr4:77150328-77150437,109
39399149,39399248,chr4,RNU6-887P,chr4:39399149-39399248,99
42257825,42266185,chr3,CCK,chr3:42257825-42266185,8360
39406930,39451533,chr4,KLB,chr4:39406930-39451533,44603
99251362,99390729,chr15,LRRC28,chr15:99251362-99390729,139367
71037685,71038703,chr2,OR7E46P,chr2:71037685-71038703,1018
113789542,113789807,chr12,DYNLL1P4,chr12:113789542-113789807,265
29921182,29921653,chr19,PPIAP58,chr19:29921182-29921653,471
95402708,95416616,chr2,FAHD2A,chr2:95402708-95416616,13908
32025808,32073809,chr19,LINC01533,chr19:32025808-32073809,48001
106357748,106510198,chr12,POLR3B,chr12:106357748-106510198,152450
55124110,55145423,chr14,LGALS3,chr14:55124110-55145423,21313
39411910,39411974,chr4,MIR5591,chr4:39411910-39411974,64
20701114,20704606,chr22,TMEM191A,chr22:20701114-20704606,3492
30656033,30723932,chr20,ANKRD20A21P,chr20:30656033-30723932,67899
93583222,93594611,chr5,NR2F1,chr5:93583222-93594611,11389
39459004,39485109,chr4,LIAS,chr4:39459004-39485109,26105
30907199,30909155,chr19,LINC01834,chr19:30907199-30909155,1956
38346760,38421348,chr3,XYLB,chr3:38346760-38421348,74588
107470018,107475684,chr7,GPR22,chr7:107470018-107475684,5666
53936777,54070594,chr20,BCAS1,chr20:53936777-54070594,133817
23444262,23445189,chr19,VN1R92P,chr19:23444262-23445189,927
33621953,33773509,chr19,CHST8,chr19:33621953-33773509,151556
113876777,114075920,chr7,PPP1R3A,chr7:113876777-114075920,199143
69976388,69996188,chr16,NPIPB14P,chr16:69976388-69996188,19800
26947039,27066134,chr9,IFT74,chr9:26947039-27066134,119095
76280956,76281267,chr5,PDCD5P2,chr5:76280956-76281267,311
16238587,16295549,chr6,GMPR,chr6:16238587-16295549,56962
111510396,111739726,chr5,STARD4-AS1,chr5:111510396-111739726,229330
93915734,93916682,chr8,MIR378D2HG,chr8:93915734-93916682,948
114613787,114613906,chr7,RNA5SP238,chr7:114613787-114613906,119
22832291,22858667,chr19,ZNF723,chr19:22832291-22858667,26376
114653345,114653455,chr7,MIR3666,chr7:114653345-114653455,110
155356985,155367934,chr7,BLACE,chr7:155356985-155367934,10949
21102984,21122286,chr22,BCRP2,chr22:21102984-21122286,19302
95973041,95973446,chr5,FABP5P5,chr5:95973041-95973446,405
58113592,58129381,chr16,CFAP20,chr16:58113592-58129381,15789
64674853,64675387,chr5,MRPL49P1,chr5:64674853-64675387,534
33299934,33302534,chr19,CEBPA,chr19:33299934-33302534,2600
119006347,119070902,chr5,DMXL1-DT,chr5:119006347-119070902,64555
155458129,155464831,chr7,EN2,chr7:155458129-155464831,6702
93957338,93957691,chr8,RPL34P18,chr8:93957338-93957691,353
95620087,95622142,chr5,GPR150,chr5:95620087-95622142,2055
29528721,29533665,chr6,LINC01015,chr6:29528721-29533665,4944
39854494,39855056,chr7,RWDD4P2,chr7:39854494-39855056,562
85177154,85217158,chr8,E2F5,chr8:85177154-85217158,40004
100052859,100053539,chr5,MTCO2P22,chr5:100052859-100053539,680
39888375,39888664,chr7,RN7SL496P,chr7:39888375-39888664,289
58161197,58161752,chr5,PGAM1P1,chr5:58161197-58161752,555
39947522,39949755,chr7,CDK13-DT,chr7:39947522-39949755,2233
79284132,79284918,chr5,RPS3AP20,chr5:79284132-79284918,786
55148112,55191608,chr14,DLGAP5,chr14:55148112-55191608,43496
70607618,70768225,chr2,ADD2,chr2:70607618-70768225,160607
132963770,132964164,chr5,AFF4-DT,chr5:132963770-132964164,394
40135005,40860763,chr7,SUGCT,chr7:40135005-40860763,725758
29537704,29538787,chr6,GPR53P,chr6:29537704-29538787,1083
29550407,29557721,chr6,OR2I1P,chr6:29550407-29557721,7314
127290796,127465737,chr5,MEGF10,chr5:127290796-127465737,174941
29555515,29559732,chr6,UBD,chr6:29555515-29559732,4217
17159352,17165447,chr22,HDHD5-AS1,chr22:17159352-17165447,6095
85676198,85690073,chr16,GINS2,chr16:85676198-85690073,13875
50756948,50801309,chr22,RPL23AP82,chr22:50756948-50801309,44361
29555629,29633976,chr6,GABBR1,chr6:29555629-29633976,78347
75218988,75226338,chr16,CTRB1,chr16:75218988-75226338,7350
35497220,35513658,chr19,DMKN,chr19:35497220-35513658,16438
35281813,35286009,chr11,SLC1A2-AS1,chr11:35281813-35286009,4196
5903767,5904448,chr11,OR52Q1P,chr11:5903767-5904448,681
5967177,5968494,chr11,OR56A5,chr11:5967177-5968494,1317
101771758,101781989,chr15,GOLGA8VP,chr15:101771758-101781989,10231
5761153,5767465,chr11,OR56B2P,chr11:5761153-5767465,6312
40964667,40979939,chr7,LINC01450,chr7:40964667-40979939,15272
41089539,41133507,chr7,LINC01449,chr7:41089539-41133507,43968
47214465,47239217,chr11,DDB2,chr11:47214465-47239217,24752
82147798,82170224,chr16,MPHOSPH6,chr16:82147798-82170224,22426
141862860,141863737,chr7,OR9A3P,chr7:141862860-141863737,877
46053869,46113928,chr22,MIRLET7BHG,chr22:46053869-46113928,60059
141911217,141911943,chr7,OR9N1P,chr7:141911217-141911943,726
141927357,141947007,chr7,CLEC5A,chr7:141927357-141947007,19650
51238724,51271362,chr12,DAZAP2,chr12:51238724-51271362,32638
84182787,84921844,chr8,RALYL,chr8:84182787-84921844,739057
14611071,14693432,chr9,ZDHHC21,chr9:14611071-14693432,82361
23433518,23435071,chr22,LINC01659,chr22:23433518-23435071,1553
99136323,99251223,chr15,TTC23,chr15:99136323-99251223,114900
21001886,21010342,chr22,THAP7-AS1,chr22:21001886-21010342,8456
127579370,127696027,chr9,STXBP1,chr9:127579370-127696027,116657
57512181,57536571,chr16,CCDC102A,chr16:57512181-57536571,24390
49531946,49585558,chr13,RCBTB1,chr13:49531946-49585558,53612
49414524,49657542,chr22,MIR3667HG,chr22:49414524-49657542,243018
3146519,3159865,chr20,FASTKD5,chr20:3146519-3159865,13346
141972631,141973773,chr7,TAS2R38,chr7:141972631-141973773,1142
55240622,55241080,chr14,COX5AP1,chr14:55240622-55241080,458
141887148,141888092,chr7,OR9A1P,chr7:141887148-141888092,944
55262222,55272075,chr14,FBXO34-AS1,chr14:55262222-55272075,9853
124647719,124647822,chr7,RNU6-102P,chr7:124647719-124647822,103
1092658,1404217,chr3,CNTN6,chr3:1092658-1404217,311559
124743885,124765792,chr7,GPR37,chr7:124743885-124765792,21907
118782926,118833536,chr12,LINC02439,chr12:118782926-118833536,50610
80826074,80892682,chr16,ARLNC1,chr16:80826074-80892682,66608
46684365,46689444,chr20,TP53RK,chr20:46684365-46689444,5079
124777292,124790689,chr7,C7orf77,chr7:124777292-124790689,13397
55271344,55370053,chr14,FBXO34,chr14:55271344-55370053,98709
76721534,76722286,chr12,RPL7P43,chr12:76721534-76722286,752
76968197,76969250,chr7,FDPSP7,chr7:76968197-76969250,1053
63981132,64033100,chr20,PRPF6,chr20:63981132-64033100,51968
51421956,51424611,chr12,SLC4A8-AS1,chr12:51421956-51424611,2655
102196459,102197833,chr12,PMCH,chr12:102196459-102197833,1374
76959835,77043775,chr7,DTX2P1-UPK3BP1-PMS2P11,chr7:76959835-77043775,83940
26512529,26514568,chr22,TFIP11-DT,chr22:26512529-26514568,2039
34560542,34698790,chr20,PIGU,chr20:34560542-34698790,138248
55298644,55299231,chr14,CHMP4BP1,chr14:55298644-55299231,587
76858709,76879023,chr12,CSRP2,chr12:76858709-76879023,20314
55366391,55411830,chr14,ATG14,chr14:55366391-55411830,45439
100165226,100165478,chr8,UFM1P3,chr8:100165226-100165478,252
2159779,2161221,chr11,INS,chr11:2159779-2161221,1442
76978617,77004308,chr7,DTX2P1,chr7:76978617-77004308,25691
43539973,43540927,chr8,CYP4F44P,chr8:43539973-43540927,954
77004662,77005774,chr7,UPK3BP1,chr7:77004662-77005774,1112
77011551,77015853,chr7,PMS2P11,chr7:77011551-77015853,4302
87575598,87576508,chr8,VTA1P2,chr8:87575598-87576508,910
77039944,77043776,chr7,PMS2P9,chr7:77039944-77043776,3832
21139886,21139957,chr13,SNORD27,chr13:21139886-21139957,71
83403758,83408900,chr8,LINC01419,chr8:83403758-83408900,5142
4983718,5073221,chr7,RBAK-RBAKDN,chr7:4983718-5073221,89503
39498755,39528311,chr4,UGDH,chr4:39498755-39528311,29556
40153482,40155310,chr8,TCIM,chr8:40153482-40155310,1828
55394940,55395233,chr14,HMGN1P1,chr14:55394940-55395233,293
55413541,55456726,chr14,TBPL2,chr14:55413541-55456726,43185
103559099,103559389,chr8,PTMAP15,chr8:103559099-103559389,290
21140514,21149084,chr13,SAP18,chr13:21140514-21149084,8570
109963636,109975771,chr8,KCNV1,chr8:109963636-109975771,12135
5072125,5073223,chr7,RBAKDN,chr7:5072125-5073223,1098
35615829,35621094,chr20,SPAG4,chr20:35615829-35621094,5265
5103719,5120245,chr7,OR10AH1P,chr7:5103719-5120245,16526
5121239,5144546,chr7,ZNF890P,chr7:5121239-5144546,23307
48590401,48594621,chr8,LINC02599,chr8:48590401-48594621,4220
4973988,5040675,chr7,RNF216P1,chr7:4973988-5040675,66687
135534282,135535964,chr5,NEUROG1,chr5:135534282-135535964,1682
2163929,2171815,chr11,TH,chr11:2163929-2171815,7886
96222947,96235546,chr8,UQCRB,chr8:96222947-96235546,12599
55413556,55414059,chr14,RPL21P6,chr14:55413556-55414059,503
55543401,55544169,chr14,RPL7AP4,chr14:55543401-55544169,768
55546674,55548123,chr14,ABI1P1,chr14:55546674-55548123,1449
70132679,70132973,chr5,CDH12P3,chr5:70132679-70132973,294
54808210,54872551,chr5,CSPG4BP,chr5:54808210-54872551,64341
67727374,67816590,chr14,ZFYVE26,chr14:67727374-67816590,89216
86221420,86301303,chr16,LINC01081,chr16:86221420-86301303,79883
39169210,39170335,chr5,GOLGA5P1,chr5:39169210-39170335,1125
54549601,54579239,chr12,PDE1B,chr12:54549601-54579239,29638
132073789,132076170,chr5,CSF2,chr5:132073789-132076170,2381
86566829,86569728,chr16,FOXC2,chr16:86566829-86569728,2899
92567817,92574529,chr15,LINC00930,chr15:92567817-92574529,6712
109588338,109589592,chr5,KRT18P42,chr5:109588338-109589592,1254
75228181,75268053,chr16,BCAR1,chr16:75228181-75268053,39872
46499630,46513559,chr20,ZNF334,chr20:46499630-46513559,13929
77660052,77668074,chr15,LINGO1-AS2,chr15:77660052-77668074,8022
97572185,97875650,chr15,LINC00923,chr15:97572185-97875650,303465
100088969,100092187,chr7,COPS6,chr7:100088969-100092187,3218
126360132,126496494,chr5,GRAMD2B,chr5:126360132-126496494,136362
92471654,92501117,chr15,C15orf32,chr15:92471654-92501117,29463
44408120,44408203,chr20,MIR3646,chr20:44408120-44408203,83
39808914,40260321,chr3,MYRIP,chr3:39808914-40260321,451407
84971093,85059472,chr2,KCMF1,chr2:84971093-85059472,88379
98081993,98103761,chr15,LINC01582,chr15:98081993-98103761,21768
46837578,46838706,chr8,MTCYBP20,chr8:46837578-46838706,1128
44355700,44432845,chr20,HNF4A,chr20:44355700-44432845,77145
96068729,96069681,chr8,GAPDHP30,chr8:96068729-96069681,952
39452587,39458931,chr4,RPL9,chr4:39452587-39458931,6344
21153595,21176552,chr13,SKA3,chr13:21153595-21176552,22957
28021964,28083936,chr8,NUGGC,chr8:28021964-28083936,61972
97215812,97432094,chr15,LINC02253,chr15:97215812-97432094,216282
64395220,64453967,chr2,LGALSL-DT,chr2:64395220-64453967,58747
100092728,100101940,chr7,MCM7,chr7:100092728-100101940,9212
98648539,98964530,chr15,IGF1R,chr15:98648539-98964530,315991
60450520,60554467,chr2,BCL11A,chr2:60450520-60554467,103947
97775057,97853013,chr8,LAPTM4B,chr8:97775057-97853013,77956
4700417,4720102,chr12,GAU1,chr12:4700417-4720102,19685
116910950,117031148,chr12,FBXW8,chr12:116910950-117031148,120198
21176658,21179084,chr13,MRPL57,chr13:21176658-21179084,2426
90592804,90606065,chr8,LINC01030,chr8:90592804-90606065,13261
77199408,77213215,chr16,SYCE1L,chr16:77199408-77213215,13807
51435602,51436509,chr8,BRIX1P1,chr8:51435602-51436509,907
99546709,99564039,chr4,TRMT10A,chr4:99546709-99564039,17330
47736913,47738164,chr8,CEBPD,chr8:47736913-47738164,1251
114104542,114105931,chr12,GLULP5,chr12:114104542-114105931,1389
21224521,21235204,chr13,LINC01046,chr13:21224521-21235204,10683
102451763,102452483,chr8,HSPE1P14,chr8:102451763-102452483,720
93569814,93583487,chr12,SOCS2,chr12:93569814-93583487,13673
21319156,21320866,chr13,GRK6P1,chr13:21319156-21320866,1710
41645177,41650817,chr8,NKX6-3,chr8:41645177-41650817,5640
106674019,107018476,chr11,GUCY1A2,chr11:106674019-107018476,344457
21372571,21459370,chr13,ZDHHC20,chr13:21372571-21459370,86799
34322992,34323642,chr8,RPL10AP3,chr8:34322992-34323642,650
93646066,93647092,chr8,ZNF317P1,chr8:93646066-93647092,1026
85169525,85676204,chr16,GSE1,chr16:85169525-85676204,506679
42697366,42737407,chr8,CHRNB3,chr8:42697366-42737407,40041
46827228,46827894,chr8,MTND2P38,chr8:46827228-46827894,666
106237881,106304279,chr12,CKAP4,chr12:106237881-106304279,66398
21358373,21359314,chr13,GAPDHP52,chr13:21358373-21359314,941
48710789,48735311,chr8,EFCAB1,chr8:48710789-48735311,24522
6211345,6234711,chr11,FHIP1B,chr11:6211345-6234711,23366
89519412,89524796,chr12,GALNT4,chr12:89519412-89524796,5384
21369790,21369899,chr13,RNA5SP25,chr13:21369790-21369899,109
49863173,49863503,chr12,RPL35AP28,chr12:49863173-49863503,330
21376977,21377874,chr13,ZDHHC20-IT1,chr13:21376977-21377874,897
102809280,102824399,chr12,LINC00485,chr12:102809280-102824399,15119
84905656,84906671,chr2,TMSB10,chr2:84905656-84906671,1015
21483834,21484174,chr13,H2BP6,chr13:21483834-21484174,340
66662331,66662988,chr5,MAST4-IT1,chr5:66662331-66662988,657
21492691,21604181,chr13,MICU2,chr13:21492691-21604181,111490
65589690,65625975,chr5,TRIM23,chr5:65589690-65625975,36285
91747940,91748986,chr2,KMT5AP2,chr2:91747940-91748986,1046
87824942,87825143,chr2,MTATP8P2,chr2:87824942-87825143,201
92770637,92929331,chr12,EEA1,chr12:92770637-92929331,158694
73202574,73212513,chr2,NOTO,chr2:73202574-73212513,9939
91684447,91685884,chr2,DRD5P1,chr2:91684447-91685884,1437
83594956,83595243,chr2,RPL37P10,chr2:83594956-83595243,287
84874696,84875020,chr2,RPL12P18,chr2:84874696-84875020,324
82268427,82269927,chr2,LYARP1,chr2:82268427-82269927,1500
100093560,100093643,chr7,MIR25,chr7:100093560-100093643,83
100093768,100093847,chr7,MIR93,chr7:100093768-100093847,79
100093993,100094074,chr7,MIR106B,chr7:100093993-100094074,81
74940258,74942670,chr2,LINC01293,chr2:74940258-74942670,2412
89575469,89631056,chr15,TICRR,chr15:89575469-89631056,55587
44270621,44271106,chr2,RPL12P19,chr2:44270621-44271106,485
54051334,54051760,chr2,HMGB1P31,chr2:54051334-54051760,426
100101549,100110345,chr7,AP4M1,chr7:100101549-100110345,8796
88922328,88922753,chr2,PGBD4P5,chr2:88922328-88922753,425
68149617,68149908,chr14,RN7SL706P,chr14:68149617-68149908,291
68236243,68236539,chr14,RN7SL108P,chr14:68236243-68236539,296
89757806,89791064,chr8,RIPK2,chr8:89757806-89791064,33258
125063302,125090516,chr11,SLC37A2,chr11:125063302-125090516,27214
68421698,68422196,chr14,PPIAP6,chr14:68421698-68422196,498
86815339,86861924,chr2,CD8B,chr2:86815339-86861924,46585
85990007,86594625,chr4,MAPK10,chr4:85990007-86594625,604618
68693090,68693583,chr14,RPL12P7,chr14:68693090-68693583,493
40457292,40468587,chr3,RPL14,chr3:40457292-40468587,11295
96500810,96502321,chr14,PAPOLA-DT,chr14:96500810-96502321,1511
97154857,97158736,chr14,LINC02304,chr14:97154857-97158736,3879
35401513,35404749,chr14,NFKBIA,chr14:35401513-35404749,3236
21530690,21531323,chr13,FNTAP2,chr13:21530690-21531323,633
34928432,34956027,chr20,GSS,chr20:34928432-34956027,27595
21551304,21551410,chr13,RNU6-59P,chr13:21551304-21551410,106
21628413,21629015,chr13,RPS7P10,chr13:21628413-21629015,602
21671073,21704498,chr13,FGF9,chr13:21671073-21704498,33425
124808981,125602227,chr5,LINC02240,chr5:124808981-125602227,793246
28348287,28490278,chr8,FBXO16,chr8:28348287-28490278,141991
99257632,99260015,chr15,HSP90B2P,chr15:99257632-99260015,2383
86603398,86623866,chr2,RNF103,chr2:86603398-86623866,20468
21790537,21790845,chr13,RN7SL766P,chr13:21790537-21790845,308
98954149,99105824,chr15,SYNM-AS1,chr15:98954149-99105824,151675
120325296,120333686,chr11,TLCD5,chr11:120325296-120333686,8390
106774621,106889316,chr12,RIC8B,chr12:106774621-106889316,114695
11900011,11901245,chr3,NUP210P2,chr3:11900011-11901245,1234
96772005,96783312,chr15,SPATA8-AS1,chr15:96772005-96783312,11307
21872763,21878256,chr13,LINC00424,chr13:21872763-21878256,5493
45254948,45696498,chr5,HCN1,chr5:45254948-45696498,441550
75746769,75747263,chr15,PPIAP47,chr15:75746769-75747263,494
35430260,35430631,chr14,DNAJC8P1,chr14:35430260-35430631,371
35468272,35469330,chr14,RPS3AP4,chr14:35468272-35469330,1058
35511825,35513089,chr14,KRT18P6,chr14:35511825-35513089,1264
16313574,16514026,chr3,RFTN1,chr3:16313574-16514026,200452
35534164,35537054,chr14,INSM2,chr14:35534164-35537054,2890
58771192,58861900,chr15,MINDY2,chr15:58771192-58861900,90708
35765795,35767110,chr14,QRSL1P3,chr14:35765795-35767110,1315
21260015,21295003,chr13,ESRRAP2,chr13:21260015-21295003,34988
80553256,80572808,chr16,LINC01227,chr16:80553256-80572808,19552
29573909,29574836,chr6,OR2H5P,chr6:29573909-29574836,927
35819837,35820220,chr14,NUTF2P2,chr14:35819837-35820220,383
29577459,29577748,chr6,TMEM183AP1,chr6:29577459-29577748,289
29582249,29582332,chr6,SNORD32B,chr6:29582249-29582332,83
29582508,29583025,chr6,RPL13AP,chr6:29582508-29583025,517
29636060,29636343,chr6,SUMO2P1,chr6:29636060-29636343,283
11841423,11961887,chr11,USP47,chr11:11841423-11961887,120464
35826338,35932325,chr14,BRMS1L,chr14:35826338-35932325,105987
29657002,29672372,chr6,MOG,chr6:29657002-29672372,15370
98402542,98402732,chr5,MRPS35P2,chr5:98402542-98402732,190
68189876,68198407,chr5,LINC02219,chr5:68189876-68198407,8531
76106016,76107324,chr2,SUCLA2P2,chr2:76106016-76107324,1308
88651935,88663161,chr16,MVD,chr16:88651935-88663161,11226
61732774,61735715,chr5,C5orf64-AS1,chr5:61732774-61735715,2941
115804733,115816659,chr5,CDO1,chr5:115804733-115816659,11926
87748087,87759476,chr2,PLGLB2,chr2:87748087-87759476,11389
36949738,37000763,chr13,ALG5,chr13:36949738-37000763,51025
60711484,60711920,chr2,RPL26P13,chr2:60711484-60711920,436
105099473,105100098,chr5,RAB9BP1,chr5:105099473-105100098,625
95947781,95948233,chr8,SRSF3P2,chr8:95947781-95948233,452
75646783,75690851,chr2,MRPL19,chr2:75646783-75690851,44068
132311285,132370170,chr5,MIR3936HG,chr5:132311285-132370170,58885
81254870,81255229,chr8,UBE2HP1,chr8:81254870-81255229,359
36054197,36055313,chr14,ILF2P2,chr14:36054197-36055313,1116
96325938,96340263,chr15,NR2F2,chr15:96325938-96340263,14325
103414714,103443453,chr8,DCAF13,chr8:103414714-103443453,28739
115289036,115289330,chr5,HMGN1P15,chr5:115289036-115289330,294
51712469,51713606,chr12,HNRNPA3P10,chr12:51712469-51713606,1137
102317377,102342702,chr14,ZNF839,chr14:102317377-102342702,25325
17511833,17512238,chr5,H3P18,chr5:17511833-17512238,405
87750142,87750313,chr12,CYCSP30,chr12:87750142-87750313,171
102197585,102402596,chr12,HELLPAR,chr12:102197585-102402596,205011
38258409,38465480,chr5,EGFLAM,chr5:38258409-38465480,207071
106991364,107093549,chr12,CRY1,chr12:106991364-107093549,102185
85102389,85102694,chr2,LSM3P3,chr2:85102389-85102694,305
32238679,32370321,chr3,CMTM8,chr3:32238679-32370321,131642
95326528,95507865,chr15,LINC00924,chr15:95326528-95507865,181337
67674531,67719339,chr16,GFOD2,chr16:67674531-67719339,44808
70978380,70985499,chr2,ANKRD53,chr2:70978380-70985499,7119
14112077,14124870,chr3,CHCHD4,chr3:14112077-14124870,12793
2295628,2303049,chr11,C11orf21,chr11:2295628-2303049,7421
93065586,93066606,chr15,YBX2P2,chr15:93065586-93066606,1020
92711808,92712110,chr15,HMGN1P38,chr15:92711808-92712110,302
124173001,124174459,chrX,ZIK1P1,chrX:124173001-124174459,1458
61785047,61944180,chr8,LINC02842,chr8:61785047-61944180,159133
124204499,124205806,chrX,HSPA8P20,chrX:124204499-124205806,1307
34478791,34525193,chr11,ELF5,chr11:34478791-34525193,46402
124227868,124373197,chrX,SH2D1A,chrX:124227868-124373197,145329
98968229,99007792,chr15,PGPEP1L,chr15:98968229-99007792,39563
67943474,67969601,chr16,SLC12A4,chr16:67943474-67969601,26127
97273488,97277928,chr8,TSPYL5,chr8:97273488-97277928,4440
77021248,77065569,chr12,E2F7,chr12:77021248-77065569,44321
6770001,7741533,chr3,GRM7,chr3:6770001-7741533,971532
71182738,71227103,chr2,PAIP2B,chr2:71182738-71227103,44365
92617448,92809884,chr15,FAM174B,chr15:92617448-92809884,192436
88122982,88128062,chr2,FABP1,chr2:88122982-88128062,5080
98426958,98432853,chr8,KCNS2,chr8:98426958-98432853,5895
124246249,124336863,chrX,TEX13D,chrX:124246249-124336863,90614
124280530,124281422,chrX,NPM1P34,chrX:124280530-124281422,892
100119634,100125508,chr7,CNPY4,chr7:100119634-100125508,5874
24265538,24271611,chr14,RABGGTA,chr14:24265538-24271611,6073
133535745,133987100,chrX,GPC3,chrX:133535745-133987100,451355
57142659,57244793,chr8,LINC01606,chr8:57142659-57244793,102134
70941817,70948610,chr2,ATP6V1B1-AS1,chr2:70941817-70948610,6793
85415228,85415633,chr15,FABP5P9,chr15:85415228-85415633,405
100126785,100128495,chr7,MBLAC1,chr7:100126785-100128495,1710
75524068,75542706,chr2,EVA1A-AS,chr2:75524068-75542706,18638
85751344,85791383,chr2,ATOH8,chr2:85751344-85791383,40039
99395179,99396593,chr15,LINC02244,chr15:99395179-99396593,1414
100139629,100140682,chr7,RPL7P60,chr7:100139629-100140682,1053
48712928,48811146,chr15,CEP152,chr15:48712928-48811146,98218
21967752,21995301,chr9,CDKN2A,chr9:21967752-21995301,27549
100154420,100158723,chr7,TRAPPC14,chr7:100154420-100158723,4303
85107215,85146080,chr8,LRRCC1,chr8:85107215-85146080,38865
123470054,123533719,chr12,RILPL1,chr12:123470054-123533719,63665
77322017,77474635,chr11,PAK1,chr11:77322017-77474635,152618
81194337,81201184,chr2,ANKRD11P1,chr2:81194337-81201184,6847
41931599,41933909,chr2,LINC01914,chr2:41931599-41933909,2310
41143780,41157555,chr2,HNRNPA1P57,chr2:41143780-41157555,13775
34955810,35002437,chr20,MYH7B,chr20:34955810-35002437,46627
100045928,100046374,chr5,MTCYBP22,chr5:100045928-100046374,446
28457145,28644142,chr2,PLB1,chr2:28457145-28644142,186997
101873316,101873623,chr12,HSPE1P4,chr12:101873316-101873623,307
36998816,37025881,chr13,EXOSC8,chr13:36998816-37025881,27065
130032928,130045057,chr12,LINC02418,chr12:130032928-130045057,12129
134371469,134392108,chr5,UBE2B,chr5:134371469-134392108,20639
34832295,34838586,chr9,FAM205BP,chr9:34832295-34838586,6291
88142296,88199887,chr12,TMTC3,chr12:88142296-88199887,57591
100156605,100156669,chr7,MIR4658,chr7:100156605-100156669,64
35041095,35045986,chr9,C9orf131,chr9:35041095-35045986,4891
100159244,100168617,chr7,GAL3ST4,chr7:100159244-100168617,9373
33554636,33554859,chr3,COX6CP10,chr3:33554636-33554859,223
40477131,40518736,chr3,ZNF620,chr3:40477131-40518736,41605
153902531,153907166,chrX,AVPR2,chrX:153902531-153907166,4635
35049271,35049563,chr9,RN7SL338P,chr9:35049271-35049563,292
35088688,35096601,chr9,PIGO,chr9:35088688-35096601,7913
100169606,100177381,chr7,GPC2,chr7:100169606-100177381,7775
126737438,126737995,chr5,HSPE1P10,chr5:126737438-126737995,557
118836074,118988547,chr5,DTWD2,chr5:118836074-118988547,152473
14810853,14934571,chr3,FGD5,chr3:14810853-14934571,123718
58490178,58500163,chr8,CYP7A1,chr8:58490178-58500163,9985
34990376,34990497,chr20,MIR499A,chr20:34990376-34990497,121
34990400,34990472,chr20,MIR499B,chr20:34990400-34990472,72
151694607,151705924,chrX,PRRG3,chrX:151694607-151705924,11317
35002404,35092807,chr20,TRPC4AP,chr20:35002404-35092807,90403
95133785,95156685,chr8,PLEKHF2,chr8:95133785-95156685,22900
112777630,112778161,chr5,CBX3P3,chr5:112777630-112778161,531
100218241,100221490,chr7,PVRIG,chr7:100218241-100221490,3249
91030990,91031307,chr5,TMEM251P1,chr5:91030990-91031307,317
118575575,118581324,chr5,LINC02216,chr5:118575575-118581324,5749
67636382,67638942,chr5,BCL9P1,chr5:67636382-67638942,2560
34915677,34925996,chr5,BRIX1,chr5:34915677-34925996,10319
151734746,151745564,chrX,CNGA2,chrX:151734746-151745564,10818
100336079,100351900,chr7,STAG3L5P,chr7:100336079-100351900,15821
48394510,48395392,chr12,OR5BJ1P,chr12:48394510-48395392,882
523775,524102,chrX,FABP5P13,chrX:523775-524102,327
74039024,74049981,chr12,LINC02394,chr12:74039024-74049981,10957
545236,545352,chrX,KRT18P53,chrX:545236-545352,116
624344,659411,chrX,SHOX,chrX:624344-659411,35067
87795733,87802028,chr12,LINC02258,chr12:87795733-87802028,6295
38906451,38909592,chr12,CPNE8-AS1,chr12:38906451-38909592,3141
100336104,100367831,chr7,STAG3L5P-PVRIG2P-PILRB,chr7:100336104-100367831,31727
103091263,103091509,chr8,MTCO2P4,chr8:103091263-103091509,246
108129288,108250537,chr12,WSCD2,chr12:108129288-108250537,121249
94487689,94553529,chr8,VIRMA,chr8:94487689-94553529,65840
35099776,35103195,chr9,STOML2,chr9:35099776-35103195,3419
49187815,49200218,chrX,SYP,chrX:49187815-49200218,12403
100352360,100353692,chr7,PVRIG2P,chr7:100352360-100353692,1332
100356651,100356721,chr7,MIR6840,chr7:100356651-100356721,70
100367530,100400096,chr7,PILRA,chr7:100367530-100400096,32566
91457508,91510554,chr14,PPP4R3A,chr14:91457508-91510554,53046
6989329,6989783,chrX,RPS27AP17,chrX:6989329-6989783,454
32091074,32105722,chr11,RCN1,chr11:32091074-32105722,14648
66139971,66183615,chr5,SREK1,chr5:66139971-66183615,43644
7147237,7804358,chrX,STS,chrX:7147237-7804358,657121
29708125,29708547,chr6,ZDHHC20P1,chr6:29708125-29708547,422
35030317,35030420,chr20,RNU6-407P,chr20:35030317-35030420,103
29722775,29738528,chr6,HLA-F,chr6:29722775-29738528,15753
57391396,57409333,chr20,RBM38,chr20:57391396-57409333,17937
109864295,110296712,chr11,RDX,chr11:109864295-110296712,432417
7147860,7147937,chrX,MIR4767,chrX:7147860-7147937,77
7898247,7927739,chrX,PNPLA4,chrX:7898247-7927739,29492
59372693,59523555,chr15,FAM81A,chr15:59372693-59523555,150862
57487959,57495366,chr20,HMGB1P1,chr20:57487959-57495366,7407
104064531,104106524,chr12,HCFC2,chr12:104064531-104106524,41993
100428790,100434118,chr7,MEPCE,chr7:100428790-100434118,5328
57495966,57525652,chr20,CTCFL,chr20:57495966-57525652,29686
73563197,73687111,chrX,CHIC1,chrX:73563197-73687111,123914
26216322,26216877,chr3,HMGB3P12,chr3:26216322-26216877,555
100435282,100436497,chr7,PPP1R35,chr7:100435282-100436497,1215
39451045,39522852,chr8,ADAM3A,chr8:39451045-39522852,71807
77190835,77202398,chr16,MON1B,chr16:77190835-77202398,11563
22381819,22382929,chr3,HMGB1P5,chr3:22381819-22382929,1110
23194929,23202703,chr3,UBE2E2-AS1,chr3:23194929-23202703,7774
120872607,120875866,chrX,CT47B1,chrX:120872607-120875866,3259
100436204,100438504,chr7,PPP1R35-AS1,chr7:100436204-100438504,2300
35104112,35116341,chr9,FAM214B,chr9:35104112-35116341,12229
100456620,100464260,chr7,C7orf61,chr7:100456620-100464260,7640
52891306,52908560,chrX,FAM156B,chrX:52891306-52908560,17254
33798571,33869707,chr3,PDCD6IP,chr3:33798571-33869707,71136
29726601,29749049,chr6,HLA-F-AS1,chr6:29726601-29749049,22448
100463359,100479232,chr7,TSC22D4,chr7:100463359-100479232,15873
118773031,118775137,chr12,LINC02440,chr12:118773031-118775137,2106
29726669,29727139,chr6,RPL23AP1,chr6:29726669-29727139,470
29741731,29748969,chr6,MICE,chr6:29741731-29748969,7238
89319364,89319649,chr12,MRPS6P4,chr12:89319364-89319649,285
137617500,137736089,chr5,KLHL3,chr5:137617500-137736089,118589
101155493,101210238,chr12,SLC5A8,chr12:101155493-101210238,54745
29750729,29751148,chr6,IFITM4P,chr6:29750729-29751148,419
29790954,29797811,chr6,HLA-V,chr6:29790954-29797811,6857
98003038,98087384,chr15,LINC02251,chr15:98003038-98087384,84346
29791753,29792750,chr6,HCG4,chr6:29791753-29792750,997
29800415,29802425,chr6,HLA-P,chr6:29800415-29802425,2010
29803195,29803991,chr6,RPL7AP7,chr6:29803195-29803991,796
27590344,27749942,chrX,DCAF8L2,chrX:27590344-27749942,159598
100064033,100082548,chr7,ZNF3,chr7:100064033-100082548,18515
29812565,29812696,chr6,MICG,chr6:29812565-29812696,131
10633762,10634695,chr6,GCNT2P1,chr6:10633762-10634695,933
52071355,52077197,chr2,ZNF863P,chr2:52071355-52077197,5842
96489571,96875555,chr12,CFAP54,chr12:96489571-96875555,385984
59401221,59402004,chr15,NSA2P4,chr15:59401221-59402004,783
10694972,10709782,chr6,PAK1IP1,chr6:10694972-10709782,14810
155997696,156010817,chrX,IL9R,chrX:155997696-156010817,13121
89471398,89496589,chr15,RHCG,chr15:89471398-89496589,25191
10722915,10731129,chr6,TMEM14C,chr6:10722915-10731129,8214
68530090,68576072,chr16,ZFP90,chr16:68530090-68576072,45982
96335766,96377091,chr2,NCAPH,chr2:96335766-96377091,41325
10743324,10747663,chr6,TMEM14B-DT,chr6:10743324-10747663,4339
64084232,64338112,chr14,ESR2,chr14:64084232-64338112,253880
152766136,152769716,chrX,MAGEA6,chrX:152766136-152769716,3580
10747759,10852753,chr6,TMEM14B,chr6:10747759-10852753,104994
18573306,18573379,chr9,MIR3152,chr9:18573306-18573379,73
18651147,18651450,chr9,RN7SKP258,chr9:18651147-18651450,303
18717974,18718526,chr9,RAP1BP1,chr9:18717974-18718526,552
38801440,38806537,chrX,MID1IP1,chrX:38801440-38806537,5097
18858906,19049358,chr9,SAXO1,chr9:18858906-19049358,190452
52930606,52990278,chr5,ITGA2-AS1,chr5:52930606-52990278,59672
51930808,51932036,chr5,KATNBL1P4,chr5:51930808-51932036,1228
52061827,52069219,chrX,MAGED4B,chrX:52061827-52069219,7392
74990189,74990637,chr5,RPL27AP5,chr5:74990189-74990637,448
113432553,113434989,chr5,TSSK1B,chr5:113432553-113434989,2436
19049427,19051025,chr9,RRAGA,chr9:19049427-19051025,1598
39141855,39154562,chr3,CSRNP1,chr3:39141855-39154562,12707
87859751,88256768,chr15,NTRK3,chr15:87859751-88256768,397017
17906563,18910950,chr9,ADAMTSL1,chr9:17906563-18910950,1004387
53859166,53860401,chr5,ASS1P9,chr5:53859166-53860401,1235
20599594,20659285,chr11,SLC6A5,chr11:20599594-20659285,59691
1394173,1394448,chr3,CRB3P1,chr3:1394173-1394448,275
36616006,36637457,chr3,NBPF21P,chr3:36616006-36637457,21451
117453012,117968990,chr12,KSR2,chr12:117453012-117968990,515978
116742991,116762209,chr5,LINC02214,chr5:116742991-116762209,19218
123512099,123617045,chr5,CSNK1G3,chr5:123512099-123617045,104946
44712643,44723831,chr3,ZNF502,chr3:44712643-44723831,11188
84294846,84329844,chr16,WFDC1,chr16:84294846-84329844,34998
73297711,73356461,chr8,RDH10-AS1,chr8:73297711-73356461,58750
43158631,43159466,chr13,LINC00400,chr13:43158631-43159466,835
122752824,122771064,chr12,DENR,chr12:122752824-122771064,18240
44861904,44865670,chr3,TMEM42,chr3:44861904-44865670,3766
43213130,43786972,chr13,ENOX1,chr13:43213130-43786972,573842
94371960,94475115,chr8,RAD54B,chr8:94371960-94475115,103155
35073835,35079942,chr9,FANCG,chr9:35073835-35079942,6107
14348451,14352568,chr3,LINC01267,chr3:14348451-14352568,4117
98794718,98794824,chr7,RNU6-393P,chr7:98794718-98794824,106
98881650,98881729,chr7,MIR3609,chr7:98881650-98881729,79
98998538,98999930,chr7,RNF14P3,chr7:98998538-98999930,1392
40387184,40428744,chr3,ENTPD3,chr3:40387184-40428744,41560
87383953,87404779,chr16,MAP1LC3B,chr16:87383953-87404779,20826
52696896,52707178,chrX,SSX2,chrX:52696896-52707178,10282
98877933,99050831,chr7,TRRAP,chr7:98877933-99050831,172898
53938831,53946544,chr12,HOXC13,chr12:53938831-53946544,7713
73159190,73208317,chr12,LINC02444,chr12:73159190-73208317,49127
101424441,101424691,chr12,RPS27P23,chr12:101424441-101424691,250
2376177,2397397,chr11,CD81,chr11:2376177-2397397,21220
56449502,56469166,chr12,MIP,chr12:56449502-56469166,19664
114238970,114241770,chr12,LINC02459,chr12:114238970-114241770,2800
86555320,86557299,chr16,FLJ30679,chr16:86555320-86557299,1979
84459259,84467361,chr16,ATP2C2-AS1,chr16:84459259-84467361,8102
73820315,74402600,chr12,LINC02882,chr12:73820315-74402600,582285
86866415,87615219,chr8,CNBD1,chr8:86866415-87615219,748804
82120638,82121769,chr16,MTCYBP28,chr16:82120638-82121769,1131
87406246,87493024,chr16,ZCCHC14,chr16:87406246-87493024,86778
34457414,34520988,chr9,DNAI1,chr9:34457414-34520988,63574
10752791,10752926,chr6,RNA5SP203,chr6:10752791-10752926,135
31097677,33339609,chrX,DMD,chrX:31097677-33339609,2241932
43394525,43394825,chr13,RPL36P19,chr13:43394525-43394825,300
43458465,43459484,chr13,ENOX1-AS2,chr13:43458465-43459484,1019
10762723,10838553,chr6,MAK,chr6:10762723-10838553,75830
82818131,82819264,chr2,MTCYBP7,chr2:82818131-82819264,1133
102073103,102120120,chr12,NUP37,chr12:102073103-102120120,47017
43543918,43548056,chr13,ENOX1-AS1,chr13:43543918-43548056,4138
3700814,4467273,chr3,SUMF1,chr3:3700814-4467273,766459
34521043,34522990,chr9,ENHO,chr9:34521043-34522990,1947
54456317,54671446,chr2,SPTBN1,chr2:54456317-54671446,215129
94719703,94793836,chr8,DPY19L4,chr8:94719703-94793836,74133
34551432,34590140,chr9,CNTFR,chr9:34551432-34590140,38708
43823909,43879740,chr13,CCDC122,chr13:43823909-43879740,55831
100050719,100051063,chr5,MTND3P19,chr5:100050719-100051063,344
135033280,135358219,chr5,PITX1-AS1,chr5:135033280-135358219,324939
48168847,48169659,chr12,PHBP18,chr12:48168847-48169659,812
88696499,88706408,chr16,RNF166,chr16:88696499-88706408,9909
111581379,111581773,chr12,IFITM3P5,chr12:111581379-111581773,394
34568012,34583072,chr9,CNTFR-AS1,chr9:34568012-34583072,15060
112142441,112419313,chr5,EPB41L4A,chr5:112142441-112419313,276872
121308245,121399896,chr12,ANAPC5,chr12:121308245-121399896,91651
43879284,43893932,chr13,LACC1,chr13:43879284-43893932,14648
34610486,34612104,chr9,RPP25L,chr9:34610486-34612104,1618
34613545,34620523,chr9,DCTN3,chr9:34613545-34620523,6978
65180566,65212006,chr11,CAPN1,chr11:65180566-65212006,31440
22946228,22957161,chr14,HAUS4,chr14:22946228-22957161,10933
102252273,102412759,chr8,UBR5,chr8:102252273-102412759,160486
43968424,43971199,chr13,DGKZP1,chr13:43968424-43971199,2775
10873223,10882041,chr6,GCM2,chr6:10873223-10882041,8818
113262920,113262999,chr13,MIR8075,chr13:113262920-113262999,79
113276616,113277734,chr13,LDHBP1,chr13:113276616-113277734,1118
88856220,88862686,chr16,TRAPPC2L,chr16:88856220-88862686,6466
113297239,113323672,chr13,LAMP1,chr13:113297239-113323672,26433
42145646,42146371,chr3,TPMTP2,chr3:42145646-42146371,725
37275693,37276598,chr3,TCEA1P2,chr3:37275693-37276598,905
34638133,34651035,chr9,GALT,chr9:34638133-34651035,12902
31181751,31182650,chr3,CNN2P6,chr3:31181751-31182650,899
29672483,29681155,chr6,ZFP57,chr6:29672483-29681155,8672
15070073,15099163,chr3,RBSN,chr3:15070073-15099163,29090
159669069,159762529,chr6,SOD2,chr6:159669069-159762529,93460
89504909,89524049,chr15,LINC00928,chr15:89504909-89524049,19140
55073015,55096553,chr5,GZMAP1,chr5:55073015-55096553,23538
135027734,135034813,chr5,PITX1,chr5:135027734-135034813,7079
101828741,101829679,chr15,OR4F14P,chr15:101828741-101829679,938
79559256,79560304,chr15,TFDP1P3,chr15:79559256-79560304,1048
84526781,84571216,chr15,UBE2Q2P1,chr15:84526781-84571216,44435
113324163,113364148,chr13,GRTP1,chr13:113324163-113364148,39985
44388732,44413989,chr5,FGF10-AS1,chr5:44388732-44413989,25257
115148764,115149644,chr5,TRIM36-IT1,chr5:115148764-115149644,880
95555101,95605102,chr5,ARSK,chr5:95555101-95605102,50001
70802084,71230722,chr16,HYDIN,chr16:70802084-71230722,428638
25909503,25911234,chr5,MSNP1,chr5:25909503-25911234,1731
42397083,42410610,chr3,LYZL4,chr3:42397083-42410610,13527
132556019,132646349,chr5,RAD50,chr5:132556019-132646349,90330
59964942,59966084,chr15,NMNAT1P5,chr15:59964942-59966084,1142
113351645,113361868,chr13,GRTP1-AS1,chr13:113351645-113361868,10223
31704058,31721652,chr3,OSBPL10-AS1,chr3:31704058-31721652,17594
159712801,159713985,chr6,HNRNPH1P1,chr6:159712801-159713985,1184
57561080,57568121,chr20,PCK1,chr20:57561080-57568121,7041
159720415,159720540,chr6,RNU4ATAC18P,chr6:159720415-159720540,125
159725585,159756319,chr6,WTAP,chr6:159725585-159756319,30734
64815632,64825668,chr15,PIF1,chr15:64815632-64825668,10036
44729596,44737083,chr3,ZNF501,chr3:44729596-44737083,7487
1211340,1214153,chr1,TNFRSF4,chr1:1211340-1214153,2813
113455819,113490951,chr13,DCUN1D2,chr13:113455819-113490951,35132
34661880,34664048,chr9,CCL27,chr9:34661880-34664048,2168
57603846,57620576,chr20,ZBP1,chr20:57603846-57620576,16730
1203508,1206592,chr1,TNFRSF18,chr1:1203508-1206592,3084
28574791,30010391,chr3,RBMS3,chr3:28574791-30010391,1435600
42048021,42058517,chr2,PKDCC,chr2:42048021-42058517,10496
96000753,96043520,chr12,LTA4H,chr12:96000753-96043520,42767
34689570,34691276,chr9,CCL19,chr9:34689570-34691276,1706
159760258,159762332,chr6,SOD2-OT1,chr6:159760258-159762332,2074
159762045,159779112,chr6,ACAT2,chr6:159762045-159779112,17067
34709005,34710136,chr9,CCL21,chr9:34709005-34710136,1131
1471765,1497848,chr1,ATAD3B,chr1:1471765-1497848,26083
34723053,34729488,chr9,FAM205A,chr9:34723053-34729488,6435
34634722,34637844,chr9,SIGMAR1,chr9:34634722-34637844,3122
32443059,32585333,chr20,NOL4L,chr20:32443059-32585333,142274
159778498,159789703,chr6,TCP1,chr6:159778498-159789703,11205
113468901,113476135,chr13,DCUN1D2-AS,chr13:113468901-113476135,7234
113478915,113479078,chr13,RNU1-16P,chr13:113478915-113479078,163
94415570,94493885,chr11,MRE11,chr11:94415570-94493885,78315
113491021,113554590,chr13,TMCO3,chr13:113491021-113554590,63569
83016423,83067252,chr15,BTBD1,chr15:83016423-83067252,50829
133051996,133052059,chr9,MIR6877,chr9:133051996-133052059,63
42143238,42170301,chr2,EML4-AS1,chr2:42143238-42170301,27063
133030675,133058503,chr9,GTF3C5,chr9:133030675-133058503,27828
629062,629433,chr1,MTND1P23,chr1:629062-629433,371
8786211,8786913,chr1,RPL7P7,chr1:8786211-8786913,702
634376,634922,chr1,MTCO3P12,chr1:634376-634922,546
182696,184174,chr1,DDX11L17,chr1:182696-184174,1478
47209214,47356889,chr20,ZMYND8,chr20:47209214-47356889,147675
3069168,3438621,chr1,PRDM16,chr1:3069168-3438621,369453
99645129,99680569,chr14,HHIPL1,chr14:99645129-99680569,35440
79085023,79088019,chr2,REG1B,chr2:79085023-79088019,2996
85240472,85247170,chr15,GOLGA6L3,chr15:85240472-85247170,6698
97339693,97523442,chr15,LINC02254,chr15:97339693-97523442,183749
95657807,95791189,chr12,NTN4,chr12:95657807-95791189,133382
24130659,24132849,chr14,FITM1,chr14:24130659-24132849,2190
19875142,19883932,chr14,OR4K2,chr14:19875142-19883932,8790
35724759,35725142,chr2,MRPL50P1,chr2:35724759-35725142,383
87118534,87120980,chr2,ANAPC1P3,chr2:87118534-87120980,2446
41606876,41904549,chr14,LRFN5,chr14:41606876-41904549,297673
94786688,94787261,chr2,SNX18P14,chr2:94786688-94787261,573
75369379,75455842,chr15,SIN3A,chr15:75369379-75455842,86463
85133392,85310387,chr2,TCF7L1,chr2:85133392-85310387,176995
66878589,66895754,chr16,PDP2,chr16:66878589-66895754,17165
9014123,9015979,chr3,SRGAP3-AS1,chr3:9014123-9015979,1856
38265812,38278757,chr3,SLC22A13,chr3:38265812-38278757,12945
113584721,113641473,chr13,TFDP1,chr13:113584721-113641473,56752
19773504,19783696,chr14,OR4M1,chr14:19773504-19783696,10192
159780250,159780381,chr6,SNORA20,chr6:159780250-159780381,131
159785594,159785733,chr6,SNORA29,chr6:159785594-159785733,139
159789812,159798436,chr6,MRPL18,chr6:159789812-159798436,8624
20014143,20019307,chr14,OR4K14,chr14:20014143-20019307,5164
22630929,22644352,chr14,OR6J1,chr14:22630929-22644352,13423
88803789,88809258,chr16,CDT1,chr16:88803789-88809258,5469
20029399,20036038,chr14,OR4K13,chr14:20029399-20036038,6639
44874608,44914990,chr3,TGM4,chr3:44874608-44914990,40382
109687802,109688329,chr5,MAN2A1-DT,chr5:109687802-109688329,527
159800249,159820704,chr6,PNLDC1,chr6:159800249-159820704,20455
19930917,19936757,chr14,OR4K1,chr14:19930917-19936757,5840
92134604,92180725,chr7,CYP51A1-AS1,chr7:92134604-92180725,46121
54313564,54415238,chr5,LINC01033,chr5:54313564-54415238,101674
84031140,84032358,chr2,CRLF3P3,chr2:84031140-84032358,1218
21568520,21580076,chr14,OR10G3,chr14:21568520-21580076,11556
92204015,92204098,chr7,MIR1285-1,chr7:92204015-92204098,83
134734898,134735129,chr7,TUBB3P2,chr7:134734898-134735129,231
84915868,84916660,chr2,RPS2P17,chr2:84915868-84916660,792
88931666,88932380,chr2,IGKV2-4,chr2:88931666-88932380,714
77760834,77769742,chr14,C14orf178,chr14:77760834-77769742,8908
629640,630683,chr1,MTND2P28,chr1:629640-630683,1043
74834127,74893359,chr2,HK2,chr2:74834127-74893359,59232
30228290,30713538,chr19,ZNF536,chr19:30228290-30713538,485248
19492281,19501740,chr14,NF1P4,chr14:19492281-19501740,9459
134744252,134970729,chr7,CALD1,chr7:134744252-134970729,226477
1292390,1309609,chr1,ACAP3,chr1:1292390-1309609,17219
19612191,19619490,chr14,NF1P11,chr14:19612191-19619490,7299
120511746,120988906,chr11,GRIK4,chr11:120511746-120988906,477160
91843687,91844529,chr5,PCBP2P3,chr5:91843687-91844529,842
125966777,125968085,chr5,RPSAP37,chr5:125966777-125968085,1308
65251127,65251784,chr5,RPEP1,chr5:65251127-65251784,657
98409675,98410100,chr5,MTCO2P24,chr5:98409675-98410100,425
115841592,115914081,chr5,AP3S1,chr5:115841592-115914081,72489
35538352,35809304,chr14,RALGAPA1,chr14:35538352-35809304,270952
19623655,19628930,chr19,LPAR2,chr19:19623655-19628930,5275
133061981,133071861,chr9,CEL,chr9:133061981-133071861,9880
42879616,42889925,chr6,RPL7L1,chr6:42879616-42889925,10309
130990138,130993976,chr12,ADGRD1-AS1,chr12:130990138-130993976,3838
41977008,41978034,chr3,GEMIN2P2,chr3:41977008-41978034,1026
116533422,116536518,chr12,LINC00173,chr12:116533422-116536518,3096
15042460,15065317,chr3,MRPS25,chr3:15042460-15065317,22857
36817428,36850787,chr19,ZNF790,chr19:36817428-36850787,33359
84648511,84667686,chr16,KLHL36,chr16:84648511-84667686,19175
133079900,133087355,chr9,CELP,chr9:133079900-133087355,7455
121888732,121918297,chr12,PSMD9,chr12:121888732-121918297,29565
133097720,133149334,chr9,RALGDS,chr9:133097720-133149334,51614
42890265,42890821,chr6,C6orf226,chr6:42890265-42890821,556
42915989,42925838,chr6,PTCRA,chr6:42915989-42925838,9849
71197433,71592025,chr8,EYA1,chr8:71197433-71592025,394592
74671855,74700960,chr16,MLKL,chr16:74671855-74700960,29105
91368631,91383317,chr5,ARRDC3,chr5:91368631-91383317,14686
11906527,11912313,chr3,MARK2P14,chr3:11906527-11912313,5786
113399611,113453488,chr13,ADPRHL1,chr13:113399611-113453488,53877
39358545,39359922,chr3,EEF1A1P24,chr3:39358545-39359922,1377
29390848,29391218,chr3,RPS12P5,chr3:29390848-29391218,370
42956345,42956765,chr6,RPL24P4,chr6:42956345-42956765,420
42960754,42963880,chr6,GNMT,chr6:42960754-42963880,3126
30037285,30037411,chr19,TAF9P3,chr19:30037285-30037411,126
32063974,32066611,chr3,NIFKP7,chr3:32063974-32066611,2637
35382172,35384052,chr19,EEF1A1P7,chr19:35382172-35384052,1880
39644502,39644612,chr19,RPS29P30,chr19:39644502-39644612,110
34481758,34512304,chr19,WTIP,chr19:34481758-34512304,30546
13937273,14082811,chr3,TPRXL,chr3:13937273-14082811,145538
42963865,42979181,chr6,PEX6,chr6:42963865-42979181,15316
55963191,56047326,chr2,MIR217HG,chr2:55963191-56047326,84135
86930250,86930754,chr2,WBP1P1,chr2:86930250-86930754,504
3658938,3668772,chr1,TP73-AS3,chr1:3658938-3668772,9834
81418723,81419302,chr2,CHMP4AP1,chr2:81418723-81419302,579
93430659,93431217,chr15,SEPHS1P2,chr15:93430659-93431217,558
7368942,7370270,chr1,CAMTA1-IT1,chr1:7368942-7370270,1328
87968609,87968971,chr2,NDUFB4P7,chr2:87968609-87968971,362
85899162,85922606,chr16,IRF8,chr16:85899162-85922606,23444
100877714,100916626,chr15,ALDH1A3,chr15:100877714-100916626,38912
19413153,19413461,chr12,PDCD5P1,chr12:19413153-19413461,308
1308597,1311677,chr1,PUSL1,chr1:1308597-1311677,3080
56183990,56386172,chr2,CCDC85A,chr2:56183990-56386172,202182
110738136,110765161,chr5,SLC25A46,chr5:110738136-110765161,27025
47753916,47782751,chr12,SLC48A1,chr12:47753916-47782751,28835
39655913,39660647,chr19,LGALS16,chr19:39655913-39660647,4734
3799431,3849834,chr3,LRRN1,chr3:3799431-3849834,50403
46936689,47164385,chr11,C11orf49,chr11:46936689-47164385,227696
70887871,70889959,chr2,LINC01143,chr2:70887871-70889959,2088
82856826,82857384,chr2,DHFRP3,chr2:82856826-82857384,558
94725674,94725935,chr2,CNN2P11,chr2:94725674-94725935,261
38867830,38878275,chr19,RINL,chr19:38867830-38878275,10445
1595777,1596245,chr3,RPL23AP38,chr3:1595777-1596245,468
14572852,14574792,chr3,RHBDF1P1,chr3:14572852-14574792,1940
59217708,59279400,chr2,LINC01793,chr2:59217708-59279400,61692
42984553,43012342,chr6,PPP2R5D,chr6:42984553-43012342,27789
26346681,26347638,chr3,VENTXP4,chr3:26346681-26347638,957
48627879,48628836,chr12,OR11M1P,chr12:48627879-48628836,957
45159774,45160175,chr3,RPS24P8,chr3:45159774-45160175,401
31269007,31269406,chr3,H3P11,chr3:31269007-31269406,399
2403964,2413797,chr1,PEX10,chr1:2403964-2413797,9833
51926882,51927362,chr2,CCDC12P1,chr2:51926882-51927362,480
97046588,97046891,chr2,IGKV2OR2-1,chr2:97046588-97046891,303
19148510,19535642,chr3,KCNH8,chr3:19148510-19535642,387132
45954465,46052759,chr13,ZC3H13,chr13:45954465-46052759,98294
54516048,54540697,chr2,SPTBN1-AS1,chr2:54516048-54540697,24649
82609652,82609977,chr2,RBX1P1,chr2:82609652-82609977,325
82170296,82175803,chr16,MPHOSPH6-DT,chr16:82170296-82175803,5507
68610855,68671901,chr12,RAP1B,chr12:68610855-68671901,61046
88677688,88686507,chr16,SNAI3,chr16:88677688-88686507,8819
30910467,31155202,chr2,GALNT14,chr2:30910467-31155202,244735
33080899,33130542,chr19,GPATCH1,chr19:33080899-33130542,49643
86710122,86742083,chr16,LINC02188,chr16:86710122-86742083,31961
50226292,50259362,chr3,GNAI2,chr3:50226292-50259362,33070
98833382,98833711,chr5,CSNK1A1P3,chr5:98833382-98833711,329
42210447,42273584,chr15,TMEM87A,chr15:42210447-42273584,63137
57428187,57447420,chr16,CIAPIN1,chr16:57428187-57447420,19233
81301587,81313297,chr5,ZCCHC9,chr5:81301587-81313297,11710
631074,632616,chr1,MTCO1P12,chr1:631074-632616,1542
1324756,1328896,chr1,CPTP,chr1:1324756-1328896,4140
32432417,32538885,chr13,N4BP2L2,chr13:32432417-32538885,106468
33177603,33208864,chr19,LRP3,chr19:33177603-33208864,31261
2228319,2310213,chr1,SKI,chr1:2228319-2310213,81894
3487951,3611508,chr1,MEGF6,chr1:3487951-3611508,123557
36182276,36246257,chr19,ZNF565,chr19:36182276-36246257,63981
126751963,126776486,chr5,LMNB1-DT,chr5:126751963-126776486,24523
54399439,54400033,chr5,RPL37P25,chr5:54399439-54400033,594
92889387,92890840,chr5,CCT7P2,chr5:92889387-92890840,1453
2301997,2318204,chr11,TSPAN32,chr11:2301997-2318204,16207
109883182,109884751,chr5,LINC01848,chr5:109883182-109884751,1569
119126782,119128444,chr5,SEPTIN7P10,chr5:119126782-119128444,1662
71132993,71133287,chr5,CDH12P4,chr5:71132993-71133287,294
39697904,39698073,chr19,RPS29P27,chr19:39697904-39698073,169
126776623,126837020,chr5,LMNB1,chr5:126776623-126837020,60397
48332356,48364059,chr19,TMEM143,chr19:48332356-48364059,31703
92604921,92836573,chr7,CDK6,chr7:92604921-92836573,231652
59768352,59769146,chr15,RPS3AP6,chr15:59768352-59769146,794
50095883,50159256,chr7,SPATA48,chr7:50095883-50159256,63373
88143935,88144165,chr15,MED28P6,chr15:88143935-88144165,230
19883614,19883716,chr15,RNU6-978P,chr15:19883614-19883716,102
20570886,20571175,chr15,RN7SL759P,chr15:20570886-20571175,289
21307749,21307855,chr15,RNU6-1235P,chr15:21307749-21307855,106
21406385,21406459,chr15,MIR3118-3,chr15:21406385-21406459,74
20738679,20738785,chr15,RNU6-498P,chr15:20738679-20738785,106
138831381,138981389,chr7,KIAA1549,chr7:138831381-138981389,150008
20832795,20832869,chr15,MIR3118-2,chr15:20832795-20832869,74
34021659,34021895,chr19,RPS4XP23,chr19:34021659-34021895,236
20855251,20855357,chr15,RNU6-749P,chr15:20855251-20855357,106
20940252,20940333,chr15,MIR5701-1,chr15:20940252-20940333,81
21102843,21103138,chr15,RN7SL400P,chr15:21102843-21103138,295
87601835,87698156,chr16,JPH3,chr16:87601835-87698156,96321
21951242,21951323,chr15,MIR5701-3,chr15:21951242-21951323,81
21866210,21866316,chr15,RNU6-631P,chr15:21866210-21866316,106
57459912,57460120,chr19,VN1R107P,chr19:57459912-57460120,208
21513959,21514040,chr15,MIR5701-2,chr15:21513959-21514040,81
22609141,22609377,chr15,RN7SL495P,chr15:22609141-22609377,236
23165897,23166186,chr15,RN7SL106P,chr15:23165897-23166186,289
22429200,22429489,chr15,RN7SL545P,chr15:22429200-22429489,289
22225278,22225329,chr15,MIR1268A,chr15:22225278-22225329,51
58479512,58512413,chr19,SLC27A5,chr19:58479512-58512413,32901
25738508,25738620,chr15,RNA5SP390,chr15:25738508-25738620,112
25848747,25848825,chr15,MIR4715,chr15:25848747-25848825,78
21843750,21843824,chr15,MIR3118-4,chr15:21843750-21843824,74
27280318,27280436,chr15,RNA5SP391,chr15:27280318-27280436,118
30143733,30143969,chr15,RN7SL469P,chr15:30143733-30143969,236
30091662,30091898,chr15,RN7SL673P,chr15:30091662-30091898,236
23197827,23197920,chr15,MIR4509-1,chr15:23197827-23197920,93
25062333,25062427,chr15,SNORD116-5,chr15:25062333-25062427,94
111662621,111997464,chr5,NREP,chr5:111662621-111997464,334843
25074114,25074215,chr15,SNORD116-10,chr15:25074114-25074215,101
25075929,25076020,chr15,SNORD116-11,chr15:25075929-25076020,91
25083588,25083679,chr15,SNORD116-17,chr15:25083588-25083679,91
24981994,24982068,chr15,SNORD107,chr15:24981994-24982068,74
24985100,24985166,chr15,SNORD64,chr15:24985100-24985166,66
74612596,74613221,chr16,HSPE1P7,chr16:74612596-74613221,625
24986925,24986995,chr15,SNORD108,chr15:24986925-24986995,70
25041974,25042040,chr15,SNORD109A,chr15:25041974-25042040,66
25051477,25051571,chr15,SNORD116-1,chr15:25051477-25051571,94
25054210,25054304,chr15,SNORD116-2,chr15:25054210-25054304,94
25056860,25056954,chr15,SNORD116-3,chr15:25056860-25056954,94
25059538,25059633,chr15,SNORD116-4,chr15:25059538-25059633,95
25065026,25065121,chr15,SNORD116-6,chr15:25065026-25065121,95
25067788,25067882,chr15,SNORD116-7,chr15:25067788-25067882,94
101252886,101270316,chr2,CNOT11,chr2:101252886-101270316,17430
64943753,65126112,chr16,CDH11,chr16:64943753-65126112,182359
1331280,1335314,chr1,TAS1R3,chr1:1331280-1335314,4034
25070432,25070526,chr15,SNORD116-8,chr15:25070432-25070526,94
25073107,25073201,chr15,SNORD116-9,chr15:25073107-25073201,94
25077051,25077142,chr15,SNORD116-12,chr15:25077051-25077142,91
25079058,25079149,chr15,SNORD116-13,chr15:25079058-25079149,91
25080142,25080233,chr15,SNORD116-14,chr15:25080142-25080233,91
25081287,25081378,chr15,SNORD116-15,chr15:25081287-25081378,91
39383370,39397351,chr3,SLC25A38,chr3:39383370-39397351,13981
25082768,25082859,chr15,SNORD116-16,chr15:25082768-25082859,91
487101,489906,chr1,CICP7,chr1:487101-489906,2805
25085385,25085476,chr15,SNORD116-18,chr15:25085385-25085476,91
25086527,25086618,chr15,SNORD116-19,chr15:25086527-25086618,91
674842,675265,chr1,WBP1LP6,chr1:674842-675265,423
25087662,25087753,chr15,SNORD116-20,chr15:25087662-25087753,91
25088804,25088895,chr15,SNORD116-21,chr15:25088804-25088895,91
3944547,3949024,chr1,LINC01345,chr1:3944547-3949024,4477
25089923,25090014,chr15,SNORD116-22,chr15:25089923-25090014,91
25091786,25091877,chr15,SNORD116-23,chr15:25091786-25091877,91
25094037,25094128,chr15,SNORD116-24,chr15:25094037-25094128,91
25097663,25097754,chr15,SNORD116-25,chr15:25097663-25097754,91
39704481,39709444,chr19,LGALS14,chr19:39704481-39709444,4963
25099499,25099594,chr15,SNORD116-26,chr15:25099499-25099594,95
25101575,25101666,chr15,SNORD116-27,chr15:25101575-25101666,91
25104642,25104732,chr15,SNORD116-28,chr15:25104642-25104732,90
35926856,35926923,chr15,MIR4510,chr15:35926856-35926923,67
8004404,8026309,chr1,ERRFI1,chr1:8004404-8026309,21905
35372256,35372364,chr15,MIR3942,chr15:35372256-35372364,108
40615665,40615928,chr15,RN7SL376P,chr15:40615665-40615928,263
40529570,40529673,chr15,RNU6-516P,chr15:40529570-40529673,103
41191965,41192265,chr15,RN7SL497P,chr15:41191965-41192265,300
133152948,133163933,chr9,GBGT1,chr9:133152948-133163933,10985
42199570,42199666,chr15,MIR627,chr15:42199570-42199666,96
43391384,43391727,chr15,RN7SL487P,chr15:43391384-43391727,343
42427591,42427697,chr15,RNU6-188P,chr15:42427591-42427697,106
75046463,75199520,chr2,TACR1,chr2:75046463-75199520,153057
7020479,7071526,chr11,NLRP14,chr11:7020479-7071526,51047
46660658,46660760,chr15,RNU6-1014P,chr15:46660658-46660760,102
46720193,46720512,chr15,RN7SKP101,chr15:46720193-46720512,319
44884616,44884780,chr15,RNU1-119P,chr15:44884616-44884780,164
47272597,47272889,chr15,RN7SKP139,chr15:47272597-47272889,292
49982443,49982561,chr15,RNA5SP394,chr15:49982443-49982561,118
4175528,4175899,chr1,EEF1DP6,chr1:4175528-4175899,371
49042341,49042643,chr15,RN7SL577P,chr15:49042341-49042643,302
51242190,51242264,chr15,MIR4713,chr15:51242190-51242264,74
10472288,10630758,chr1,PEX14,chr1:10472288-10630758,158470
49169070,49169153,chr15,MIR4716,chr15:49169070-49169153,83
49198900,49199194,chr15,RN7SL307P,chr15:49198900-49199194,294
50347423,50347529,chr15,RNU6-94P,chr15:50347423-50347529,106
50360329,50360410,chr15,MIR4712,chr15:50360329-50360410,81
53299051,53308644,chr19,FAM90A28P,chr19:53299051-53308644,9593
50244628,50244931,chr15,RN7SL494P,chr15:50244628-50244931,303
53651977,53652123,chr15,RNU2-53P,chr15:53651977-53652123,146
56029684,56029981,chr15,RN7SL568P,chr15:56029684-56029981,297
57405074,57405175,chr15,RNU6-844P,chr15:57405074-57405175,101
63882587,63882685,chr11,RNU6-1306P,chr11:63882587-63882685,98
33388336,33441371,chr3,UBP1,chr3:33388336-33441371,53035
58703852,58704154,chr15,RN7SKP95,chr15:58703852-58704154,302
63911230,63917164,chr11,RCOR2,chr11:63911230-63917164,5934
58760466,58760681,chr15,SNORD3P1,chr15:58760466-58760681,215
7842262,7844143,chrX,VCX,chrX:7842262-7844143,1881
64762387,64762515,chr15,MIR1272,chr15:64762387-64762515,128
60736769,60736886,chr15,RNA5SP397,chr15:60736769-60736886,117
32597006,32676597,chr19,ANKRD27,chr19:32597006-32676597,79591
59171183,59171262,chr15,MIR2116,chr15:59171183-59171262,79
59212648,59212788,chr15,RNU4-80P,chr15:59212648-59212788,140
59341314,59341417,chr15,RNU6-212P,chr15:59341314-59341417,103
19719315,19773617,chr7,TMEM196,chr7:19719315-19773617,54302
40097270,40611053,chr2,SLC8A1,chr2:40097270-40611053,513783
57278570,57278673,chr15,SNORD13D,chr15:57278570-57278673,103
62304658,62304734,chr15,MIR8067,chr15:62304658-62304734,76
65304677,65304792,chr15,RNU5B-1,chr15:65304677-65304792,115
67839939,67840045,chr15,RNU6-1,chr15:67839939-67840045,106
70193236,70193341,chr15,RNU6-745P,chr15:70193236-70193341,105
4571481,4594016,chr1,LINC01646,chr1:4571481-4594016,22535
70079372,70079468,chr15,MIR629,chr15:70079372-70079468,96
59574103,59574222,chr15,RNA5SP396,chr15:59574103-59574222,119
68801850,68801925,chr15,MIR4312,chr15:68801850-68801925,75
74411357,74411432,chr15,MIR6881,chr15:74411357-74411432,75
75292706,75292928,chr15,RN7SL327P,chr15:75292706-75292928,222
104039956,104042454,chrX,H2BW2,chrX:104039956-104042454,2498
74072454,74072676,chr15,RN7SL429P,chr15:74072454-74072676,222
74840642,74840707,chr15,MIR6882,chr15:74840642-74840707,65
65553081,65553187,chr15,RNU6-19P,chr15:65553081-65553187,106
43011143,43016868,chr6,MEA1,chr6:43011143-43016868,5725
72045183,72045367,chr15,RNU2-65P,chr15:72045183-72045367,184
111511645,111522399,chrX,SERTM2,chrX:111511645-111522399,10754
76976915,76977210,chr15,RN7SL278P,chr15:76976915-76977210,295
23235967,23275108,chr7,GPNMB,chr7:23235967-23275108,39141
4412027,4424689,chr1,LINC01777,chr1:4412027-4424689,12662
75762215,75762315,chr15,MIR4313,chr15:75762215-75762315,100
75785134,75785354,chr15,RN7SL319P,chr15:75785134-75785354,220
80663772,80663878,chr15,RNU6-380P,chr15:80663772-80663878,106
47078355,47093314,chrX,RGN,chrX:47078355-47093314,14959
74788672,74788757,chr15,MIR4513,chr15:74788672-74788757,85
75895040,75895302,chr15,RN7SL510P,chr15:75895040-75895302,262
63938959,63957319,chr11,NAA40,chr11:63938959-63957319,18360
80581103,80581239,chr15,MIR5572,chr15:80581103-80581239,136
75353611,75353685,chr15,MIR631,chr15:75353611-75353685,74
79209788,79209871,chr15,MIR184,chr15:79209788-79209871,83
83717427,83717522,chr15,RNU6-401P,chr15:83717427-83717522,95
83824863,83824953,chr15,RNU6-1339P,chr15:83824863-83824953,90
76586647,76586691,chr15,MIR3713,chr15:76586647-76586691,44
76736641,76736980,chr15,RN7SKP217,chr15:76736641-76736980,339
85770496,85770578,chr15,MIR1276,chr15:85770496-85770578,82
85210053,85210299,chr15,RN7SL428P,chr15:85210053-85210299,246
88608107,88608197,chr15,MIR1179,chr15:88608107-88608197,90
82174224,82174385,chr15,RNU1-77P,chr15:82174224-82174385,161
87474183,87474289,chr15,RNU6-185P,chr15:87474183-87474289,106
85389823,85389884,chr15,RNU7-79P,chr15:85389823-85389884,61
85651522,85651628,chr15,RNU6-1280P,chr15:85651522-85651628,106
85380596,85380662,chr15,MIR7706,chr15:85380596-85380662,66
75268430,75268652,chr15,RN7SL489P,chr15:75268430-75268652,222
88611825,88611934,chr15,MIR7-2,chr15:88611825-88611934,109
43021623,43034156,chr6,RRP36,chr6:43021623-43034156,12533
88611847,88611924,chr15,MIR3529,chr15:88611847-88611924,77
96842069,96842384,chr15,RN7SKP181,chr15:96842069-96842384,315
97353497,97353815,chr15,RN7SL677P,chr15:97353497-97353815,318
92904399,92904475,chr15,MIR3175,chr15:92904399-92904475,76
97472126,97472252,chr15,RNA5SP401,chr15:97472126-97472252,126
98784426,98784502,chr15,MIR4714,chr15:98784426-98784502,76
96333261,96333307,chr15,MIR1469,chr15:96333261-96333307,46
96486582,96486891,chr15,RN7SKP254,chr15:96486582-96486891,309
101773238,101773513,chr15,RN7SL209P,chr15:101773238-101773513,275
98074667,98074763,chr15,RNU6-1186P,chr15:98074667-98074763,96
95745804,95745994,chr15,RNU2-3P,chr15:95745804-95745994,190
633535,633741,chr1,MTATP8P1,chr1:633535-633741,206
84748592,84806445,chr15,ZNF592,chr15:84748592-84806445,57853
632757,633438,chr1,MTCO2P12,chr1:632757-633438,681
5086459,5090899,chr1,LINC02782,chr1:5086459-5090899,4440
43036196,43036500,chr6,RN7SL403P,chr6:43036196-43036500,304
43040777,43075095,chr6,KLC4,chr6:43040777-43075095,34318
133224905,133228591,chr9,LCN1P1,chr9:133224905-133228591,3686
2425980,2505532,chr1,PLCH2,chr1:2425980-2505532,79552
133233278,133276024,chr9,ABO,chr9:133233278-133276024,42746
63970470,63970576,chr11,RNU6-45P,chr11:63970470-63970576,106
47087506,47087612,chrX,RNU6-1189P,chrX:47087506-47087612,106
47132671,47132826,chrX,RNU12-2P,chrX:47132671-47132826,155
63974620,63976543,chr11,COX8A,chr11:63974620-63976543,1923
47145221,47186813,chrX,RBM10,chrX:47145221-47186813,41592
44167969,44244384,chr2,PPM1B,chr2:44167969-44244384,76415
63998558,64166113,chr11,MACROD1,chr11:63998558-64166113,167555
25106521,25106603,chr15,SNORD116-29,chr15:25106521-25106603,82
84476355,84554033,chr16,MEAK7,chr16:84476355-84554033,77678
25108268,25108352,chr15,SNORD116-30,chr15:25108268-25108352,84
25135642,25138055,chr15,PWAR1,chr15:25135642-25138055,2413
25169337,25169676,chr15,DMAC1P1,chr15:25169337-25169676,339
25170723,25170804,chr15,SNORD115-1,chr15:25170723-25170804,81
25172635,25172716,chr15,SNORD115-2,chr15:25172635-25172716,81
25174927,25175008,chr15,SNORD115-3,chr15:25174927-25175008,81
25176832,25176913,chr15,SNORD115-4,chr15:25176832-25176913,81
25178738,25178819,chr15,SNORD115-5,chr15:25178738-25178819,81
25180497,25180578,chr15,SNORD115-6,chr15:25180497-25180578,81
25182385,25182466,chr15,SNORD115-7,chr15:25182385-25182466,81
25184306,25184387,chr15,SNORD115-8,chr15:25184306-25184387,81
25185631,25185712,chr15,SNORD115-9,chr15:25185631-25185712,81
25187536,25187616,chr15,SNORD115-10,chr15:25187536-25187616,80
25189414,25189495,chr15,SNORD115-11,chr15:25189414-25189495,81
25191416,25191497,chr15,SNORD115-12,chr15:25191416-25191497,81
25193321,25193402,chr15,SNORD115-13,chr15:25193321-25193402,81
25194921,25195001,chr15,SNORD115-14,chr15:25194921-25195001,80
25197576,25197656,chr15,SNORD115-15,chr15:25197576-25197656,80
25199448,25199529,chr15,SNORD115-16,chr15:25199448-25199529,81
25201323,25201404,chr15,SNORD115-17,chr15:25201323-25201404,81
25203227,25203308,chr15,SNORD115-18,chr15:25203227-25203308,81
25204357,25204438,chr15,SNORD115-19,chr15:25204357-25204438,81
25206262,25206343,chr15,SNORD115-20,chr15:25206262-25206343,81
25208083,25208163,chr15,SNORD115-21,chr15:25208083-25208163,80
25209918,25209999,chr15,SNORD115-22,chr15:25209918-25209999,81
25211796,25211877,chr15,SNORD115-23,chr15:25211796-25211877,81
25213648,25213729,chr15,SNORD115-24,chr15:25213648-25213729,81
25215541,25215622,chr15,SNORD115-25,chr15:25215541-25215622,81
25218617,25218698,chr15,SNORD115-26,chr15:25218617-25218698,81
25220497,25220578,chr15,SNORD115-27,chr15:25220497-25220578,81
25222348,25222428,chr15,SNORD115-28,chr15:25222348-25222428,80
25223246,25223327,chr15,SNORD115-29,chr15:25223246-25223327,81
25225203,25225284,chr15,SNORD115-30,chr15:25225203-25225284,81
25227109,25227190,chr15,SNORD115-31,chr15:25227109-25227190,81
25228967,25229048,chr15,SNORD115-32,chr15:25228967-25229048,81
25230838,25230919,chr15,SNORD115-33,chr15:25230838-25230919,81
25232387,25232468,chr15,SNORD115-34,chr15:25232387-25232468,81
25234247,25234328,chr15,SNORD115-35,chr15:25234247-25234328,81
25236085,25236166,chr15,SNORD115-36,chr15:25236085-25236166,81
25237986,25238067,chr15,SNORD115-37,chr15:25237986-25238067,81
25239838,25239919,chr15,SNORD115-38,chr15:25239838-25239919,81
25241746,25241827,chr15,SNORD115-39,chr15:25241746-25241827,81
40477113,40491053,chr3,ZNF619,chr3:40477113-40491053,13940
25243614,25243695,chr15,SNORD115-40,chr15:25243614-25243695,81
32504506,32509395,chr13,N4BP2L2-IT2,chr13:32504506-32509395,4889
25245478,25245559,chr15,SNORD115-41,chr15:25245478-25245559,81
25247345,25247426,chr15,SNORD115-42,chr15:25247345-25247426,81
25249198,25249279,chr15,SNORD115-43,chr15:25249198-25249279,81
74871362,75000173,chr16,WDR59,chr16:74871362-75000173,128811
25250859,25250940,chr15,SNORD115-44,chr15:25250859-25250940,81
26291862,26374383,chr7,SNX10,chr7:26291862-26374383,82521
25264510,25264590,chr15,SNORD115-45,chr15:25264510-25264590,80
25266591,25266661,chr15,SNORD115-46,chr15:25266591-25266661,70
64185272,64204543,chr11,STIP1,chr11:64185272-64204543,19271
25268466,25268551,chr15,SNORD115-47,chr15:25268466-25268551,85
25269783,25269858,chr15,SNORD115-48,chr15:25269783-25269858,75
52033611,52129092,chr13,NEK5,chr13:52033611-52129092,95481
25278343,25278409,chr15,SNORD109B,chr15:25278343-25278409,66
66021553,66101245,chr8,DNAJC5B,chr8:66021553-66101245,79692
67632266,67646789,chr5,LINC02242,chr5:67632266-67646789,14523
51907200,51907305,chr15,RNU6-90P,chr15:51907200-51907305,105
20535825,20565809,chr19,ZNF737,chr19:20535825-20565809,29984
112419583,112420978,chr5,EPB41L4A-DT,chr5:112419583-112420978,1395
133317794,133318469,chr9,LCN1P2,chr9:133317794-133318469,675
133328776,133336188,chr9,SURF6,chr9:133328776-133336188,7412
70860285,70860579,chr5,CDH12P1,chr5:70860285-70860579,294
135892246,135895841,chr5,IL9,chr5:135892246-135895841,3595
51938025,51971778,chr15,LEO1,chr15:51938025-51971778,33753
9292894,9369532,chr1,SPSB1,chr1:9292894-9369532,76638
51721670,51722164,chr8,BTF3P1,chr8:51721670-51722164,494
44937673,44938482,chr3,RPL12P44,chr3:44937673-44938482,809
44537058,44620821,chr19,CEACAM22P,chr19:44537058-44620821,83763
37748110,37748900,chr3,RPL21P135,chr3:37748110-37748900,790
96261902,96336995,chr8,PTDSS1,chr8:96261902-96336995,75093
96120220,96322147,chr7,SLC25A13,chr7:96120220-96322147,201927
133338312,133348131,chr9,MED22,chr9:133338312-133348131,9819
347982,348366,chr1,RPL23AP24,chr1:347982-348366,384
31348881,31417794,chr19,TSHZ3-AS1,chr19:31348881-31417794,68913
28315003,28349050,chr3,AZI2,chr3:28315003-28349050,34047
39731255,39738029,chr19,CLC,chr19:39731255-39738029,6774
47156638,47158199,chrX,ITPK1P1,chrX:47156638-47158199,1561
9922113,9943407,chr1,LZIC,chr1:9922113-9943407,21294
96050115,96215519,chr5,MIR583HG,chr5:96050115-96215519,165404
47190861,47215128,chrX,UBA1,chrX:47190861-47215128,24267
91840601,91843802,chr2,ABCD1P5,chr2:91840601-91843802,3201
136028988,136063818,chr5,TGFBI,chr5:136028988-136063818,34830
105038069,105099960,chr2,MRPS9,chr2:105038069-105099960,61891
44613563,44636781,chr19,IGSF23,chr19:44613563-44636781,23218
99416739,99466163,chr7,PTCD1,chr7:99416739-99466163,49424
51829628,51947295,chr15,TMOD3,chr15:51829628-51947295,117667
86530178,86555235,chr16,MTHFSD,chr16:86530178-86555235,25057
32636078,32636475,chr19,RPS12P31,chr19:32636078-32636475,397
36714383,36772825,chr19,ZNF850,chr19:36714383-36772825,58442
26581205,26641366,chr2,CIB4,chr2:26581205-26641366,60161
43593054,43604901,chr15,CKMT1B,chr15:43593054-43604901,11847
141776674,141781691,chr7,TAS2R4,chr7:141776674-141781691,5017
58513530,58538911,chr19,ZBTB45,chr19:58513530-58538911,25381
44999475,45076469,chr7,CCM2,chr7:44999475-45076469,76994
48915267,48916530,chr2,CTBP2P5,chr2:48915267-48916530,1263
44631573,44725217,chr19,CEACAM16-AS1,chr19:44631573-44725217,93644
9780822,9781240,chr1,MZT1P1,chr1:9780822-9781240,418
36354749,36355114,chr2,CRIM1-DT,chr2:36354749-36355114,365
94861362,94862667,chr2,SOWAHCP5,chr2:94861362-94862667,1305
60734895,60735715,chr2,ATP1B3P1,chr2:60734895-60735715,820
133348218,133351426,chr9,RPL7A,chr9:133348218-133351426,3208
43967862,43998326,chr19,ZNF155,chr19:43967862-43998326,30464
41819747,41820754,chr2,LDHAP3,chr2:41819747-41820754,1007
6244179,6245578,chr1,HES3,chr1:6244179-6245578,1399
79481124,79556077,chr13,NDFIP2,chr13:79481124-79556077,74953
30146941,30160533,chr2,YPEL5,chr2:30146941-30160533,13592
50418501,50561126,chr14,MAP4K5,chr14:50418501-50561126,142625
1850904,1892267,chr11,LSP1,chr11:1850904-1892267,41363
103016744,103017589,chr8,NPM1P52,chr8:103016744-103017589,845
3735511,3747373,chr1,TP73-AS1,chr1:3735511-3747373,11862
43599563,43618800,chr15,STRC,chr15:43599563-43618800,19237
7715443,7718453,chr8,FAM90A14P,chr8:7715443-7718453,3010
50354750,50359521,chr3,TMEM115,chr3:50354750-50359521,4771
85762909,85766931,chr8,REXO1L9P,chr8:85762909-85766931,4022
57392546,57392882,chr8,RPL30P10,chr8:57392546-57392882,336
118923557,118951885,chr8,TNFRSF11B,chr8:118923557-118951885,28328
54626215,54626646,chr3,RPS15P5,chr3:54626215-54626646,431
50191610,50197696,chr3,GNAT1,chr3:50191610-50197696,6086
38899700,38908893,chr19,NFKBIB,chr19:38899700-38908893,9193
133349396,133349470,chr9,SNORD24,chr9:133349396-133349470,74
133350095,133350168,chr9,SNORD36B,chr9:133350095-133350168,73
133350456,133350528,chr9,SNORD36A,chr9:133350456-133350528,72
91775944,91781169,chr2,GGT8P,chr2:91775944-91781169,5225
133350847,133350912,chr9,SNORD36C,chr9:133350847-133350912,65
43054029,43059438,chr6,MRPL2,chr6:43054029-43059438,5409
133351758,133356676,chr9,SURF1,chr9:133351758-133356676,4918
94895767,95116455,chr8,NDUFAF6,chr8:94895767-95116455,220688
63232453,63233577,chr2,MTFR2P1,chr2:63232453-63233577,1124
52370602,52390056,chr2,LINC01867,chr2:52370602-52390056,19454
29526251,29642809,chr3,RBMS3-AS2,chr3:29526251-29642809,116558
79069767,79090069,chr5,BHMT2,chr5:79069767-79090069,20302
64453969,64461381,chr2,LGALSL,chr2:64453969-64461381,7412
55947832,55988629,chr19,NLRP8,chr19:55947832-55988629,40797
87057784,87070105,chr16,LINC02181,chr16:87057784-87070105,12321
44975241,45036066,chr3,EXOSC7,chr3:44975241-45036066,60825
9035106,9088478,chr1,SLC2A5,chr1:9035106-9088478,53372
67518418,67546788,chr16,RIPOR1,chr16:67518418-67546788,28370
101964573,102056443,chr14,DYNC1H1,chr14:101964573-102056443,91870
34533427,34534084,chr19,RPS26P55,chr19:34533427-34534084,657
133356550,133361158,chr9,SURF2,chr9:133356550-133361158,4608
43074331,43074739,chr6,KLC4-AS1,chr6:43074331-43074739,408
94734655,94735844,chr2,GXYLT1P7,chr2:94734655-94735844,1189
43827321,43852017,chr19,ZNF283,chr19:43827321-43852017,24696
20777329,20903048,chr13,XPO4,chr13:20777329-20903048,125719
95297327,95386077,chr2,KCNIP3,chr2:95297327-95386077,88750
136191468,136193162,chr5,SMIM32,chr5:136191468-136193162,1694
43076307,43161719,chr6,PTK7,chr6:43076307-43161719,85412
83940554,84384880,chr5,EDIL3,chr5:83940554-84384880,444326
151428832,151440813,chr7,CRYGN,chr7:151428832-151440813,11981
22040972,22276526,chr13,LINC00540,chr13:22040972-22276526,235554
133361450,133376166,chr9,SURF4,chr9:133361450-133376166,14716
48255675,48258199,chr19,CARD8-AS1,chr19:48255675-48258199,2524
65373799,65401136,chr7,ZNF92,chr7:65373799-65401136,27337
41549518,41586844,chr19,CEACAM21,chr19:41549518-41586844,37326
50299890,50312381,chr3,HYAL1,chr3:50299890-50312381,12491
126600925,126627252,chr5,PHAX,chr5:126600925-126627252,26327
40079106,40535807,chr13,LINC00598,chr13:40079106-40535807,456701
47204921,47205865,chrX,INE1,chrX:47204921-47205865,944
151375909,151410727,chr7,WDR86,chr7:151375909-151410727,34818
47142071,47145466,chrX,NDUFB11,chrX:47142071-47145466,3395
95516560,95551476,chr12,USP44,chr12:95516560-95551476,34916
53109816,53127673,chr5,MOCS2-DT,chr5:53109816-53127673,17857
107123427,107206433,chrX,NUP62CL,chrX:107123427-107206433,83006
1378666,1379032,chr1,NDUFB4P8,chr1:1378666-1379032,366
4973381,4981568,chr1,LINC02781,chr1:4973381-4981568,8187
43192071,43280850,chr5,NIM1K,chr5:43192071-43280850,88779
112288623,112288952,chr7,RN7SKP187,chr7:112288623-112288952,329
100895771,100896118,chr8,RPS26P6,chr8:100895771-100896118,347
87565828,87566764,chr2,PAFAH1B1P1,chr2:87565828-87566764,936
112372647,112373729,chr7,MTND5P8,chr7:112372647-112373729,1082
112373733,112374250,chr7,MTND6P24,chr7:112373733-112374250,517
101509530,101510222,chr2,RPS6P3,chr2:101509530-101510222,692
112374324,112375429,chr7,MTCYBP24,chr7:112374324-112375429,1105
95206876,95216525,chr8,LINC01298,chr8:95206876-95216525,9649
44643798,44666162,chr19,PVR,chr19:44643798-44666162,22364
107131659,107132269,chrX,GTF3C6P2,chrX:107131659-107132269,610
68365282,68397453,chr2,PLEK,chr2:68365282-68397453,32171
107272582,107273656,chrX,MYCLP1,chrX:107272582-107273656,1074
107351650,107352843,chrX,DNAJA1P3,chrX:107351650-107352843,1193
112422887,112481017,chr7,IFRD1,chr7:112422887-112481017,58130
14089107,14089871,chr3,VN1R21P,chr3:14089107-14089871,764
107206611,107244247,chrX,DNAAF6,chrX:107206611-107244247,37636
117038923,117099479,chr12,TESC,chr12:117038923-117099479,60556
80288449,80289781,chr5,KRT18P45,chr5:80288449-80289781,1332
97504663,97690180,chr5,LINC01340,chr5:97504663-97690180,185517
50347330,50350826,chr3,NPRL2,chr3:50347330-50350826,3496
33014081,33015026,chr8,MTND1P6,chr8:33014081-33015026,945
97858049,97858947,chr8,SUMO2P18,chr8:97858049-97858947,898
43602543,43602648,chr15,RNU6-554P,chr15:43602543-43602648,105
89581209,89677701,chr5,LINC02161,chr5:89581209-89677701,96492
55530156,55530701,chr5,RNF138P1,chr5:55530156-55530701,545
43637632,43637738,chr15,RNU6-610P,chr15:43637632-43637738,106
76258034,76258897,chr2,PNPP1,chr2:76258034-76258897,863
11425257,11425821,chr1,MTCYBP45,chr1:11425257-11425821,564
100046450,100046970,chr5,MTND6P22,chr5:100046450-100046970,520
43649123,43649280,chr15,PDIA3P2,chr15:43649123-43649280,157
86720291,86778041,chr2,RMND5A,chr2:86720291-86778041,57750
74231401,74259976,chr13,LINC00402,chr13:74231401-74259976,28575
60937705,60939871,chr8,NASPP1,chr8:60937705-60939871,2166
39284140,39424868,chr5,C9,chr5:39284140-39424868,140728
69942948,69944648,chr8,SDCBPP2,chr8:69942948-69944648,1700
106568258,106716679,chr13,LINC00551,chr13:106568258-106716679,148421
97272692,97276209,chr12,LINC02409,chr12:97272692-97276209,3517
43692886,43699222,chr15,CKMT1A,chr15:43692886-43699222,6336
89752913,89753831,chr12,MRPL2P1,chr12:89752913-89753831,918
133376366,133406096,chr9,STKLD1,chr9:133376366-133406096,29730
113816738,113966325,chr12,RBM19,chr12:113816738-113966325,149587
77910690,78050395,chrX,ATP7A,chrX:77910690-78050395,139705
30384511,30572256,chr8,RBPMS,chr8:30384511-30572256,187745
48262900,48271283,chr19,ZNF114-AS1,chr19:48262900-48271283,8383
104488458,104510509,chr2,LINC01103,chr2:104488458-104510509,22051
41599735,41605984,chr19,CEACAMP3,chr19:41599735-41605984,6249
30418339,30422251,chr13,LINC01058,chr13:30418339-30422251,3912
133406059,133418096,chr9,REXO4,chr9:133406059-133418096,12037
47192405,47345074,chr2,EPCAM-DT,chr2:47192405-47345074,152669
8861000,8879190,chr1,ENO1,chr1:8861000-8879190,18190
43872365,43901385,chr19,ZNF404,chr19:43872365-43901385,29020
62552463,62553434,chr2,PSAT1P2,chr2:62552463-62553434,971
41605341,41605671,chr19,DNAJC19P2,chr19:41605341-41605671,330
54529343,54529801,chr2,RPL23AP32,chr2:54529343-54529801,458
1888078,1891895,chr11,PRR33,chr11:1888078-1891895,3817
48270081,48287608,chr19,ZNF114,chr19:48270081-48287608,17527
94871430,94876823,chr2,TEKT4,chr2:94871430-94876823,5393
71929018,71997597,chr11,RNF121,chr11:71929018-71997597,68579
97160867,97183247,chr5,RIOK2,chr5:97160867-97183247,22380
43996896,44003298,chr19,ZNF230-DT,chr19:43996896-44003298,6402
56077417,56090382,chr2,LINC01813,chr2:56077417-56090382,12965
102619553,102711355,chr2,SLC9A2,chr2:102619553-102711355,91802
43702363,43702470,chr15,RNU6-353P,chr15:43702363-43702470,107
134928030,134928326,chr5,MTND4LP30,chr5:134928030-134928326,296
41638569,41638899,chr19,DNAJC19P3,chr19:41638569-41638899,330
43734179,43734285,chr15,RNU6-354P,chr15:43734179-43734285,106
40778242,40808418,chr19,RAB4B-EGLN2,chr19:40778242-40808418,30176
43772605,43777315,chr15,ELL3,chr15:43772605-43777315,4710
30340267,30377145,chr13,LINC00426,chr13:30340267-30377145,36878
56909260,56925532,chr5,SETD9,chr5:56909260-56925532,16272
133414358,133459402,chr9,ADAMTS13,chr9:133414358-133459402,45044
23126569,23127792,chr19,SNX6P1,chr19:23126569-23127792,1223
40699066,40699338,chr3,HMGN2P24,chr3:40699066-40699338,272
38935297,38938632,chr19,ERVK9-11,chr19:38935297-38938632,3335
37381062,37440186,chr3,C3orf35,chr3:37381062-37440186,59124
33906352,33908391,chr19,SUNO1,chr19:33906352-33908391,2039
29923644,30016612,chr19,URI1,chr19:29923644-30016612,92968
112480853,112491062,chr7,LSMEM1,chr7:112480853-112491062,10209
101002229,101024032,chr2,RPL31,chr2:101002229-101024032,21803
58492096,58502360,chr3,KCTD6,chr3:58492096-58502360,10264
71998613,72005715,chr11,IL18BP,chr11:71998613-72005715,7102
69167135,69178245,chr5,CCNB1,chr5:69167135-69178245,11110
112520488,112521670,chr7,NPM1P14,chr7:112520488-112521670,1182
150991017,151014588,chr7,NOS3,chr7:150991017-151014588,23571
22904135,22905151,chr3,RANP7,chr3:22904135-22905151,1016
19947097,19985175,chr3,RAB5A,chr3:19947097-19985175,38078
87830023,87869507,chr16,SLC7A5,chr16:87830023-87869507,39484
43793659,43793759,chr15,MIR1282,chr15:43793659-43793759,100
43804492,43824690,chr15,MFAP1,chr15:43804492-43824690,20198
44002957,44013924,chr19,ZNF230,chr19:44002957-44013924,10967
29935771,29950488,chr13,LINC00544,chr13:29935771-29950488,14717
22046218,22065674,chr12,CMAS,chr12:22046218-22065674,19456
65611366,65660995,chr15,SLC24A1,chr15:65611366-65660995,49629
41673303,41706976,chr19,CEACAM7,chr19:41673303-41706976,33673
37789921,37790445,chr3,NDUFAF4P3,chr3:37789921-37790445,524
21302862,21348721,chr13,LINC00539,chr13:21302862-21348721,45859
37241789,37244177,chr3,GOLGA4-AS1,chr3:37241789-37244177,2388
69608564,69610907,chr12,LRRC10,chr12:69608564-69610907,2343
39183210,39192596,chr3,XIRP1,chr3:39183210-39192596,9386
34296277,34296592,chr19,RPL29P33,chr19:34296277-34296592,315
87696485,87765992,chr16,KLHDC4,chr16:87696485-87765992,69507
44023118,44025262,chr19,ZNF222-DT,chr19:44023118-44025262,2144
24049701,24063681,chr2,FKBP1B,chr2:24049701-24063681,13980
48597458,48621018,chr8,LINC02847,chr8:48597458-48621018,23560
43912624,43935282,chr19,ZNF45,chr19:43912624-43935282,22658
56373064,56395365,chr8,SDR16C6P,chr8:56373064-56395365,22301
32996609,33097202,chr3,GLB1,chr3:32996609-33097202,100593
34784028,34865364,chr8,LINC01288,chr8:34784028-34865364,81336
121237675,121298308,chr12,CAMKK2,chr12:121237675-121298308,60633
48917598,48921740,chr8,SNAI2,chr8:48917598-48921740,4142
109051315,109052457,chr5,GJA1P1,chr5:109051315-109052457,1142
25172819,25180079,chr13,LINC00463,chr13:25172819-25180079,7260
17634460,17635053,chr5,TAF11L14,chr5:17634460-17635053,593
72047873,72047951,chr11,RNU6-72P,chr11:72047873-72047951,78
72072228,72072302,chr11,MIR3165,chr11:72072228-72072302,74
43607224,43619629,chr19,ZNF428,chr19:43607224-43619629,12405
72085895,72103297,chr11,LAMTOR1,chr11:72085895-72103297,17402
23058564,23095614,chr14,ACIN1,chr14:23058564-23095614,37050
102503753,102504137,chr8,RPS12P15,chr8:102503753-102504137,384
66493520,66518524,chr8,VXN,chr8:66493520-66518524,25004
3595832,3601403,chr5,IRX1,chr5:3595832-3601403,5571
97756333,97995948,chr2,TMEM131,chr2:97756333-97995948,239615
44025342,44033110,chr19,ZNF222,chr19:44025342-44033110,7768
44400173,44405984,chr13,TUSC8,chr13:44400173-44405984,5811
120464300,120687332,chr5,PRR16,chr5:120464300-120687332,223032
32978592,33064888,chr19,RHPN2,chr19:32978592-33064888,86296
70751184,70795914,chr5,GUSBP16,chr5:70751184-70795914,44730
72105924,72109329,chr11,TOMT,chr11:72105924-72109329,3405
72131282,72131907,chr11,RPEP6,chr11:72131282-72131907,625
72158822,72159734,chr11,FOLR1P1,chr11:72158822-72159734,912
31908361,31909186,chr5,TPT1P5,chr5:31908361-31909186,825
135922279,135954983,chr5,LECT2,chr5:135922279-135954983,32704
72239077,72245664,chr11,PHOX2A,chr11:72239077-72245664,6587
152114599,152117939,chrX,MAGEA5P,chrX:152114599-152117939,3340
18535079,18536120,chrX,GJA6P,chrX:18535079-18536120,1041
18639688,18672108,chrX,RS1,chrX:18639688-18672108,32420
120445400,120542133,chr8,MTBP,chr8:120445400-120542133,96733
18688643,18691604,chrX,PPEF1-AS1,chrX:18688643-18691604,2961
18838709,18839452,chrX,BLOC1S6P1,chrX:18838709-18839452,743
18865771,18866554,chrX,HAUS1P2,chrX:18865771-18866554,783
18890296,18894974,chrX,PHKA2-AS1,chrX:18890296-18894974,4678
2771356,2771577,chr11,COX6CP18,chr11:2771356-2771577,221
15684320,15734769,chr1,PLEKHM2,chr1:15684320-15734769,50449
2840135,2861568,chr11,KCNQ1-AS1,chr11:2840135-2861568,21433
18892298,18984114,chrX,PHKA2,chrX:18892298-18984114,91816
2870033,2872105,chr11,KCNQ1DN,chr11:2870033-2872105,2072
151048292,151052756,chr7,ASIC3,chr7:151048292-151052756,4464
78360611,78480739,chr5,SCAMP1,chr5:78360611-78480739,120128
2887344,2903575,chr11,SLC22A18AS,chr11:2887344-2903575,16231
40798996,40808434,chr19,EGLN2,chr19:40798996-40808434,9438
102880040,102896033,chr13,METTL21EP,chr13:102880040-102896033,15993
105337532,105349211,chr2,C2orf49,chr2:105337532-105349211,11679
65658046,65792293,chr15,DENND4A,chr15:65658046-65792293,134247
2899721,2925246,chr11,SLC22A18,chr11:2899721-2925246,25525
43171269,43181506,chr6,SRF,chr6:43171269-43181506,10237
65155407,65155778,chr8,RPL31P41,chr8:65155407-65155778,371
38050817,38350259,chr13,LINC00571,chr13:38050817-38350259,299442
60678740,60868028,chr8,CHD7,chr8:60678740-60868028,189288
60936819,60938049,chr2,NONOP2,chr2:60936819-60938049,1230
28460256,28460361,chr2,SNRPGP7,chr2:28460256-28460361,105
43354859,43691594,chr3,ANO10,chr3:43354859-43691594,336735
43182184,43224587,chr6,CUL9,chr6:43182184-43224587,42403
48296162,48303702,chr13,RB1-DT,chr13:48296162-48303702,7540
87972656,87973082,chr2,WBP1P2,chr2:87972656-87973082,426
18915243,18915535,chrX,RN7SL48P,chrX:18915243-18915535,292
24360639,24367839,chrX,SUPT20HL1,chrX:24360639-24367839,7200
77788382,77793087,chr2,RPL38P2,chr2:77788382-77793087,4705
101349447,101390796,chrX,BTK,chrX:101349447-101390796,41349
86861825,86912978,chr2,ANAPC1P1,chr2:86861825-86912978,51153
30863369,30883424,chr13,LINC00545,chr13:30863369-30883424,20055
87427214,87674235,chr13,MIR4500HG,chr13:87427214-87674235,247021
133459965,133470848,chr9,CACFD1,chr9:133459965-133470848,10883
43622368,43639850,chr19,CADM4,chr19:43622368-43639850,17482
97089075,97437217,chr5,LIX1-AS1,chr5:97089075-97437217,348142
101271219,101308701,chr2,RNF149,chr2:101271219-101308701,37482
72439903,72507410,chr5,ZNF366,chr5:72439903-72507410,67507
88512960,88531053,chr16,ZFPM1-AS1,chr16:88512960-88531053,18093
94641074,94707466,chr8,ESRP1,chr8:94641074-94707466,66392
2928273,2929420,chr11,PHLDA2,chr11:2928273-2929420,1147
35399511,35419385,chr19,LINC01531,chr19:35399511-35419385,19874
89737549,89816657,chr16,FANCA,chr16:89737549-89816657,79108
115602057,115623897,chr5,TICAM2-AS1,chr5:115602057-115623897,21840
151053815,151057897,chr7,CDK5,chr7:151053815-151057897,4082
2944431,2992377,chr11,NAP1L4,chr11:2944431-2992377,47946
133471094,133479127,chr9,SLC2A6,chr9:133471094-133479127,8033
31193686,31329146,chr5,CDH6,chr5:31193686-31329146,135460
1232237,1235041,chr1,B3GALT6,chr1:1232237-1235041,2804
37907208,38208369,chr19,SIPA1L3,chr19:37907208-38208369,301161
12567910,12618210,chr1,DHRS3,chr1:12567910-12618210,50300
49956670,50125720,chr13,DLEU2,chr13:49956670-50125720,169050
111952144,111952671,chr2,SLC30A6P1,chr2:111952144-111952671,527
77915870,77918011,chr2,LINC01851,chr2:77915870-77918011,2141
36656322,36656941,chr2,RACK1P2,chr2:36656322-36656941,619
79372636,79514134,chr5,HOMER1,chr5:79372636-79514134,141498
75652000,75710985,chr2,GCFC2,chr2:75652000-75710985,58985
65696833,65696936,chr15,SNORD13E,chr15:65696833-65696936,103
65719246,65719332,chr15,MIR4511,chr15:65719246-65719332,86
8945867,8975092,chr1,CA6,chr1:8945867-8975092,29225
65726054,65891989,chr15,RAB11A,chr15:65726054-65891989,165935
96887373,97013708,chr9,MFSD14C,chr9:96887373-97013708,126335
151081085,151083493,chr7,TMUB1,chr7:151081085-151083493,2408
43225629,43229481,chr6,DNPH1,chr6:43225629-43229481,3852
101393273,101408012,chrX,GLA,chrX:101393273-101408012,14739
40808474,40812100,chr19,CYP2T1P,chr19:40808474-40812100,3626
41750977,41772211,chr19,CEACAM6,chr19:41750977-41772211,21234
97067749,97068628,chr9,TCEA1P1,chr9:97067749-97068628,879
97075671,97081945,chr9,GAS2L1P2,chr9:97075671-97081945,6274
151085831,151144436,chr7,AGAP3,chr7:151085831-151144436,58605
43243481,43288258,chr6,TTBK1,chr6:43243481-43288258,44777
97093694,97094638,chr9,VN1R51P,chr9:97093694-97094638,944
97121659,97122489,chr9,FAM220CP,chr9:97121659-97122489,830
65816302,65817481,chr15,HNRNPA1P44,chr15:65816302-65817481,1179
97156570,97221235,chr9,ANKRD18CP,chr9:97156570-97221235,64665
45128569,45129030,chr19,EIF5AP3,chr19:45128569-45129030,461
97192923,97193025,chr9,RNU6-798P,chr9:97192923-97193025,102
88602780,88603117,chr5,H3P23,chr5:88602780-88603117,337
97198303,97199511,chr9,ZNF322P1,chr9:97198303-97199511,1208
32345594,32387667,chr19,ZNF507,chr19:32345594-32387667,42073
32284152,32284258,chr15,RNU6-18P,chr15:32284152-32284258,106
52812962,52830688,chr3,ITIH4,chr3:52812962-52830688,17726
16369150,16369530,chr1,RPL22P3,chr1:16369150-16369530,380
97238645,97246184,chr9,SUGT1P4,chr9:97238645-97246184,7539
133196455,133612541,chr5,FSTL4,chr5:133196455-133612541,416086
13474973,13514003,chr1,LRRC38,chr1:13474973-13514003,39030
32384937,32387484,chr15,DNM1P31,chr15:32384937-32387484,2547
97029677,97156556,chr9,CTSV,chr9:97029677-97156556,126879
32394365,32394613,chr15,RN7SL185P,chr15:32394365-32394613,248
72614386,72622073,chr6,KCNQ5-DT,chr6:72614386-72622073,7687
9943428,9985501,chr1,NMNAT1,chr1:9943428-9985501,42073
72967687,72967753,chr6,MIR4282,chr6:72967687-72967753,66
72986313,72987750,chr6,KNOP1P4,chr6:72986313-72987750,1437
73055097,73055857,chr6,PGAM1P10,chr6:73055097-73055857,760
73130646,73143514,chr6,KCNQ5-AS1,chr6:73130646-73143514,12868
32406597,32434992,chr15,ULK4P1,chr15:32406597-32434992,28395
73157517,73158139,chr6,RBPMS2P1,chr6:73157517-73158139,622
73209083,73210080,chr6,KHDC1P1,chr6:73209083-73210080,997
73223544,73225770,chr6,KHDC1L,chr6:73223544-73225770,2226
32436503,32439767,chr15,DNM1P32,chr15:32436503-32439767,3264
48695554,48709016,chrX,SUV39H1,chrX:48695554-48709016,13462
48576974,48590587,chr13,LINC00462,chr13:48576974-48590587,13613
32441914,32455634,chr15,GOLGA8O,chr15:32441914-32455634,13720
73263212,73301789,chr6,KHDC1-AS1,chr6:73263212-73301789,38577
633696,634376,chr1,MTATP6P1,chr1:633696-634376,680
7382487,7389754,chr1,CAMTA1-AS2,chr1:7382487-7389754,7267
44110451,44240517,chr13,SMIM2-AS1,chr13:44110451-44240517,130066
73290403,73291262,chr6,RPSAP41,chr6:73290403-73291262,859
73291962,73293277,chr6,EIF3EP1,chr6:73291962-73293277,1315
15191828,15192845,chr1,MFFP1,chr1:15191828-15192845,1017
73322837,73323450,chr6,SDCBP2P1,chr6:73322837-73323450,613
73327524,73329017,chr6,PAICSP3,chr6:73327524-73329017,1493
13222705,13226106,chr1,PRAMEF18,chr1:13222705-13226106,3401
73353063,73354276,chr6,DPPA5,chr6:73353063-73354276,1213
73362658,73364171,chr6,KHDC3L,chr6:73362658-73364171,1513
117730515,118266267,chr5,LINC02147,chr5:117730515-118266267,535752
10058671,10059648,chr1,PGAM1P11,chr1:10058671-10059648,977
48724455,48724561,chrX,RNU6-1056P,chrX:48724455-48724561,106
48761747,48773648,chrX,GLOD5,chrX:48761747-48773648,11901
73369704,73387717,chr6,OOEP-AS1,chr6:73369704-73387717,18013
3746460,3771645,chr1,CCDC27,chr1:3746460-3771645,25185
38282264,38290986,chr5,EGFLAM-AS4,chr5:38282264-38290986,8722
73373108,73373263,chr6,RPL39P3,chr6:73373108-73373263,155
73391038,73391767,chr6,RPS6P8,chr6:73391038-73391767,729
43646095,43670547,chr19,PLAUR,chr19:43646095-43670547,24452
73394828,73417566,chr6,DDX43,chr6:73394828-73417566,22738
79936579,79967626,chr5,LINC01455,chr5:79936579-79967626,31047
48776965,48777071,chrX,RNU6-29P,chrX:48776965-48777071,106
48786562,48794311,chrX,GATA1,chrX:48786562-48794311,7749
64909488,64909780,chr14,RPPH1-2P,chr14:64909488-64909780,292
64914485,65061803,chr14,CHURC1-FNTB,chr14:64914485-65061803,147318
79991311,80083287,chr5,THBS4,chr5:79991311-80083287,91976
21298133,21306373,chr13,MIPEPP3,chr13:21298133-21306373,8240
32446674,32446964,chr15,RN7SL539P,chr15:32446674-32446964,290
100053074,100088967,chr13,PCCA-DT,chr13:100053074-100088967,35893
6101787,6180321,chr1,CHD5,chr1:6101787-6180321,78534
110863987,110870330,chr13,PRECSIT,chr13:110863987-110870330,6343
48801377,48824982,chrX,HDAC6,chrX:48801377-48824982,23605
10721100,10785110,chr2,ATP6V1C2,chr2:10721100-10785110,64010
61630233,61681049,chr6,KHDRBS2-OT1,chr6:61630233-61681049,50816
77894684,77904674,chr15,CSPG4P13,chr15:77894684-77904674,9990
61679961,62286225,chr6,KHDRBS2,chr6:61679961-62286225,606264
22859050,22916369,chr13,LINC00621,chr13:22859050-22916369,57319
70219918,70258930,chr5,GUSBP14,chr5:70219918-70258930,39012
64945814,64973226,chr14,RAB15,chr14:64945814-64973226,27412
42101119,42142620,chr6,C6orf132,chr6:42101119-42142620,41501
111093263,111236203,chr8,LINC01609,chr8:111093263-111236203,142940
35991336,35992285,chr9,OR13C6P,chr9:35991336-35992285,949
36002909,36003867,chr9,OR13C7,chr9:36002909-36003867,958
36021692,36022113,chr9,OR2AM1P,chr9:36021692-36022113,421
36036913,36124455,chr9,RECK,chr9:36036913-36124455,87542
42183284,42194956,chr6,GUCA1B,chr6:42183284-42194956,11672
2963771,2963893,chr11,SNORA54,chr11:2963771-2963893,122
43602692,43707405,chr5,NNT,chr5:43602692-43707405,104713
9606142,9606609,chr11,RPL23AP65,chr11:9606142-9606609,467
95648711,95676973,chr13,DNAJC3-DT,chr13:95648711-95676973,28262
42206807,42217861,chr6,MRPS10,chr6:42206807-42217861,11054
103398635,103415189,chr8,SLC25A32,chr8:103398635-103415189,16554
9664077,9752993,chr11,SWAP70,chr11:9664077-9752993,88916
106360717,106572017,chr6,CRYBG1,chr6:106360717-106572017,211300
77916718,77916982,chr15,RN7SL214P,chr15:77916718-77916982,264
77941442,77944582,chr15,COMMD4P1,chr15:77941442-77944582,3140
77976042,77993057,chr15,ADAMTS7P3,chr15:77976042-77993057,17015
110105076,110105964,chr8,RPSAP48,chr8:110105076-110105964,888
66574030,66731223,chr2,LINC01798,chr2:66574030-66731223,157193
40818414,40826772,chr19,CYP2F2P,chr19:40818414-40826772,8358
66419589,66428977,chr8,RRS1-DT,chr8:66419589-66428977,9388
78104606,78131535,chr15,CIB2,chr15:78104606-78131535,26929
34788527,34832869,chr19,LINC01801,chr19:34788527-34832869,44342
20174244,21145967,chr3,SGO1-AS1,chr3:20174244-21145967,971723
103623630,103623830,chr2,CAPZBP1,chr2:103623630-103623830,200
96239398,96261610,chr8,MTERF3,chr8:96239398-96261610,22212
36299388,36299830,chr2,RPL21P36,chr2:36299388-36299830,442
55785397,55836800,chr19,NLRP11,chr19:55785397-55836800,51403
64986895,65062652,chr14,FNTB,chr14:64986895-65062652,75757
106449381,106449497,chr6,RNA5SP211,chr6:106449381-106449497,116
10759350,10764209,chr3,LINC00606,chr3:10759350-10764209,4859
99181223,99200757,chr13,UBAC2-AS1,chr13:99181223-99200757,19534
19468997,19520095,chr2,LINC01808,chr2:19468997-19520095,51098
36190856,36304781,chr9,CLTA,chr9:36190856-36304781,113925
106570771,106629498,chr6,RTN4IP1,chr6:106570771-106629498,58727
9680924,9681238,chr11,RN7SKP50,chr11:9680924-9681238,314
9754770,9759533,chr11,LINC02709,chr11:9754770-9759533,4763
13549125,13638422,chr3,FBLN2,chr3:13549125-13638422,89297
9758268,9811335,chr11,SBF2-AS1,chr11:9758268-9811335,53067
66904436,66971462,chr2,LINC01799,chr2:66904436-66971462,67026
151175698,151187832,chr7,ASB10,chr7:151175698-151187832,12134
106607716,106607819,chr6,RNU6-527P,chr6:106607716-106607819,103
106629578,106668417,chr6,QRSL1,chr6:106629578-106668417,38839
68445710,68449174,chr2,WDR4P2,chr2:68445710-68449174,3464
9843815,9843876,chr11,RNU7-28P,chr11:9843815-9843876,61
44094822,44147765,chr13,LINC00390,chr13:44094822-44147765,52943
84516455,84819589,chr2,DNAH6,chr2:84516455-84819589,303134
106642463,106642928,chr6,RPL21P65,chr6:106642463-106642928,465
106695535,106699994,chr6,LINC02526,chr6:106695535-106699994,4459
10302657,10303704,chr11,ADM-DT,chr11:10302657-10303704,1047
106738948,106739054,chr6,RNU6-117P,chr6:106738948-106739054,106
106784125,106784220,chr6,MIR587,chr6:106784125-106784220,95
110848546,110848673,chr6,SNORA40C,chr6:110848546-110848673,127
110856417,110856522,chr6,RNU6-1115P,chr6:110856417-110856522,105
110858239,110859147,chr6,CNN2P9,chr6:110858239-110859147,908
10305073,10307397,chr11,ADM,chr11:10305073-10307397,2324
151190873,151205496,chr7,IQCA1L,chr7:151190873-151205496,14623
110874770,110898879,chr6,AMD1,chr6:110874770-110898879,24109
7771296,7781432,chr1,VAMP3,chr1:7771296-7781432,10136
88638572,88640468,chr16,IL17C,chr16:88638572-88640468,1896
151211484,151227205,chr7,ABCF2,chr7:151211484-151227205,15721
65006174,65102695,chr14,MAX,chr14:65006174-65102695,96521
78131498,78171945,chr15,IDH3A,chr15:78131498-78171945,40447
122078756,122147344,chr12,MLXIP,chr12:122078756-122147344,68588
89720400,89740925,chr16,ZNF276,chr16:89720400-89740925,20525
95244913,95269201,chr8,CFAP418,chr8:95244913-95269201,24288
46052497,46161379,chr13,CPB2-AS1,chr13:46052497-46161379,108882
15834474,15848147,chr1,FLJ37453,chr1:15834474-15848147,13673
39597832,39598002,chr19,RPS29P26,chr19:39597832-39598002,170
12926162,12928253,chr1,PRAMEF29P,chr1:12926162-12928253,2091
27805423,27806205,chr19,SLC25A1P5,chr19:27805423-27806205,782
58503588,58504068,chr8,PPIAP85,chr8:58503588-58504068,480
35608285,35612666,chr19,HAUS5-DT,chr19:35608285-35612666,4381
11479155,11537551,chr1,DISP3,chr1:11479155-11537551,58396
119833976,119855894,chr8,DSCC1,chr8:119833976-119855894,21918
41796587,41811554,chr19,CEACAM3,chr19:41796587-41811554,14967
36214441,36277042,chr9,GNE,chr9:36214441-36277042,62601
85775106,85779090,chr8,REXO1L2P,chr8:85775106-85779090,3984
10399192,10399317,chr11,RNU6ATAC33P,chr11:10399192-10399317,125
120380761,120445402,chr8,MRPL13,chr8:120380761-120445402,64641
10507894,10509186,chr11,MTRNR2L8,chr11:10507894-10509186,1292
10508270,10508326,chr11,MIR4485,chr11:10508270-10508326,56
10511673,10541230,chr11,RNF141,chr11:10511673-10541230,29557
45691704,45691776,chr11,MIR7154,chr11:45691704-45691776,72
35632659,35697459,chr7,HERPUD2,chr7:35632659-35697459,64800
32405543,32485895,chr19,DPY19L3,chr19:32405543-32485895,80352
52777595,52792068,chr3,ITIH1,chr3:52777595-52792068,14473
110958706,110967890,chr6,GTF3C6,chr6:110958706-110967890,9184
103085651,103086590,chr8,MTND1P5,chr8:103085651-103086590,939
20032650,20051628,chr2,LAPTM4A,chr2:20032650-20051628,18978
110982015,111028263,chr6,RPF2,chr6:110982015-111028263,46248
119416446,119424434,chr8,CCN3,chr8:119416446-119424434,7988
9728926,9823984,chr1,CLSTN1,chr1:9728926-9823984,95058
87326987,87392142,chr16,FBXO31,chr16:87326987-87392142,65155
35695214,35699413,chr7,HERPUD2-AS1,chr7:35695214-35699413,4199
95943331,95968720,chr12,AMDHD1,chr12:95943331-95968720,25389
107983116,107983965,chr8,NRBF2P4,chr8:107983116-107983965,849
111046868,111047521,chr6,GSTM2P1,chr6:111046868-111047521,653
154825176,154825279,chr6,RNU6-824P,chr6:154825176-154825279,103
154853360,154853436,chr6,MIR1273C,chr6:154853360-154853436,76
45749454,45752279,chr11,LINC02690,chr11:45749454-45752279,2825
77696459,77783022,chr7,RSBN1L,chr7:77696459-77783022,86563
155256134,155314493,chr6,TFB1M,chr6:155256134-155314493,58359
45804072,45813016,chr11,SLC35C1,chr11:45804072-45813016,8944
109573978,109691791,chr8,SYBU,chr8:109573978-109691791,117813
102836889,102958410,chr12,PAH,chr12:102836889-102958410,121521
64846130,64863626,chr2,LINC01800,chr2:64846130-64863626,17496
155264013,155276548,chr6,CLDN20,chr6:155264013-155276548,12535
45847118,45883248,chr11,CRY2,chr11:45847118-45883248,36130
80540734,80550811,chr16,DYNLRB2,chr16:80540734-80550811,10077
94900990,94901602,chr2,MTCO3P45,chr2:94900990-94901602,612
155395368,155455839,chr6,NOX3,chr6:155395368-155455839,60471
97050729,97051028,chr2,IGKV2OR2-2,chr2:97050729-97051028,299
111675026,111675343,chr2,RPL34P8,chr2:111675026-111675343,317
36303499,36304924,chr9,HMGB3P24,chr9:36303499-36304924,1425
109552536,109552846,chr2,RPL37P12,chr2:109552536-109552846,310
125146573,125189939,chr9,PPP6C,chr9:125146573-125189939,43366
30864250,30864552,chr6,RN7SKP186,chr6:30864250-30864552,302
30866982,30875918,chr6,DDR1-DT,chr6:30866982-30875918,8936
94703454,94803430,chr13,SOX21-AS1,chr13:94703454-94803430,99976
30890883,30890972,chr6,MIR4640,chr6:30890883-30890972,89
66433452,66573869,chr2,MEIS1,chr2:66433452-66573869,140417
30908207,30914106,chr6,GTF2H4,chr6:30908207-30914106,5899
77793728,77798434,chr7,TMEM60,chr7:77793728-77798434,4706
65044688,65044769,chr14,MIR4706,chr14:65044688-65044769,81
125150653,125151589,chr9,PRPS1P2,chr9:125150653-125151589,936
77798792,77957503,chr7,PHTF2,chr7:77798792-77957503,158711
80154979,80563354,chr16,DYNLRB2-AS1,chr16:80154979-80563354,408375
112105357,112106882,chr13,LINC00404,chr13:112105357-112106882,1525
125194649,125195821,chr9,RPSAP76,chr9:125194649-125195821,1172
125200542,125234161,chr9,RABEPK,chr9:125200542-125234161,33619
55836540,55881855,chr19,NLRP4,chr19:55836540-55881855,45315
24924673,24968505,chr13,TPTE2P1,chr13:24924673-24968505,43832
22829879,22835037,chr14,MRPL52,chr14:22829879-22835037,5158
71063101,71063989,chr15,RPL5P3,chr15:71063101-71063989,888
71147650,71189064,chr15,THSD4-AS1,chr15:71147650-71189064,41414
62221249,62369406,chr3,PTPRG-AS1,chr3:62221249-62369406,148157
67562467,67639177,chr16,CTCF,chr16:67562467-67639177,76710
125234853,125241382,chr9,HSPA5,chr9:125234853-125241382,6529
71164770,71165415,chr15,HMGB1P6,chr15:71164770-71165415,645
84166547,84169896,chr15,DNM1P41,chr15:84166547-84169896,3349
84172493,84188379,chr15,UBE2Q2L,chr15:84172493-84188379,15886
2590639,2633016,chr1,MMEL1,chr1:2590639-2633016,42377
84186752,84197384,chr15,CSPG4P11,chr15:84186752-84197384,10632
45885651,45906465,chr11,MAPK8IP1,chr11:45885651-45906465,20814
84199311,84230136,chr15,GOLGA2P7,chr15:84199311-84230136,30825
58345178,58353492,chr19,A1BG,chr19:58345178-58353492,8314
104986316,105074197,chr12,NOPCHAP1,chr12:104986316-105074197,87881
125303920,125304026,chr9,RNU6-1020P,chr9:125303920-125304026,106
38165089,38255484,chr3,OXSR1,chr3:38165089-38255484,90395
32293558,32293692,chr9,RNA5SP281,chr9:32293558-32293692,134
32333457,32334354,chr9,SLC25A5P8,chr9:32333457-32334354,897
32384603,32454769,chr9,ACO1,chr9:32384603-32454769,70166
43716076,43720021,chr19,IRGC,chr19:43716076-43720021,3945
48417150,48417337,chr12,OR8S21P,chr12:48417150-48417337,187
93124063,93124543,chr12,NACAP8,chr12:93124063-93124543,480
44699151,44710718,chr19,CEACAM16,chr19:44699151-44710718,11567
118376555,118418033,chr12,SUDS3,chr12:118376555-118418033,41478
84205454,84205700,chr15,RN7SL331P,chr15:84205454-84205700,246
84255913,84256014,chr15,UBE2Q2P8,chr15:84255913-84256014,101
30931353,30955636,chr6,SFTA2,chr6:30931353-30955636,24283
45906513,45907272,chr11,C11orf94,chr11:45906513-45907272,759
41829692,41830938,chr19,HNRNPA1P52,chr19:41829692-41830938,1246
84394072,84394336,chr15,RN7SL417P,chr15:84394072-84394336,264
45909663,45918812,chr11,PEX16,chr11:45909663-45918812,9149
84398316,84411701,chr15,DNM1P51,chr15:84398316-84411701,13385
30934523,30954221,chr6,MUCL3,chr6:30934523-30954221,19698
88027205,88064252,chr2,KRCC1,chr2:88027205-88064252,37047
68787660,68796253,chr14,ZFP36L1,chr14:68787660-68796253,8593
84401807,84408005,chr15,CSPG4P5,chr15:84401807-84408005,6198
84412773,84421837,chr15,UBE2Q2P11,chr15:84412773-84421837,9064
43727983,43754962,chr19,SMG9,chr19:43727983-43754962,26979
52474073,52474411,chr2,GGCTP3,chr2:52474073-52474411,338
43826980,43868412,chr15,WDR76,chr15:43826980-43868412,41432
38814,46870,chr2,FAM110C,chr2:38814-46870,8056
30945979,30954862,chr6,HCG21,chr6:30945979-30954862,8883
30961403,30962396,chr6,NAPGP2,chr6:30961403-30962396,993
80716912,80719671,chr12,MYF5,chr12:80716912-80719671,2759
30983718,30989903,chr6,MUC21,chr6:30983718-30989903,6185
109737139,109737523,chr2,RPL22P11,chr2:109737139-109737523,384
66411704,66498677,chr14,CCDC196,chr14:66411704-66498677,86973
68459422,68467294,chr2,FBXO48,chr2:68459422-68467294,7872
31010474,31035402,chr6,MUC22,chr6:31010474-31035402,24928
76344474,76348415,chr12,BBS10,chr12:76344474-76348415,3941
85061213,85067347,chr2,LINC01964,chr2:85061213-85067347,6134
31083010,31083109,chr6,RNU6-1133P,chr6:31083010-31083109,99
31111223,31112575,chr6,C6orf15,chr6:31111223-31112575,1352
126400792,126405528,chr12,LINC02825,chr12:126400792-126405528,4736
101345550,101387503,chr2,CREG2,chr2:101345550-101387503,41953
31114750,31140092,chr6,PSORS1C1,chr6:31114750-31140092,25342
133125479,133125952,chr12,RPL23AP67,chr12:133125479-133125952,473
101520834,101521976,chr2,PRCPP1,chr2:101520834-101521976,1142
93677375,93894840,chr12,CRADD,chr12:93677375-93894840,217465
63050057,63057836,chr2,OTX1,chr2:63050057-63057836,7779
134114681,134151865,chr5,TCF7,chr5:134114681-134151865,37184
21405737,21406508,chr3,VENTXP7,chr3:21405737-21406508,771
31115087,31120446,chr6,CDSN,chr6:31115087-31120446,5359
54632122,54639857,chr3,ESRG,chr3:54632122-54639857,7735
45921621,45929096,chr11,LARGE2,chr11:45921621-45929096,7475
1280436,1292029,chr1,SCNN1D,chr1:1280436-1292029,11593
31137534,31139066,chr6,PSORS1C2,chr6:31137534-31139066,1532
44761721,44873376,chr3,KIF15,chr3:44761721-44873376,111655
31140727,31140913,chr6,POLR2LP1,chr6:31140727-31140913,186
31158547,31167159,chr6,TCF19,chr6:31158547-31167159,8612
43875849,43876244,chr15,PIN4P1,chr15:43875849-43876244,395
43699441,43718260,chr15,STRCP1,chr15:43699441-43718260,18819
77131270,77142734,chr14,ZDHHC22,chr14:77131270-77142734,11464
23927285,24004909,chr2,UBXN2A,chr2:23927285-24004909,77624
77173075,77173652,chr14,FAM204DP,chr14:77173075-77173652,577
40843541,40850447,chr19,CYP2A6,chr19:40843541-40850447,6906
77266218,77266290,chr14,MIR1260A,chr14:77266218-77266290,72
88186605,88195217,chr16,LINC02182,chr16:88186605-88195217,8612
63042632,63071915,chr15,TPM1,chr15:63042632-63071915,29283
77320996,77331597,chr14,GSTZ1,chr14:77320996-77331597,10601
88643289,88651054,chr16,CYBA,chr16:88643289-88651054,7765
31173735,31177899,chr6,PSORS1C3,chr6:31173735-31177899,4164
119334712,119541040,chr12,CCDC60,chr12:119334712-119541040,206328
85186409,85187253,chr2,TCF7L1-IT1,chr2:85186409-85187253,844
94899566,94900661,chr2,MTCO1P48,chr2:94899566-94900661,1095
30914205,30926459,chr6,VARS2,chr6:30914205-30926459,12254
58347718,58355455,chr19,A1BG-AS1,chr19:58347718-58355455,7737
46142716,46143594,chr11,FBLIM1P2,chr11:46142716-46143594,878
46213150,46220438,chr11,LINC02710,chr11:46213150-46220438,7288
105241743,105243467,chr2,GPR45,chr2:105241743-105243467,1724
46277662,46321409,chr11,CREB3L1,chr11:46277662-46321409,43747
48440043,48440597,chr2,PPP1R21-DT,chr2:48440043-48440597,554
91723023,91723605,chr2,NKAIN1P2,chr2:91723023-91723605,582
58561931,58573575,chr19,MZF1,chr19:58561931-58573575,11644
117099481,117142091,chr12,TESC-AS1,chr12:117099481-117142091,42610
54253178,54256229,chr2,TSPYL6,chr2:54253178-54256229,3051
94791103,94857282,chr2,ANKRD20A8P,chr2:94791103-94857282,66179
93377883,93408146,chr12,NUDT4,chr12:93377883-93408146,30263
32553001,32573184,chr9,NDUFB6,chr9:32553001-32573184,20183
87301658,87302251,chr2,DBF4P3,chr2:87301658-87302251,593
107382715,107748270,chr2,LINC01885,chr2:107382715-107748270,365555
64486353,64500904,chr2,LINC01805,chr2:64486353-64500904,14551
57542643,57591681,chr16,ADGRG5,chr16:57542643-57591681,49038
46332905,46380554,chr11,DGKZ,chr11:46332905-46380554,47649
77990384,77995171,chr7,DDX3ILA1,chr7:77990384-77995171,4787
32566148,32567126,chr9,DFFBP1,chr9:32566148-32567126,978
32629454,32635669,chr9,TAF1L,chr9:32629454-32635669,6215
29192774,29921586,chr2,ALK,chr2:29192774-29921586,728812
78347142,78359458,chr7,RPL13AP17,chr7:78347142-78359458,12316
32676063,32676520,chr9,SNRPCP1,chr9:32676063-32676520,457
32455302,32526208,chr9,DDX58,chr9:32455302-32526208,70906
78939850,78940895,chr7,MAGI2-AS1,chr7:78939850-78940895,1045
38815422,38831841,chr19,ECH1,chr19:38815422-38831841,16419
79008988,79012277,chr7,MAGI2-AS2,chr7:79008988-79012277,3289
79030240,79030345,chr7,RNU6-337P,chr7:79030240-79030345,105
63687179,64369176,chr8,LINC01414,chr8:63687179-64369176,681997
15152532,15220478,chr1,TMEM51,chr1:15152532-15220478,67946
79343266,79343372,chr7,RNU6-530P,chr7:79343266-79343372,106
79543911,79544853,chr7,NUP35P2,chr7:79543911-79544853,942
48826513,48830138,chrX,ERAS,chrX:48826513-48830138,3625
48831096,48835610,chrX,PCSK1N,chrX:48831096-48835610,4514
69987415,69987697,chr8,SUMO2P20,chr8:69987415-69987697,282
78017055,79453667,chr7,MAGI2,chr7:78017055-79453667,1436612
108606850,108787594,chr8,TMEM74,chr8:108606850-108787594,180744
123497889,123541206,chr8,FBXO32,chr8:123497889-123541206,43317
48890197,48903402,chrX,PQBP1,chrX:48890197-48903402,13205
88813734,88856970,chr16,GALNS,chr16:88813734-88856970,43236
10946471,10982037,chr1,C1orf127,chr1:10946471-10982037,35566
106301929,106347003,chr12,TCP11L2,chr12:106301929-106347003,45074
185217,195411,chr1,WASH9P,chr1:185217-195411,10194
54135241,54148514,chr8,MRPL15,chr8:54135241-54148514,13273
36797502,36831596,chr19,ZNF790-AS1,chr19:36797502-36831596,34094
1173880,1197936,chr1,TTLL10,chr1:1173880-1197936,24056
50558025,50571027,chr3,C3orf18,chr3:50558025-50571027,13002
134286350,134371047,chr5,CDKL3,chr5:134286350-134371047,84697
44747705,44760044,chr19,BCL3,chr19:44747705-44760044,12339
42072752,43189970,chr20,PTPRT,chr20:42072752-43189970,1117218
32540544,32552586,chr9,TOPORS,chr9:32540544-32552586,12042
77335029,77377094,chr14,TMED8,chr14:77335029-77377094,42065
136494433,136546048,chr9,NOTCH1,chr9:136494433-136546048,51615
88715338,88785220,chr16,PIEZO1,chr16:88715338-88785220,69882
105172938,105181323,chr14,NUDT14,chr14:105172938-105181323,8385
45014672,45051099,chr12,DBX2,chr12:45014672-45051099,36427
11232963,11233112,chr1,RPL39P6,chr1:11232963-11233112,149
55449509,55455139,chr8,SBF1P1,chr8:55449509-55455139,5630
3625015,3630127,chr1,TPRG1L,chr1:3625015-3630127,5112
45178784,45216933,chr19,BLOC1S3,chr19:45178784-45216933,38149
101877580,102012130,chr12,DRAM1,chr12:101877580-102012130,134550
124973295,124979389,chr8,ZNF572,chr8:124973295-124979389,6094
52534013,52579237,chr3,SMIM4,chr3:52534013-52579237,45224
132670035,132694953,chr9,GTF3C4,chr9:132670035-132694953,24918
16246840,16352480,chr1,FBXO42,chr1:16246840-16352480,105640
50786674,50788285,chr3,ZNF652P1,chr3:50786674-50788285,1611
41837074,41844697,chr19,LYPD4,chr19:41837074-41844697,7623
50320027,50328251,chr3,TUSC2,chr3:50320027-50328251,8224
132725578,132878777,chr9,AK8,chr9:132725578-132878777,153199
48893447,48898143,chrX,TIMM17B,chrX:48893447-48898143,4696
54046367,54102017,chr8,LYPLA1,chr8:54046367-54102017,55650
100487544,100487787,chr14,RN7SKP92,chr14:100487544-100487787,243
42646583,42686701,chr12,LINC02451,chr12:42646583-42686701,40118
1242446,1246722,chr1,C1QTNF12,chr1:1242446-1246722,4276
56381781,56382075,chr5,HMGN1P17,chr5:56381781-56382075,294
28264390,28265974,chr14,BNIP3P1,chr14:28264390-28265974,1584
55226862,55300738,chr3,LINC02030,chr3:55226862-55300738,73876
118981541,119163051,chr12,SRRM4,chr12:118981541-119163051,181510
32719753,32829580,chr19,TDRD12,chr19:32719753-32829580,109827
28489910,28490362,chr14,RPL26P3,chr14:28489910-28490362,452
57519669,57520010,chr3,RNF7P1,chr3:57519669-57520010,341
90153052,90290078,chr5,LINC01339,chr5:90153052-90290078,137026
28829881,28968400,chr14,LINC02327,chr14:28829881-28968400,138519
61561569,62297609,chr3,PTPRG,chr3:61561569-62297609,736040
132878027,132890201,chr9,SPACA9,chr9:132878027-132890201,12174
138744434,138753309,chr5,CTNNA1-AS1,chr5:138744434-138753309,8875
82073055,82073702,chr5,ATG10-AS1,chr5:82073055-82073702,647
123636110,123637403,chr5,KRT18P16,chr5:123636110-123637403,1293
18871430,18902724,chr1,ALDH4A1,chr1:18871430-18902724,31294
85190629,85190830,chr5,RBBP4P6,chr5:85190629-85190830,201
135038831,135040047,chr5,EPIST,chr5:135038831-135040047,1216
76850001,76921650,chr5,S100Z,chr5:76850001-76921650,71649
71125085,71441898,chr12,TSPAN8,chr12:71125085-71441898,316813
43287470,43313512,chr5,HMGCS1,chr5:43287470-43313512,26042
132891348,132946874,chr9,TSC1,chr9:132891348-132946874,55526
28875404,29064993,chr14,LINC02326,chr14:28875404-29064993,189589
48903180,48911958,chrX,SLC35A2,chrX:48903180-48911958,8778
50669989,50672048,chr3,LINC02019,chr3:50669989-50672048,2059
28982303,28982410,chr14,RNU6-864P,chr14:28982303-28982410,107
62388634,62407285,chr20,CABLES2,chr20:62388634-62407285,18651
44915257,44976185,chr3,ZDHHC3,chr3:44915257-44976185,60928
35612735,35625355,chr19,HAUS5,chr19:35612735-35625355,12620
66844414,66854153,chr16,CA7,chr16:66844414-66854153,9739
57128483,57213361,chr12,LRP1,chr12:57128483-57213361,84878
106344566,106345433,chr2,ILRUNP1,chr2:106344566-106345433,867
84750769,84751231,chr2,DUXAP1,chr2:84750769-84751231,462
29476784,29476912,chr14,RNU11-5P,chr14:29476784-29476912,128
104412146,104414195,chr2,LINC01831,chr2:104412146-104414195,2049
5482736,5526709,chr20,LINC00654,chr20:5482736-5526709,43973
29811916,29812018,chr14,RNU6-1234P,chr14:29811916-29812018,102
64513952,64540368,chr14,HSPA2-AS1,chr14:64513952-64540368,26416
72107234,72209565,chr5,MAP1B,chr5:72107234-72209565,102331
70447284,70554193,chr2,TGFA,chr2:70447284-70554193,106909
64549920,64589381,chr14,PPP1R36,chr14:64549920-64589381,39461
79676048,79809716,chr16,LINC01229,chr16:79676048-79809716,133668
40004216,40011323,chr20,LINC01370,chr20:40004216-40011323,7107
48359884,48370636,chr20,LINC00494,chr20:48359884-48370636,10752
8352397,8848921,chr1,RERE,chr1:8352397-8848921,496524
52833121,52897562,chr3,STIMATE-MUSTN1,chr3:52833121-52897562,64441
64600243,64601644,chr14,NUP50P1,chr14:64600243-64601644,1401
64704102,64750249,chr14,PLEKHG3,chr14:64704102-64750249,46147
58354357,58362848,chr19,ZNF497,chr19:58354357-58362848,8491
36507702,36573391,chr20,DLGAP4-AS1,chr20:36507702-36573391,65689
50341106,50345697,chr3,ZMYND10-AS1,chr3:50341106-50345697,4591
22989823,22991582,chr3,SALL4P5,chr3:22989823-22991582,1759
65687301,65688468,chr3,ILF2P1,chr3:65687301-65688468,1167
30496621,30504841,chr7,GGCT,chr7:30496621-30504841,8220
57755428,57766052,chr2,ACTG1P22,chr2:57755428-57766052,10624
57556274,57566848,chr3,PDE12,chr3:57556274-57566848,10574
165987551,165989615,chr6,LINC00602,chr6:165987551-165989615,2064
40890826,40912357,chr19,CYP2G1P,chr19:40890826-40912357,21531
166058505,166066028,chr6,GAPDHP72,chr6:166058505-166066028,7523
166209403,166209506,chr6,RNU6-153P,chr6:166209403-166209506,103
40586535,40587428,chr3,RPL5P10,chr3:40586535-40587428,893
50337511,50338300,chr3,RASSF1-AS1,chr3:50337511-50338300,789
46376402,46376484,chr11,MIR4688,chr11:46376402-46376484,82
21085576,21106514,chr20,LINC00237,chr20:21085576-21106514,20938
36901742,36902117,chr19,RPL31P61,chr19:36901742-36902117,375
166240290,166240493,chr6,GNG5P1,chr6:166240290-166240493,203
38325237,38329070,chr3,DLEC1P1,chr3:38325237-38329070,3833
98087116,98313299,chr2,VWA3B,chr2:98087116-98313299,226183
166305300,166308448,chr6,PRR18,chr6:166305300-166308448,3148
95768953,95790409,chr11,FAM76B,chr11:95768953-95790409,21456
54707916,54713453,chr19,LILRP2,chr19:54707916-54713453,5537
166319728,166342576,chr6,SFT2D1,chr6:166319728-166342576,22848
16265160,16350299,chr3,OXNAD1,chr3:16265160-16350299,85139
71074225,71093193,chr5,OCLNP1,chr5:71074225-71093193,18968
85798633,85807068,chr16,COX4I1,chr16:85798633-85807068,8435
35280716,35285143,chr19,HAMP,chr19:35280716-35285143,4427
35476203,35490985,chr20,CEP250-AS1,chr20:35476203-35490985,14782
44495099,44658569,chr5,LINC02224,chr5:44495099-44658569,163470
132630589,132664272,chr5,TH2LCRR,chr5:132630589-132664272,33683
30651942,30700129,chr7,CRHR2,chr7:30651942-30700129,48187
40908480,40910685,chr19,CYP2A7P2,chr19:40908480-40910685,2205
57435325,57447101,chr19,ZNF749,chr19:57435325-57447101,11776
166334568,166335471,chr6,HNRNPA1P49,chr6:166334568-166335471,903
166364919,166383013,chr6,MPC1,chr6:166364919-166383013,18094
35648323,35658782,chr19,COX6B1,chr19:35648323-35658782,10459
166383189,166384824,chr6,MPC1-DT,chr6:166383189-166384824,1635
64746283,64879907,chr14,SPTB,chr14:64746283-64879907,133624
54977867,55022671,chr5,ESM1,chr5:54977867-55022671,44804
166460663,166465383,chr6,RPS6KA2-IT1,chr6:166460663-166465383,4720
166509354,166509433,chr6,MIR1913,chr6:166509354-166509433,79
166157656,166168700,chr6,TBXT,chr6:166157656-166168700,11044
115956571,115958599,chr5,LINCADL,chr5:115956571-115958599,2028
76081946,76084186,chr5,SV2C-AS1,chr5:76081946-76084186,2240
119132651,119132882,chr5,LAMTOR3P2,chr5:119132651-119132882,231
83279921,83280644,chr5,COQ10BP2,chr5:83279921-83280644,723
139740951,139747406,chr5,PSD2-AS1,chr5:139740951-139747406,6455
106815197,107011052,chr5,LINC01950,chr5:106815197-107011052,195855
48913182,48919024,chrX,PIM2,chrX:48913182-48919024,5842
40191426,40215575,chr19,MAP3K10,chr19:40191426-40215575,24149
74327995,74334766,chr5,LINC01332,chr5:74327995-74334766,6771
120658077,120658371,chr5,PRELID3BP8,chr5:120658077-120658371,294
95789965,95832693,chr11,CEP57,chr11:95789965-95832693,42728
76953045,76981158,chr5,CRHBP,chr5:76953045-76981158,28113
86331632,86349688,chr16,LINC00917,chr16:86331632-86349688,18056
48922024,48958386,chrX,OTUD5,chrX:48922024-48958386,36362
35737032,35749079,chr6,ARMC12,chr6:35737032-35749079,12047
123984138,124040782,chr8,FER1L6-AS1,chr8:123984138-124040782,56644
68626870,68627187,chr12,RPL10P12,chr12:68626870-68627187,317
60055853,60072956,chr20,LINC02910,chr20:60055853-60072956,17103
127686343,127738987,chr8,CASC11,chr8:127686343-127738987,52644
52545352,52685917,chr3,PBRM1,chr3:52545352-52685917,140565
121918592,122003927,chr12,CFAP251,chr12:121918592-122003927,85335
122091480,122091609,chr8,MRPS36P3,chr8:122091480-122091609,129
41844743,41852333,chr19,DMRTC2,chr19:41844743-41852333,7590
43403061,43510728,chr15,TP53BP1,chr15:43403061-43510728,107667
50162765,50166233,chr20,LINC01275,chr20:50162765-50166233,3468
97868840,98036724,chr8,MATN2,chr8:97868840-98036724,167884
98768650,98798643,chr5,RGMB,chr5:98768650-98798643,29993
60087826,60653784,chr20,MIR646HG,chr20:60087826-60653784,565958
36871870,36928964,chr6,C6orf89,chr6:36871870-36928964,57094
86720575,86722042,chr16,LINC02189,chr16:86720575-86722042,1467
58400221,58400679,chr19,LINC02560,chr19:58400221-58400679,458
131659046,131660115,chr5,ACTBP4,chr5:131659046-131660115,1069
48959179,48959282,chrX,RNU6-722P,chrX:48959179-48959282,103
48961378,48971844,chrX,KCND1,chrX:48961378-48971844,10466
32963499,32963865,chr19,RPL31P60,chr19:32963499-32963865,366
124059794,124438625,chr5,LINC01170,chr5:124059794-124438625,378831
64785626,64785686,chr14,MIR7855,chr14:64785626-64785686,60
30580533,30634033,chr7,GARS1,chr7:30580533-30634033,53500
36150922,36152449,chr19,COX7A1,chr19:36150922-36152449,1527
73092349,73099337,chr16,HCCAT5,chr16:73092349-73099337,6988
43376645,43412391,chr5,CCL28,chr5:43376645-43412391,35746
77274956,77320883,chr14,POMT2,chr14:77274956-77320883,45927
48973720,49002264,chrX,GRIPAP1,chrX:48973720-49002264,28544
61918321,61940697,chr16,CDH8-AS1,chr16:61918321-61940697,22376
124324415,124567589,chr12,NCOR2,chr12:124324415-124567589,243174
82035004,82098534,chr16,HSD17B2,chr16:82035004-82098534,63530
11806096,11848079,chr1,CLCN6,chr1:11806096-11848079,41983
38743599,38751494,chr2,SRSF7,chr2:38743599-38751494,7895
58367618,58381030,chr19,ZNF837,chr19:58367618-58381030,13412
56099680,56233330,chr5,ANKRD55,chr5:56099680-56233330,133650
95840017,95840124,chr11,RNA5SP345,chr11:95840017-95840124,107
95963219,95963624,chr11,RPL32P25,chr11:95963219-95963624,405
54738513,54753052,chr19,KIR2DL3,chr19:54738513-54753052,14539
65866441,65873592,chr11,EFEMP2,chr11:65866441-65873592,7151
86286427,86293389,chr16,LINC02135,chr16:86286427-86293389,6962
46260420,46260858,chr19,IGFL1P2,chr19:46260420-46260858,438
24402908,24426194,chr6,MRS2,chr6:24402908-24426194,23286
73940639,73941781,chr16,RPSAP56,chr16:73940639-73941781,1142
63180610,63181071,chr16,UBE2FP2,chr16:63180610-63181071,461
54755023,54767371,chr19,KIR2DP1,chr19:54755023-54767371,12348
59655602,59656336,chr16,DUXAP11,chr16:59655602-59656336,734
57372477,57385044,chr16,CX3CL1,chr16:57372477-57385044,12567
33386950,33521791,chr19,PEPD,chr19:33386950-33521791,134841
136214048,136222159,chr5,TRPC7-AS1,chr5:136214048-136222159,8111
115389643,115392370,chr5,CTNNA1P1,chr5:115389643-115392370,2727
95652181,95698711,chr5,SPATA9,chr5:95652181-95698711,46530
75293698,75433503,chr16,CFDP1,chr16:75293698-75433503,139805
39566385,39610320,chr7,YAE1,chr7:39566385-39610320,43935
58228940,58309494,chr20,PPP4R1L,chr20:58228940-58309494,80554
101816475,101816780,chr5,OR7H2P,chr5:101816475-101816780,305
116447547,116508276,chr5,SEMA6A-AS1,chr5:116447547-116508276,60729
71197646,71208130,chr5,GUSBP9,chr5:71197646-71208130,10484
39623565,39708120,chr7,RALA,chr7:39623565-39708120,84555
67796054,67825562,chr2,LINC01812,chr2:67796054-67825562,29508
76634998,76658478,chr16,LINC02125,chr16:76634998-76658478,23480
104771282,104771885,chr2,HMGB3P11,chr2:104771282-104771885,603
72320367,72368395,chr5,PTCD2,chr5:72320367-72368395,48028
84777259,84778223,chr2,LDHAP7,chr2:84777259-84778223,964
69976297,70065948,chr16,PDXDC2P-NPIPB14P,chr16:69976297-70065948,89651
2635976,2801717,chr1,TTC34,chr1:2635976-2801717,165741
91883076,91931714,chr2,SLC9B1P2,chr2:91883076-91931714,48638
107065182,107115515,chr6,BEND3,chr6:107065182-107115515,50333
39768341,39768444,chr7,RNU6-719P,chr7:39768341-39768444,103
105273218,105454062,chr6,PREP,chr6:105273218-105454062,180844
39796593,39797911,chr7,CICP22,chr7:39796593-39797911,1318
39833571,39834718,chr7,SSBP3P1,chr7:39833571-39834718,1147
12857086,12861909,chr1,PRAMEF2,chr1:12857086-12861909,4823
39733430,39793092,chr7,LINC00265,chr7:39733430-39793092,59662
94912432,94912831,chr2,RPS24P6,chr2:94912432-94912831,399
96497646,96508109,chr2,NEURL3,chr2:96497646-96508109,10463
12879212,12886201,chr1,PRAMEF4,chr1:12879212-12886201,6989
38163335,38176730,chr8,LSM1,chr8:38163335-38176730,13395
93482760,93482855,chr7,MIR653,chr7:93482760-93482855,95
15456728,15472091,chr1,CELA2A,chr1:15456728-15472091,15363
93483936,93484019,chr7,MIR489,chr7:93483936-93484019,83
65883740,65888531,chr11,FIBP,chr11:65883740-65888531,4791
93424486,93574730,chr7,CALCR,chr7:93424486-93574730,150244
26562585,26579532,chr2,FAM166C,chr2:26562585-26579532,16947
54927305,54927433,chrX,SNORA11G,chrX:54927305-54927433,128
77722492,77742260,chr16,NUDT7,chr16:77722492-77742260,19768
100133351,100145817,chr8,FBXO43,chr8:100133351-100145817,12466
54920462,54931431,chrX,TRO,chrX:54920462-54931431,10969
46916157,47076137,chr2,TTC7A,chr2:46916157-47076137,159980
62544165,62551526,chr20,MIR1-1HG-AS1,chr20:62544165-62551526,7361
15465909,15491395,chr1,CELA2B,chr1:15465909-15491395,25486
154733378,154834244,chr6,SCAF8,chr6:154733378-154834244,100866
58552924,58582859,chr8,SDCBP,chr8:58552924-58582859,29935
58818918,58850903,chr20,GNAS-AS1,chr20:58818918-58850903,31985
21557417,21666621,chr20,LINC01727,chr20:21557417-21666621,109204
88706483,88715396,chr16,CTU2,chr16:88706483-88715396,8913
15836095,15940456,chr1,SPEN,chr1:15836095-15940456,104361
54769793,54784322,chr19,KIR2DL1,chr19:54769793-54784322,14529
62772980,62776996,chr20,LINC00659,chr20:62772980-62776996,4016
40161023,40221123,chr15,BUB1B,chr15:40161023-40221123,60100
65890673,65891635,chr11,CCDC85B,chr11:65890673-65891635,962
65892049,65900573,chr11,FOSL1,chr11:65892049-65900573,8524
62352988,62356480,chr20,LAMA5-AS1,chr20:62352988-62356480,3492
2391775,2405442,chr1,RER1,chr1:2391775-2405442,13667
10006381,10368823,chr20,SNAP25-AS1,chr20:10006381-10368823,362442
65916810,65919062,chr11,C11orf68,chr11:65916810-65919062,2252
53001279,53061824,chr6,CILK1,chr6:53001279-53061824,60545
65919274,65921563,chr11,DRAP1,chr11:65919274-65921563,2289
141907813,142106747,chr7,MGAM,chr7:141907813-142106747,198934
52012765,52030240,chr19,ZNF614,chr19:52012765-52030240,17475
33980679,33994357,chr20,RALY-AS1,chr20:33980679-33994357,13678
80052374,80083654,chr5,THBS4-AS1,chr5:80052374-80083654,31280
53954903,53958956,chr12,HOXC12,chr12:53954903-53958956,4053
108727825,108728260,chr5,LINC01023,chr5:108727825-108728260,435
123036271,123054667,chr5,PPIC-AS1,chr5:123036271-123054667,18396
44210907,44226027,chr20,OSER1-DT,chr20:44210907-44226027,15120
100143058,100144671,chr12,UHRF1BP1L-DT,chr12:100143058-100144671,1613
54497752,54548243,chr12,NCKAP1L,chr12:54497752-54548243,50491
70049638,70078522,chr5,SMN2,chr5:70049638-70078522,28884
58401504,58418327,chr19,ZNF584,chr19:58401504-58418327,16823
1325400,1378735,chr20,SDCBP2-AS1,chr20:1325400-1378735,53335
126340115,126348875,chr6,CENPW,chr6:126340115-126348875,8760
65945445,65959963,chr11,TSGA10IP,chr11:65945445-65959963,14518
50247643,50283250,chr20,PELATON,chr20:50247643-50283250,35607
2508537,2526597,chr1,PANK4,chr1:2508537-2526597,18060
58573503,58605223,chr19,CENPBD1P1,chr19:58573503-58605223,31720
39314698,39322968,chr6,KCNK16,chr6:39314698-39322968,8270
52031378,52095738,chr19,ZNF432,chr19:52031378-52095738,64360
65961728,65980137,chr11,SART1,chr11:65961728-65980137,18409
20138820,20145471,chr14,OR4N5,chr14:20138820-20145471,6651
21846329,21877735,chr15,POTEB,chr15:21846329-21877735,31406
102242040,102242619,chr8,SUMO2P19,chr8:102242040-102242619,579
103121032,103132966,chr8,LINC01181,chr8:103121032-103132966,11934
28563850,28602856,chr20,FRG1CP,chr20:28563850-28602856,39006
104769349,104795751,chr14,AKT1,chr14:104769349-104795751,26402
69706996,69726668,chr16,NQO1,chr16:69706996-69726668,19672
111225585,111227049,chr8,EEF1A1P37,chr8:111225585-111227049,1464
119873717,120050918,chr8,DEPTOR,chr8:119873717-120050918,177201
132945707,132945771,chr9,MIR548AW,chr9:132945707-132945771,64
132963732,132963793,chr9,RNU7-21P,chr9:132963732-132963793,61
133019486,133020874,chr9,EEF1A1P5,chr9:133019486-133020874,1388
132944000,132991687,chr9,GFI1B,chr9:132944000-132991687,47687
40991282,41018398,chr19,CYP2B6,chr19:40991282-41018398,27116
130366017,130443067,chr6,TMEM200A,chr6:130366017-130443067,77050
90929968,90935196,chr15,HDDC3,chr15:90929968-90935196,5228
107271394,107271846,chr12,SETP7,chr12:107271394-107271846,452
72884234,72884679,chr3,LAPTM4BP2,chr3:72884234-72884679,445
50685551,50685791,chr3,PPIAP69,chr3:50685551-50685791,240
138903493,138988261,chr6,REPS1,chr6:138903493-138988261,84768
47585269,47782106,chr3,SMARCC1,chr3:47585269-47782106,196837
67849044,67849338,chr8,NDUFS5P6,chr8:67849044-67849338,294
46828117,46828413,chr8,MTND1P7,chr8:46828117-46828413,296
101963901,101964340,chr12,NENFP2,chr12:101963901-101964340,439
89708959,89712590,chr12,ATP2B1-AS1,chr12:89708959-89712590,3631
38977909,39493095,chr7,POU6F2,chr7:38977909-39493095,515186
12134,13783,chr9,DDX11L5,chr9:12134-13783,1649
47332175,47347329,chr19,C5AR2,chr19:47332175-47347329,15154
3630767,3652761,chr1,WRAP73,chr1:3630767-3652761,21994
58411359,58451501,chr8,UBXN2B,chr8:58411359-58451501,40142
14475,73865,chr9,WASHC1,chr9:14475-73865,59390
65996545,66002176,chr11,EIF1AD,chr11:65996545-66002176,5631
35083410,35085295,chr15,NANOGP8,chr15:35083410-35085295,1885
40222208,40226697,chr19,CCNP,chr19:40222208-40226697,4489
57376881,57393062,chr20,RBM38-AS1,chr20:57376881-57393062,16181
22547671,22578642,chr20,LINC00261,chr20:22547671-22578642,30971
27657,30891,chr9,MIR1302-9HG,chr9:27657-30891,3234
47184101,47774228,chr15,SEMA6D,chr15:47184101-47774228,590127
132196372,132329589,chr12,GALNT9,chr12:132196372-132329589,133217
92907180,92939591,chr5,LINC02058,chr5:92907180-92939591,32411
30144,30281,chr9,MIR1302-9,chr9:30144-30281,137
34394,37269,chr9,FAM138C,chr9:34394-37269,2875
88809339,88811937,chr16,APRT,chr16:88809339-88811937,2598
115512077,115513694,chr5,CCT5P1,chr5:115512077-115513694,1617
38446343,38450940,chr20,SNHG11,chr20:38446343-38450940,4597
80019609,80019920,chr5,RBX1P2,chr5:80019609-80019920,311
41860255,41872925,chr19,RPS19,chr19:41860255-41872925,12670
134923303,134924049,chr5,MTCYBP18,chr5:134923303-134924049,746
126867714,127030558,chr5,MARCHF3,chr5:126867714-127030558,162844
112713,113754,chr9,LINC01388,chr9:112713-113754,1041
116231,118417,chr9,FOXD4,chr9:116231-118417,2186
27311482,27459391,chr8,PTK2B,chr8:27311482-27459391,147909
18675909,18827921,chrX,PPEF1,chrX:18675909-18827921,152012
99374249,99394816,chr7,ARPC1B,chr7:99374249-99394816,20567
86117912,86219926,chr4,MAPK10-AS1,chr4:86117912-86219926,102014
121038,179147,chr9,CBWD1,chr9:121038-179147,58109
85464434,85465310,chr5,RPL5P17,chr5:85464434-85465310,876
86336318,86336614,chr4,RN7SKP96,chr4:86336318-86336614,296
86542482,86542552,chr4,MIR4452,chr4:86542482-86542552,70
139795808,139844466,chr5,PSD2,chr5:139795808-139844466,48658
46243548,46475230,chr4,GABRA2,chr4:46243548-46475230,231682
9950572,9960787,chr1,TMEM274P,chr1:9950572-9960787,10215
86576368,86583478,chr16,FOXL1,chr16:86576368-86583478,7110
33114014,33147773,chr3,CRTAP,chr3:33114014-33147773,33759
75148494,75172236,chr16,ZFP1,chr16:75148494-75172236,23742
54786355,54790318,chr19,KIR3DP1,chr19:54786355-54790318,3963
47860113,47861512,chr19,TPRX2P,chr19:47860113-47861512,1399
66002228,66004149,chr11,BANF1,chr11:66002228-66004149,1921
43575801,43583964,chr19,PINLYP,chr19:43575801-43583964,8163
65174916,65193509,chr3,LINC02040,chr3:65174916-65193509,18593
72782885,73891871,chr16,ZFHX3,chr16:72782885-73891871,1108986
49556544,49568145,chr12,MCRS1,chr12:49556544-49568145,11601
17065598,17276843,chr5,BASP1,chr5:17065598-17276843,211245
97060128,97060415,chr2,IGKV1OR2-3,chr2:97060128-97060415,287
2098813,3057959,chr3,CNTN4,chr3:2098813-3057959,959146
68467572,68655862,chr2,APLF,chr2:68467572-68655862,188290
47863409,47865459,chr19,LINC01595,chr19:47863409-47865459,2050
12230030,12512047,chr1,VPS13D,chr1:12230030-12512047,282017
66012008,66013505,chr11,CST6,chr11:66012008-66013505,1497
136303757,136316100,chr5,TRPC7-AS2,chr5:136303757-136316100,12343
33502072,33503135,chr5,TOMM40P3,chr5:33502072-33503135,1063
73120569,73131809,chr5,TMEM171,chr5:73120569-73131809,11240
66016752,66026479,chr11,CATSPER1,chr11:66016752-66026479,9727
41877279,41881372,chr19,CD79A,chr19:41877279-41881372,4093
133955510,133968674,chr5,C5orf15,chr5:133955510-133968674,13164
66040765,66049161,chr11,GAL3ST3,chr11:66040765-66049161,8396
24308210,24314069,chrX,SUPT20HL2,chrX:24308210-24314069,5859
116751158,116751648,chr2,MTCYBP39,chr2:116751158-116751648,490
69985204,69985501,chr5,CDH12P2,chr5:69985204-69985501,297
24513450,24513687,chrX,SNRPEP9,chrX:24513450-24513687,237
24465244,24550466,chrX,PDK3,chrX:24465244-24550466,85222
115204012,115262877,chr5,PGGT1B,chr5:115204012-115262877,58865
112055269,112119318,chr2,TMEM87B,chr2:112055269-112119318,64049
34359480,34402413,chr19,GPI,chr19:34359480-34402413,42933
66050729,66069308,chr11,SF3B2,chr11:66050729-66069308,18579
57999546,58021618,chr16,USB1,chr16:57999546-58021618,22072
21653835,21667642,chr14,OR4E2,chr14:21653835-21667642,13807
31014646,31014742,chr14,MIR624,chr14:31014646-31014742,96
105248533,105251093,chr14,BTBD6,chr14:105248533-105251093,2560
101537485,101539276,chrX,PRKCIP1,chrX:101537485-101539276,1791
101550547,101554700,chrX,ARMCX1,chrX:101550547-101554700,4153
143755089,143757696,chr7,CTAGE6,chr7:143755089-143757696,2607
20239286,20244349,chr14,OR11H4,chr14:20239286-20244349,5063
66556216,66557065,chr7,SAPCD2P3,chr7:66556216-66557065,849
101597510,101598671,chrX,ARMCX7P,chrX:101597510-101598671,1161
66606738,66607107,chr7,RPL35P5,chr7:66606738-66607107,369
101615118,101618001,chrX,ARMCX6,chrX:101615118-101618001,2883
136132845,136188747,chr5,SMAD5,chr5:136132845-136188747,55902
50532509,50634017,chr14,ATL1,chr14:50532509-50634017,101508
66880708,66882981,chr7,GTF2IP23,chr7:66880708-66882981,2273
72916260,72936071,chr2,EMX1,chr2:72916260-72936071,19811
66891188,66891291,chr7,RNU6-1254P,chr7:66891188-66891291,103
66902857,66906297,chr7,LINC02604,chr7:66902857-66906297,3440
101622797,101627843,chrX,ARMCX3,chrX:101622797-101627843,5046
150685697,150693641,chr7,GIMAP2,chr7:150685697-150693641,7944
1211445,1249953,chr4,CTBP1,chr4:1211445-1249953,38508
150716606,150724284,chr7,GIMAP1,chr7:150716606-150724284,7678
67562067,67620545,chr2,LINC02831,chr2:67562067-67620545,58478
150716668,150743646,chr7,GIMAP1-GIMAP5,chr7:150716668-150743646,26978
150746893,150747728,chr7,GIMAP3P,chr7:150746893-150747728,835
150749736,150750094,chr7,BET1P1,chr7:150749736-150750094,358
150791285,150801360,chr7,TMEM176B,chr7:150791285-150801360,10075
77220406,77221258,chr16,VN2R10P,chr16:77220406-77221258,852
74621399,74666877,chr16,RFWD3,chr16:74621399-74666877,45478
30874514,30895065,chr14,COCH,chr14:30874514-30895065,20551
101622983,101624164,chrX,ARMCX3-AS1,chrX:101622983-101624164,1181
50317790,50322782,chr3,HYAL2,chr3:50317790-50322782,4992
101634006,101634112,chrX,RNU6-30P,chrX:101634006-101634112,106
62550447,62570767,chr20,MIR1-1HG,chr20:62550447-62570767,20320
101655281,101659850,chrX,ARMCX2,chrX:101655281-101659850,4569
48440598,48515391,chr2,PPP1R21,chr2:48440598-48515391,74793
64165843,64372869,chr5,RNF180,chr5:64165843-64372869,207026
82319172,82320279,chr3,RPL7AP23,chr3:82319172-82320279,1107
74667506,74668706,chr16,TMPOP2,chr16:74667506-74668706,1200
57060664,57075432,chr3,SPATA12,chr3:57060664-57075432,14768
134402065,134411881,chr5,CDKN2AIPNL,chr5:134402065-134411881,9816
150800403,150805118,chr7,TMEM176A,chr7:150800403-150805118,4715
74999024,75110994,chr16,ZNRF1,chr16:74999024-75110994,111970
66264777,66265666,chr11,KLC2-AS1,chr11:66264777-66265666,889
66267635,66268129,chr11,KLC2-AS2,chr11:66267635-66268129,494
42321005,42322695,chr3,SALL4P6,chr3:42321005-42322695,1690
66268590,66277492,chr11,RAB1B,chr11:66268590-66277492,8902
64187544,64200965,chr3,PRICKLE2-AS3,chr3:64187544-64200965,13421
77316752,77317598,chr3,VDAC1P7,chr3:77316752-77317598,846
55102646,55110252,chr5,GZMA,chr5:55102646-55110252,7606
94568929,94569470,chr5,MTND6P3,chr5:94568929-94569470,541
43690108,43734371,chr3,ABHD5,chr3:43690108-43734371,44263
63627179,63628824,chr20,MHENCR,chr20:63627179-63628824,1645
132996985,133026604,chr5,ZCCHC10,chr5:132996985-133026604,29619
66278175,66285301,chr11,CNIH2,chr11:66278175-66285301,7126
67884885,67888855,chr16,NRN1L,chr16:67884885-67888855,3970
23356586,23358175,chr20,LINC01431,chr20:23356586-23358175,1589
101691580,101691685,chrX,RNU6-587P,chrX:101691580-101691685,105
56435741,56464578,chr4,PAICS,chr4:56435741-56464578,28837
15790156,15830694,chrX,ZRSR2,chrX:15790156-15830694,40538
130070325,130072685,chr12,LINC02419,chr12:130070325-130072685,2360
126869010,126874725,chr12,LINC02372,chr12:126869010-126874725,5715
81988855,82011481,chr16,SDR42E1,chr16:81988855-82011481,22626
131806990,131945698,chr5,MEIKIN,chr5:131806990-131945698,138708
38419638,38435409,chr20,SNHG17,chr20:38419638-38435409,15771
66284580,66289145,chr11,YIF1A,chr11:66284580-66289145,4565
101280105,101386618,chr12,UTP20,chr12:101280105-101386618,106513
77247813,77435034,chr16,ADAMTS18,chr16:77247813-77435034,187221
116944286,116944414,chr7,RNA5SP239,chr7:116944286-116944414,128
116952446,116954334,chr7,ST7-AS1,chr7:116952446-116954334,1888
79111809,79132288,chr5,BHMT,chr5:79111809-79132288,20479
116953899,117098806,chr7,ST7-OT4,chr7:116953899-117098806,144907
13316235,13420322,chr3,NUP210,chr3:13316235-13420322,104087
101418287,101533459,chrX,ARMCX4,chrX:101418287-101533459,115172
116972165,116972911,chr7,TPM3P1,chr7:116972165-116972911,746
117020211,117020319,chr7,MIR6132,chr7:117020211-117020319,108
117072072,117146480,chr7,ST7-AS2,chr7:117072072-117146480,74408
113513694,113595285,chr5,YTHDC2,chr5:113513694-113595285,81591
95368507,95368885,chr2,FABP7P2,chr2:95368507-95368885,378
87980714,87992858,chr2,ANAPC1P5,chr2:87980714-87992858,12144
9818239,9819469,chrX,EIF5P1,chrX:9818239-9819469,1230
9865093,9865543,chrX,HMGN1P33,chrX:9865093-9865543,450
9967358,9968352,chrX,CLDN34,chrX:9967358-9968352,994
62561058,62561423,chr2,RSL24D1P2,chr2:62561058-62561423,365
10024842,10038654,chrX,WWC3-AS1,chrX:10024842-10038654,13812
44996413,44996873,chr2,KRTCAP2P1,chr2:44996413-44996873,460
117263917,117264388,chr7,MTND4P6,chr7:117263917-117264388,471
102125679,102140426,chrX,TCEAL2,chrX:102125679-102140426,14747
53701692,54158512,chr16,FTO,chr16:53701692-54158512,456820
117264393,117264530,chr7,MTCYBP6,chr7:117264393-117264530,137
66291894,66296664,chr11,TMEM151A,chr11:66291894-66296664,4770
140645829,140646126,chr7,RN7SL771P,chr7:140645829-140646126,297
45306413,45322875,chr19,CKM,chr19:45306413-45322875,16462
140672945,140696261,chr7,ADCK2,chr7:140672945-140696261,23316
102140476,102142970,chrX,TCEAL6,chrX:102140476-102142970,2494
66314494,66317044,chr11,CD248,chr11:66314494-66317044,2550
183318100,183320276,chr4,CLDN22,chr4:183318100-183320276,2176
36281616,36347511,chr4,DTHD1,chr4:36281616-36347511,65895
66330241,66336840,chr11,RIN1,chr11:66330241-66336840,6599
98997261,99154964,chr2,TSGA10,chr2:98997261-99154964,157703
102153708,102155977,chrX,BEX5,chrX:102153708-102155977,2269
170290703,170407067,chr6,FAM120B,chr6:170290703-170407067,116364
127451489,127503499,chr9,LRSAM1,chr9:127451489-127503499,52010
107713221,107777342,chrX,TSC22D3,chrX:107713221-107777342,64121
58386400,58394806,chr19,RPS5,chr19:58386400-58394806,8406
71439798,71586310,chr12,LGR5,chr12:71439798-71586310,146512
103021063,103073051,chr8,ATP6V1C1,chr8:103021063-103073051,51988
140690777,140722790,chr7,NDUFB2,chr7:140690777-140722790,32013
30893799,31026401,chr14,STRN3,chr14:30893799-31026401,132602
66337333,66345125,chr11,BRMS1,chr11:66337333-66345125,7792
153684070,153706260,chr4,TLR2,chr4:153684070-153706260,22190
73182501,73183291,chr3,GPATCH11P1,chr3:73182501-73183291,790
37861880,37984469,chr3,CTDSPL,chr3:37861880-37984469,122589
114055926,114496500,chr5,KCNN2,chr5:114055926-114496500,440574
94207611,94291292,chr4,SMARCAD1,chr4:94207611-94291292,83681
58440448,58445849,chr19,ZNF132-DT,chr19:58440448-58445849,5401
107774899,107795829,chrX,NCBP2L,chrX:107774899-107795829,20930
44777869,44800652,chr19,CBLC,chr19:44777869-44800652,22783
110194186,110440318,chrX,AMMECR1,chrX:110194186-110440318,246132
35573585,35728583,chr6,FKBP5,chr6:35573585-35728583,154998
140695336,140697077,chr7,NDUFB2-AS1,chr7:140695336-140697077,1741
140719327,140924929,chr7,BRAF,chr7:140719327-140924929,205602
87492555,87516940,chr16,ZCCHC14-DT,chr16:87492555-87516940,24385
79798050,79827150,chr16,LINC01228,chr16:79798050-79827150,29100
119588337,119606443,chrX,NKRF,chrX:119588337-119606443,18106
88453280,88537031,chr16,ZFPM1,chr16:88453280-88537031,83751
55434373,55579197,chr6,HMGCLL1,chr6:55434373-55579197,144824
66345374,66347629,chr11,B4GAT1,chr11:66345374-66347629,2255
101686542,102124907,chr8,NCALD,chr8:101686542-102124907,438365
30964347,30964622,chr14,HIGD1AP17,chr14:30964347-30964622,275
139526431,139628434,chr5,UBE2D2,chr5:139526431-139628434,102003
41024268,41027720,chr19,CYP2A7P1,chr19:41024268-41027720,3452
66362521,66372214,chr11,SLC29A2,chr11:66362521-66372214,9693
31111569,31112239,chr14,RPL21P5,chr14:31111569-31112239,670
31142939,31143048,chr14,RNU6-541P,chr14:31142939-31143048,109
11822423,12724523,chrX,FRMPD4,chrX:11822423-12724523,902100
47870467,47886315,chr19,SULT2A1,chr19:47870467-47886315,15848
84565596,84618078,chr16,COTL1,chr16:84565596-84618078,52482
68874128,68979440,chr14,ACTN1,chr14:68874128-68979440,105312
41050449,41062444,chr19,CYP2G2P,chr19:41050449-41062444,11995
54816468,54830778,chr19,KIR3DL1,chr19:54816468-54830778,14310
35255192,35255633,chr16,RARRES2P6,chr16:35255192-35255633,441
19664875,19680966,chr1,HTR6,chr1:19664875-19680966,16091
58025754,58046901,chr16,MMP15,chr16:58025754-58046901,21147
52903572,53046750,chr3,SFMBT1,chr3:52903572-53046750,143178
11609468,11613358,chr1,LINC01647,chr1:11609468-11613358,3890
30653359,30731462,chrX,GK,chrX:30653359-30731462,78103
12220794,12221109,chr1,RPL10P17,chr1:12220794-12221109,315
39022411,39022558,chr5,AIG1P1,chr5:39022411-39022558,147
83426676,83427030,chr5,FTH1P9,chr5:83426676-83427030,354
85380571,85749358,chr15,AKAP13,chr15:85380571-85749358,368787
74084068,74103216,chr5,LINC02122,chr5:74084068-74103216,19148
3454665,3481113,chr1,ARHGEF16,chr1:3454665-3481113,26448
77290268,77291800,chr5,ALDH7A1P1,chr5:77290268-77291800,1532
138868921,138875368,chr5,LRRTM2,chr5:138868921-138875368,6447
77350851,77376613,chr10,KCNMA1-AS3,chr10:77350851-77376613,25762
52765380,52772784,chr10,MBL2,chr10:52765380-52772784,7404
115520908,115544775,chr5,FEM1C,chr5:115520908-115544775,23867
67561411,67562309,chr16,CTCF-DT,chr16:67561411-67562309,898
109127327,109128930,chr2,SH3RF3-AS1,chr2:109127327-109128930,1603
38345347,38346551,chr5,EGFLAM-AS3,chr5:38345347-38346551,1204
78412793,78413094,chr2,CYCSP6,chr2:78412793-78413094,301
80966448,81020270,chr16,CMC2,chr16:80966448-81020270,53822
87221113,87222488,chr2,CENPNP1,chr2:87221113-87222488,1375
123971845,124015439,chr12,ZNF664,chr12:123971845-124015439,43594
130270440,130272272,chr2,MTND1P29,chr2:130270440-130272272,1832
37379285,37753435,chr5,WDR70,chr5:37379285-37753435,374150
100970767,100977766,chr2,NPAS2-AS1,chr2:100970767-100977766,6999
99782640,99852594,chr10,ABCC2,chr10:99782640-99852594,69954
39329709,39333680,chr3,CCR8,chr3:39329709-39333680,3971
74654228,74683853,chr2,SEMA4F,chr2:74654228-74683853,29625
60732144,60732636,chr3,PPIAP71,chr3:60732144-60732636,492
66389609,66390168,chr11,BRD9P1,chr11:66389609-66390168,559
66393449,66393612,chr11,RNU1-84P,chr11:66393449-66393612,163
88338416,88467594,chr3,CSNKA2IP,chr3:88338416-88467594,129178
66421004,66426707,chr11,NPAS4,chr11:66421004-66426707,5703
681829,689271,chr4,SLC49A3,chr4:681829-689271,7442
11712054,11807046,chr6,ADTRP,chr6:11712054-11807046,94992
75906695,77649964,chr3,ROBO2,chr3:75906695-77649964,1743269
9997206,10016021,chr1,RBP7,chr1:9997206-10016021,18815
66070272,66244744,chr11,PACS1,chr11:66070272-66244744,174472
124151923,124152433,chr8,ARF1P3,chr8:124151923-124152433,510
123680794,123737402,chr8,ANXA13,chr8:123680794-123737402,56608
13196188,13201409,chr1,PRAMEF13,chr1:13196188-13201409,5221
129109629,129113294,chr12,TMEM132D-AS1,chr12:129109629-129113294,3665
9100305,9129102,chr1,GPR157,chr1:9100305-9129102,28797
124220579,124221077,chr5,HMGB1P29,chr5:124220579-124221077,498
35666516,35678483,chr19,UPK1A,chr19:35666516-35678483,11967
13273539,13275627,chr1,PRAMEF32P,chr1:13273539-13275627,2088
16615926,16681905,chr5,RETREG1-AS1,chr5:16615926-16681905,65979
100267140,100341715,chr12,SCYL2,chr12:100267140-100341715,74575
129408382,129408621,chrX,RPS26P56,chrX:129408382-129408621,239
22428838,22531157,chr1,ZBTB40,chr1:22428838-22531157,102319
129436530,129436647,chrX,RNA5SP513,chrX:129436530-129436647,117
129446501,129523500,chrX,SMARCA1,chrX:129446501-129523500,76999
87085498,87095106,chr6,CGA,chr6:87085498-87095106,9608
61390668,61391871,chr5,RPL3P6,chr5:61390668-61391871,1203
31249879,31250987,chr5,DUX4L51,chr5:31249879-31250987,1108
43526267,43557758,chr5,PAIP1,chr5:43526267-43557758,31491
104678223,104678673,chr2,RPL23AP27,chr2:104678223-104678673,450
106822923,106825031,chr2,ST6GAL2-IT1,chr2:106822923-106825031,2108
22773853,22774424,chr19,BNIP3P34,chr19:22773853-22774424,571
60938204,60938604,chr2,RPS12P3,chr2:60938204-60938604,400
57462660,57472009,chr16,POLR2C,chr16:57462660-57472009,9349
111742586,111744662,chr2,CENPNP2,chr2:111742586-111744662,2076
47689707,47730436,chr10,SHLD2P3,chr10:47689707-47730436,40729
105092368,105103036,chr2,MRPS9-AS1,chr2:105092368-105103036,10668
47692399,47692727,chr10,RN7SL453P,chr10:47692399-47692727,328
34428352,34471251,chr19,UBA2,chr19:34428352-34471251,42899
47706203,47706802,chr10,RHEBP2,chr10:47706203-47706802,599
105894775,106004027,chr4,NPNT,chr4:105894775-106004027,109252
52622458,52745843,chr8,RB1CC1,chr8:52622458-52745843,123385
160702238,160754097,chr6,PLG,chr6:160702238-160754097,51859
47918739,47923524,chr10,NPY4R2,chr10:47918739-47923524,4785
47995322,47999791,chr10,FAM25C,chr10:47995322-47999791,4469
64606975,64616556,chr2,LINC02579,chr2:64606975-64616556,9581
131535187,131536988,chr2,MED15P4,chr2:131535187-131536988,1801
140884072,140884178,chr7,RNU6-85P,chr7:140884072-140884178,106
140997952,140999800,chr7,CCT4P1,chr7:140997952-140999800,1848
8878835,8879894,chr1,ENO1-AS1,chr1:8878835-8879894,1059
88586753,88606976,chr10,LIPJ,chr10:88586753-88606976,20223
126438837,126472790,chr12,LINC02347,chr12:126438837-126472790,33953
141002610,141015228,chr7,MRPS33,chr7:141002610-141015228,12618
19597067,19656927,chr1,MICOS10-NBL1,chr1:19597067-19656927,59860
61615036,61639449,chr11,RPLP0P2,chr11:61615036-61639449,24413
88618223,88618934,chr10,RPL7P34,chr10:88618223-88618934,711
88664441,88678814,chr10,LIPF,chr10:88664441-88678814,14373
61680391,61747001,chr11,DAGLA,chr11:61680391-61747001,66610
4846665,4882401,chr16,UBN1,chr16:4846665-4882401,35736
102714630,102736888,chr2,MFSD9,chr2:102714630-102736888,22258
138377905,138383486,chr6,SMIM28,chr6:138377905-138383486,5581
5103629,5260950,chr6,LYRM4,chr6:5103629-5260950,157321
107563484,107578523,chr7,DUS4L,chr7:107563484-107578523,15039
11654375,11663327,chr1,FBXO44,chr1:11654375-11663327,8952
166167920,166171376,chr6,LNCDAT,chr6:166167920-166171376,3456
5918564,5918844,chr6,RN7SL221P,chr6:5918564-5918844,280
5972412,5974012,chr6,PKMP5,chr6:5972412-5974012,1600
101034868,101076407,chr8,FLJ42969,chr8:101034868-101076407,41539
5997999,6007605,chr6,NRN1,chr6:5997999-6007605,9606
107986523,108013994,chr2,SLC5A7,chr2:107986523-108013994,27471
61746493,61757655,chr11,MYRF-AS1,chr11:61746493-61757655,11162
6169304,6169435,chr6,MIR7853,chr6:6169304-6169435,131
6169334,6169409,chr6,MIR5683,chr6:6169334-6169409,75
129539849,129592561,chrX,OCRL,chrX:129539849-129592561,52712
6347081,6347381,chr6,SNAPC5P1,chr6:6347081-6347381,300
6144084,6321013,chr6,F13A1,chr6:6144084-6321013,176929
67422038,67746378,chr8,CPA6,chr8:67422038-67746378,324340
130266863,130289798,chr7,CPA2,chr7:130266863-130289798,22935
120322115,120327779,chr12,PLA2G1B,chr12:120322115-120327779,5664
88699683,88700401,chr10,NAPGP1,chr10:88699683-88700401,718
61768501,61792802,chr11,TMEM258,chr11:61768501-61792802,24301
88727485,88728914,chr10,KRT8P38,chr10:88727485-88728914,1429
87089129,87158363,chr3,LINC00506,chr3:87089129-87158363,69234
88785600,88787061,chr10,RCBTB2P1,chr10:88785600-88787061,1461
88802730,88820546,chr10,LIPM,chr10:88802730-88820546,17816
90202316,90257415,chr3,PROS2P,chr3:90202316-90257415,55099
54874605,54901255,chr3,CACNA2D3-AS1,chr3:54874605-54901255,26650
66751752,66754740,chr16,DYNC1LI2-DT,chr16:66751752-66754740,2988
112829751,112836816,chr2,IL1B,chr2:112829751-112836816,7065
61792495,61792561,chr11,MIR611,chr11:61792495-61792561,66
61792911,61797238,chr11,FEN1,chr11:61792911-61797238,4327
50611520,50649291,chr3,MAPKAPK3,chr3:50611520-50649291,37771
88759982,88779626,chr10,LIPN,chr10:88759982-88779626,19644
169175277,169182841,chr6,LINC02544,chr6:169175277-169182841,7564
67987746,68079320,chr16,DUS2,chr16:67987746-68079320,91574
122843439,123029354,chr5,SNX24,chr5:122843439-123029354,185915
30299569,30299673,chr10,RNU6-598P,chr10:30299569-30299673,104
30301823,30302072,chr10,EEF1A1P39,chr10:30301823-30302072,249
130953907,131141469,chr12,ADGRD1,chr12:130953907-131141469,187562
169296471,169297959,chr6,VTA1P1,chr6:169296471-169297959,1488
30353706,30357365,chr10,DNM1P17,chr10:30353706-30357365,3659
30364410,30374386,chr10,GOLGA2P6,chr10:30364410-30374386,9976
12892896,12898270,chr1,PRAMEF10,chr1:12892896-12898270,5374
130293134,130324180,chr7,CPA4,chr7:130293134-130324180,31046
30366064,30366299,chr10,RN7SL241P,chr10:30366064-30366299,235
119618162,119618474,chr8,CYCSP23,chr8:119618162-119618474,312
61799627,61829318,chr11,FADS1,chr11:61799627-61829318,29691
30368597,30368665,chr10,MIR7162,chr10:30368597-30368665,68
30380174,30381062,chr10,NIFKP1,chr10:30380174-30381062,888
28319660,28319852,chr6,SMIM15P2,chr6:28319660-28319852,192
102551589,102561018,chr8,ODF1,chr8:102551589-102561018,9429
30403197,30403776,chr10,CCND3P1,chr10:30403197-30403776,579
30434021,30461833,chr10,MAP3K8,chr10:30434021-30461833,27812
41088451,41096195,chr19,CYP2A13,chr19:41088451-41096195,7744
154401236,154412112,chrX,DNASE1L1,chrX:154401236-154412112,10876
138725211,138773652,chr6,CCDC28A-AS1,chr6:138725211-138773652,48441
12824605,12831410,chr1,PRAMEF11,chr1:12824605-12831410,6805
103371538,103382989,chr8,CTHRC1,chr8:103371538-103382989,11451
138822747,138823799,chr6,ACKR4P1,chr6:138822747-138823799,1052
138773769,138793319,chr6,CCDC28A,chr6:138773769-138793319,19550
47968046,47992170,chr19,BSPH1,chr19:47968046-47992170,24124
12791397,12796628,chr1,PRAMEF1,chr1:12791397-12796628,5231
30517616,30518861,chr10,HNRNPA1P32,chr10:30517616-30518861,1245
30555601,30555904,chr10,RN7SL63P,chr10:30555601-30555904,303
167357033,167384510,chr6,TCP10L3,chr6:167357033-167384510,27477
110139214,110139426,chr10,SNRPGP12,chr10:110139214-110139426,212
54832676,54848569,chr19,KIR2DS4,chr19:54832676-54848569,15893
36355778,36551135,chr2,CRIM1,chr2:36355778-36551135,195357
110290730,110304938,chr10,SMNDC1,chr10:110290730-110304938,14208
104566086,104566429,chr8,NDUFA5P2,chr8:104566086-104566429,343
10990978,10991797,chr1,CFL1P6,chr1:10990978-10991797,819
2536647,2732573,chr4,FAM193A,chr4:2536647-2732573,195926
61742455,61743106,chr3,RPL10AP6,chr3:61742455-61743106,651
130380339,130388114,chr7,CPA1,chr7:130380339-130388114,7775
117523271,117524061,chr8,RPS10P16,chr8:117523271-117524061,790
37007857,37130368,chr19,ZNF420,chr19:37007857-37130368,122511
117520713,117540262,chr8,MED30,chr8:117520713-117540262,19549
97764521,97801229,chr3,ARL6,chr3:97764521-97801229,36708
5862811,5992473,chr1,NPHP4,chr1:5862811-5992473,129662
158725747,158726803,chr6,AMZ2P2,chr6:158725747-158726803,1056
158764661,158764753,chr6,MIR3918,chr6:158764661-158764753,92
95646754,95684773,chr5,RFESD,chr5:95646754-95684773,38019
158817979,158822252,chr6,EZR-AS1,chr6:158817979-158822252,4273
114084168,114084792,chr6,RPSAP43,chr6:114084168-114084792,624
114220681,114220786,chr6,RNA5SP213,chr6:114220681-114220786,105
33302857,33305054,chr19,CEBPA-DT,chr19:33302857-33305054,2197
127664554,127681555,chr6,LINC02536,chr6:127664554-127681555,17001
71895991,71896330,chr8,RPS20P20,chr8:71895991-71896330,339
110428840,110496590,chr10,DUSP5-DT,chr10:110428840-110496590,67750
127909833,127910052,chr6,MRPS17P5,chr6:127909833-127910052,219
58451611,58457833,chr19,ZNF324B,chr19:58451611-58457833,6222
52791371,52803860,chr6,GSTA1,chr6:52791371-52803860,12489
110450629,110451240,chr10,HMGB3P5,chr10:110450629-110451240,611
110497907,110511533,chr10,DUSP5,chr10:110497907-110511533,13626
130486042,130491033,chr7,MESTIT1,chr7:130486042-130491033,4991
73294602,73325281,chr8,RDH10,chr8:73294602-73325281,30679
97091867,97142753,chr5,LIX1,chr5:97091867-97142753,50886
102599168,102604159,chrX,ARMCX5,chrX:102599168-102604159,4991
130486171,130506465,chr7,MEST,chr7:130486171-130506465,20294
86876388,86991149,chr3,VGLL3,chr3:86876388-86991149,114761
64522187,64524093,chr2,AFTPH-DT,chr2:64522187-64524093,1906
30309801,30374448,chr10,MTPAP,chr10:30309801-30374448,64647
143192500,143194166,chr5,ARHGAP26-IT1,chr5:143192500-143194166,1666
52113091,52139938,chr19,ZNF616,chr19:52113091-52139938,26847
107061885,107118823,chrX,RBM41,chrX:107061885-107118823,56938
84423528,84460045,chr2,SUCLG1,chr2:84423528-84460045,36517
125024260,125091819,chr8,WASHC5,chr8:125024260-125091819,67559
52805613,52813460,chr6,GSTA6P,chr6:52805613-52813460,7847
52831655,52840843,chr6,GSTA5,chr6:52831655-52840843,9188
157085832,157142869,chr5,HAVCR2,chr5:157085832-157142869,57037
43369221,43409771,chr15,TUBGCP4,chr15:43369221-43409771,40550
81489703,81761645,chr3,GBE1,chr3:81489703-81761645,271942
52847910,52870329,chr6,GSTA11P,chr6:52847910-52870329,22419
56507850,56530221,chr19,ZNF471,chr19:56507850-56530221,22371
52873014,52879940,chr6,GSTA10P,chr6:52873014-52879940,6926
41335608,41350889,chr6,NCR2,chr6:41335608-41350889,15281
154675249,154751583,chrX,GAB3,chrX:154675249-154751583,76334
128543916,128543977,chr9,RNU7-171P,chr9:128543916-128543977,61
68911653,68911759,chr10,RNU6-571P,chr10:68911653-68911759,106
68991137,68991707,chr10,MED28P1,chr10:68991137-68991707,570
69022778,69023866,chr10,ACTBP14,chr10:69022778-69023866,1088
35596581,35601596,chr19,LINC01766,chr19:35596581-35601596,5015
69088103,69104805,chr10,SRGN,chr10:69088103-69104805,16702
41499033,41519852,chr6,LINC01276,chr6:41499033-41519852,20819
65843890,65844446,chr3,RPL17P17,chr3:65843890-65844446,556
128552558,128633662,chr9,SPTAN1,chr9:128552558-128633662,81104
41598723,41598788,chr6,MIR4641,chr6:41598723-41598788,65
25754699,25781199,chr6,SLC17A4,chr6:25754699-25781199,26500
69161530,69161906,chr10,RPS12P17,chr10:69161530-69161906,376
61815161,61815240,chr11,MIR1908,chr11:61815161-61815240,79
89587886,89588570,chr3,MTCO2P6,chr3:89587886-89588570,684
145228811,145230054,chr5,ASS1P10,chr5:145228811-145230054,1243
47460162,47484158,chr10,ANXA8,chr10:47460162-47484158,23996
80216261,80217234,chr3,HNRNPA3P8,chr3:80216261-80217234,973
46347087,46392981,chr19,PPP5C,chr19:46347087-46392981,45894
61873519,61892051,chr11,FADS3,chr11:61873519-61892051,18532
79957566,79958142,chr3,HMGB1P38,chr3:79957566-79958142,576
104395002,104396280,chr2,AHCYP3,chr2:104395002-104396280,1278
50674927,51384198,chr3,DOCK3,chr3:50674927-51384198,709271
102233986,102296284,chr5,SLCO4C1,chr5:102233986-102296284,62298
41850203,41850601,chr2,RPS12P4,chr2:41850203-41850601,398
28308161,28308570,chr2,RPL23AP34,chr2:28308161-28308570,409
100470482,100483280,chr2,NMS,chr2:100470482-100483280,12798
25782915,25832052,chr6,SLC17A1,chr6:25782915-25832052,49137
154768528,154768659,chrX,SNORA36A,chrX:154768528-154768659,131
154768596,154768656,chrX,MIR664B,chrX:154768596-154768656,60
154774998,154775126,chrX,SNORA56,chrX:154774998-154775126,128
100669892,100676038,chr2,LINC01868,chr2:100669892-100676038,6146
154823348,154834662,chrX,SMIM9,chrX:154823348-154834662,11314
154887360,154887458,chrX,MIR1184-1,chrX:154887360-154887458,98
56750300,56750563,chr2,PPIAP63,chr2:56750300-56750563,263
100671783,100732123,chrX,SYTL4,chrX:100671783-100732123,60340
88947301,88947957,chr2,IGKV1-5,chr2:88947301-88947957,656
68154768,68159740,chr12,IFNG,chr12:68154768-68159740,4972
100806933,100903282,chr5,ST8SIA4,chr5:100806933-100903282,96349
119186442,119186829,chrX,ARL5AP1,chrX:119186442-119186829,387
119078635,119150579,chrX,KIAA1210,chrX:119078635-119150579,71944
68341107,68407294,chr10,RUFY2,chr10:68341107-68407294,66187
101387299,101393255,chr8,LINC02845,chr8:101387299-101393255,5956
42169353,42332548,chr2,EML4,chr2:42169353-42332548,163195
88863333,88866660,chr16,PABPN1L,chr16:88863333-88866660,3327
53851795,53959303,chr8,RGS20,chr8:53851795-53959303,107508
10015254,10144474,chrX,WWC3,chrX:10015254-10144474,129220
133971871,134004975,chr5,VDAC1,chr5:133971871-134004975,33104
72888046,72998138,chr3,GXYLT2,chr3:72888046-72998138,110092
93173470,93182299,chr12,LINC02412,chr12:93173470-93182299,8829
25833066,25882286,chr6,SLC17A3,chr6:25833066-25882286,49220
9588911,9614877,chr1,TMEM201,chr1:9588911-9614877,25966
123458088,123473154,chr12,SNRNP35,chr12:123458088-123473154,15066
40815451,40828709,chr15,PPP1R14D,chr15:40815451-40828709,13258
64067964,64103131,chr3,PRICKLE2-AS1,chr3:64067964-64103131,35167
88948142,88950928,chr3,ICE2P2,chr3:88948142-88950928,2786
35414279,35414747,chr16,RARRES2P7,chr16:35414279-35414747,468
62124204,62124608,chr3,ID2B,chr3:62124204-62124608,404
85690084,85751129,chr16,C16orf74,chr16:85690084-85751129,61045
74954418,74956772,chr15,RPP25,chr15:74954418-74956772,2354
90998673,91022603,chr15,VPS33B,chr15:90998673-91022603,23930
115613210,115632992,chr5,TMED7,chr5:115613210-115632992,19782
33277025,33403662,chr3,FBXL2,chr3:33277025-33403662,126637
126723412,126749027,chr12,LINC00943,chr12:126723412-126749027,25615
61878216,61878278,chr11,MIR6746,chr11:61878216-61878278,62
61897301,61920269,chr11,RAB3IL1,chr11:61897301-61920269,22968
17528669,17529265,chr5,TAF11L6,chr5:17528669-17529265,596
129748094,129766732,chr5,MINAR2,chr5:129748094-129766732,18638
116562562,116562930,chr5,RPS14P8,chr5:116562562-116562930,368
71910845,72161750,chrX,NHSL2,chrX:71910845-72161750,250905
42839368,42855718,chr19,PSG10P,chr19:42839368-42855718,16350
142566700,142567076,chr5,RPS12P10,chr5:142566700-142567076,376
86474529,86509099,chr16,FENDRR,chr16:86474529-86509099,34570
8201518,8215210,chr1,LINC01714,chr1:8201518-8215210,13692
117778826,117779532,chr5,RPL7L1P4,chr5:117778826-117779532,706
96832254,96995956,chr10,LCOR,chr10:96832254-96995956,163702
124996985,124998198,chr8,SQLE-DT,chr8:124996985-124998198,1213
103088796,103090671,chr8,MTCO1P4,chr8:103088796-103090671,1875
54850443,54867207,chr19,KIR3DL2,chr19:54850443-54867207,16764
52512077,52520803,chrX,XAGE1B,chrX:52512077-52520803,8726
96875986,96919703,chr5,ERAP2,chr5:96875986-96919703,43717
101871830,101872549,chr8,PDCL3P2,chr8:101871830-101872549,719
11106535,11262551,chr1,MTOR,chr1:11106535-11262551,156016
90173217,90222851,chr16,LINC02193,chr16:90173217-90222851,49634
61937894,61938000,chr11,RNU6-1243P,chr11:61937894-61938000,106
112538889,112539317,chr8,RPL30P16,chr8:112538889-112539317,428
25882026,25882395,chr6,H2AC3P,chr6:25882026-25882395,369
61752636,61788518,chr11,MYRF,chr11:61752636-61788518,35882
70103798,70104179,chr8,H2AZP2,chr8:70103798-70104179,381
25885419,25885751,chr6,H2BP5,chr6:25885419-25885751,332
25962802,25991231,chr6,TRIM38,chr6:25962802-25991231,28429
100257060,100336218,chr8,RNF19A,chr8:100257060-100336218,79158
26016379,26016601,chr6,H3P26,chr6:26016379-26016601,222
26017032,26017787,chr6,H1-1,chr6:26017032-26017787,755
146814106,146814744,chrX,CXorf51A,chrX:146814106-146814744,638
88874858,88977207,chr16,CBFA2T3,chr16:88874858-88977207,102349
106369724,106378247,chr2,ANAPC1P6,chr2:106369724-106378247,8523
26020451,26020958,chr6,H3C1,chr6:26020451-26020958,507
112446998,112818744,chr10,VTI1A,chr10:112446998-112818744,371746
26021649,26022050,chr6,H4C1,chr6:26021649-26022050,401
26031589,26032099,chr6,H3C2,chr6:26031589-26032099,510
26033092,26033618,chr6,H2AC4,chr6:26033092-26033618,526
66162671,66268867,chrX,HEPH,chrX:66162671-66268867,106196
26043227,26043713,chr6,H2BC3,chr6:26043227-26043713,486
26043989,26044357,chr6,H2AC5P,chr6:26043989-26044357,368
108049200,108052755,chr2,LINC01593,chr2:108049200-108052755,3555
26045384,26045869,chr6,H3C3,chr6:26045384-26045869,485
120213631,120214989,chr2,MTND4P26,chr2:120213631-120214989,1358
26055740,26056470,chr6,H1-2,chr6:26055740-26056470,730
26107412,26108135,chr6,H1-6,chr6:26107412-26108135,723
26156329,26157115,chr6,H1-4,chr6:26156329-26157115,786
118766965,118835110,chr2,LINC01956,chr2:118766965-118835110,68145
78130337,78131004,chr12,PRXL2AP1,chr12:78130337-78131004,667
26164072,26164363,chr6,LARP1P1,chr6:26164072-26164363,291
113541937,113563298,chr2,PGM5P4,chr2:113541937-113563298,21361
26172059,26184655,chr6,H2BC6,chr6:26172059-26184655,12596
117025077,117026118,chr2,MTND2P21,chr2:117025077-117026118,1041
87249095,87253750,chr2,LINC01955,chr2:87249095-87253750,4655
26188710,26189112,chr6,H4C4,chr6:26188710-26189112,402
127933689,127983854,chr12,LINC00508,chr12:127933689-127983854,50165
107914948,107915286,chr2,RPL22P8,chr2:107914948-107915286,338
31494881,31511124,chr6,MICB,chr6:31494881-31511124,16243
99102018,99102752,chr2,SMC3P1,chr2:99102018-99102752,734
125983702,126043485,chr12,LINC02826,chr12:125983702-126043485,59783
109129205,109504634,chr2,SH3RF3,chr2:109129205-109504634,375429
68988803,69043544,chr10,KIFBP,chr10:68988803-69043544,54741
108652373,108653315,chr8,TRMT10BP1,chr8:108652373-108653315,942
51511058,51511483,chr2,KNOP1P3,chr2:51511058-51511483,425
94590821,94591093,chr12,LSM3P2,chr12:94590821-94591093,272
96266159,96274173,chr2,CIAO1,chr2:96266159-96274173,8014
133130575,133159465,chr12,ZNF10,chr12:133130575-133159465,28890
103500696,104256094,chr8,RIMS2,chr8:103500696-104256094,755398
56536156,56538575,chr19,ZFP28-DT,chr19:56536156-56538575,2419
52143043,52143336,chr19,RPL37P23,chr19:52143043-52143336,293
31519480,31520291,chr6,PPIAP9,chr6:31519480-31520291,811
31528114,31528693,chr6,RPL15P4,chr6:31528114-31528693,579
54874235,54891420,chr19,FCAR,chr19:54874235-54891420,17185
31528962,31530232,chr6,MCCD1,chr6:31528962-31530232,1270
102736905,103019900,chr2,TMEM182,chr2:102736905-103019900,282995
31530219,31542448,chr6,DDX39B,chr6:31530219-31542448,12229
17695266,17696994,chr11,LINC02729,chr11:17695266-17696994,1728
17719571,17722136,chr11,MYOD1,chr11:17719571-17722136,2565
46973989,46978983,chr16,DNAJA2-DT,chr16:46973989-46978983,4994
25377263,25418498,chr4,ANAPC4,chr4:25377263-25418498,41235
86510527,86515422,chr16,FOXF1,chr16:86510527-86515422,4895
50739318,50816495,chr10,ASAH2B,chr10:50739318-50816495,77177
17734774,17856804,chr11,KCNC1,chr11:17734774-17856804,122030
31025106,31130996,chr14,AP4S1,chr14:31025106-31130996,105890
5226196,5244199,chr12,LINC02443,chr12:5226196-5244199,18003
80597907,80804598,chr16,CDYL2,chr16:80597907-80804598,206691
24675775,24683393,chr15,NPAP1,chr15:24675775-24683393,7618
61852389,62060473,chr15,VPS13C,chr15:61852389-62060473,208084
146137755,146138381,chr5,RPL35AP16,chr5:146137755-146138381,626
5890203,5937594,chr10,FBH1,chr10:5890203-5937594,47391
108116695,108147603,chr11,ACAT1,chr11:108116695-108147603,30908
115592604,115592983,chr12,UBA52P7,chr12:115592604-115592983,379
122775079,122834543,chr5,SNX2,chr5:122775079-122834543,59464
74832655,74833987,chr2,HK2-DT,chr2:74832655-74833987,1332
95450310,95451500,chr2,UBTFL5,chr2:95450310-95451500,1190
40692439,41072415,chr12,CNTN1,chr12:40692439-41072415,379976
98599314,98608515,chr2,COA5,chr2:98599314-98608515,9201
26015669,26016369,chr3,RPEP2,chr3:26015669-26016369,700
67828157,67847811,chr16,CENPT,chr16:67828157-67847811,19654
38666081,38741237,chr2,GALM,chr2:38666081-38741237,75156
75446769,75491202,chr3,ENPP7P2,chr3:75446769-75491202,44433
69168782,69542583,chr3,FRMD4B,chr3:69168782-69542583,373801
85385927,85388765,chr14,LINC02329,chr14:85385927-85388765,2838
113022089,113052867,chr2,IL36B,chr2:113022089-113052867,30778
85393828,85420550,chr14,LINC00911,chr14:85393828-85420550,26722
85530144,85654428,chr14,FLRT2,chr14:85530144-85654428,124284
851014,856247,chr19,ELANE,chr19:851014-856247,5233
15339818,15446167,chr4,C1QTNF7,chr4:15339818-15446167,106349
130496111,130496204,chr7,MIR335,chr7:130496111-130496204,93
132643286,132671579,chr2,LYPD1,chr2:132643286-132671579,28293
152025674,152122340,chr7,GALNT11,chr7:152025674-152122340,96666
72516820,72516898,chr14,MIR7843,chr14:72516820-72516898,78
32927085,32946149,chr2,LINC00486,chr2:32927085-32946149,19064
3652516,3736201,chr1,TP73,chr1:3652516-3736201,83685
41114432,41128381,chr19,CYP2F1,chr19:41114432-41128381,13949
96501433,96567116,chr14,PAPOLA,chr14:96501433-96567116,65683
114439435,114450279,chr11,REXO2,chr11:114439435-114450279,10844
88897232,88897784,chr2,IGKV5-2,chr2:88897232-88897784,552
80335730,80963750,chr4,CFAP299,chr4:80335730-80963750,628020
87654890,87655243,chr2,RPS14P5,chr2:87654890-87655243,353
101068378,101068656,chr2,BBIP1P1,chr2:101068378-101068656,278
96143169,96145440,chr2,DUSP2,chr2:96143169-96145440,2271
126179565,126193858,chr5,LINC02039,chr5:126179565-126193858,14293
100428124,100535262,chr5,FAM174A-DT,chr5:100428124-100535262,107138
72929044,72929593,chr3,FTH1P23,chr3:72929044-72929593,549
155666726,155737059,chr4,GUCY1A1,chr4:155666726-155737059,70333
134924123,134924644,chr5,MTND6P4,chr5:134924123-134924644,521
42340588,42342367,chr3,EIF4BP4,chr3:42340588-42342367,1779
50365334,50368197,chr3,CYB561D2,chr3:50365334-50368197,2863
91940668,91942040,chr2,ACTR3BP2,chr2:91940668-91942040,1372
43785874,43827206,chr19,LYPD5,chr19:43785874-43827206,41332
113890063,113962596,chr2,ACTR3,chr2:113890063-113962596,72533
40596207,40597494,chr3,EEF1GP3,chr3:40596207-40597494,1287
65418731,65420027,chr12,KRT18P60,chr12:65418731-65420027,1296
127176696,127177050,chr5,SELENOTP2,chr5:127176696-127177050,354
152128879,152129686,chr7,YBX1P4,chr7:152128879-152129686,807
52833114,52835019,chr3,MUSTN1,chr3:52833114-52835019,1905
152367519,152368661,chr7,SEPTIN7P6,chr7:152367519-152368661,1142
92999218,93019820,chr12,LINC02413,chr12:92999218-93019820,20602
152435695,152443176,chr7,FABP5P3,chr7:152435695-152443176,7481
93360779,93585649,chr5,NR2F1-AS1,chr5:93360779-93585649,224870
31530219,31546608,chr6,ATP6V1G2-DDX39B,chr6:31530219-31546608,16389
152445477,152447150,chr7,CCT8L1P,chr7:152445477-152447150,1673
108778191,108857590,chr12,SSH1,chr12:108778191-108857590,79399
152463786,152465549,chr7,LINC01003,chr7:152463786-152465549,1763
31536374,31536449,chr6,SNORD117,chr6:31536374-31536449,75
99438922,99457373,chr7,CPSF4,chr7:99438922-99457373,18451
31541101,31541178,chr6,SNORD84,chr6:31541101-31541178,77
31542304,31543138,chr6,DDX39B-AS1,chr6:31542304-31543138,834
31546870,31558829,chr6,NFKBIL1,chr6:31546870-31558829,11959
120215181,120217279,chr2,MTND5P28,chr2:120215181-120217279,2098
128139792,128140516,chr2,SRMP3,chr2:128139792-128140516,724
113577382,113578852,chr2,FAM138B,chr2:113577382-113578852,1470
48029383,48044079,chr19,CABP5,chr19:48029383-48044079,14696
158166650,158236169,chr2,CCDC148-AS1,chr2:158166650-158236169,69519
114833830,114835588,chr2,DPP10-AS2,chr2:114833830-114835588,1758
91817771,91818248,chr2,IGKV1OR2-1,chr2:91817771-91818248,477
56538948,56556808,chr19,ZFP28,chr19:56538948-56556808,17860
117814691,117832377,chr2,DDX18,chr2:117814691-117832377,17686
114512706,114513431,chr11,NXPE2P1,chr11:114512706-114513431,725
48004336,48009733,chrX,SPACA5,chrX:48004336-48009733,5397
114521645,114559895,chr11,NXPE1,chr11:114521645-114559895,38250
41194741,41260096,chr3,CTNNB1,chr3:41194741-41260096,65355
101882288,101932031,chrX,ZMAT1,chrX:101882288-101932031,49743
60516936,60623644,chr8,RAB2A,chr8:60516936-60623644,106708
31572054,31574324,chr6,LTA,chr6:31572054-31574324,2270
114570591,114595786,chr11,NXPE4,chr11:114570591-114595786,25195
35487324,35495558,chr19,KRTDAP,chr19:35487324-35495558,8234
135829229,135837280,chrX,CT45A7,chrX:135829229-135837280,8051
99448475,99466186,chr7,ATP5MF,chr7:99448475-99466186,17711
88067825,88113384,chr2,SMYD1,chr2:88067825-88113384,45559
117900641,117929459,chr11,TMPRSS13,chr11:117900641-117929459,28818
111842228,111902222,chr12,MAPKAPK5,chr12:111842228-111902222,59994
31575565,31578336,chr6,TNF,chr6:31575565-31578336,2771
90871952,90908553,chr10,RPP30,chr10:90871952-90908553,36601
67934506,67936864,chr16,PSMB10,chr16:67934506-67936864,2358
154477775,154479281,chrX,LAGE3,chrX:154477775-154479281,1506
130622325,130903234,chrX,ENOX2,chrX:130622325-130903234,280909
31580525,31582522,chr6,LTB,chr6:31580525-31582522,1997
41134722,41137308,chr19,CYP2T3P,chr19:41134722-41137308,2586
43096456,43097360,chr19,CEACAMP9,chr19:43096456-43097360,904
57065334,57066139,chr19,RPL7AP69,chr19:57065334-57066139,805
66432492,66468907,chr8,ADHFE1,chr8:66432492-66468907,36415
41169861,41170166,chr19,RPL36P16,chr19:41169861-41170166,305
18555545,18589564,chr2,NT5C1B-RDH14,chr2:18555545-18589564,34019
99472890,99503650,chr7,ZNF789,chr7:99472890-99503650,30760
31586124,31588909,chr6,LST1,chr6:31586124-31588909,2785
54906148,54916140,chr19,NCR1,chr19:54906148-54916140,9992
113599036,113601261,chr2,DDX11L2,chr2:113599036-113601261,2225
85771758,85799608,chr16,EMC8,chr16:85771758-85799608,27850
138669157,138780390,chr2,NXPH2,chr2:138669157-138780390,111233
146194296,146194821,chr2,RPL17P12,chr2:146194296-146194821,525
101393116,101407772,chr12,ARL1,chr12:101393116-101407772,14656
99473877,99504857,chr7,ZNF394,chr7:99473877-99504857,30980
57048350,57049336,chr2,EIF2S2P7,chr2:57048350-57049336,986
86934462,86934822,chr2,NDUFB4P5,chr2:86934462-86934822,360
57134530,57137523,chrX,SPIN2A,chrX:57134530-57137523,2993
18554723,18560679,chr2,RDH14,chr2:18554723-18560679,5956
55435156,55435622,chr2,BTF3P5,chr2:55435156-55435622,466
50586796,50814302,chrX,SHROOM4,chrX:50586796-50814302,227506
41935368,41956806,chr2,LINC02898,chr2:41935368-41956806,21438
99546300,99558536,chr7,FAM200A,chr7:99546300-99558536,12236
73275107,73458617,chr14,NUMB,chr14:73275107-73458617,183510
117026537,117027024,chr2,MTCO1P43,chr2:117026537-117027024,487
117986370,118003037,chr11,IL10RA,chr11:117986370-118003037,16667
98206151,98207724,chr2,ATP5F1BP1,chr2:98206151-98207724,1573
104746638,104757719,chr2,LINC01114,chr2:104746638-104757719,11081
99558406,99576453,chr7,ZNF655,chr7:99558406-99576453,18047
14748066,14765413,chr16,NPIPA2,chr16:14748066-14765413,17347
56567468,56588911,chr19,ZNF470,chr19:56567468-56588911,21443
133431666,133433897,chr2,NCKAP5-IT1,chr2:133431666-133433897,2231
20779973,21293011,chr10,NEBL,chr10:20779973-21293011,513038
113512222,113515488,chr2,LINC01961,chr2:113512222-113515488,3266
107920763,107921248,chr2,SRSF3P5,chr2:107920763-107921248,485
51775258,51775402,chr2,CRYGGP,chr2:51775258-51775402,144
118842171,118847648,chr2,EN1,chr2:118842171-118847648,5477
55143102,55161310,chrX,FAM104B,chrX:55143102-55161310,18208
15363628,15381047,chr16,NPIPA5,chr16:15363628-15381047,17419
68310387,68350090,chr4,YTHDC1,chr4:68310387-68350090,39703
158171073,158456753,chr2,CCDC148,chr2:158171073-158456753,285680
68957377,68957677,chr12,PRELID2P1,chr12:68957377-68957677,300
57769655,57819939,chr19,ZNF586,chr19:57769655-57819939,50284
129208601,129212662,chr12,TMEM132D-AS2,chr12:129208601-129212662,4061
118013588,118033130,chr12,RFC5,chr12:118013588-118033130,19542
20006713,20116907,chrX,MAP7D2,chrX:20006713-20116907,110194
60654235,60656649,chr16,GNPATP,chr16:60654235-60656649,2414
56589495,56590281,chr19,SIGLEC31P,chr19:56589495-56590281,786
118067237,118067539,chr11,RN7SL828P,chr11:118067237-118067539,302
55007982,55008306,chr16,MTND5P34,chr16:55007982-55008306,324
35533455,35545319,chr19,GAPDHS,chr19:35533455-35545319,11864
118077012,118121890,chr11,TMPRSS4,chr11:118077012-118121890,44878
31588895,31593006,chr6,NCR3,chr6:31588895-31593006,4111
535316,535368,chr16,MIR5587,chr16:535316-535368,52
543277,543366,chr16,MIR3176,chr16:543277-543366,89
17052,17119,chr16,MIR6859-4,chr16:17052-17119,67
2135977,2136129,chr16,MIR3180-5,chr16:2135977-2136129,152
2274620,2274691,chr16,MIR4717,chr16:2274620-2274691,71
2155023,2155105,chr16,SNORD60,chr16:2155023-2155105,82
4633591,4633881,chr16,RN7SL850P,chr16:4633591-4633881,290
4671318,4671390,chr16,MIR6769A,chr16:4671318-4671390,72
2270713,2270772,chr16,MIR3677,chr16:2270713-2270772,59
2133119,2133204,chr16,MIR4516,chr16:2133119-2133204,85
15154850,15155002,chr16,MIR3180-4,chr16:15154850-15155002,152
12720321,12720371,chr16,MIR4718,chr16:12720321-12720371,50
2271747,2271840,chr16,MIR940,chr16:2271747-2271840,93
14911220,14911313,chr16,MIR3180-1,chr16:14911220-14911313,93
15010321,15010397,chr16,MIR1972-1,chr16:15010321-15010397,76
15134075,15134145,chr16,MIR6511B2,chr16:15134075-15134145,70
18411894,18411977,chr16,MIR3179-3,chr16:18411894-18411977,83
17089296,17217047,chr5,BASP1-AS1,chr5:17089296-17217047,127751
18405698,18405762,chr16,MIR3670-3,chr16:18405698-18405762,64
18344013,18344079,chr16,MIR6511A4,chr16:18344013-18344079,66
14643788,14643849,chr16,RNU7-125P,chr16:14643788-14643849,61
18402178,18402271,chr16,MIR3180-3,chr16:18402178-18402271,93
14601823,14602094,chr16,RN7SL274P,chr16:14601823-14602094,271
19498610,19498747,chr16,RNU4-46P,chr16:19498610-19498747,137
14901508,14901591,chr16,MIR3179-1,chr16:14901508-14901591,83
14925937,14926003,chr16,MIR6511A1,chr16:14925937-14926003,66
14303967,14304049,chr16,MIR193B,chr16:14303967-14304049,82
14930820,14930879,chr16,MIR6770-1,chr16:14930820-14930879,59
14309285,14309371,chr16,MIR365A,chr16:14309285-14309371,86
21506049,21506135,chr16,MIR3680-1,chr16:21506049-21506135,86
25185253,25185538,chr16,RN7SL557P,chr16:25185253-25185538,285
126905409,127452517,chr10,DOCK1,chr10:126905409-127452517,547108
2106669,2106753,chr16,MIR6511B1,chr16:2106669-2106753,84
147234963,147387855,chr5,STK32A,chr5:147234963-147387855,152892
27863251,27863356,chr16,RNU6-159P,chr16:27863251-27863356,105
27998295,27998401,chr16,RNU6-1241P,chr16:27998295-27998401,106
18379351,18379410,chr16,MIR6770-3,chr16:18379351-18379410,59
19012157,19012263,chr16,RNU6-1340P,chr16:19012157-19012263,106
14907717,14907781,chr16,MIR3670-1,chr16:14907717-14907781,64
26025237,26025310,chr16,MIR548W,chr16:26025237-26025310,73
26028912,26029025,chr16,RNA5SP405,chr16:26028912-26029025,113
18488301,18488365,chr16,MIR3670-4,chr16:18488301-18488365,64
18494493,18494576,chr16,MIR3179-4,chr16:18494493-18494576,83
35735625,35735733,chr16,RNA5SP409,chr16:35735625-35735733,108
35734393,35734504,chr16,RNA5SP406,chr16:35734393-35734504,111
48731704,48731801,chr16,RNU6-257P,chr16:48731704-48731801,97
35735372,35735471,chr16,RNA5SP408,chr16:35735372-35735471,99
35745989,35746094,chr16,RNA5SP410,chr16:35745989-35746094,105
46556089,46556191,chr16,RNU6-845P,chr16:46556089-46556191,102
35747032,35747140,chr16,RNA5SP413,chr16:35747032-35747140,108
35750061,35750175,chr16,RNA5SP415,chr16:35750061-35750175,114
35751574,35751684,chr16,RNA5SP416,chr16:35751574-35751684,110
31611083,31611356,chr6,UQCRHP1,chr6:31611083-31611356,273
35751828,35751935,chr16,RNA5SP417,chr16:35751828-35751935,107
44228729,44305046,chr19,ZNF235,chr19:44228729-44305046,76317
35752826,35752942,chr16,RNA5SP418,chr16:35752826-35752942,116
35753796,35753930,chr16,RNA5SP419,chr16:35753796-35753930,134
31615217,31617021,chr6,AIF1,chr6:31615217-31617021,1804
35754046,35754182,chr16,RNA5SP420,chr16:35754046-35754182,136
35754555,35754688,chr16,RNA5SP421,chr16:35754555-35754688,133
35754923,35755033,chr16,RNA5SP422,chr16:35754923-35755033,110
35755177,35755285,chr16,RNA5SP423,chr16:35755177-35755285,108
35746523,35746636,chr16,RNA5SP411,chr16:35746523-35746636,113
119302225,119366834,chr2,C2orf76,chr2:119302225-119366834,64609
47505432,47505543,chr16,RNA5SP425,chr16:47505432-47505543,111
35746772,35746894,chr16,RNA5SP412,chr16:35746772-35746894,122
35748520,35748655,chr16,RNA5SP414,chr16:35748520-35748655,135
34162959,34163110,chr16,RNA5-8SP2,chr16:34162959-34163110,151
35734639,35734748,chr16,RNA5SP407,chr16:35734639-35734748,109
55291379,55291675,chr16,RN7SL841P,chr16:55291379-55291675,296
51671236,51671563,chr16,RN7SKP142,chr16:51671236-51671563,327
59540126,59540266,chr16,RNU4-58P,chr16:59540126-59540266,140
11189355,11195981,chr1,ANGPTL7,chr1:11189355-11195981,6626
62187540,62187646,chr16,RNU6-21P,chr16:62187540-62187646,106
66429014,66430733,chr8,RRS1,chr8:66429014-66430733,1719
66301809,66301940,chr16,RNA5SP428,chr16:66301809-66301940,131
61743154,61743476,chr16,RN7SKP76,chr16:61743154-61743476,322
72673503,72673564,chr16,RNU7-90P,chr16:72673503-72673564,61
72821933,72821992,chr16,RNU7-71P,chr16:72821933-72821992,59
75861048,75861157,chr16,RNA5SP430,chr16:75861048-75861157,109
75286712,75286800,chr16,RNU6-758P,chr16:75286712-75286800,88
70608577,70663279,chr8,LACTB2-AS1,chr8:70608577-70663279,54702
76287630,76287739,chr16,RN7SKP233,chr16:76287630-76287739,109
84262815,84262928,chr16,RNA5SP433,chr16:84262815-84262928,113
76469508,76469595,chr16,SNORD33,chr16:76469508-76469595,87
155758992,155807811,chr4,GUCY1B1,chr4:155758992-155807811,48819
85741621,85741700,chr16,MIR1910,chr16:85741621-85741700,79
76868936,76869019,chr16,MIR4719,chr16:76868936-76869019,83
85918347,85918416,chr16,MIR6774,chr16:85918347-85918416,69
82192505,82192790,chr16,RN7SKP190,chr16:82192505-82192790,285
44809071,44821421,chr19,BCAM,chr19:44809071-44821421,12350
69933081,69933180,chr16,MIR140,chr16:69933081-69933180,99
88468918,88469031,chr16,MIR5189,chr16:88468918-88469031,113
81961926,81962243,chr16,RN7SKP176,chr16:81961926-81962243,317
122414332,122428551,chr8,SMILR,chr8:122414332-122428551,14219
87834592,87834660,chr16,MIR6775,chr16:87834592-87834660,68
85659378,85659675,chr16,RN7SL381P,chr16:85659378-85659675,297
85781775,85781899,chr16,RNU1-103P,chr16:85781775-85781899,124
88716278,88716337,chr16,MIR4722,chr16:88716278-88716337,59
2964216,2968383,chr16,KREMEN2,chr16:2964216-2968383,4167
27459756,27479883,chr8,CHRNA2,chr8:27459756-27479883,20127
99598267,99611045,chr7,TMEM225B,chr7:99598267-99611045,12778
128023788,128027166,chr12,LINC02441,chr12:128023788-128027166,3378
139612002,139612363,chr5,H3P25,chr5:139612002-139612363,361
115402380,115402962,chr5,AK3P4,chr5:115402380-115402962,582
20017088,20017187,chrX,MIR23C,chrX:20017088-20017187,99
24961345,24963097,chr1,RUNX3-AS1,chr1:24961345-24963097,1752
20124525,20141838,chrX,EIF1AX,chrX:20124525-20141838,17313
2528745,2530263,chr1,HES5,chr1:2528745-2530263,1518
136080470,136080597,chr5,VTRNA2-1,chr5:136080470-136080597,127
14639426,14641018,chr5,CCT6P2,chr5:14639426-14641018,1592
136381268,136381511,chr5,HSPD1P18,chr5:136381268-136381511,243
125958688,125983665,chr12,LINC00939,chr12:125958688-125983665,24977
99616946,99632408,chr7,ZSCAN25,chr7:99616946-99632408,15462
31623079,31623210,chr6,SNORA38,chr6:31623079-31623210,131
31633787,31633858,chr6,MIR6832,chr6:31633787-31633858,71
31652416,31658210,chr6,APOM,chr6:31652416-31658210,5794
95713522,95824383,chr5,RHOBTB3,chr5:95713522-95824383,110861
84639285,84654343,chr15,WDR73,chr15:84639285-84654343,15058
65666695,65667737,chr2,KRT18P33,chr2:65666695-65667737,1042
107754112,107822129,chr2,GACAT1,chr2:107754112-107822129,68017
7954291,7985505,chr1,PARK7,chr1:7954291-7985505,31214
91877969,91880195,chr2,PABPC1P6,chr2:91877969-91880195,2226
26335352,26833194,chr12,ITPR2,chr12:26335352-26833194,497842
113610502,113627090,chr2,RPL23AP7,chr2:113610502-113627090,16588
153761450,153762646,chr2,DNAJA1P2,chr2:153761450-153762646,1196
127183832,127220313,chr2,CYP27C1,chr2:127183832-127220313,36481
20139968,20140444,chrX,EIF1AX-AS1,chrX:20139968-20140444,476
20149911,20267519,chrX,RPS6KA3,chrX:20149911-20267519,117608
99648194,99679998,chr7,CYP3A5,chr7:99648194-99679998,31804
31658298,31660778,chr6,C6orf47,chr6:31658298-31660778,2480
31658329,31660721,chr6,C6orf47-AS1,chr6:31658329-31660721,2392
31661228,31666283,chr6,GPANK1,chr6:31661228-31666283,5055
29304305,29396095,chr5,LINC02064,chr5:29304305-29396095,91790
43166256,43186536,chr19,PSG5,chr19:43166256-43186536,20280
72887382,72892158,chr2,SPR,chr2:72887382-72892158,4776
37983070,37983373,chr8,RPL12P48,chr8:37983070-37983373,303
73277364,73278046,chr8,PRXL2AP2,chr8:73277364-73278046,682
146477427,146478113,chr2,OTX2P2,chr2:146477427-146478113,686
98371228,98942827,chr8,STK3,chr8:98371228-98942827,571599
24067586,24076373,chr2,SF3B6,chr2:24067586-24076373,8787
95907603,96033745,chr10,CC2D2B,chr10:95907603-96033745,126142
2968024,2980479,chr16,PKMYT1,chr16:2968024-2980479,12455
20529467,20529976,chr2,NDUFAF2P1,chr2:20529467-20529976,509
61201304,61304811,chr5,LINC02057,chr5:61201304-61304811,103507
2549920,2557031,chr1,TNFRSF14-AS1,chr1:2549920-2557031,7111
35292125,35313807,chr19,MAG,chr19:35292125-35313807,21682
134924648,134926459,chr5,MTND5P11,chr5:134924648-134926459,1811
115974513,115976275,chr5,DDX43P1,chr5:115974513-115976275,1762
173075435,173268015,chr2,MAP3K20,chr2:173075435-173268015,192580
16241213,16241398,chr1,MT1XP1,chr1:16241213-16241398,185
94567461,94568909,chr5,MTND5P12,chr5:94567461-94568909,1448
12938472,12947580,chr1,PRAMEF6,chr1:12938472-12947580,9108
109088188,109093631,chr12,ALKBH2,chr12:109088188-109093631,5443
99685145,99700034,chr7,CYP3A51P,chr7:99685145-99700034,14889
99705036,99735196,chr7,CYP3A7,chr7:99705036-99735196,30160
138610967,138935034,chr5,CTNNA1,chr5:138610967-138935034,324067
31670167,31673776,chr6,LY6G5B,chr6:31670167-31673776,3609
24745382,24844321,chr1,CLIC4,chr1:24745382-24844321,98939
31676684,31684040,chr6,LY6G5C,chr6:31676684-31684040,7356
42678873,42679124,chr12,RPS27P21,chr12:42678873-42679124,251
104129888,104232364,chr10,CFAP43,chr10:104129888-104232364,102476
31754720,31755121,chr12,IFITM3P2,chr12:31754720-31755121,401
84669597,84966690,chr4,WDFY3,chr4:84669597-84966690,297093
118149801,118372907,chr12,TAOK3,chr12:118149801-118372907,223106
99820018,99820086,chr7,CYP3A137P,chr7:99820018-99820086,68
85987323,86154225,chr8,ATP6V0D2,chr8:85987323-86154225,166902
27206930,27207796,chr1,NPM1P39,chr1:27206930-27207796,866
99872168,99872258,chr7,CYP3A52P,chr7:99872168-99872258,90
12822686,12823159,chr1,LINC01784,chr1:12822686-12823159,473
75647912,75662301,chr15,SNX33,chr15:75647912-75662301,14389
99923266,99929620,chr7,GJC3,chr7:99923266-99929620,6354
27392622,27395814,chr1,GPR3,chr1:27392622-27395814,3192
31686955,31703356,chr6,ABHD16A,chr6:31686955-31703356,16401
118193725,118225094,chr11,JAML,chr11:118193725-118225094,31369
27325329,27325796,chr1,ACTG1P20,chr1:27325329-27325796,467
146116002,148420998,chr7,CNTNAP2,chr7:146116002-148420998,2304996
26519354,26520250,chr1,DPPA2P2,chr1:26519354-26520250,896
16197854,16198357,chr1,ARHGEF19-AS1,chr1:16197854-16198357,503
6783892,6784843,chr1,CAMTA1-DT,chr1:6783892-6784843,951
43628503,43668118,chr15,CATSPER2,chr15:43628503-43668118,39615
15807169,15809348,chr1,UQCRHL,chr1:15807169-15809348,2179
64914361,64944591,chr14,CHURC1,chr14:64914361-64944591,30230
101166805,101169629,chr8,ZNNT1,chr8:101166805-101169629,2824
27379176,27383333,chr1,CD164L2,chr1:27379176-27383333,4157
37962990,37966599,chr8,ADRB3,chr8:37962990-37966599,3609
18513118,18513383,chr1,DYNLL1P3,chr1:18513118-18513383,265
67569416,67570078,chr8,NACAP10,chr8:67569416-67570078,662
16352575,16398145,chr1,SZRD1,chr1:16352575-16398145,45570
102644479,102658318,chr10,TRIM8,chr10:102644479-102658318,13839
127072694,127227541,chr8,CASC19,chr8:127072694-127227541,154847
39114285,39136973,chr14,GEMIN2,chr14:39114285-39136973,22688
128236716,128318868,chr2,HS6ST1,chr2:128236716-128318868,82152
58183029,58213562,chr19,ZNF274,chr19:58183029-58213562,30533
120217479,120223400,chr2,TMEM185B,chr2:120217479-120223400,5921
19912860,19991061,chrX,BCLAF3,chrX:19912860-19991061,78201
91957436,91963610,chr2,CHEK2P3,chr2:91957436-91963610,6174
112973203,112985658,chr2,IL36G,chr2:112973203-112985658,12455
2969270,2973484,chr16,PAQR4,chr16:2969270-2973484,4214
26111165,26125555,chr1,PDIK1L,chr1:26111165-26125555,14390
132580117,132580223,chrX,RNU6-98P,chrX:132580117-132580223,106
87700984,87738105,chr2,ANAPC1P4,chr2:87700984-87738105,37121
132667642,132669888,chrX,HS6ST2-AS1,chrX:132667642-132669888,2246
132907279,132907575,chrX,NAA20P1,chrX:132907279-132907575,296
133023168,133097109,chrX,USP26,chrX:133023168-133097109,73941
147080934,147097609,chr7,CNTNAP2-AS1,chr7:147080934-147097609,16675
112853328,112854122,chr2,XIAPP3,chr2:112853328-112854122,794
147146342,147146756,chr7,DUTP3,chr7:147146342-147146756,414
147167344,147167572,chr7,RANP2,chr7:147167344-147167572,228
147378017,147378121,chr7,MIR548F4,chr7:147378017-147378121,104
119942834,119992838,chrX,RHOXF1P3,chrX:119942834-119992838,50004
117023918,117024867,chr2,MTND1P28,chr2:117023918-117024867,949
147831770,147831877,chr7,RNU6-1184P,chr7:147831770-147831877,107
45847042,45851541,chrX,LINC02595,chrX:45847042-45851541,4499
2988256,3002016,chr16,GREP1,chr16:2988256-3002016,13760
147849884,147849982,chr7,RNA5SP249,chr7:147849884-147849982,98
122560665,122643736,chr10,DMBT1,chr10:122560665-122643736,83071
147940007,147940301,chr7,RN7SL456P,chr7:147940007-147940301,294
6785454,7769706,chr1,CAMTA1,chr1:6785454-7769706,984252
138897151,138898098,chr2,YY1P2,chr2:138897151-138898098,947
148438309,148438577,chr7,RN7SL72P,chr7:148438309-148438577,268
86503430,86563479,chr2,CHMP3,chr2:86503430-86563479,60049
55179750,55188934,chr7,EGFR-AS1,chr7:55179750-55188934,9184
55819790,55837489,chr4,EXOC1L,chr4:55819790-55837489,17699
55235965,55255635,chr7,ELDR,chr7:55235965-55255635,19670
154563011,154572807,chr4,FGB,chr4:154563011-154572807,9796
55259809,55260256,chr7,CALM1P2,chr7:55259809-55260256,447
76087444,76087547,chr7,RNU6-863P,chr7:76087444-76087547,103
3012923,3014505,chr16,CLDN9,chr16:3012923-3014505,1582
76090431,76108779,chr7,GTF2IP7,chr7:76090431-76108779,18348
3014712,3020071,chr16,CLDN6,chr16:3014712-3020071,5359
118208932,118209211,chr11,HSPE1P18,chr11:118208932-118209211,279
76201896,76287288,chr7,SRRM3,chr7:76201896-76287288,85392
56918623,57299281,chr15,TCF12,chr15:56918623-57299281,380658
118226690,118252365,chr11,MPZL3,chr11:118226690-118252365,25675
72609034,72894101,chr14,DPF3,chr14:72609034-72894101,285067
3024027,3027755,chr16,THOC6,chr16:3024027-3027755,3728
78326680,78359746,chr12,LINC02424,chr12:78326680-78359746,33066
118136124,118145584,chr12,PEBP1,chr12:118136124-118145584,9460
132120859,132481095,chr8,KCNQ3,chr8:132120859-132481095,360236
120120953,120245273,chrX,NKAPP1,chrX:120120953-120245273,124320
128650998,128652145,chr9,VTI1BP4,chr9:128650998-128652145,1147
29811991,29824312,chr19,CCNE1,chr19:29811991-29824312,12321
111491272,111570974,chr2,SOCAR,chr2:111491272-111570974,79702
76326799,76358991,chr7,YWHAG,chr7:76326799-76358991,32192
118253416,118264536,chr11,MPZL2,chr11:118253416-118264536,11120
35053928,35072668,chr9,VCP,chr9:35053928-35072668,18740
96060024,96060375,chr12,YPEL5P3,chr12:96060024-96060375,351
111295629,111296046,chr2,RPS14P4,chr2:111295629-111296046,417
16440721,16460078,chr1,NECAP2,chr1:16440721-16460078,19357
76361768,76362113,chr7,PPIAP81,chr7:76361768-76362113,345
76389334,76409697,chr7,SSC4D,chr7:76389334-76409697,20363
13266041,13303452,chrX,LINC02154,chrX:13266041-13303452,37411
120341330,120369164,chr12,MSI1,chr12:120341330-120369164,27834
125314918,125492932,chr4,FAT4,chr4:125314918-125492932,178014
48529925,48776517,chr2,STON1-GTF2A1L,chr2:48529925-48776517,246592
54530183,54621521,chrX,GNL3L,chrX:54530183-54621521,91338
76397518,76442071,chr7,ZP3,chr7:76397518-76442071,44553
118344344,118355161,chr11,CD3G,chr11:118344344-118355161,10817
35351552,35353862,chr19,FFAR1,chr19:35351552-35353862,2310
128086621,128118656,chr12,LINC02369,chr12:128086621-128118656,32035
31701029,31701091,chr6,MIR4646,chr6:31701029-31701091,62
31706866,31710679,chr6,LY6G6F,chr6:31706866-31710679,3813
52190048,52229518,chr19,PPP2R1A,chr19:52190048-52229518,39470
31706904,31717918,chr6,LY6G6F-LY6G6D,chr6:31706904-31717918,11014
55294490,55294598,chr4,RNU6-746P,chr4:55294490-55294598,108
55313011,55313924,chr4,LRRC34P2,chr4:55313011-55313924,913
19920607,19921578,chr14,OR4K5,chr14:19920607-19921578,971
18166929,18179346,chr1,IGSF21-AS1,chr1:18166929-18179346,12417
76470162,76471058,chr7,FDPSP2,chr7:76470162-76471058,896
55351812,55352408,chr4,FCF1P8,chr4:55351812-55352408,596
102957674,102960513,chr12,ASCL1,chr12:102957674-102960513,2839
18601117,18602097,chr14,OR11H12,chr14:18601117-18602097,980
65377592,65378111,chr8,PPIAP86,chr8:65377592-65378111,519
20190896,20201075,chr14,OR11G2,chr14:20190896-20201075,10179
55363971,55395847,chr4,SRD5A3-AS1,chr4:55363971-55395847,31876
128405269,128564679,chr8,LINC00824,chr8:128405269-128564679,159410
26169516,26171831,chr1,ZNF593OS,chr1:26169516-26171831,2315
104138587,104180894,chr14,KIF26A,chr14:104138587-104180894,42307
76302673,76304295,chr7,HSPB1,chr7:76302673-76304295,1622
31718648,31721746,chr6,LY6G6C,chr6:31718648-31721746,3098
109023089,109088023,chr12,USP30,chr12:109023089-109088023,64934
72189558,72196323,chr11,FOLR1,chr11:72189558-72196323,6765
125951861,125952314,chr8,SOD1P3,chr8:125951861-125952314,453
11664200,11674354,chr1,FBXO6,chr1:11664200-11674354,10154
71448811,71449219,chr8,TRAPPC2P2,chr8:71448811-71449219,408
31730581,31739763,chr6,CLIC1,chr6:31730581-31739763,9182
107647279,107648032,chr8,PGAM1P13,chr8:107647279-107648032,753
69424849,69448282,chr8,LINC01603,chr8:69424849-69448282,23433
3027682,3036944,chr16,BICDL2,chr16:3027682-3036944,9262
16087525,16502504,chr7,CRPPA,chr7:16087525-16502504,414979
55395957,55453397,chr4,TMEM165,chr4:55395957-55453397,57440
58805412,59119147,chr8,TOX,chr8:58805412-59119147,313735
22322840,22323331,chr1,PPIAP34,chr1:22322840-22323331,491
23321457,23326163,chr14,PABPN1,chr14:23321457-23326163,4706
30732469,30757774,chr1,LAPTM5,chr1:30732469-30757774,25305
3069523,3069651,chr16,RNU1-125P,chr16:3069523-3069651,128
130052104,130443674,chr8,ASAP1,chr8:130052104-130443674,391570
16208945,16209265,chr7,RPL36AP29,chr7:16208945-16209265,320
109614364,109618990,chr2,SOWAHC,chr2:109614364-109618990,4626
3086143,3086300,chr16,RNU1-22P,chr16:3086143-3086300,157
16210484,16270604,chr7,CRPPA-AS1,chr7:16210484-16270604,60120
185652374,185800151,chr2,FSIP2-AS1,chr2:185652374-185800151,147777
3088890,3099295,chr16,ZSCAN10,chr16:3088890-3099295,10405
103845151,103919548,chrX,TMSB15B-AS1,chrX:103845151-103919548,74397
26037252,26046118,chr1,SLC30A2,chr1:26037252-26046118,8866
146587506,146589310,chr2,PABPC1P2,chr2:146587506-146589310,1804
16461481,16530580,chr7,SOSTDC1,chr7:16461481-16530580,69099
1793293,1808872,chr4,FGFR3,chr4:1793293-1808872,15579
105744912,105894274,chr2,NCK2,chr2:105744912-105894274,149362
146203605,146289223,chr5,RBM27,chr5:146203605-146289223,85618
95821766,95925315,chr11,MTMR2,chr11:95821766-95925315,103549
118246084,118246962,chr12,RPS2P5,chr12:118246084-118246962,878
126094112,126177632,chr12,LINC02359,chr12:126094112-126177632,83520
16526825,16581568,chr7,LRRC72,chr7:16526825-16581568,54743
149938613,150224580,chrX,LINC00894,chrX:149938613-150224580,285967
57134096,57145202,chr19,ZIM3,chr19:57134096-57145202,11106
28369582,28500364,chr1,PHACTR4,chr1:28369582-28500364,130782
21667886,21673818,chr14,OR4E1,chr14:21667886-21673818,5932
5495819,5495917,chr7,MIR589,chr7:5495819-5495917,98
24439766,24442905,chr14,SDR39U1,chr14:24439766-24442905,3139
54923509,54966312,chr19,NLRP7,chr19:54923509-54966312,42803
89919437,89919776,chr12,BRWD1P2,chr12:89919437-89919776,339
5526409,5563902,chr7,ACTB,chr7:5526409-5563902,37493
3129777,3142804,chr16,ZNF213,chr16:3129777-3142804,13027
58565959,58781747,chr12,LINC02388,chr12:58565959-58781747,215788
54517759,54546586,chr5,SNX18,chr5:54517759-54546586,28827
111034165,111350554,chr12,CUX2,chr12:111034165-111350554,316389
190189735,190344193,chr2,HIBCH,chr2:190189735-190344193,154458
8949630,8950559,chr4,OR7E85BP,chr4:8949630-8950559,929
8959628,8963981,chr4,UNC93B8,chr4:8959628-8963981,4353
115840899,115908066,chrX,DANT1,chrX:115840899-115908066,67167
8981436,8982360,chr4,OR7E111FP,chr4:8981436-8982360,924
31739677,31762676,chr6,MSH5,chr6:31739677-31762676,22999
80228489,80335364,chrX,CHMP1B2P,chrX:80228489-80335364,106875
9051842,9052051,chr4,SNRPCP16,chr4:9051842-9052051,209
68215756,68301821,chr5,PIK3R1,chr5:68215756-68301821,86065
3144015,3149963,chr16,CASP16P,chr16:3144015-3149963,5948
9079023,9141608,chr4,ENPP7P10,chr4:9079023-9141608,62585
25125053,25125454,chr1,IFITM3P7,chr1:25125053-25125454,401
3204247,3205188,chr16,OR1F1,chr16:3204247-3205188,941
117144284,117176894,chr11,PAFAH1B2,chr11:117144284-117176894,32610
3215611,3216543,chr16,OR1F2P,chr16:3215611-3216543,932
3263743,3267567,chr16,LINC00921,chr16:3263743-3267567,3824
127914707,127960028,chr12,LINC00507,chr12:127914707-127960028,45321
153152163,153339319,chr4,TRIM2,chr4:153152163-153339319,187156
3263800,3301401,chr16,ZNF263,chr16:3263800-3301401,37601
2609340,2658924,chrX,CD99P1,chrX:2609340-2658924,49584
26177484,26189884,chr1,CNKSR1,chr1:26177484-26189884,12400
77265483,77271206,chr14,NGB,chr14:77265483-77271206,5723
19712904,19714332,chr14,OR11H2,chr14:19712904-19714332,1428
46839629,47675605,chr14,MDGA2,chr14:46839629-47675605,835976
3298808,3305729,chr16,TIGD7,chr16:3298808-3305729,6921
109539711,109565996,chr8,EBAG9,chr8:109539711-109565996,26285
58244378,58244865,chr12,RPL21P103,chr12:58244378-58244865,487
117178736,117197445,chr11,SIDT2,chr11:117178736-117197445,18709
120036236,120146855,chrX,RHOXF1-AS1,chrX:120036236-120146855,110619
131949942,132080460,chr12,EP400,chr12:131949942-132080460,130518
3355889,3357306,chr16,OR2C1,chr16:3355889-3357306,1417
136639539,136642429,chrX,LINC00892,chrX:136639539-136642429,2890
33589206,33589688,chr19,RPL21P131,chr19:33589206-33589688,482
3367719,3369246,chr16,MTCO1P28,chr16:3367719-3369246,1527
46256759,46327680,chrX,LINC01186,chrX:46256759-46327680,70921
3369957,3370906,chr16,MTND1P8,chr16:3369957-3370906,949
3370979,3372668,chr16,MTRNR2L4,chr16:3370979-3372668,1689
5592816,5606655,chr7,FSCN1,chr7:5592816-5606655,13839
42654200,42669076,chr19,CEACAMP5,chr19:42654200-42669076,14876
3401215,3409364,chr16,ZNF174,chr16:3401215-3409364,8149
43192702,43207299,chr19,PSG4,chr19:43192702-43207299,14597
140709562,140793215,chrX,LINC00632,chrX:140709562-140793215,83653
5662432,5680461,chr7,RNF216-IT1,chr7:5662432-5680461,18029
5711840,5711910,chr7,MIR6874,chr7:5711840-5711910,70
20891385,20892348,chr14,RNASE3,chr14:20891385-20892348,963
3432414,3443504,chr16,ZNF597,chr16:3432414-3443504,11090
151238764,151277896,chr7,SMARCD3,chr7:151238764-151277896,39132
21768489,21769080,chr14,TRAV6,chr14:21768489-21769080,591
21782993,21783503,chr14,TRAV7,chr14:21782993-21783503,510
21797287,21797886,chr14,TRAV8-1,chr14:21797287-21797886,599
21811502,21811977,chr14,TRAV9-1,chr14:21811502-21811977,475
21825472,21826075,chr14,TRAV10,chr14:21825472-21826075,603
21829539,21830070,chr14,TRAV11,chr14:21829539-21830070,531
21841240,21841774,chr14,TRAV12-1,chr14:21841240-21841774,534
21846537,21847221,chr14,TRAV8-2,chr14:21846537-21847221,684
21852558,21853006,chr14,TRAV8-3,chr14:21852558-21853006,448
3443649,3486953,chr16,NAA60,chr16:3443649-3486953,43304
21868839,21869365,chr14,TRAV13-1,chr14:21868839-21869365,526
154424378,154428512,chrX,CH17-340M24.3,chrX:154424378-154428512,4134
21887857,21888502,chr14,TRAV12-2,chr14:21887857-21888502,645
63222993,63561095,chrX,LINC01278,chrX:63222993-63561095,338102
21894433,21895030,chr14,TRAV8-4,chr14:21894433-21895030,597
21903077,21904598,chr14,TRAV8-5,chr14:21903077-21904598,1521
21918188,21918756,chr14,TRAV13-2,chr14:21918188-21918756,568
21924063,21924651,chr14,TRAV14DV4,chr14:21924063-21924651,588
64580365,64583627,chr8,BHLHE22,chr8:64580365-64583627,3262
138901433,138902747,chr2,AHCYP4,chr2:138901433-138902747,1314
21941128,21941657,chr14,TRAV9-2,chr14:21941128-21941657,529
128199901,128200195,chr2,DYNLT3P2,chr2:128199901-128200195,294
21950406,21950654,chr14,TRAV15,chr14:21950406-21950654,248
119165034,119245673,chr8,MAL2,chr8:119165034-119245673,80639
155313440,155313958,chr2,MTND6P9,chr2:155313440-155313958,518
21965451,21966061,chr14,TRAV12-3,chr14:21965451-21966061,610
21978459,21979120,chr14,TRAV8-6,chr14:21978459-21979120,661
23943846,23944351,chr2,SDHCP3,chr2:23943846-23944351,505
128518788,128519177,chr2,ISCA1P6,chr2:128518788-128519177,389
21990496,21990938,chr14,TRAV16,chr14:21990496-21990938,442
21997539,21998168,chr14,TRAV17,chr14:21997539-21998168,629
31948334,31948827,chr12,RPL12P32,chr12:31948334-31948827,493
173166446,173282036,chr2,MAP3K20-AS1,chr2:173166446-173282036,115590
22003106,22003673,chr14,TRAV18,chr14:22003106-22003673,567
94423744,94424969,chr12,RBMS2P1,chr12:94423744-94424969,1225
111899263,111901391,chr12,ADAM1A,chr12:111899263-111901391,2128
110809394,110809894,chr8,NDUFB9P3,chr8:110809394-110809894,500
22007512,22008181,chr14,TRAV19,chr14:22007512-22008181,669
2717510,2730037,chr9,KCNV2,chr9:2717510-2730037,12527
106940880,106941482,chr2,PPP1R2P5,chr2:106940880-106941482,602
72537225,72938349,chr8,KCNB2,chr8:72537225-72938349,401124
120369440,120371688,chr12,RPS27P25,chr12:120369440-120371688,2248
109251422,109251646,chr2,SNRPGP9,chr2:109251422-109251646,224
22040594,22041153,chr14,TRAV20,chr14:22040594-22041153,559
185719874,185740479,chr2,FSIP2-AS2,chr2:185719874-185740479,20605
70273369,70273837,chr8,BTF3P12,chr8:70273369-70273837,468
22052514,22053056,chr14,TRAV21,chr14:22052514-22053056,542
38941401,38975742,chr19,FBXO17,chr19:38941401-38975742,34341
22070557,22071208,chr14,TRAV22,chr14:22070557-22071208,651
123768439,123815452,chr8,FAM91A1,chr8:123768439-123815452,47013
2621182,2660056,chr9,VLDLR,chr9:2621182-2660056,38874
22086407,22086961,chr14,TRAV23DV6,chr14:22086407-22086961,554
26401920,26456711,chr2,DRC1,chr2:26401920-26456711,54791
70415352,70448015,chr5,GTF2H2B,chr5:70415352-70448015,32663
22096032,22096619,chr14,TRDV1,chr14:22096032-22096619,587
68842197,68971570,chr12,CPM,chr12:68842197-68971570,129373
22105343,22105846,chr14,TRAV24,chr14:22105343-22105846,503
22112347,22113031,chr14,TRAV25,chr14:22112347-22113031,684
22123318,22124285,chr14,TRAV26-1,chr14:22123318-22124285,967
22132553,22133034,chr14,TRAV8-7,chr14:22132553-22133034,481
44512535,44541330,chr7,NPC1L1,chr7:44512535-44541330,28795
22147995,22148633,chr14,TRAV27,chr14:22147995-22148633,638
45745210,45770274,chrX,MIR222HG,chrX:45745210-45770274,25064
22155079,22155638,chr14,TRAV28,chr14:22155079-22155638,559
22163238,22163870,chr14,TRAV29DV5,chr14:22163238-22163870,632
84934113,84934895,chrX,UBE2DNL,chrX:84934113-84934895,782
22168429,22168988,chr14,TRAV30,chr14:22168429-22168988,559
22177273,22177864,chr14,TRAV31,chr14:22177273-22177864,591
22185562,22186057,chr14,TRAV32,chr14:22185562-22186057,495
22190158,22190713,chr14,TRAV33,chr14:22190158-22190713,555
22202583,22203368,chr14,TRAV26-2,chr14:22202583-22203368,785
38335775,38370943,chr19,CATSPERG,chr19:38335775-38370943,35168
22207522,22208129,chr14,TRAV34,chr14:22207522-22208129,607
75455994,75456578,chr2,GAPDHP57,chr2:75455994-75456578,584
22221896,22222475,chr14,TRAV35,chr14:22221896-22222475,579
22226746,22227254,chr14,TRAV36DV7,chr14:22226746-22227254,508
144754776,144755998,chr2,SGCEP1,chr2:144754776-144755998,1222
139668547,139669305,chr2,MRPS18BP2,chr2:139668547-139669305,758
22265749,22266264,chr14,TRAV37,chr14:22265749-22266264,515
22271968,22272563,chr14,TRAV38-1,chr14:22271968-22272563,595
102769158,102885406,chrX,LINC00630,chrX:102769158-102885406,116248
117199370,117207464,chr11,TAGLN,chr11:117199370-117207464,8094
22281105,22281748,chr14,TRAV38-2DV8,chr14:22281105-22281748,643
98619106,98731132,chr2,MGAT4A,chr2:98619106-98731132,112026
22304054,22304553,chr14,TRAV39,chr14:22304054-22304553,499
22314490,22314919,chr14,TRAV40,chr14:22314490-22314919,429
22320188,22320691,chr14,TRAV41,chr14:22320188-22320691,503
105736343,105743071,chr14,IGHG1,chr14:105736343-105743071,6728
153344649,153415118,chr4,MND1,chr4:153344649-153415118,70469
105764503,105771405,chr14,IGHG3,chr14:105764503-105771405,6902
105194990,105196969,chr8,TMCC1P1,chr8:105194990-105196969,1979
31765743,31768201,chr15,DEPDC1P1,chr15:31765743-31768201,2458
73940435,74293574,chrX,FTX,chrX:73940435-74293574,353139
105785505,105785831,chr14,ATP6V1G1P1,chr14:105785505-105785831,326
105836765,105845677,chr14,IGHD,chr14:105836765-105845677,8912
52411742,52421867,chr12,KRT90P,chr12:52411742-52421867,10125
26159079,26163962,chr1,FAM110D,chr1:26159079-26163962,4883
105851705,105856218,chr14,IGHM,chr14:105851705-105856218,4513
131165011,131232940,chr12,LINC01257,chr12:131165011-131232940,67929
31923438,32173018,chr15,CHRNA7,chr15:31923438-32173018,249580
129007036,129028331,chr9,SH3GLB2,chr9:129007036-129028331,21295
61909984,61910802,chr8,C1GALT1P3,chr8:61909984-61910802,818
6221193,6235972,chr1,ICMT,chr1:6221193-6235972,14779
105857513,105857572,chr14,MIR4539,chr14:105857513-105857572,59
105858124,105858175,chr14,MIR4507,chr14:105858124-105858175,51
105858165,105858242,chr14,MIR4538,chr14:105858165-105858242,77
105859484,105859553,chr14,MIR4537,chr14:105859484-105859553,69
29658376,29658798,chr12,RPL21P99,chr12:29658376-29658798,422
105863198,105863258,chr14,IGHJ6,chr14:105863198-105863258,60
133036728,133102912,chr8,SLA,chr8:133036728-133102912,66184
105863416,105863465,chr14,IGHJ3P,chr14:105863416-105863465,49
105863814,105863862,chr14,IGHJ5,chr14:105863814-105863862,48
31740020,31764851,chr6,MSH5-SAPCD1,chr6:31740020-31764851,24831
59020169,59020894,chr12,RPS6P22,chr12:59020169-59020894,725
105864215,105864260,chr14,IGHJ4,chr14:105864215-105864260,45
111879338,111880249,chr12,RPS2P41,chr12:111879338-111880249,911
117232625,117286454,chr11,RNF214,chr11:117232625-117286454,53829
105864587,105864635,chr14,IGHJ3,chr14:105864587-105864635,48
65142703,65145763,chr4,EFL1P2,chr4:65142703-65145763,3060
108858932,108901043,chr12,DAO,chr12:108858932-108901043,42111
105864793,105864852,chr14,IGHJ2P,chr14:105864793-105864852,59
105865199,105865250,chr14,IGHJ2,chr14:105865199-105865250,51
154337471,154338452,chr5,HNRNPA3P7,chr5:154337471-154338452,981
65225867,65241814,chr4,LINC02835,chr4:65225867-65241814,15947
105865407,105865458,chr14,IGHJ1,chr14:105865407-105865458,51
197250858,197302519,chr2,ANKRD44-IT1,chr2:197250858-197302519,51661
105865551,105865561,chr14,IGHD7-27,chr14:105865551-105865561,10
65669961,65698029,chr4,EPHA5-AS1,chr4:65669961-65698029,28068
105865624,105865678,chr14,IGHJ1P,chr14:105865624-105865678,54
157731420,157741449,chr5,THG1L,chr5:157731420-157741449,10029
105881034,105881053,chr14,IGHD1-26,chr14:105881034-105881053,19
105881539,105881556,chr14,IGHD6-25,chr14:105881539-105881556,17
65807240,65807435,chr4,RNU2-40P,chr4:65807240-65807435,195
105883903,105883922,chr14,IGHD5-24,chr14:105883903-105883922,19
100820139,100996829,chr2,NPAS2,chr2:100820139-100996829,176690
152927446,152928207,chr4,FAM192BP,chr4:152927446-152928207,761
105884870,105884888,chr14,IGHD4-23,chr14:105884870-105884888,18
105886031,105886061,chr14,IGHD3-22,chr14:105886031-105886061,30
105888551,105888578,chr14,IGHD2-21,chr14:105888551-105888578,27
27404230,27490167,chr1,WASF2,chr1:27404230-27490167,85937
86876205,86892422,chr4,C4orf36,chr4:86876205-86892422,16217
105891191,105891207,chr14,IGHD1-20,chr14:105891191-105891207,16
105891699,105891719,chr14,IGHD6-19,chr14:105891699-105891719,20
105893542,105893561,chr14,IGHD5-18,chr14:105893542-105893561,19
105894508,105894523,chr14,IGHD4-17,chr14:105894508-105894523,15
87152409,87196337,chr7,DMTF1,chr7:87152409-87196337,43928
105895634,105895670,chr14,IGHD3-16,chr14:105895634-105895670,36
105897957,105897987,chr14,IGHD2-15,chr14:105897957-105897987,30
181329241,181342213,chr5,SEPTIN14P5,chr5:181329241-181342213,12972
105900638,105900654,chr14,IGHD1-14,chr14:105900638-105900654,16
105901142,105901162,chr14,IGHD6-13,chr14:105901142-105901162,20
28285964,28287807,chr5,LINC02103,chr5:28285964-28287807,1843
105902649,105902671,chr14,IGHD5-12,chr14:105902649-105902671,22
57625454,57693077,chr3,DENND6A,chr3:57625454-57693077,67623
105903616,105903631,chr14,IGHD4-11,chr14:105903616-105903631,15
105904497,105904527,chr14,IGHD3-10,chr14:105904497-105904527,30
105904681,105904711,chr14,IGHD3-9,chr14:105904681-105904711,30
105907211,105907241,chr14,IGHD2-8,chr14:105907211-105907241,30
98410235,98411792,chr5,MTCO1P24,chr5:98410235-98411792,1557
105909907,105909923,chr14,IGHD1-7,chr14:105909907-105909923,16
105910410,105910427,chr14,IGHD6-6,chr14:105910410-105910427,17
105912257,105912276,chr14,IGHD5-5,chr14:105912257-105912276,19
105913222,105913237,chr14,IGHD4-4,chr14:105913222-105913237,15
52787916,52804044,chr5,PELO,chr5:52787916-52804044,16128
28329002,28335965,chr1,MED18,chr1:28329002-28335965,6963
105914359,105914389,chr14,IGHD3-3,chr14:105914359-105914389,30
105916826,105916856,chr14,IGHD2-2,chr14:105916826-105916856,30
105919502,105919518,chr14,IGHD1-1,chr14:105919502-105919518,16
105939756,105940253,chr14,IGHV6-1,chr14:105939756-105940253,497
105945210,105945389,chr14,IGHVII-1-1,chr14:105945210-105945389,179
86949669,86950113,chr4,TECRP1,chr4:86949669-86950113,444
105969729,105972269,chr14,ADAM6,chr14:105969729-105972269,2540
157029413,157059119,chr5,HAVCR1,chr5:157029413-157059119,29706
87160103,87240314,chr4,KLHL8,chr4:87160103-87240314,80211
105986582,105987083,chr14,IGHV1-2,chr14:105986582-105987083,501
106001534,106001824,chr14,IGHVIII-2-1,chr14:106001534-106001824,290
106005095,106005574,chr14,IGHV1-3,chr14:106005095-106005574,479
2632568,2636620,chr1,MMEL1-AS1,chr1:2632568-2636620,4052
30013952,30037612,chr1,LINC01648,chr1:30013952-30037612,23660
106011922,106012420,chr14,IGHV4-4,chr14:106011922-106012420,498
54122547,55074557,chr3,CACNA2D3,chr3:54122547-55074557,952010
106025145,106025630,chr14,IGHV7-4-1,chr14:106025145-106025630,485
106037902,106038365,chr14,IGHV2-5,chr14:106037902-106038365,463
44297104,44297355,chr19,NDUFA3P1,chr19:44297104-44297355,251
27098809,27166981,chr1,SLC9A1,chr1:27098809-27166981,68172
42670005,42670816,chr19,RPS10P28,chr19:42670005-42670816,811
106039666,106039764,chr14,IGHVIII-5-1,chr14:106039666-106039764,98
106045600,106045860,chr14,IGHVIII-5-2,chr14:106045600-106045860,260
106055549,106055998,chr14,IGHV3-6,chr14:106055549-106055998,449
106062151,106062683,chr14,IGHV3-7,chr14:106062151-106062683,532
3485381,3485469,chr16,MIR6126,chr16:3485381-3485469,88
32830509,32869767,chr19,SLC7A9,chr19:32830509-32869767,39258
106636672,106636786,chr14,RNA5SP389,chr14:106636672-106636786,114
3493484,3495489,chr16,C16orf90,chr16:3493484-3495489,2005
106637718,106637973,chr14,IGHVII-60-1,chr14:106637718-106637973,255
31756951,31757053,chr6,RNU6-850P,chr6:31756951-31757053,102
106639119,106639657,chr14,IGHV4-61,chr14:106639119-106639657,538
31762996,31764851,chr6,SAPCD1,chr6:31762996-31764851,1855
53935328,53939643,chr12,HOXC13-AS,chr12:53935328-53939643,4315
106643142,106643585,chr14,IGHV3-62,chr14:106643142-106643585,443
106650551,106650785,chr14,IGHVII-62-1,chr14:106650551-106650785,234
106652237,106652681,chr14,IGHV3-63,chr14:106652237-106652681,444
106657725,106658258,chr14,IGHV3-64,chr14:106657725-106658258,533
79558782,79559166,chr12,NOP56P3,chr12:79558782-79559166,384
110846769,110907535,chr12,CCDC63,chr12:110846769-110907535,60766
106666092,106666532,chr14,IGHV3-65,chr14:106666092-106666532,440
117314557,117413266,chr11,CEP164,chr11:117314557-117413266,98709
106671772,106672073,chr14,IGHVII-65-1,chr14:106671772-106672073,301
31764310,31765588,chr6,SAPCD1-AS1,chr6:31764310-31765588,1278
3500976,3539048,chr16,CLUAP1,chr16:3500976-3539048,38072
106675017,106675544,chr14,IGHV3-66,chr14:106675017-106675544,527
31765590,31777328,chr6,VWA7,chr6:31765590-31777328,11738
106680603,106681042,chr14,IGHV1-67,chr14:106680603-106681042,439
106683395,106684350,chr14,SLC20A1P1,chr14:106683395-106684350,955
106686517,106686562,chr14,IGHVII-67-1,chr14:106686517-106686562,45
106687113,106687200,chr14,IGHVIII-67-2,chr14:106687113-106687200,87
106692657,106692888,chr14,IGHVIII-67-3,chr14:106692657-106692888,231
106695102,106695397,chr14,IGHVIII-67-4,chr14:106695102-106695397,295
106703846,106704286,chr14,IGHV1-68,chr14:106703846-106704286,440
106714684,106715181,chr14,IGHV1-69,chr14:106714684-106715181,497
106723574,106724093,chr14,IGHV2-70D,chr14:106723574-106724093,519
173297629,173298512,chr2,RPS2P18,chr2:173297629-173298512,883
106728163,106728615,chr14,IGHV3-69-1,chr14:106728163-106728615,452
130006200,130009123,chr2,ARHGAP42P2,chr2:130006200-130009123,2923
106737110,106737547,chr14,IGHV1-69-2,chr14:106737110-106737547,437
106762092,106762588,chr14,IGHV1-69D,chr14:106762092-106762588,496
106770577,106771020,chr14,IGHV2-70,chr14:106770577-106771020,443
106775157,106775618,chr14,IGHV3-71,chr14:106775157-106775618,461
73464073,73464177,chr6,RNU6-975P,chr6:73464073-73464177,104
106790694,106791233,chr14,IGHV3-72,chr14:106790694-106791233,539
73487590,73487877,chr6,RN7SL827P,chr6:73487590-73487877,287
129081111,129090438,chr9,DOLPP1,chr9:129081111-129090438,9327
105357712,105438513,chr2,FHL2,chr2:105357712-105438513,80801
106802694,106803233,chr14,IGHV3-73,chr14:106802694-106803233,539
31727038,31730617,chr6,DDAH2,chr6:31727038-31730617,3579
168548495,168579368,chr5,PANK3,chr5:168548495-168579368,30873
106810442,106811131,chr14,IGHV3-74,chr14:106810442-106811131,689
106821174,106821414,chr14,IGHVII-74-1,chr14:106821174-106821414,240
106823687,106824147,chr14,IGHV3-75,chr14:106823687-106824147,460
106827869,106828163,chr14,IGHV3-76,chr14:106827869-106828163,294
106831767,106832052,chr14,IGHVIII-76-1,chr14:106831767-106832052,285
106850885,106850999,chr14,MIR5195,chr14:106850885-106850999,114
106851123,106851417,chr14,IGHV5-78,chr14:106851123-106851417,294
106865627,106865895,chr14,IGHVII-78-1,chr14:106865627-106865895,268
106867660,106868092,chr14,IGHV3-79,chr14:106867660-106868092,432
106872783,106873186,chr14,IGHV4-80,chr14:106872783-106873186,403
106874583,106875071,chr14,IGHV7-81,chr14:106874583-106875071,488
106879563,106879812,chr14,IGHVIII-82,chr14:106879563-106879812,249
37197913,37552361,chr14,MIPOL1,chr14:37197913-37552361,354448
147585438,147782775,chr5,JAKMIP2,chr5:147585438-147782775,197337
27211265,27211484,chr1,SNRPEP7,chr1:27211265-27211484,219
48385417,48386265,chr12,OR5BT1P,chr12:48385417-48386265,848
25543606,25568886,chr1,LDLRAP1,chr1:25543606-25568886,25280
20815674,21090245,chr12,SLCO1B3-SLCO1B7,chr12:20815674-21090245,274571
43211791,43248646,chr19,CEACAMP10,chr19:43211791-43248646,36855
87207092,87208086,chr4,GAPDHP60,chr4:87207092-87208086,994
56595313,56799602,chr19,ZIM2-AS1,chr19:56595313-56799602,204289
118761856,118762201,chr8,RPS26P35,chr8:118761856-118762201,345
87300495,87300583,chr4,MIR5705,chr4:87300495-87300583,88
133054959,133057767,chr8,PTCSC1,chr8:133054959-133057767,2808
87303789,87322886,chr4,HSD17B13,chr4:87303789-87322886,19097
117336256,117336631,chr11,PRR13P3,chr11:117336256-117336631,375
67952046,68237032,chr8,PREX2,chr8:67952046-68237032,284986
57037534,57038436,chr11,OR5AK4P,chr11:57037534-57038436,902
129110950,129148946,chr9,PTPA,chr9:129110950-129148946,37996
57045091,57045390,chr11,OR5AO1P,chr11:57045091-57045390,299
6204840,6205780,chr1,RNF207-AS1,chr1:6204840-6205780,940
50861568,50880567,chr19,KLK2,chr19:50861568-50880567,18999
57055587,57056132,chr11,OR5BP1P,chr11:57055587-57056132,545
57181747,57191717,chr11,LRRC55,chr11:57181747-57191717,9970
28236109,28246906,chr1,ATP5IF1,chr1:28236109-28246906,10797
57299638,57324952,chr11,TNKS1BP1,chr11:57299638-57324952,25314
66015426,66020426,chrX,MIR223HG,chrX:66015426-66020426,5000
3539033,3577403,chr16,NLRC3,chr16:3539033-3577403,38370
31275572,31278754,chr6,USP8P1,chr6:31275572-31278754,3182
31280317,31281519,chr6,RPL3P2,chr6:31280317-31281519,1202
31287510,31288964,chr6,WASF5P,chr6:31287510-31288964,1454
31293908,31301642,chr6,LINC02571,chr6:31293908-31301642,7734
115694880,115969146,chrX,DANT2,chrX:115694880-115969146,274266
31355224,31355316,chr6,MIR6891,chr6:31355224-31355316,92
87336515,87391188,chr4,HSD17B11,chr4:87336515-87391188,54673
3712200,3714298,chr1,TP73-AS2,chr1:3712200-3714298,2098
31366352,31366898,chr6,DHFRP2,chr6:31366352-31366898,546
31370134,31370240,chr6,RNU6-283P,chr6:31370134-31370240,106
31377419,31378019,chr6,FGFR3P1,chr6:31377419-31378019,600
31380411,31380839,chr6,ZDHHC20P2,chr6:31380411-31380839,428
30869466,30908758,chr1,SDC3,chr1:30869466-30908758,39292
31382074,31382288,chr6,HLA-S,chr6:31382074-31382288,214
42564029,42693505,chr6,UBR2,chr6:42564029-42693505,129476
57325986,57335892,chr11,SSRP1,chr11:57325986-57335892,9906
95654423,95683193,chr3,MTHFD2P1,chr3:95654423-95683193,28770
132626015,132961395,chrX,HS6ST2,chrX:132626015-132961395,335380
9652610,9654586,chr1,PIK3CD-AS1,chr1:9652610-9654586,1976
111927018,111929017,chr12,ADAM1B,chr12:111927018-111929017,1999
81612238,81612805,chr3,SETP6,chr3:81612238-81612805,567
98053374,98053739,chr3,OR5BM1P,chr3:98053374-98053739,365
27200834,27201473,chr1,CHCHD3P3,chr1:27200834-27201473,639
98064472,98065396,chr3,OR5AC1,chr3:98064472-98065396,924
89947693,89949726,chr12,LINC02399,chr12:89947693-89949726,2033
25959767,25998117,chr1,PAFAH2,chr1:25959767-25998117,38350
126524248,126524626,chr12,NDUFA5P6,chr12:126524248-126524626,378
87386883,87387174,chr4,RN7SL681P,chr4:87386883-87387174,291
146580048,146580210,chr4,RNU1-44P,chr4:146580048-146580210,162
146638893,146642474,chr4,POU4F2,chr4:146638893-146642474,3581
62398346,62875416,chr3,CADPS,chr3:62398346-62875416,477070
107318421,107659642,chr12,BTBD11,chr12:107318421-107659642,341221
42664162,42664268,chr6,RNU6-890P,chr6:42664162-42664268,106
42696598,42722597,chr6,PRPH2,chr6:42696598-42722597,25999
57376769,57381150,chr11,PRG3,chr11:57376769-57381150,4381
9234385,9236046,chr4,USP17L15,chr4:9234385-9236046,1661
42727234,42727700,chr6,ATP6V0CP3,chr6:42727234-42727700,466
168598240,168598757,chr4,BTF3L4P4,chr4:168598240-168598757,517
42744498,42746103,chr6,TBCC,chr6:42744498-42746103,1605
168647896,168648587,chr4,PALLD-AS1,chr4:168647896-168648587,691
136545192,136545492,chr6,RN7SKP299,chr6:136545192-136545492,300
57154021,57167485,chr19,DUXA,chr19:57154021-57167485,13464
3581181,3611606,chr16,SLX4,chr16:3581181-3611606,30425
136557046,136792477,chr6,MAP3K5,chr6:136557046-136792477,235431
47935977,48016681,chr4,CNGA1,chr4:47935977-48016681,80704
116671192,116850251,chr10,HSPA12A,chr10:116671192-116850251,179059
57386780,57390650,chr11,PRG2,chr11:57386780-57390650,3870
48047843,48110817,chr19,PLA2G4C,chr19:48047843-48110817,62974
78648954,78649242,chr4,HIGD1AP13,chr4:78648954-78649242,288
78773654,78775973,chr4,BMP2K-DT,chr4:78773654-78775973,2319
27234632,27308636,chr1,WDTC1,chr1:27234632-27308636,74004
78887127,78939438,chr4,PAQR3,chr4:78887127-78939438,52311
119759922,119984899,chr2,PTPN4,chr2:119759922-119984899,224977
3651639,3717553,chr16,TRAP1,chr16:3651639-3717553,65914
103153394,103298772,chr8,BAALC-AS1,chr8:103153394-103298772,145378
64225941,64230686,chr11,NUDT22,chr11:64225941-64230686,4745
136629066,136648198,chr6,MAP3K5-AS1,chr6:136629066-136648198,19132
136630243,136630355,chr6,RNA5SP219,chr6:136630243-136630355,112
136822564,136913934,chr6,PEX7,chr6:136822564-136913934,91370
126552443,126558478,chr8,LRATD2,chr8:126552443-126558478,6035
137424904,137425021,chr8,ZYXP1,chr8:137424904-137425021,117
95407266,95516650,chr14,SYNE3,chr14:95407266-95516650,109384
118995452,119108455,chr8,COLEC10,chr8:118995452-119108455,113003
78485215,78770021,chr5,LHFPL2,chr5:78485215-78770021,284806
28199456,28233029,chr1,DNAJC8,chr1:28199456-28233029,33573
64241003,64244132,chr11,FKBP2,chr11:64241003-64244132,3129
73529051,73529157,chr10,RNU6-883P,chr10:73529051-73529157,106
73537803,73538391,chr10,RPS26P41,chr10:73537803-73538391,588
122769274,122770150,chr8,CDK5P1,chr8:122769274-122770150,876
78898855,78899154,chr4,RN7SL127P,chr4:78898855-78899154,299
184584093,184625030,chr4,LINC02365,chr4:184584093-184625030,40937
73631612,73641474,chr10,MYOZ1,chr10:73631612-73641474,9862
184627696,184649509,chr4,CASP3,chr4:184627696-184649509,21813
127735434,127742951,chr8,MYC,chr8:127735434-127742951,7517
172042079,172188224,chr5,STK10,chr5:172042079-172188224,146145
136922301,136925660,chr6,SLC35D3,chr6:136922301-136925660,3359
73644881,73663803,chr10,SYNPO2L,chr10:73644881-73663803,18922
136973930,136974217,chr6,RPL35AP3,chr6:136973930-136974217,287
136982165,136993234,chr6,NHEG1,chr6:136982165-136993234,11069
35350722,35351607,chr1,RPL5P4,chr1:35350722-35351607,885
28259518,28282491,chr1,SESN2,chr1:28259518-28282491,22973
32934629,32941028,chr6,HLA-DMB,chr6:32934629-32941028,6399
158419955,158425303,chr2,HNRNPDLP2,chr2:158419955-158425303,5348
155314066,155314368,chr2,MTCYBP9,chr2:155314066-155314368,302
73653980,73675450,chr10,SYNPO2L-AS1,chr10:73653980-73675450,21470
94460003,94462484,chr12,CEP83-DT,chr12:94460003-94462484,2481
73674295,73730466,chr10,BMS1P4-AGAP5,chr10:73674295-73730466,56171
71903194,71904081,chr11,OR7E126P,chr11:71903194-71904081,887
115810359,115886137,chr12,LINC02463,chr12:115810359-115886137,75778
12163683,12163767,chr11,MIR6124,chr11:12163683-12163767,84
131292068,131293176,chr12,RPS6P20,chr12:131292068-131293176,1108
52269587,52296046,chr19,ZNF766,chr19:52269587-52296046,26459
3029009,3041260,chr11,CARS1-AS1,chr11:3029009-3041260,12251
96274338,96321271,chr2,SNRNP200,chr2:96274338-96321271,46933
73699151,73730487,chr10,BMS1P4,chr10:73699151-73730487,31336
114791653,114791929,chr8,CARS1P2,chr8:114791653-114791929,276
126458462,126458792,chr12,FAM32EP,chr12:126458462-126458792,330
3048359,3048521,chr11,RNU1-91P,chr11:3048359-3048521,162
31409565,31434680,chr1,SERINC2,chr1:31409565-31434680,25115
73706490,73706613,chr10,RNA5SP320,chr10:73706490-73706613,123
128116730,128123103,chr12,LINC02368,chr12:128116730-128123103,6373
128702503,128720916,chr9,PKN3,chr9:128702503-128720916,18413
3087107,3166739,chr11,OSBPL5,chr11:3087107-3166739,79632
32948613,32969094,chr6,HLA-DMA,chr6:32948613-32969094,20481
123041968,123152153,chr8,TBC1D31,chr8:123041968-123152153,110185
73731824,73733638,chr10,DUSP8P5,chr10:73731824-73733638,1814
128793194,128823958,chr12,SLC15A4,chr12:128793194-128823958,30764
73744372,73772161,chr10,SEC24C,chr10:73744372-73772161,27789
74852871,74876154,chr14,PROX2,chr14:74852871-74876154,23283
178113532,178126081,chr5,N4BP3,chr5:178113532-178126081,12549
35232291,35233003,chr19,FAM187B2P,chr19:35232291-35233003,712
57191500,57222846,chr19,ZNF264,chr19:57191500-57222846,31346
71320449,71741229,chr14,SIPA1L1,chr14:71320449-71741229,420780
134905120,135007959,chr5,PCBD2,chr5:134905120-135007959,102839
34084017,34101862,chr15,EMC7,chr15:34084017-34101862,17845
126688341,126720333,chr12,LINC02824,chr12:126688341-126720333,31992
65924629,65925135,chr5,ERBIN-DT,chr5:65924629-65925135,506
32968594,32981505,chr6,BRD2,chr6:32968594-32981505,12911
43211791,43269530,chr19,PSG9,chr19:43211791-43269530,57739
184649667,184694963,chr4,PRIMPOL,chr4:184649667-184694963,45296
34085911,34086314,chr15,RPL32P2,chr15:34085911-34086314,403
128709780,128710043,chr9,RN7SL560P,chr9:128709780-128710043,263
34102083,34108686,chr15,PGBD4,chr15:34102083-34108686,6603
128720870,128724127,chr9,ZDHHC12,chr9:128720870-128724127,3257
132003592,132007022,chr5,ACSL6-AS1,chr5:132003592-132007022,3430
34140674,34210096,chr15,KATNBL1,chr15:34140674-34210096,69422
32226994,32312987,chr5,MTMR12,chr5:32226994-32312987,85993
110910819,110921443,chr12,MYL2,chr12:110910819-110921443,10624
128729786,128772414,chr9,ZER1,chr9:128729786-128772414,42628
4654609,4792534,chr1,AJAP1,chr1:4654609-4792534,137925
42721638,42740481,chr19,PSG3,chr19:42721638-42740481,18843
73772276,73780251,chr10,FUT11,chr10:73772276-73780251,7975
28147166,28193936,chr1,PTAFR,chr1:28147166-28193936,46770
131347470,131367555,chr12,LINC02370,chr12:131347470-131367555,20085
73782047,73783652,chr10,CHCHD1,chr10:73782047-73783652,1605
184694085,184734130,chr4,CENPU,chr4:184694085-184734130,40045
129013336,129016663,chr12,NLRP9P1,chr12:129013336-129016663,3327
40771648,40796943,chr19,MIA-RAB4B,chr19:40771648-40796943,25295
123441517,123441852,chr12,COPS5P2,chr12:123441517-123441852,335
82806515,82808021,chr3,CYP51A1P1,chr3:82806515-82808021,1506
128787253,128810430,chr9,TBC1D13,chr9:128787253-128810430,23177
52297169,52325922,chr19,ZNF480,chr19:52297169-52325922,28753
73785606,73801797,chr10,ZSWIM8,chr10:73785606-73801797,16191
66998307,67011210,chr3,KBTBD8,chr3:66998307-67011210,12903
101232092,101238820,chr7,CLDN15,chr7:101232092-101238820,6728
111599498,111600256,chr12,ATXN2-AS,chr12:111599498-111600256,758
104976749,104978027,chr12,KRT18P20,chr12:104976749-104978027,1278
26529761,26575030,chr1,RPS6KA1,chr1:26529761-26575030,45269
34225013,34230156,chr15,EMC4,chr15:34225013-34230156,5143
112570380,112898881,chr12,RPH3A,chr12:112570380-112898881,328501
100225374,100226073,chr3,VTI1BP1,chr3:100225374-100226073,699
48061371,48064945,chr19,PLA2G4C-AS1,chr19:48061371-48064945,3574
69054730,69080408,chr3,UBA3,chr3:69054730-69080408,25678
40771648,40777490,chr19,MIA,chr19:40771648-40777490,5842
130668643,130687432,chr7,TSGA13,chr7:130668643-130687432,18789
4189374,4242080,chr16,SRL,chr16:4189374-4242080,52706
134194332,134226073,chr5,PPP2CA,chr5:134194332-134226073,31741
43278933,43284318,chr19,CEACAMP11,chr19:43278933-43284318,5385
99504662,99534700,chr7,ZKSCAN5,chr7:99504662-99534700,30038
4257186,4273075,chr16,TFAP4,chr16:4257186-4273075,15889
38990714,39032785,chr19,FBXO27,chr19:38990714-39032785,42071
128818500,128822676,chr9,ENDOG,chr9:128818500-128822676,4176
34341719,34343136,chr15,NOP10,chr15:34341719-34343136,1417
184755595,184826818,chr4,ACSL1,chr4:184755595-184826818,71223
128819651,128829794,chr9,SPOUT1,chr9:128819651-128829794,10143
34343315,34357737,chr15,NUTM1,chr15:34343315-34357737,14422
3000922,3057613,chr11,CARS1,chr11:3000922-3057613,56691
131723253,131724279,chr2,TOMM40P4,chr2:131723253-131724279,1026
72417489,72418335,chr5,YBX1P5,chr5:72417489-72418335,846
130342877,130347967,chr2,IMP4,chr2:130342877-130347967,5090
29956369,29956988,chr19,RPL9P32,chr19:29956369-29956988,619
71032670,71067689,chr5,GTF2H2,chr5:71032670-71067689,35019
43303171,43304523,chr19,CEACAMP4,chr19:43303171-43304523,1352
98846488,98870771,chr7,TMEM130,chr7:98846488-98870771,24283
42752686,42855691,chr19,PSG8,chr19:42752686-42855691,103005
4314761,4339597,chr16,GLIS2,chr16:4314761-4339597,24836
4324667,4328340,chr16,GLIS2-AS1,chr16:4324667-4328340,3673
4331549,4355607,chr16,PAM16,chr16:4331549-4355607,24058
34373541,34374603,chr15,ACTG1P15,chr15:34373541-34374603,1062
34382069,34382150,chr15,MIR1233-1,chr15:34382069-34382150,81
127079874,127092600,chr8,PRNCR1,chr8:127079874-127092600,12726
125040684,125044989,chr8,WASHC5-AS1,chr8:125040684-125044989,4305
104590733,105804539,chr8,ZFPM2,chr8:104590733-105804539,1213806
89041223,89082819,chr15,CARMAL,chr15:89041223-89082819,41596
32875925,32971991,chr19,CEP89,chr19:32875925-32971991,96066
89087459,89202355,chr15,ABHD2,chr15:89087459-89202355,114896
64503712,64533690,chr14,ZBTB1,chr14:64503712-64533690,29978
150824627,150861504,chr7,AOC1,chr7:150824627-150861504,36877
75598652,75599673,chr3,OR7E121P,chr3:75598652-75599673,1021
98434034,98434847,chr3,UBFD1P1,chr3:98434034-98434847,813
87051192,87052738,chr3,PPATP1,chr3:87051192-87052738,1546
50975262,51096061,chr14,TRIM9,chr14:50975262-51096061,120799
81986138,82463675,chr3,LINC02008,chr3:81986138-82463675,477537
128832942,128882494,chr9,KYAT1,chr9:128832942-128882494,49552
89243401,89243793,chr8,RPSAP74,chr8:89243401-89243793,392
111376639,111757710,chr8,LINC02237,chr8:111376639-111757710,381071
73796514,73801399,chr10,ZSWIM8-AS1,chr10:73796514-73801399,4885
44000580,44007612,chr6,C6orf223,chr6:44000580-44007612,7032
73382431,73624941,chr3,PDZRN3,chr3:73382431-73624941,242510
119214625,119246848,chr8,MAL2-AS1,chr8:119214625-119246848,32223
7441096,7441554,chr1,CAMTA1-AS1,chr1:7441096-7441554,458
73801911,73811798,chr10,NDST2,chr10:73801911-73811798,9887
44113451,44127452,chr6,MRPL14,chr6:44113451-44127452,14001
4340251,4420494,chr16,CORO7-PAM16,chr16:4340251-4420494,80243
31179745,31239887,chr1,NKAIN1,chr1:31179745-31239887,60142
56064002,56080670,chr7,SUMF2,chr7:56064002-56080670,16668
44126914,44155519,chr6,TMEM63B,chr6:44126914-44155519,28605
110899996,111040372,chr8,LINC01608,chr8:110899996-111040372,140376
204306842,204307364,chr2,DSTNP5,chr2:204306842-204307364,522
56643159,56657247,chr19,SMIM17,chr19:56643159-56657247,14088
197263111,197263535,chr2,ATP5MC2P3,chr2:197263111-197263535,424
111558413,111559937,chr2,DBF4P2,chr2:111558413-111559937,1524
113970719,114007304,chr2,LINC01191,chr2:113970719-114007304,36585
61695513,61748259,chr14,HIF1A,chr14:61695513-61748259,52746
31259568,31296788,chr1,SNRNP40,chr1:31259568-31296788,37220
49119544,49151026,chr19,PPFIA3,chr19:49119544-49151026,31482
139732708,139733282,chr2,RPL9P13,chr2:139732708-139733282,574
49299170,49327492,chr10,C10orf71,chr10:49299170-49327492,28322
140231423,142131016,chr2,LRP1B,chr2:140231423-142131016,1899593
45940522,45940851,chr10,RPL35AP23,chr10:45940522-45940851,329
45972489,46003742,chr10,TIMM23,chr10:45972489-46003742,31253
89120779,89120840,chr15,RNU7-195P,chr15:89120779-89120840,61
89135547,89136495,chr15,HMGB1P8,chr15:89135547-89136495,948
45984610,45984810,chr10,SNORA74C-1,chr10:45984610-45984810,200
89209869,89221614,chr15,RLBP1,chr15:89209869-89221614,11745
46033307,46048180,chr10,MSMB,chr10:46033307-46048180,14873
9539465,9585173,chr1,SLC25A33,chr1:9539465-9585173,45708
4354542,4425705,chr16,CORO7,chr16:4354542-4425705,71163
123400582,123402095,chr8,IMPDH1P6,chr8:123400582-123402095,1513
46063250,46063715,chr10,RPL23AP61,chr10:46063250-46063715,465
46109621,46131358,chr10,AGAP7P,chr10:46109621-46131358,21737
66637149,66637412,chr3,RPL21P41,chr3:66637149-66637412,263
124998497,125022283,chr8,SQLE,chr8:124998497-125022283,23786
98579446,98593648,chr3,CPOX,chr3:98579446-98593648,14202
21424625,21427967,chr1,NBPF2P,chr1:21424625-21427967,3342
58607080,58644491,chr3,FAM3D-AS1,chr3:58607080-58644491,37411
89326739,89326810,chr15,MIR6766,chr15:89326739-89326810,71
58564117,58627610,chr3,FAM107A,chr3:58564117-58627610,63493
89335053,89336161,chr15,POLG-DT,chr15:89335053-89336161,1108
1159768,1289426,chr10,LINC00200,chr10:1159768-1289426,129658
15756607,15786594,chr1,FBLIM1,chr1:15756607-15786594,29987
128882133,128918039,chr9,LRRC8A,chr9:128882133-128918039,35906
89368017,89368106,chr15,MIR9-3,chr15:89368017-89368106,89
34229784,34338060,chr15,SLC12A6,chr15:34229784-34338060,108276
69123512,69174412,chr10,VPS26A,chr10:69123512-69174412,50900
44158811,44184401,chr6,CAPN11,chr6:44158811-44184401,25590
128920966,128942041,chr9,PHYHD1,chr9:128920966-128942041,21075
144877734,144882033,chr2,LINC01966,chr2:144877734-144882033,4299
71024127,71029893,chr2,OR7E91P,chr2:71024127-71029893,5766
111369261,111403310,chr12,LINC02356,chr12:111369261-111403310,34049
113058638,113065382,chr2,IL36RN,chr2:113058638-113065382,6744
65526738,65562781,chr8,LINC01299,chr8:65526738-65562781,36043
121132819,121188032,chr12,P2RX7,chr12:121132819-121188032,55213
96493813,96611790,chr8,SDC2,chr8:96493813-96611790,117977
69180234,69209099,chr10,SUPV3L1,chr10:69180234-69209099,28865
186261419,186261919,chr2,RPL23AP35,chr2:186261419-186261919,500
197705369,197708395,chr2,MARS2,chr2:197705369-197708395,3026
68754620,68844410,chr11,CPT1A,chr11:68754620-68844410,89790
115468056,115468938,chr2,RPSAP23,chr2:115468056-115468938,882
87630301,87631619,chr3,PSMC1P6,chr3:87630301-87631619,1318
184798296,184799046,chr4,SLED1,chr4:184798296-184799046,750
75678660,75785583,chr3,ZNF717,chr3:75678660-75785583,106923
112981166,112981434,chr2,HMGN2P23,chr2:112981166-112981434,268
43506969,43510686,chr6,LRRC73,chr6:43506969-43510686,3717
108099110,108099492,chr2,ACTP1,chr2:108099110-108099492,382
34781214,34786369,chr1,GJB3,chr1:34781214-34786369,5155
184844554,184855751,chr4,MIR3945HG,chr4:184844554-184855751,11197
154697855,154858354,chr2,KCNJ3,chr2:154697855-154858354,160499
29329620,29350114,chr1,LINC01756,chr1:29329620-29350114,20494
184851013,184851110,chr4,MIR3945,chr4:184851013-184851110,97
43509702,43562419,chr6,POLR1C,chr6:43509702-43562419,52717
184938383,184938440,chr4,MIR4455,chr4:184938383-184938440,57
30718504,30726827,chr1,MATN1-AS1,chr1:30718504-30726827,8323
104974672,104974771,chr4,RNU6-351P,chr4:104974672-104974771,99
105171354,105178063,chr4,TET2-AS1,chr4:105171354-105178063,6709
105293664,105293946,chr4,RN7SL89P,chr4:105293664-105293946,282
105406997,105407092,chr4,RNU6-553P,chr4:105406997-105407092,95
119679167,119686507,chr2,TMEM177,chr2:119679167-119686507,7340
105145875,105279816,chr4,TET2,chr4:105145875-105279816,133941
94937086,94938024,chr3,WDR82P1,chr3:94937086-94938024,938
42781206,42786595,chr19,CEACAMP6,chr19:42781206-42786595,5389
68975217,69013684,chr3,EOGT,chr3:68975217-69013684,38467
15526813,15592379,chr1,DNAJC16,chr1:15526813-15592379,65566
56661980,56671783,chr19,ZNF835,chr19:56661980-56671783,9803
80359080,80360040,chr5,HNRNPA1P12,chr5:80359080-80360040,960
146138771,146139008,chr5,RPL35AP17,chr5:146138771-146139008,237
153871922,154453979,chr2,GALNT13,chr2:153871922-154453979,582057
33132090,33175799,chr19,WDR88,chr19:33132090-33175799,43709
147390808,147510068,chr5,DPYSL3,chr5:147390808-147510068,119260
69220332,69267552,chr10,HKDC1,chr10:69220332-69267552,47220
61707564,61751099,chr14,HIF1A-AS3,chr14:61707564-61751099,43535
61762420,61796428,chr14,SNAPC1,chr14:61762420-61796428,34008
109362461,109537207,chr8,PKHD1L1,chr8:109362461-109537207,174746
57240632,57262728,chr19,ZNF805,chr19:57240632-57262728,22096
122610108,122621066,chr4,IL21,chr4:122610108-122621066,10958
68870664,68874542,chr11,LINC02701,chr11:68870664-68874542,3878
5620047,5781696,chr7,RNF216,chr7:5620047-5781696,161649
68891276,68903835,chr11,MRPL21,chr11:68891276-68903835,12559
69300432,69300817,chr10,RPS15AP28,chr10:69300432-69300817,385
69432972,69433371,chr10,ATP5MC1P7,chr10:69432972-69433371,399
69451465,69507666,chr10,TSPAN15,chr10:69451465-69507666,56201
40447765,40465764,chr19,BLVRB,chr19:40447765-40465764,17999
122618983,122689156,chr4,IL21-AS1,chr4:122618983-122689156,70173
52336243,52367778,chr19,ZNF610,chr19:52336243-52367778,31535
61831861,61832369,chr14,COX4I1P1,chr14:61831861-61832369,508
122732702,122744942,chr4,BBS12,chr4:122732702-122744942,12240
62134149,62139973,chr14,LINC00644,chr14:62134149-62139973,5824
119244422,119270714,chr2,STEAP3-AS1,chr2:119244422-119270714,26292
68980021,68980986,chr11,MRGPRD,chr11:68980021-68980986,965
24171853,24180257,chr14,REC8,chr14:24171853-24180257,8404
128945530,128947603,chr9,DOLK,chr9:128945530-128947603,2073
1974636,1974760,chr4,SCARNA22,chr4:1974636-1974760,124
128947699,129007096,chr9,NUP188,chr9:128947699-129007096,59397
1982717,2041903,chr4,NELFA,chr4:1982717-2041903,59186
69004395,69013382,chr11,MRGPRF,chr11:69004395-69013382,8987
106848671,106849260,chr3,FCF1P3,chr3:106848671-106849260,589
75619506,75623849,chr3,UNC93B3,chr3:75619506-75623849,4343
41956681,41959321,chr19,RABAC1,chr19:41956681-41959321,2640
69012283,69018447,chr11,MRGPRF-AS1,chr11:69012283-69018447,6164
157743712,157760709,chr5,LSM11,chr5:157743712-157760709,16997
36324152,36390125,chr7,KIAA0895,chr7:36324152-36390125,65973
96753185,96754671,chr3,RCC2P5,chr3:96753185-96754671,1486
69048932,69136316,chr11,TPCN2,chr11:69048932-69136316,87384
80163327,80164795,chr3,OSBPL9P1,chr3:80163327-80164795,1468
172194172,172203454,chr5,EFCAB9,chr5:172194172-172203454,9282
97941818,97972457,chr3,RIOX2,chr3:97941818-97972457,30639
132875395,132963634,chr5,AFF4,chr5:132875395-132963634,88239
69523311,69523650,chr10,TMEM256P1,chr10:69523311-69523650,339
67123357,67397980,chr2,LINC01829,chr2:67123357-67397980,274623
69571698,69573422,chr10,NEUROG3,chr10:69571698-69573422,1724
69589880,69590355,chr10,MTATP6P23,chr10:69589880-69590355,475
69590583,69591262,chr10,MTCO2P23,chr10:69590583-69591262,679
69591406,69592931,chr10,MTCO1P23,chr10:69591406-69592931,1525
69594041,69594932,chr10,MTND2P15,chr10:69594041-69594932,891
69595487,69596436,chr10,MTND1P20,chr10:69595487-69596436,949
69630247,69633596,chr10,FAM241B,chr10:69630247-69633596,3349
211375717,212538841,chr2,ERBB4,chr2:211375717-212538841,1163124
54953130,55001142,chr19,NLRP2,chr19:54953130-55001142,48012
69684899,69692452,chr10,LINC02651,chr10:69684899-69692452,7553
27315120,27315226,chr10,RNU6-666P,chr10:27315120-27315226,106
43511832,43516985,chr6,YIPF3,chr6:43511832-43516985,5153
27335501,27335607,chr10,RNU6-452P,chr10:27335501-27335607,106
27343436,27344917,chr10,LINC02673,chr10:27343436-27344917,1481
27349717,27350290,chr10,FAM210CP,chr10:27349717-27350290,573
27378138,27378362,chr10,TRIAP1P1,chr10:27378138-27378362,224
27397121,27414368,chr10,PTCHD3,chr10:27397121-27414368,17247
1986384,1986477,chr4,MIR943,chr4:1986384-1986477,93
10973336,11169623,chr7,PHF14,chr7:10973336-11169623,196287
2059327,2069089,chr4,NAT8L,chr4:2059327-2069089,9762
27168135,27243046,chr10,ACBD5,chr10:27168135-27243046,74911
101492439,101669726,chr8,GRHL2,chr8:101492439-101669726,177287
27342020,27353937,chr1,SYTL1,chr1:27342020-27353937,11917
1871393,1982207,chr4,NSD2,chr4:1871393-1982207,110814
83937045,83938236,chr3,SRRM1P2,chr3:83937045-83938236,1191
75521803,75522012,chr3,SNRPCP10,chr3:75521803-75522012,209
75542149,75542929,chr3,RPS3AP15,chr3:75542149-75542929,780
98981058,98983096,chr3,LINC00973,chr3:98981058-98983096,2038
107327830,107329197,chr3,CSP2,chr3:107327830-107329197,1367
88601061,88601402,chr3,NDUFA5P5,chr3:88601061-88601402,341
24070837,24078100,chr14,CPNE6,chr14:24070837-24078100,7263
75658534,75659014,chr3,RARRES2P1,chr3:75658534-75659014,480
64561322,64592757,chr3,ADAMTS9-AS1,chr3:64561322-64592757,31435
129094142,129111189,chr9,CRAT,chr9:129094142-129111189,17047
118359600,118399211,chr11,UBE4A,chr11:118359600-118399211,39611
76434018,76435428,chr3,CAP1P1,chr3:76434018-76435428,1410
143368876,143384221,chr8,RHPN1,chr8:143368876-143384221,15345
52681156,52694497,chr3,GNL3,chr3:52681156-52694497,13341
69422656,69422995,chr12,RPS26P45,chr12:69422656-69422995,339
126915199,127060565,chr12,LINC02405,chr12:126915199-127060565,145366
4371848,4383538,chr16,VASN,chr16:4371848-4383538,11690
128203361,128203775,chr2,RPL14P6,chr2:128203361-128203775,414
27970344,28088637,chr1,EYA3,chr1:27970344-28088637,118293
155070324,155087392,chr7,HTR5A,chr7:155070324-155087392,17068
149271859,149343637,chr5,AFAP1L1,chr5:149271859-149343637,71778
4425805,4456775,chr16,DNAJA3,chr16:4425805-4456775,30970
129071725,129904025,chr12,TMEM132D,chr12:129071725-129904025,832300
129476946,129513687,chr9,LINC00963,chr9:129476946-129513687,36741
108786757,108885477,chr2,CCDC138,chr2:108786757-108885477,98720
43522334,43576038,chr6,XPO5,chr6:43522334-43576038,53704
130393771,130442433,chr7,CEP41,chr7:130393771-130442433,48662
122485194,122733804,chr8,LINC01151,chr8:122485194-122733804,248610
111931282,112013185,chr12,TMEM116,chr12:111931282-112013185,81903
75653561,75654773,chr3,AGGF1P3,chr3:75653561-75654773,1212
96617188,96618236,chr3,MTRNR2L12,chr3:96617188-96618236,1048
72876737,72878102,chr3,PSMD12P1,chr3:72876737-72878102,1365
89107621,89482134,chr3,EPHA3,chr3:89107621-89482134,374513
65161145,65184210,chr8,LINC00251,chr8:65161145-65184210,23065
130082738,130084768,chr8,ASAP1-IT2,chr8:130082738-130084768,2030
89412621,89415071,chr8,KRT8P4,chr8:89412621-89415071,2450
70635318,70669185,chr8,LACTB2,chr8:70635318-70669185,33867
144158162,144170714,chr5,YIPF5,chr5:144158162-144170714,12552
68903863,68940602,chr11,IGHMBP2,chr11:68903863-68940602,36739
49151198,49155396,chr19,HRC,chr19:49151198-49155396,4198
65070696,65130331,chr2,RAB1A,chr2:65070696-65130331,59635
142611049,142614479,chr8,ARC,chr8:142611049-142614479,3430
23346314,23352912,chr14,SLC22A17,chr14:23346314-23352912,6598
127322183,127420066,chr8,POU5F1B,chr8:127322183-127420066,97883
86043102,86043507,chr8,RPL32P4,chr8:86043102-86043507,405
70573218,70608416,chr8,TRAM1,chr8:70573218-70608416,35198
43353686,43363172,chr19,CD177,chr19:43353686-43363172,9486
136428892,136429854,chr5,HNRNPA1P13,chr5:136428892-136429854,962
101222546,101320575,chr3,IMPG2,chr3:101222546-101320575,98029
63813190,63813307,chr9,RNA5SP284,chr9:63813190-63813307,117
14960232,14961393,chr5,SEPHS2P1,chr5:14960232-14961393,1161
63817748,63818462,chr9,DUX4L50,chr9:63817748-63818462,714
63819574,63819654,chr9,MIR4477B,chr9:63819574-63819654,80
63832127,63859641,chr9,FRG1JP,chr9:63832127-63859641,27514
109884610,109885423,chr5,PGAM5P1,chr5:109884610-109885423,813
43576185,43620523,chr6,POLH,chr6:43576185-43620523,44338
190408355,190509205,chr2,MFSD6,chr2:190408355-190509205,100850
113022099,113488823,chr5,MCC,chr5:113022099-113488823,466724
70529060,71446904,chr9,TRPM3,chr9:70529060-71446904,917844
4474690,4510347,chr16,HMOX2,chr16:4474690-4510347,35657
100185687,100211766,chr3,TMEM30CP,chr3:100185687-100211766,26079
100376418,100530303,chr14,WDR25,chr14:100376418-100530303,153885
43588230,43591362,chr6,POLH-AS1,chr6:43588230-43591362,3132
142784882,142786539,chr8,LY6D,chr8:142784882-142786539,1657
43605316,43629264,chr6,GTPBP2,chr6:43605316-43629264,23948
143098484,143098829,chr2,MTND3P9,chr2:143098484-143098829,345
56468578,56479708,chr12,SPRYD4,chr12:56468578-56479708,11130
69019827,69052339,chr3,TMF1,chr3:69019827-69052339,32512
40778216,40796942,chr19,RAB4B,chr19:40778216-40796942,18726
117859427,117934942,chr2,HTR5BP,chr2:117859427-117934942,75515
128853427,128984968,chr12,GLT1D1,chr12:128853427-128984968,131541
70109782,70403808,chr8,NCOA2,chr8:70109782-70403808,294026
140683360,140683888,chr2,COPRSP1,chr2:140683360-140683888,528
130012065,130040560,chr2,FAR2P1,chr2:130012065-130040560,28495
108878308,108878460,chr2,RPL39P16,chr2:108878308-108878460,152
26169908,26170873,chr1,ZNF593,chr1:26169908-26170873,965
211777206,211777856,chr2,MTND2P23,chr2:211777206-211777856,650
126311466,126311927,chr2,SLC6A14P3,chr2:126311466-126311927,461
209072597,209074148,chr2,HSPA8P6,chr2:209072597-209074148,1551
130272479,130273511,chr2,MTND2P22,chr2:130272479-130273511,1032
8750430,8751087,chr1,RPL7P11,chr1:8750430-8751087,657
154286589,154287425,chr2,PHBP4,chr2:154286589-154287425,836
92574105,92655395,chr10,KIF11,chr10:92574105-92655395,81290
172677141,172736206,chr2,RAPGEF4-AS1,chr2:172677141-172736206,59065
31365253,31376850,chr1,FABP3,chr1:31365253-31376850,11597
43629540,43640941,chr6,MAD2L1BP,chr6:43629540-43640941,11401
93904730,93927066,chr14,FAM181A-AS1,chr14:93904730-93927066,22336
171922448,171983686,chr2,HAT1,chr2:171922448-171983686,61238
123089241,123194266,chr5,PRDM6,chr5:123089241-123194266,105025
43645036,43672600,chr6,RSPH9,chr6:43645036-43672600,27564
107808734,107809568,chr7,PIGCP2,chr7:107808734-107809568,834
93934166,93976739,chr14,ASB2,chr14:93934166-93976739,42573
12746200,12763699,chr1,C1orf158,chr1:12746200-12763699,17499
47019837,47045775,chr19,NPAS1,chr19:47019837-47045775,25938
107923799,108003213,chr7,LAMB1,chr7:107923799-108003213,79414
43844878,43852317,chr6,LINC02537,chr6:43844878-43852317,7439
41666906,41667649,chr6,NPM1P51,chr6:41666906-41667649,743
132725503,132761832,chr12,ANKLE2,chr12:132725503-132761832,36329
71800541,71804640,chr11,ALG1L9P,chr11:71800541-71804640,4099
106901068,106901965,chr3,MTND1P16,chr3:106901068-106901965,897
115267190,115296693,chr5,CCDC112,chr5:115267190-115296693,29503
41736711,41754109,chr6,PGC,chr6:41736711-41754109,17398
78525101,78525485,chr3,MRPS17P3,chr3:78525101-78525485,384
16124337,16156069,chr1,EPHA2,chr1:16124337-16156069,31732
71814045,71821548,chr11,ZNF705E,chr11:71814045-71821548,7503
90261414,90261708,chr3,HSPE1P19,chr3:90261414-90261708,294
75435232,75538029,chr3,LINC02018,chr3:75435232-75538029,102797
71833200,71837710,chr11,DEFB108B,chr11:71833200-71837710,4510
71845196,71845245,chr11,RNA5SP342,chr11:71845196-71845245,49
71856277,71863658,chr11,DEFB130C,chr11:71856277-71863658,7381
71878453,71884561,chr11,DEFB131B,chr11:71878453-71884561,6108
71893410,71894433,chr11,OR7E128P,chr11:71893410-71894433,1023
176804987,176806337,chr2,FUCA1P1,chr2:176804987-176806337,1350
132866958,133134903,chr8,TG,chr8:132866958-133134903,267945
15112424,15247208,chr11,INSC,chr11:15112424-15247208,134784
92034522,92035000,chr2,IGKV1OR2-2,chr2:92034522-92035000,478
41770176,41786542,chr6,FRS3,chr6:41770176-41786542,16366
143098898,143099933,chr2,MTCO3P5,chr2:143098898-143099933,1035
131591752,131628147,chr2,POTEKP,chr2:131591752-131628147,36395
154940541,154941067,chr2,CBX3P6,chr2:154940541-154941067,526
140103583,140131780,chr2,LINC01853,chr2:140103583-140131780,28197
93987225,94008863,chr14,CCDC197,chr14:93987225-94008863,21638
92596852,92597287,chr10,RPL11P4,chr10:92596852-92597287,435
92659044,92659302,chr10,RN7SL644P,chr10:92659044-92659302,258
69994276,70019496,chr10,LINC02636,chr10:69994276-70019496,25220
211778273,211779763,chr2,MTCO1P46,chr2:211778273-211779763,1490
3976133,4012704,chr1,LINC02780,chr1:3976133-4012704,36571
70098223,70132934,chr10,AIFM2,chr10:70098223-70132934,34711
96349554,96350939,chr3,HNRNPKP4,chr3:96349554-96350939,1385
16197854,16212652,chr1,ARHGEF19,chr1:16197854-16212652,14798
130356045,130375405,chr2,PTPN18,chr2:130356045-130375405,19360
106897671,106898268,chr3,MTATP6P22,chr3:106897671-106898268,597
114682292,114767989,chr12,TBX3-AS1,chr12:114682292-114767989,85697
97986673,98035304,chr3,GABRR3,chr3:97986673-98035304,48631
94026340,94048930,chr14,OTUB2,chr14:94026340-94048930,22590
41780782,41787452,chr6,PRICKLE4,chr6:41780782-41787452,6670
43372742,43379123,chr19,CD177P1,chr19:43372742-43379123,6381
70147289,70170523,chr10,SAR1A,chr10:70147289-70170523,23234
55229779,55259017,chr19,PPP6R1,chr19:55229779-55259017,29238
100357074,100422055,chr12,SLC17A8,chr12:100357074-100422055,64981
62071752,62165554,chr4,ADGRL3-AS1,chr4:62071752-62165554,93802
95171920,95172377,chr3,RPS18P6,chr3:95171920-95172377,457
94081301,94103846,chr14,IFI27L1,chr14:94081301-94103846,22545
75629993,75634057,chr3,CLUHP10,chr3:75629993-75634057,4064
102371774,102499016,chr5,SLCO6A1,chr5:102371774-102499016,127242
73489308,73525587,chr6,EEF1A1,chr6:73489308-73525587,36279
103630661,103630912,chr3,TUBBP11,chr3:103630661-103630912,251
86481943,86496996,chr3,LINC02070,chr3:86481943-86496996,15053
14338825,14419973,chr1,KAZN-AS1,chr1:14338825-14419973,81148
98353854,98354819,chr3,OR5K4,chr3:98353854-98354819,965
62105660,62106049,chr4,RPS15AP17,chr4:62105660-62106049,389
78038705,78046794,chr3,LINC02077,chr3:78038705-78046794,8089
62248294,62248770,chr4,RPL21P47,chr4:62248294-62248770,476
100260992,100325251,chr3,TBC1D23,chr3:100260992-100325251,64259
75724577,75814286,chr4,USO1,chr4:75724577-75814286,89709
11691710,11725857,chr1,DRAXIN,chr1:11691710-11725857,34147
127274265,127284328,chr12,LINC02376,chr12:127274265-127284328,10063
118645315,118648724,chr12,LINC02460,chr12:118645315-118648724,3409
6247353,6261098,chr1,GPR153,chr1:6247353-6261098,13745
106015897,106017006,chr12,ST13P3,chr12:106015897-106017006,1109
111992996,111993875,chr12,SLC25A3P2,chr12:111992996-111993875,879
57243453,57251188,chr12,STAC3,chr12:57243453-57251188,7735
11278616,11279351,chr1,UBE2V2P3,chr1:11278616-11279351,735
94127779,94130253,chr14,IFI27L2,chr14:94127779-94130253,2474
27354067,27366961,chr1,MAP3K6,chr1:27354067-27366961,12894
70163685,70164124,chr10,CALM2P2,chr10:70163685-70164124,439
70198988,70199239,chr10,RPS25P9,chr10:70198988-70199239,251
70202835,70233911,chr10,PPA1,chr10:70202835-70233911,31076
30710537,30710665,chr16,SNORA30,chr16:30710537-30710665,128
30740642,30745196,chr16,TMEM265,chr16:30740642-30745196,4554
94146128,94279734,chr14,PPP4R4,chr14:94146128-94279734,133606
30748293,30761176,chr16,PHKG2,chr16:30748293-30761176,12883
34645662,34646070,chr19,SCGB2B3P,chr19:34645662-34646070,408
57267211,57280334,chr19,ZNF460-AS1,chr19:57267211-57280334,13123
141639302,141651418,chr5,FCHSD1,chr5:141639302-141651418,12116
218125289,218137251,chr2,CXCR2,chr2:218125289-218137251,11962
47045909,47048624,chr19,TMEM160,chr19:47045909-47048624,2715
52369917,52385795,chr19,ZNF880,chr19:52369917-52385795,15878
75829454,75829589,chr4,RNU2-16P,chr4:75829454-75829589,135
75859864,75902571,chr4,PPEF2,chr4:75859864-75902571,42707
111642146,111685956,chr12,BRAP,chr12:111642146-111685956,43810
128633653,128656847,chr9,DYNC2I2,chr9:128633653-128656847,23194
35545600,35547526,chr19,TMEM147,chr19:35545600-35547526,1926
70137981,70146700,chr10,TYSND1,chr10:70137981-70146700,8719
186364598,186365128,chr2,MED28P3,chr2:186364598-186365128,530
100363431,100401089,chr3,TOMM70,chr3:100363431-100401089,37658
173354820,173368997,chr2,CDCA7,chr2:173354820-173368997,14177
133896438,133956968,chr11,IGSF9B,chr11:133896438-133956968,60530
31259599,31259704,chr10,RNA5SP309,chr10:31259599-31259704,105
31360955,31361215,chr10,SPTLC1P1,chr10:31360955-31361215,260
64535905,64546173,chr14,HSPA2,chr14:64535905-64546173,10268
89360787,89498130,chr9,SEMA4D,chr9:89360787-89498130,137343
36516392,36521149,chr14,NKX2-1,chr14:36516392-36521149,4757
121713607,121713994,chr10,RPS15AP5,chr10:121713607-121713994,387
89588714,89590097,chr3,MTCO1P6,chr3:89588714-89590097,1383
121957091,121975217,chr10,NSMCE4A,chr10:121957091-121975217,18126
58755854,58985179,chr17,PPM1E,chr17:58755854-58985179,229325
13892792,15118043,chr1,KAZN,chr1:13892792-15118043,1225251
101324205,101513241,chr3,SENP7,chr3:101324205-101513241,189036
30757423,30762221,chr16,CCDC189,chr16:30757423-30762221,4798
75913660,75941013,chr4,NAAA,chr4:75913660-75941013,27353
56824375,56824656,chr14,RN7SL461P,chr14:56824375-56824656,281
56824986,56825092,chr14,RNU6-1204P,chr14:56824986-56825092,106
131296110,131297972,chr12,LINC02415,chr12:131296110-131297972,1862
94569540,94570676,chr5,MTCYBP35,chr5:94569540-94570676,1136
56799905,56816693,chr14,OTX2,chr14:56799905-56816693,16788
69449470,69460724,chr12,LINC02373,chr12:69449470-69460724,11254
40388525,40417896,chr17,TOP2A,chr17:40388525-40417896,29371
113314579,113383544,chr11,TTC12,chr11:113314579-113383544,68965
97677547,97678681,chr5,MTCYBP40,chr5:97677547-97678681,1134
52245048,52247448,chr12,KRT7-AS,chr12:52245048-52247448,2400
134926660,134928036,chr5,MTND4P12,chr5:134926660-134928036,1376
101696947,101744140,chr12,CHPT1,chr12:101696947-101744140,47193
168552277,168553727,chr5,SLC2A3P1,chr5:168552277-168553727,1450
123023250,123036725,chr5,PPIC,chr5:123023250-123036725,13475
111380603,111380868,chr8,SERPINA15P,chr8:111380603-111380868,265
103298433,103332866,chr8,FZD6,chr8:103298433-103332866,34433
10627260,10628225,chr5,ANKRD33B-AS1,chr5:10627260-10628225,965
35523367,35528351,chr19,SBSN,chr19:35523367-35528351,4984
40512333,40755963,chr5,TTC33,chr5:40512333-40755963,243630
102065349,102068036,chr10,HPS6,chr10:102065349-102068036,2687
158548425,158549224,chr2,RPL7AP22,chr2:158548425-158549224,799
13254212,13263314,chr1,PRAMEF5,chr1:13254212-13263314,9102
209145241,209147687,chr2,CRYGFP,chr2:209145241-209147687,2446
102106489,102120368,chr10,LDB1,chr10:102106489-102120368,13879
197804593,198572581,chr2,PLCL1,chr2:197804593-198572581,767988
30778456,30787205,chr16,ZNF629,chr16:30778456-30787205,8749
8424645,8435013,chr1,RERE-AS1,chr1:8424645-8435013,10368
1289887,1340147,chr4,MAEA,chr4:1289887-1340147,50260
15604597,15605043,chr1,CHCHD2P6,chr1:15604597-15605043,446
30875266,30875323,chr16,MIR4519,chr16:30875266-30875323,57
96935394,97037513,chr5,LNPEP,chr5:96935394-97037513,102119
30893903,30893985,chr16,MIR762,chr16:30893903-30893985,82
30904348,30910208,chr16,CTF2P,chr16:30904348-30910208,5860
64749663,64781707,chr17,ARHGAP27P1-BPTFP1-KPNA2P3,chr17:64749663-64781707,32044
6234692,6239444,chr1,LINC00337,chr1:6234692-6239444,4752
30919319,30923269,chr16,FBXL19-AS1,chr16:30919319-30923269,3950
73064543,73124088,chr8,SBSPON,chr8:73064543-73124088,59545
35268962,35279821,chr19,USF2,chr19:35268962-35279821,10859
64905883,64906018,chr17,RDM1P4,chr17:64905883-64906018,135
118737964,118738511,chr12,RPL17P37,chr12:118737964-118738511,547
105264391,105329735,chr2,TGFBRAP1,chr2:105264391-105329735,65344
30949068,30956461,chr16,ORAI3,chr16:30949068-30956461,7393
12166991,12209228,chr1,TNFRSF1B,chr1:12166991-12209228,42237
105049395,105065445,chr14,GPR132,chr14:105049395-105065445,16050
60149942,60170899,chr17,CA4,chr17:60149942-60170899,20957
95791733,95858839,chr12,SNRPF-DT,chr12:95791733-95858839,67106
127881616,127898645,chr12,LINC02393,chr12:127881616-127898645,17029
30985207,30989147,chr16,HSD3B7,chr16:30985207-30989147,3940
20014780,20098868,chr12,LINC02398,chr12:20014780-20098868,84088
143304384,143359979,chr8,TOP1MT,chr8:143304384-143359979,55595
102132994,102150333,chr10,PPRC1,chr10:102132994-102150333,17339
114670255,114684175,chr12,TBX3,chr12:114670255-114684175,13920
66921510,66922482,chr2,LINC01628,chr2:66921510-66922482,972
223398267,223398546,chr2,HIGD1AP4,chr2:223398267-223398546,279
131758031,131767221,chr2,CDRT15P4,chr2:131758031-131767221,9190
105140982,105168824,chr14,JAG2,chr14:105140982-105168824,27842
196133583,196176503,chr2,STK17B,chr2:196133583-196176503,42920
78605233,78632155,chr17,SCAT1,chr17:78605233-78632155,26922
8893409,8894151,chr1,HMGN2P17,chr1:8893409-8894151,742
21428303,21429536,chr1,HS6ST1P1,chr1:21428303-21429536,1233
46592573,46593305,chr12,OR7A19P,chr12:46592573-46593305,732
35358822,35366077,chr1,ZMYM4-AS1,chr1:35358822-35366077,7255
30989256,31010638,chr16,STX1B,chr16:30989256-31010638,21382
108907741,109021068,chr12,SVOP,chr12:108907741-109021068,113327
15164344,15171317,chr1,TMEM51-AS2,chr1:15164344-15171317,6973
181040225,181061521,chr5,BTNL9,chr5:181040225-181061521,21296
15742499,15747982,chr1,TMEM82,chr1:15742499-15747982,5483
96754553,96778129,chr9,ZNF510,chr9:96754553-96778129,23576
62136972,62140639,chr17,POLRMTP1,chr17:62136972-62140639,3667
106288803,106289053,chr2,RPS21P2,chr2:106288803-106289053,250
80466834,80477843,chr17,NPTX1,chr17:80466834-80477843,11009
102152176,102163871,chr10,NOLC1,chr10:102152176-102163871,11695
140898423,140899106,chr2,LRRC57P1,chr2:140898423-140899106,683
116423112,117415070,chr9,ASTN2,chr9:116423112-117415070,991958
50842920,50887884,chr12,TMPRSS12,chr12:50842920-50887884,44964
134119983,134454621,chr2,MGAT5,chr2:134119983-134454621,334638
63849292,63864379,chr17,TCAM1P,chr17:63849292-63864379,15087
35433492,35557950,chr1,KIAA0319L,chr1:35433492-35557950,124458
31032889,31042975,chr16,STX4,chr16:31032889-31042975,10086
151319422,151319776,chr5,ATP6V1G1P5,chr5:151319422-151319776,354
132144457,132152473,chr12,NOC4L,chr12:132144457-132152473,8016
149730298,149855022,chr5,PPARGC1B,chr5:149730298-149855022,124724
80544819,80966371,chr17,RPTOR,chr17:80544819-80966371,421552
157210847,157211539,chr2,CDK7P1,chr2:157210847-157211539,692
209178804,209182018,chr2,MEAF6P1,chr2:209178804-209182018,3214
55013705,55038264,chr19,GP6,chr19:55013705-55038264,24559
130416755,130431363,chr2,FAR2P2,chr2:130416755-130431363,14608
84638405,84881924,chr3,LINC00971,chr3:84638405-84881924,243519
1345691,1395989,chr4,UVSSA,chr4:1345691-1395989,50298
22116629,22134851,chr12,SULT6B2P,chr12:22116629-22134851,18222
150322639,150332721,chr7,ZBED6CL,chr7:150322639-150332721,10082
4909905,4918256,chr12,KCNA1,chr12:4909905-4918256,8351
99215224,99216266,chr3,ACTG1P13,chr3:99215224-99216266,1042
150323263,150338156,chr7,LRRC61,chr7:150323263-150338156,14893
101163094,101163986,chr3,ACTR3P3,chr3:101163094-101163986,892
102226299,102229589,chr10,ELOVL3,chr10:102226299-102229589,3290
99817837,100181732,chr3,CMSS1,chr3:99817837-100181732,363895
5619764,5644398,chr11,TRIM34,chr11:5619764-5644398,24634
150338317,150341662,chr7,RARRES2,chr7:150338317-150341662,3345
100509277,100509612,chr2,ARPP19P2,chr2:100509277-100509612,335
128217588,128218072,chr2,RPL21P34,chr2:128217588-128218072,484
102230186,102241512,chr10,PITX3,chr10:102230186-102241512,11326
133218312,133235877,chr12,ANHX,chr12:133218312-133235877,17565
105150778,105150864,chr14,MIR6765,chr14:105150778-105150864,86
31777518,31795752,chr6,VARS1,chr6:31777518-31795752,18234
105300563,105398147,chr14,PACS2,chr14:105300563-105398147,97584
32944481,32944999,chr10,AK3P5,chr10:32944481-32944999,518
33023368,33023647,chr10,MTND4LP11,chr10:33023368-33023647,279
33034655,33034924,chr10,RN7SL847P,chr10:33034655-33034924,269
74216242,74343414,chr2,SLC4A5,chr2:74216242-74343414,127172
33057615,33058407,chr10,RPL7AP53,chr10:33057615-33058407,792
105704203,105744062,chr12,CASC18,chr12:105704203-105744062,39859
3065424,3066001,chr10,PFKP-DT,chr10:3065424-3066001,577
47064187,47113776,chr19,ZC3H4,chr19:47064187-47113776,49589
143017982,143023832,chr8,LY6E,chr8:143017982-143023832,5850
65121780,65134532,chr11,SYVN1,chr11:65121780-65134532,12752
3066333,3137718,chr10,PFKP,chr10:3066333-3137718,71385
123973241,124316024,chr12,RFLNA,chr12:123973241-124316024,342783
150363777,150372590,chr7,REPIN1-AS1,chr7:150363777-150372590,8813
135444461,135444925,chr7,SDHDP2,chr7:135444461-135444925,464
135557917,135648757,chr7,NUP205,chr7:135557917-135648757,90840
127631248,127636488,chr12,LINC02411,chr12:127631248-127636488,5240
80764862,80789388,chr3,LINC02050,chr3:80764862-80789388,24526
1402932,1406442,chr4,NKX1-1,chr4:1402932-1406442,3510
181367268,181368262,chr5,OR4F3,chr5:181367268-181368262,994
100334739,100361635,chr3,NIT2,chr3:100334739-100361635,26896
179110853,179345461,chr5,ADAMTS2,chr5:179110853-179345461,234608
35550031,35563658,chr19,ATP4A,chr19:35550031-35563658,13627
8005301,8005381,chr4,MIR95,chr4:8005301-8005381,80
8174421,8174999,chr4,GMPSP1,chr4:8174421-8174999,578
8269754,8307098,chr4,HTRA3,chr4:8269754-8307098,37344
118063593,118136026,chr12,VSIG10,chr12:118063593-118136026,72433
31060843,31074240,chr16,ZNF668,chr16:31060843-31074240,13397
100221268,100223858,chr3,DUSP12P1,chr3:100221268-100223858,2590
73061659,73063337,chr3,EBLN2,chr3:73061659-73063337,1678
103240987,103241230,chr3,NDUFA4P2,chr3:103240987-103241230,243
101728648,101739472,chr12,SYCP3,chr12:101728648-101739472,10824
105655461,105869552,chr3,CBLB,chr3:105655461-105869552,214091
31797396,31806966,chr6,LSM2,chr6:31797396-31806966,9570
148307298,148308258,chr5,PGBD4P3,chr5:148307298-148308258,960
31074422,31084196,chr16,ZNF646,chr16:31074422-31084196,9774
7965310,8158832,chr4,ABLIM2,chr4:7965310-8158832,193522
162761833,162762313,chr5,ARL2BPP5,chr5:162761833-162762313,480
142859604,142868922,chr5,ARHGAP26-AS1,chr5:142859604-142868922,9318
46719511,46746994,chr19,STRN4,chr19:46719511-46746994,27483
31506226,31583306,chr1,LINC01226,chr1:31506226-31583306,77080
31083425,31089628,chr16,PRSS53,chr16:31083425-31089628,6203
142108779,142154440,chr5,NDFIP1,chr5:142108779-142154440,45661
142834247,142916506,chr8,GML,chr8:142834247-142916506,82259
134135365,134159968,chr9,WDR5,chr9:134135365-134159968,24603
31809619,31815283,chr6,HSPA1L,chr6:31809619-31815283,5664
61411751,61413280,chr17,LINC02875,chr17:61411751-61413280,1529
47303460,47323613,chr17,EFCAB13-DT,chr17:47303460-47323613,20153
31815543,31817946,chr6,HSPA1A,chr6:31815543-31817946,2403
38556765,38671216,chr5,LIFR-AS1,chr5:38556765-38671216,114451
142995850,142996482,chr8,CDC42P3,chr8:142995850-142996482,632
10032832,10181239,chr1,UBE4B,chr1:10032832-10181239,148407
31827738,31830254,chr6,HSPA1B,chr6:31827738-31830254,2516
74670578,74747335,chr17,RAB37,chr17:74670578-74747335,76757
134838069,134842637,chr8,NCRNA00250,chr8:134838069-134842637,4568
29920104,29990289,chr7,SCRN1,chr7:29920104-29990289,70185
65645992,65646462,chr12,PCNPP3,chr12:65645992-65646462,470
140636281,140638283,chr8,ERICD,chr8:140636281-140638283,2002
31834608,31839766,chr6,SNHG32,chr6:31834608-31839766,5158
31090842,31095980,chr16,VKORC1,chr16:31090842-31095980,5138
111621458,111621797,chr8,H2AZP7,chr8:111621458-111621797,339
49967194,49977139,chr12,AQP6,chr12:49967194-49977139,9945
143213218,143217170,chr8,GPIHBP1,chr8:143213218-143217170,3952
27524290,27526498,chr9,IFNK,chr9:27524290-27526498,2208
121444991,121499844,chr9,GGTA1,chr9:121444991-121499844,54853
127143082,127143247,chr5,MRPS5P3,chr5:127143082-127143247,165
178764861,178818435,chr5,AACSP1,chr5:178764861-178818435,53574
73675638,73761137,chr11,RAB6A,chr11:73675638-73761137,85499
3141632,3167972,chr10,PITRM1-AS1,chr10:3141632-3167972,26340
110190048,110208159,chr9,C9orf152,chr9:110190048-110208159,18111
137168758,137170051,chr9,LRRC26,chr9:137168758-137170051,1293
142657460,142681968,chr8,JRK,chr8:142657460-142681968,24508
109171974,109321059,chr9,EPB41L4B,chr9:109171974-109321059,149085
54452423,54452511,chr10,RNU6-687P,chr10:54452423-54452511,88
31106107,31112791,chr16,BCKDK,chr16:31106107-31112791,6684
54599678,54600683,chr10,NEFMP1,chr10:54599678-54600683,1005
54607874,54607957,chr10,MIR548F1,chr10:54607874-54607957,83
122628952,122730685,chr5,LINC02201,chr5:122628952-122730685,101733
55599042,55600728,chr10,MTRNR2L5,chr10:55599042-55600728,1686
55667341,55668350,chr10,GAPDHP21,chr10:55667341-55668350,1009
88275205,88275308,chr4,RNU6-112P,chr4:88275205-88275308,103
103770453,103841234,chr12,NT5DC3,chr12:103770453-103841234,70781
29988600,30027543,chr7,FKBP14-AS1,chr7:29988600-30027543,38943
88457119,88506163,chr4,HERC5,chr4:88457119-88506163,49044
30010587,30026702,chr7,FKBP14,chr7:30010587-30026702,16115
128083766,128189677,chr5,SLC12A2,chr5:128083766-128189677,105911
3137728,3172841,chr10,PITRM1,chr10:3137728-3172841,35113
142750150,142752532,chr8,LYPD2,chr8:142750150-142752532,2382
142764338,142769828,chr8,SLURP2,chr8:142764338-142769828,5490
132136594,132144319,chr12,DDX51,chr12:132136594-132144319,7725
44104345,44114562,chr7,AEBP1,chr7:44104345-44114562,10217
133573183,133573861,chr8,ST3GAL1-DT,chr8:133573183-133573861,678
132507962,132565246,chr8,HPYR1,chr8:132507962-132565246,57284
142910559,142917843,chr8,CYP11B2,chr8:142910559-142917843,7284
114893343,114930595,chr9,TNFSF8,chr9:114893343-114930595,37252
21397987,21398362,chr1,PPP1R11P1,chr1:21397987-21398362,375
118620498,118906155,chr8,SAMD12-AS1,chr8:118620498-118906155,285657
31835263,31835326,chr6,SNORD48,chr6:31835263-31835326,63
15111815,15153618,chr1,TMEM51-AS1,chr1:15111815-15153618,41803
31837076,31837142,chr6,SNORD52,chr6:31837076-31837142,66
31877808,31884204,chr6,EHMT2-AS1,chr6:31877808-31884204,6396
21480839,21482313,chr9,IFNE,chr9:21480839-21482313,1474
92412380,92424471,chr9,OMD,chr9:92412380-92424471,12091
31879759,31897687,chr6,EHMT2,chr6:31879759-31897687,17928
136754386,136758543,chr9,LCN8,chr9:136754386-136758543,4157
143289676,143299952,chr8,ZNF696,chr8:143289676-143299952,10276
20028179,20091911,chr1,PLA2G5,chr1:20028179-20091911,63732
88508591,88510403,chr4,NCOA4P2,chr4:88508591-88510403,1812
145337230,145338057,chr2,RPL6P5,chr2:145337230-145338057,827
88520998,88523776,chr4,PYURF,chr4:88520998-88523776,2778
41126435,41128681,chr9,FOXD4L6,chr9:41126435-41128681,2246
127324152,127340109,chr12,LINC02375,chr12:127324152-127340109,15957
122742303,122750783,chr9,OR1L6,chr9:122742303-122750783,8480
142858354,142858797,chr8,ZNHIT1P1,chr8:142858354-142858797,443
136322303,136327323,chr9,DKFZP434A062,chr9:136322303-136327323,5020
208165343,208190030,chr2,C2orf80,chr2:208165343-208190030,24687
31254361,31254445,chr12,MREGP1,chr12:31254361-31254445,84
88520998,88523776,chr4,PIGY,chr4:88520998-88523776,2778
126912034,126912322,chr12,HSPE1P20,chr12:126912034-126912322,288
136327476,136359605,chr9,GPSM1,chr9:136327476-136359605,32129
88523826,88524983,chr4,PIGY-DT,chr4:88523826-88524983,1157
46682071,46682713,chr12,MARK3P1,chr12:46682071-46682713,642
107899316,108083642,chr8,RSPO2,chr8:107899316-108083642,184326
12838125,12841357,chr1,PRAMEF30P,chr1:12838125-12841357,3232
88583666,88583972,chr4,RN7SKP244,chr4:88583666-88583972,306
625573,670782,chr4,PDE6B,chr4:625573-670782,45209
57406954,57427580,chr11,SLC43A3,chr11:57406954-57427580,20626
57628810,57654918,chr3,DENND6A-AS1,chr3:57628810-57654918,26108
23529504,24562544,chr12,SOX5,chr12:23529504-24562544,1033040
106894352,106895718,chr3,MTND4P16,chr3:106894352-106895718,1366
44110849,44110912,chr7,MIR4649,chr7:44110849-44110912,63
105374618,105374971,chr14,RPS20P33,chr14:105374618-105374971,353
44125752,44125873,chr7,RNA5SP230,chr7:44125752-44125873,121
100401532,100456319,chr3,LNP1,chr3:100401532-100456319,54787
105398538,105450106,chr14,TEX22,chr14:105398538-105450106,51568
44138864,44141332,chr7,MYL7,chr7:44138864-44141332,2468
29236516,29326813,chr1,PTPRU,chr1:29236516-29326813,90297
107430892,107463912,chr3,LINC01990,chr3:107430892-107463912,33020
143366631,143368548,chr8,RHPN1-AS1,chr8:143366631-143368548,1917
106900593,106900855,chr3,MTND6P6,chr3:106900593-106900855,262
98525061,98525274,chr3,RPL38P4,chr3:98525061-98525274,213
112802478,112812819,chr3,CD200R1L-AS1,chr3:112802478-112812819,10341
133408006,133409107,chr8,ST13P6,chr8:133408006-133409107,1101
45215547,45215943,chr15,H3P39,chr15:45215547-45215943,396
105419820,105470729,chr14,MTA1,chr14:105419820-105470729,50909
45235930,45279251,chr15,SLC28A2-AS1,chr15:45235930-45279251,43321
142567260,142577881,chr8,MROH4P,chr8:142567260-142577881,10621
97025981,97031636,chr2,TRIM43CP,chr2:97025981-97031636,5655
96776945,96777683,chr3,CDV3P1,chr3:96776945-96777683,738
45252234,45277846,chr15,SLC28A2,chr15:45252234-45277846,25612
222566899,222656092,chr2,FARSB,chr2:222566899-222656092,89193
94937980,95168351,chr3,LINC00879,chr3:94937980-95168351,230371
115950511,116325062,chr8,LINC00536,chr8:115950511-116325062,374551
27002661,27003259,chr17,PDLIM1P3,chr17:27002661-27003259,598
135234131,135299719,chr8,LINC01591,chr8:135234131-135299719,65588
80101556,80119881,chr17,GAA,chr17:80101556-80119881,18325
73667831,73672112,chr7,VPS37D,chr7:73667831-73672112,4281
73680918,73683453,chr7,DNAJC30,chr7:73680918-73683453,2535
142212080,142403182,chr8,TSNARE1,chr8:142212080-142403182,191102
31114489,31131393,chr16,KAT8,chr16:31114489-31131393,16904
73683025,73705161,chr7,BUD23,chr7:73683025-73705161,22136
173431349,173431812,chr2,JPT1P1,chr2:173431349-173431812,463
57280051,57294069,chr19,ZNF460,chr19:57280051-57294069,14018
131502789,131523806,chr9,POMT1,chr9:131502789-131523806,21017
190343570,190371665,chr2,INPP1,chr2:190343570-190371665,28095
48115445,48170603,chr19,LIG1,chr19:48115445-48170603,55158
50341110,50345732,chr3,ZMYND10,chr3:50341110-50345732,4622
45354779,45354885,chr15,RNU6-953P,chr15:45354779-45354885,106
98576341,98577260,chr5,CTBP2P4,chr5:98576341-98577260,919
172209646,172283764,chr5,UBTD2,chr5:172209646-172283764,74118
45361124,45402327,chr15,GATM,chr15:45361124-45402327,41203
92334463,92334564,chr10,RNY3P12,chr10:92334463-92334564,101
92418667,92420875,chr10,MARK2P9,chr10:92418667-92420875,2208
117301104,117301442,chr5,RPL35AP15,chr5:117301104-117301442,338
172254418,172255439,chr5,KLF3P1,chr5:172254418-172255439,1021
135648584,135653935,chr5,SLC25A48-AS1,chr5:135648584-135653935,5351
159314780,159330487,chr5,IL12B,chr5:159314780-159330487,15707
92451684,92574096,chr10,IDE,chr10:92451684-92574096,122412
42892713,43030658,chr4,GRXCR1,chr4:42892713-43030658,137945
80206716,80220923,chr17,SGSH,chr17:80206716-80220923,14207
31131433,31135727,chr16,PRSS8,chr16:31131433-31135727,4294
135457456,135656722,chr8,KHDRBS3,chr8:135457456-135656722,199266
157204182,157366075,chr4,GRIA2,chr4:157204182-157366075,161893
176238367,176345991,chr5,SIMC1,chr5:176238367-176345991,107624
62369681,62374324,chr3,FEZF2,chr3:62369681-62374324,4643
31138926,31150083,chr16,PRSS36,chr16:31138926-31150083,11157
113964137,114056594,chr3,CCDC191,chr3:113964137-114056594,92457
143099936,143100612,chr2,MTATP6P5,chr2:143099936-143100612,676
190504338,190534722,chr2,NEMP2,chr2:190504338-190534722,30384
14504874,14643635,chr11,PSMA1,chr11:14504874-14643635,138761
58692573,58735611,chr17,RAD51C,chr17:58692573-58735611,43038
216632828,216664436,chr2,IGFBP2,chr2:216632828-216664436,31608
73699206,73719672,chr7,STX1A,chr7:73699206-73719672,20466
142740949,142742406,chr8,SLURP1,chr8:142740949-142742406,1457
45402336,45421415,chr15,SPATA5L1,chr15:45402336-45421415,19079
143267433,143276931,chr8,GLI4,chr8:143267433-143276931,9498
31899613,31902086,chr6,ZBTB12,chr6:31899613-31902086,2473
108907792,108953879,chr3,GUCA1C,chr3:108907792-108953879,46087
97368776,97370421,chr5,YTHDF1P1,chr5:97368776-97370421,1645
137964020,138016364,chr2,HNMT,chr2:137964020-138016364,52344
148312419,148315922,chr5,SPINK7,chr5:148312419-148315922,3503
31665227,31670343,chr6,CSNK2B,chr6:31665227-31670343,5116
26938470,26966650,chr12,FGFR1OP2,chr12:26938470-26966650,28180
31174573,31174822,chr16,NDUFA3P6,chr16:31174573-31174822,249
45433050,45433129,chr15,MIR147B,chr15:45433050-45433129,79
57268342,57292685,chr3,ASB14,chr3:57268342-57292685,24343
31201486,31203450,chr16,PYCARD,chr16:31201486-31203450,1964
45479606,45522755,chr15,SLC30A4,chr15:45479606-45522755,43149
133454848,133571940,chr8,ST3GAL1,chr8:133454848-133571940,117092
31201885,31203452,chr16,PYCARD-AS1,chr16:31201885-31203452,1567
79860573,79861806,chr10,NPAP1P2,chr10:79860573-79861806,1233
31214091,31231537,chr16,TRIM72,chr16:31214091-31231537,17446
96619304,96619831,chr3,RPL18AP8,chr3:96619304-96619831,527
79870375,79873903,chr10,CTSLP6,chr10:79870375-79873903,3528
32258940,32260230,chr3,KRT18P15,chr3:32258940-32260230,1290
79892148,79893175,chr10,PGGT1BP2,chr10:79892148-79893175,1027
141991749,142013041,chr5,GNPDA1,chr5:141991749-142013041,21292
97822011,97944984,chr3,CRYBG3,chr3:97822011-97944984,122973
34986165,35031945,chr1,ZMYM6,chr1:34986165-35031945,45780
19941521,19943018,chr12,TCP1P3,chr12:19941521-19943018,1497
79906605,79907856,chr10,BMS1P21,chr10:79906605-79907856,1251
45511136,45586290,chr15,HMGN2P46,chr15:45511136-45586290,75154
54477796,54478168,chr17,ISCA1P3,chr17:54477796-54478168,372
79920178,79923119,chr10,MBL1P,chr10:79920178-79923119,2941
140216997,140217239,chr2,MTCO1P44,chr2:140216997-140217239,242
229357629,229714555,chr2,DNER,chr2:229357629-229714555,356926
42924132,42937207,chr19,PSG7,chr19:42924132-42937207,13075
10750188,10777446,chr12,LINC02366,chr12:10750188-10777446,27258
21197450,21214510,chr16,ZP2,chr16:21197450-21214510,17060
79937467,79982614,chr10,SFTPD,chr10:79937467-79982614,45147
45537250,45537377,chr15,SNORA41B,chr15:45537250-45537377,127
45566776,45567074,chr15,DPPA5P2,chr15:45566776-45567074,298
48892765,48895871,chr17,ATP5MC1,chr17:48892765-48895871,3106
105472962,105480162,chr14,CRIP2,chr14:105472962-105480162,7200
99638475,99799226,chr3,COL8A1,chr3:99638475-99799226,160751
45587214,45615945,chr15,BLOC1S6,chr15:45587214-45615945,28731
79968213,79973213,chr10,SFTPD-AS1,chr10:79968213-79973213,5000
79981839,79982212,chr10,ZNRF2P3,chr10:79981839-79982212,373
79982910,79983240,chr10,DPY19L2P5,chr10:79982910-79983240,330
80024737,80025159,chr10,C1DP3,chr10:80024737-80025159,422
80031968,80032393,chr10,C1DP2,chr10:80031968-80032393,425
159890988,159917447,chr6,MAS1,chr6:159890988-159917447,26459
80040621,80041044,chr10,C1DP4,chr10:80040621-80041044,423
135839626,135876443,chr2,MCM6,chr2:135839626-135876443,36817
80046860,80078912,chr10,TMEM254-AS1,chr10:80046860-80078912,32052
55262223,55280381,chr19,HSPBP1,chr19:55262223-55280381,18158
159969082,160113507,chr6,IGF2R,chr6:159969082-160113507,144425
130780301,131040909,chr8,ADCY8,chr8:130780301-131040909,260608
39550033,39619803,chr12,ABCD2,chr12:39550033-39619803,69770
36630335,36630857,chr1,FTLP18,chr1:36630335-36630857,522
34755047,34758512,chr1,GJB5,chr1:34755047-34758512,3465
80078646,80092557,chr10,TMEM254,chr10:80078646-80092557,13911
35808016,35857890,chr1,AGO4,chr1:35808016-35857890,49874
73711317,73711397,chr7,MIR4284,chr7:73711317-73711397,80
73732569,73732868,chr7,RN7SL265P,chr7:73732569-73732868,299
73735038,73736158,chr7,ABHD11-AS1,chr7:73735038-73736158,1120
73768997,73770270,chr7,CLDN3,chr7:73768997-73770270,1273
69359710,69390870,chr12,YEATS4,chr12:69359710-69390870,31160
73834590,73842516,chr7,METTL27,chr7:73834590-73842516,7926
107502727,107565742,chr11,ALKBH8,chr11:107502727-107565742,63015
119993199,119993611,chr2,RPL27P7,chr2:119993199-119993611,412
94506766,94507620,chr3,ARMC10P1,chr3:94506766-94507620,854
179399728,179400875,chr2,RAD52P1,chr2:179399728-179400875,1147
209178966,209181123,chr2,PKP4P1,chr2:209178966-209181123,2157
65056366,65087004,chr2,CEP68,chr2:65056366-65087004,30638
113002444,113019861,chr3,NEPRO,chr3:113002444-113019861,17417
73861159,73865890,chr7,TMEM270,chr7:73861159-73865890,4731
67909395,67964140,chr4,TMPRSS11A,chr4:67909395-67964140,54745
61452404,61485110,chr17,TBX4,chr17:61452404-61485110,32706
21233699,21253850,chr16,ANKS4B,chr16:21233699-21253850,20151
21300849,21339037,chr16,CRYM-AS1,chr16:21300849-21339037,38188
128297685,128343908,chr7,RBM28,chr7:128297685-128343908,46223
37692481,37709719,chr1,CDCA8,chr1:37692481-37709719,17238
42949503,42950387,chr19,CEACAMP7,chr19:42949503-42950387,884
160003291,160007664,chr6,AIRN,chr6:160003291-160007664,4373
160093423,160093993,chr6,CHP1P2,chr6:160093423-160093993,570
157984658,157989990,chr5,MARK2P11,chr5:157984658-157989990,5332
138130023,138497261,chr8,FAM135B,chr8:138130023-138497261,367238
160121815,160158718,chr6,SLC22A1,chr6:160121815-160158718,36903
49157741,49211836,chr19,TRPM4,chr19:49157741-49211836,54095
21376648,21386064,chr16,SNX29P1,chr16:21376648-21386064,9416
136857628,136858342,chr5,ANKRD49P3,chr5:136857628-136858342,714
237085882,237100474,chr2,COPS8,chr2:237085882-237100474,14592
589530,589589,chr12,RNU7-103P,chr12:589530-589589,59
2954240,2954338,chr12,RNU6-1315P,chr12:2954240-2954338,98
3726222,3726327,chr12,RNU6-174P,chr12:3726222-3726327,105
179732822,179777283,chr5,MAML1,chr5:179732822-179777283,44461
21402237,21448567,chr16,NPIPB3,chr16:21402237-21448567,46330
8484746,8484852,chr12,RNU6-275P,chr12:8484746-8484852,106
158124474,158173318,chr4,GASK1B,chr4:158124474-158173318,48844
9445058,9445205,chr12,SNORA75,chr12:9445058-9445205,147
10084186,10084490,chr12,RN7SKP161,chr12:10084186-10084490,304
11546479,11546540,chr12,RNU7-60P,chr12:11546479-11546540,61
14250232,14250341,chr12,RNU6-491P,chr12:14250232-14250341,109
17071398,17071505,chr12,RNU6-837P,chr12:17071398-17071505,107
12111952,12112036,chr12,MIR1244-4,chr12:12111952-12112036,84
12226674,12226777,chr12,RNU6-545P,chr12:12226674-12226777,103
17673299,17673394,chr12,MIR3974,chr12:17673299-17673394,95
104079847,104406121,chr5,LINC02163,chr5:104079847-104406121,326274
19445949,19446055,chr12,RNU6-254P,chr12:19445949-19446055,106
24212421,24212495,chr12,MIR920,chr12:24212421-24212495,74
15671707,15671810,chr12,RNU6-251P,chr12:15671707-15671810,103
24706788,24707083,chr12,RN7SL38P,chr12:24706788-24707083,295
12289227,12289329,chr12,RNU6-318P,chr12:12289227-12289329,102
93741591,93764749,chr11,C11orf54,chr11:93741591-93764749,23158
22195469,22195629,chr12,RNU1-149P,chr12:22195469-22195629,160
26373598,26373733,chr12,RNA5SP354,chr12:26373598-26373733,135
32402109,32403115,chr1,GAPDHP20,chr1:32402109-32403115,1006
25874020,25874079,chr12,MIR4302,chr12:25874020-25874079,59
19176288,19176589,chr12,RN7SL459P,chr12:19176288-19176589,301
176308063,176309013,chr5,BRCC3P1,chr5:176308063-176309013,950
19303480,19303775,chr12,RN7SL67P,chr12:19303480-19303775,295
16231692,16237183,chr1,CPLANE2,chr1:16231692-16237183,5491
34205699,34205817,chr12,RNA5SP357,chr12:34205699-34205817,118
41658676,41658793,chr12,RNA5SP360,chr12:41658676-41658793,117
25779287,25779569,chr12,RN7SKP262,chr12:25779287-25779569,282
80125941,80126317,chr10,RPL22P18,chr10:80125941-80126317,376
45874035,45874330,chr12,RN7SL246P,chr12:45874035-45874330,295
30306431,30306524,chr12,RNA5SP356,chr12:30306431-30306524,93
45117771,45117888,chr12,RNA5SP361,chr12:45117771-45117888,117
80131682,80145359,chr10,PLAC9,chr10:80131682-80145359,13677
38161466,38161582,chr12,RNA5SP358,chr12:38161466-38161582,116
38163403,38163515,chr12,RNA5SP359,chr12:38163403-38163515,112
19724435,19724599,chr12,RNU1-146P,chr12:19724435-19724599,164
47187812,47187891,chr12,MIR4698,chr12:47187812-47187891,79
33923374,33923480,chr12,RNU6-472P,chr12:33923374-33923480,106
78423697,78577396,chr17,DNAH17,chr17:78423697-78577396,153699
32465072,32496686,chr1,ZBTB8B,chr1:32465072-32496686,31614
50841498,50841785,chr12,RN7SL519P,chr12:50841498-50841785,287
50234142,50234212,chr12,MIR1293,chr12:50234142-50234212,70
50256238,50256344,chr12,RNU6-1093P,chr12:50256238-50256344,106
49593104,49593213,chr12,RNU6-834P,chr12:49593104-49593213,109
47364186,47364269,chr12,MIR4494,chr12:47364186-47364269,83
151100706,151157785,chr5,ANXA6,chr5:151100706-151157785,57079
45631148,45691281,chr15,SQOR,chr15:45631148-45691281,60133
48656648,48656782,chr12,SNORA2A,chr12:48656648-48656782,134
15792796,15793285,chr1,RPL12P14,chr1:15792796-15793285,489
5024844,5034141,chr16,NAGPA,chr16:5024844-5034141,9297
48667457,48667593,chr12,SNORA2B,chr12:48667457-48667593,136
48654382,48654518,chr12,SNORA2C,chr12:48654382-48654518,136
48654444,48654530,chr12,MIR1291,chr12:48654444-48654530,86
31802958,31803090,chr12,RNU6-1069P,chr12:31802958-31803090,132
53138545,53138651,chr12,RNU6-333P,chr12:53138545-53138651,106
6185020,6209389,chr1,RPL22,chr1:6185020-6209389,24369
33576095,33576200,chr12,RNU6-400P,chr12:33576095-33576200,105
53816185,53816479,chr12,RN7SKP289,chr12:53816185-53816479,294
128344081,128344142,chr7,RNU7-27P,chr7:128344081-128344142,61
59450673,59450772,chr12,RNU6-871P,chr12:59450673-59450772,99
57977965,57978277,chr12,RN7SKP65,chr12:57977965-57978277,312
41683978,41736259,chr6,TFEB,chr6:41683978-41736259,52281
59369051,59369151,chr12,RNU6-279P,chr12:59369051-59369151,100
70052544,70112282,chr10,MACROH2A2,chr10:70052544-70112282,59738
128350325,128361685,chr7,PRRT4,chr7:128350325-128361685,11360
59586793,59586943,chr12,RNU4-20P,chr12:59586793-59586943,150
57194504,57194576,chr12,MIR1228,chr12:57194504-57194576,72
62334091,62334197,chr12,RNU6-595P,chr12:62334091-62334197,106
15002481,15070153,chr4,CPEB2,chr4:15002481-15070153,67672
62850738,62850901,chr12,RNU1-83P,chr12:62850738-62850901,163
62260359,62260454,chr12,MIR6125,chr12:62260359-62260454,95
69400903,69401200,chr12,RN7SL804P,chr12:69400903-69401200,297
50633273,50633376,chr12,RNU6-769P,chr12:50633273-50633376,103
53056944,53057012,chr12,MIR6757,chr12:53056944-53057012,68
73679188,73679296,chr12,RNU6-1012P,chr12:73679188-73679296,108
50656973,50657078,chr12,RNU6-238P,chr12:50656973-50657078,105
76315751,76316048,chr12,RN7SKP172,chr12:76315751-76316048,297
79419257,79419321,chr12,MIR1252,chr12:79419257-79419321,64
89282223,89282285,chr12,RNU7-120P,chr12:89282223-89282285,62
88581639,88581796,chr12,RNU1-117P,chr12:88581639-88581796,157
69584722,69584823,chr12,MIR3913-1,chr12:69584722-69584823,101
68627234,68627375,chr12,SNORA70G,chr12:68627234-68627375,141
79878305,79878419,chr12,RNA5SP363,chr12:79878305-79878419,114
93509487,93509768,chr12,RN7SL737P,chr12:93509487-93509768,281
69584723,69584822,chr12,MIR3913-2,chr12:69584723-69584822,99
53991738,53991847,chr12,MIR196A2,chr12:53991738-53991847,109
105486317,105488947,chr14,CRIP1,chr14:105486317-105488947,2630
54033950,54034045,chr12,MIR615,chr12:54033950-54034045,95
68911921,68911982,chr12,RNU7-4P,chr12:68911921-68911982,61
80832533,80832629,chr12,MIR617,chr12:80832533-80832629,96
80935736,80935833,chr12,MIR618,chr12:80935736-80935833,97
81158388,81158461,chr12,MIR4699,chr12:81158388-81158461,73
95308420,95308513,chr12,MIR331,chr12:95308420-95308513,93
89726936,89727042,chr12,RNA5SP365,chr12:89726936-89727042,106
133754811,133755450,chr8,MTND2P7,chr8:133754811-133755450,639
89754059,89754152,chr12,RNU6-148P,chr12:89754059-89754152,93
128392277,128410252,chr7,IMPDH1,chr7:128392277-128410252,17975
95290692,95290799,chr12,RNU6-808P,chr12:95290692-95290799,107
94561789,94561859,chr12,MIR5700,chr12:94561789-94561859,70
127400399,127402150,chr8,CCAT2,chr8:127400399-127402150,1751
97939056,97939121,chr12,MIR4495,chr12:97939056-97939121,65
92952639,92952745,chr12,RNU6-1329P,chr12:92952639-92952745,106
83021890,83021992,chr12,RNU6-977P,chr12:83021890-83021992,102
101199271,101199377,chr12,RNU6-768P,chr12:101199271-101199377,106
109409678,109410084,chr3,H3P12,chr3:109409678-109410084,406
142771197,142777810,chr8,LYNX1,chr8:142771197-142777810,6613
96101951,96102249,chr12,RN7SL88P,chr12:96101951-96102249,298
6205475,6221299,chr1,RNF207,chr1:6205475-6221299,15824
94515476,94515760,chr12,RN7SL483P,chr12:94515476-94515760,284
101472339,101472456,chr12,RNA5SP367,chr12:101472339-101472456,117
95309923,95309984,chr12,MIR3685,chr12:95309923-95309984,61
96303375,96303513,chr12,RNU4-24P,chr12:96303375-96303513,138
105366909,105576900,chr3,ALCAM,chr3:105366909-105576900,209991
101871742,101871801,chr12,RNU6-1183P,chr12:101871742-101871801,59
101466705,101466820,chr12,RNU5E-5P,chr12:101466705-101466820,115
98417896,98418038,chr12,RNU4-41P,chr12:98417896-98418038,142
72288785,72289110,chr2,RPS15AP13,chr2:72288785-72289110,325
101836820,101836927,chr12,RNA5SP369,chr12:101836820-101836927,107
94571231,94571352,chr12,MIR7844,chr12:94571231-94571352,121
94361220,94361526,chr12,RN7SL330P,chr12:94361220-94361526,306
69273157,69273218,chr12,MIR1279,chr12:69273157-69273218,61
102217318,102217613,chr12,RN7SL793P,chr12:102217318-102217613,295
100660199,100660678,chr2,NANOGNBP1,chr2:100660199-100660678,479
95438737,95438843,chr12,RNU6-735P,chr12:95438737-95438843,106
97995383,97995448,chr12,MIR4303,chr12:97995383-97995448,65
101765406,101765509,chr12,RNU6-101P,chr12:101765406-101765509,103
101719808,101719918,chr12,RNY1P16,chr12:101719808-101719918,110
101779814,101779929,chr12,RNA5SP368,chr12:101779814-101779929,115
101796410,101796502,chr12,RNU6-172P,chr12:101796410-101796502,92
97721716,97721822,chr12,RNU6-36P,chr12:97721716-97721822,106
93831076,93831372,chr12,RN7SL630P,chr12:93831076-93831372,296
101411357,101411459,chr12,RNU6-1068P,chr12:101411357-101411459,102
95792529,95792635,chr12,RNU6-247P,chr12:95792529-95792635,106
116428252,116428318,chr12,MIR4472-2,chr12:116428252-116428318,66
111799834,111799905,chr12,MIR6761,chr12:111799834-111799905,71
111304142,111304209,chr12,MIR6760,chr12:111304142-111304209,67
106282927,106282989,chr12,RNU7-94P,chr12:106282927-106282989,62
112695034,112695176,chr12,MIR1302-1,chr12:112695034-112695176,142
108836908,108837006,chr12,MIR619,chr12:108836908-108837006,98
100189884,100189949,chr12,MIR1827,chr12:100189884-100189949,65
116082570,116082676,chr12,RNU6-1188P,chr12:116082570-116082676,106
111339527,111339621,chr12,RNA5SP373,chr12:111339527-111339621,94
107486511,107486635,chr12,RNA5SP371,chr12:107486511-107486635,124
116148560,116148654,chr12,MIR620,chr12:116148560-116148654,94
100158502,100158765,chr12,RN7SL176P,chr12:100158502-100158765,263
94008739,94009047,chr12,RN7SKP263,chr12:94008739-94009047,308
17717625,17749978,chr1,LINC02810,chr1:17717625-17749978,32353
96427200,96427486,chr12,RN7SKP11,chr12:96427200-96427486,286
120313238,120313341,chr12,RNU6-1088P,chr12:120313238-120313341,103
112995517,112995937,chr2,POLR2DP1,chr2:112995517-112995937,420
118829681,118829805,chr12,RNA5SP374,chr12:118829681-118829805,124
142764334,142778224,chr8,LYNX1-SLURP2,chr8:142764334-142778224,13890
115717725,115718013,chr12,RN7SL865P,chr12:115717725-115718013,288
70247329,70284004,chr10,NPFFR1,chr10:70247329-70284004,36675
37544763,37545294,chr1,FTH1P1,chr1:37544763-37545294,531
121908103,121908163,chr12,RNU7-170P,chr12:121908103-121908163,60
109059986,109060100,chr12,RNA5SP372,chr12:109059986-109060100,114
121444273,121444352,chr12,MIR7107,chr12:121444273-121444352,79
127321355,127321529,chr12,RNU1-104P,chr12:127321355-127321529,174
131299640,131299751,chr12,RNA5SP376,chr12:131299640-131299751,111
18630846,18748866,chr1,PAX7,chr1:18630846-18748866,118020
128294092,128294178,chr12,MIR3612,chr12:128294092-128294178,86
133238335,133238438,chr12,RNU6-717P,chr12:133238335-133238438,103
118993857,118994159,chr12,RN7SL508P,chr12:118993857-118994159,302
119544432,119662251,chr2,CFAP221,chr2:119544432-119662251,117819
104591633,104591716,chr12,MIR3922,chr12:104591633-104591716,83
3232264,3258897,chr10,LINC02668,chr10:3232264-3258897,26633
97491909,97491978,chr12,MIR1251,chr12:97491909-97491978,69
108926435,108926541,chr12,RNU6-361P,chr12:108926435-108926541,106
97563812,97563911,chr12,MIR135A2,chr12:97563812-97563911,99
124337181,124337242,chr12,MIR6880,chr12:124337181-124337242,61
122781655,122974510,chr8,ZHX2,chr8:122781655-122974510,192855
132031224,132031359,chr12,SNORA49,chr12:132031224-132031359,135
1660315,1660380,chr12,MIR3649,chr12:1660315-1660380,65
1688574,1788674,chr12,ADIPOR2,chr12:1688574-1788674,100100
5084284,5097795,chr16,EEF2KMT,chr16:5084284-5097795,13511
134598071,134600689,chr8,ZFAT-AS1,chr8:134598071-134600689,2618
135693407,135704498,chr9,SOHLH1,chr9:135693407-135704498,11091
32887273,33005792,chr10,ITGB1,chr10:32887273-33005792,118519
50417385,50418692,chr15,AHCYP7,chr15:50417385-50418692,1307
105489855,105499575,chr14,TEDC1,chr14:105489855-105499575,9720
72086888,72087725,chr3,CCDC137P,chr3:72086888-72087725,837
58824437,59019093,chr3,CFAP20DC-AS1,chr3:58824437-59019093,194656
50424380,50514421,chr15,USP8,chr15:50424380-50514421,90041
65009289,65056740,chr17,GNA13,chr17:65009289-65056740,47451
143246821,143262705,chr8,ZFP41,chr8:143246821-143262705,15884
107834586,107928907,chr3,LINC00636,chr3:107834586-107928907,94321
1757231,1758011,chr12,RPS4XP14,chr12:1757231-1758011,780
111979010,111993368,chr3,ABHD10,chr3:111979010-111993368,14358
135702185,135795508,chr9,KCNT1,chr9:135702185-135795508,93323
81976807,82017406,chr17,ASPSCR1,chr17:81976807-82017406,40599
1791963,1918666,chr12,CACNA2D4,chr12:1791963-1918666,126703
53537060,53540300,chr8,MAPK6P1,chr8:53537060-53540300,3240
124044395,124171522,chr8,FER1L6-AS2,chr8:124044395-124171522,127127
54497879,54510687,chr19,LAIR2,chr19:54497879-54510687,12808
112120839,112133270,chr3,GCSAM,chr3:112120839-112133270,12431
73290242,73295789,chr8,RPL7,chr8:73290242-73295789,5547
39838110,39883511,chr1,TRIT1,chr1:39838110-39883511,45401
66744451,66843516,chr11,C11orf80,chr11:66744451-66843516,99065
81030708,81057627,chr4,BMP3,chr4:81030708-81057627,26919
213155806,213167712,chr2,LINC01953,chr2:213155806-213167712,11906
49255472,49256102,chr19,SLC6A21P,chr19:49255472-49256102,630
141208082,141208376,chr2,RPS16P3,chr2:141208082-141208376,294
190024367,190027257,chr4,FRG2,chr4:190024367-190027257,2890
5110793,5148685,chr16,ENPP7P14,chr16:5110793-5148685,37892
58278966,58315197,chr19,ZNF8-ERVK3-1,chr19:58278966-58315197,36231
185956587,185957063,chr2,RPL21P32,chr2:185956587-185957063,476
5215243,5220843,chr16,LINC02164,chr16:5215243-5220843,5600
45467995,45475179,chr19,FOSB,chr19:45467995-45475179,7184
5270174,5270954,chr16,RPS3AP48,chr16:5270174-5270954,780
5289200,5289409,chr16,SNRPCP20,chr16:5289200-5289409,209
154445997,154461053,chr5,SAP30L,chr5:154445997-154461053,15056
5365797,5366688,chr16,NPM1P3,chr16:5365797-5366688,891
5596856,5616373,chr16,LINC01570,chr16:5596856-5616373,19517
172735274,173052893,chr2,RAPGEF4,chr2:172735274-173052893,317619
2078998,2242276,chr4,HAUS3,chr4:2078998-2242276,163278
5632467,5632566,chr16,MIR8065,chr16:5632467-5632566,99
6748908,6748969,chr16,RNU7-99P,chr16:6748908-6748969,61
133755845,133756646,chr8,MTCO1P49,chr8:133755845-133756646,801
26746593,26861087,chr10,ABI1,chr10:26746593-26861087,114494
6873899,6874005,chr16,RNU6-457P,chr16:6873899-6874005,106
7004007,7004112,chr16,RNU6-328P,chr16:7004007-7004112,105
96645242,97149654,chr8,CPQ,chr8:96645242-97149654,504412
56565073,56568957,chr16,MT4,chr16:56565073-56568957,3884
107522936,107811339,chr3,BBX,chr3:107522936-107811339,288403
163887506,163887827,chr5,LSM1P2,chr5:163887506-163887827,321
56608584,56609497,chr16,MT2A,chr16:56608584-56609497,913
180830326,180839742,chr5,LINC00847,chr5:180830326-180839742,9416
165279664,165309605,chr6,C6orf118,chr6:165279664-165309605,29941
24806117,24980204,chr4,CCDC149,chr4:24806117-24980204,174087
165409562,165409676,chr6,RNA5SP226,chr6:165409562-165409676,114
56625475,56627112,chr16,MT1E,chr16:56625475-56627112,1637
165718235,165718338,chr6,RNU6-730P,chr6:165718235-165718338,103
31857659,31862905,chr6,NEU1,chr6:31857659-31862905,5246
116574482,116611200,chr5,SEMA6A-AS2,chr5:116574482-116611200,36718
124766498,124800706,chr11,MSANTD2,chr11:124766498-124800706,34208
78644265,78644845,chr5,HMGB1P21,chr5:78644265-78644845,580
57320472,57330770,chr19,ZNF543,chr19:57320472-57330770,10298
118973796,118974122,chr5,PTMAP2,chr5:118973796-118974122,326
82777797,82778586,chr5,RPL5P16,chr5:82777797-82778586,789
56632659,56633981,chr16,MT1M,chr16:56632659-56633981,1322
148321203,148339852,chr5,SPINK9,chr5:148321203-148339852,18649
123013170,123042302,chr8,DERL1,chr8:123013170-123042302,29132
49275119,49275420,chr19,SUMO1P4,chr19:49275119-49275420,301
41521043,41521989,chr19,PLEKHA3P1,chr19:41521043-41521989,946
35586161,35587296,chr19,PMIS2,chr19:35586161-35587296,1135
149351709,149896233,chr4,IQCM,chr4:149351709-149896233,544524
56635739,56637086,chr16,MT1JP,chr16:56635739-56637086,1347
66257294,66267860,chr11,KLC2,chr11:66257294-66267860,10566
16902294,16902641,chr5,RPS26P28,chr5:16902294-16902641,347
48170680,48197620,chr19,ZSWIM9,chr19:48170680-48197620,26940
139846779,140043299,chr5,NRG2,chr5:139846779-140043299,196520
56638666,56640087,chr16,MT1A,chr16:56638666-56640087,1421
56648248,56649514,chr16,MT1CP,chr16:56648248-56649514,1266
56651886,56653204,chr16,MT1B,chr16:56651886-56653204,1318
44417519,44448578,chr19,ZNF229,chr19:44417519-44448578,31059
151102751,151325605,chr4,SH3D19,chr4:151102751-151325605,222854
80169992,80209331,chr17,CARD14,chr17:80169992-80209331,39339
85607779,85644063,chr6,SYNCRIP,chr6:85607779-85644063,36284
56657731,56660698,chr16,MT1F,chr16:56657731-56660698,2967
56676132,56677763,chr16,MT1IP,chr16:56676132-56677763,1631
56682470,56684196,chr16,MT1X,chr16:56682470-56684196,1726
55039108,55071291,chr19,RDH13,chr19:55039108-55071291,32183
56686851,56688052,chr16,DPPA2P4,chr16:56686851-56688052,1201
56708450,56730010,chr16,NUP93-DT,chr16:56708450-56730010,21560
21238874,21303083,chr16,CRYM,chr16:21238874-21303083,64209
105526583,105530202,chr14,TMEM121,chr14:105526583-105530202,3619
128443449,128443510,chr7,RNU7-54P,chr7:128443449-128443510,61
105536861,105537239,chr14,ATP5MC1P1,chr14:105536861-105537239,378
105546610,105549694,chr14,ELK2BP,chr14:105546610-105549694,3084
128455849,128458418,chr7,HILPDA,chr7:128455849-128458418,2569
65644734,65771261,chr8,MTFR1,chr8:65644734-65771261,126527
105583731,105588395,chr14,IGHA2,chr14:105583731-105588395,4664
128476729,128506602,chr7,METTL2B,chr7:128476729-128506602,29873
105597691,105601728,chr14,IGHE,chr14:105597691-105601728,4037
105620506,105626066,chr14,IGHG4,chr14:105620506-105626066,5560
44885903,44951306,chr11,TP53I11,chr11:44885903-44951306,65403
21639550,21652608,chr16,IGSF6,chr16:21639550-21652608,13058
52397849,52418412,chr19,ZNF528,chr19:52397849-52418412,20563
105621116,105621180,chr14,MIR8071-1,chr14:105621116-105621180,64
105639559,105644790,chr14,IGHG2,chr14:105639559-105644790,5231
168486451,168519301,chr5,RARS1,chr5:168486451-168519301,32850
21642054,21642160,chr16,RNU6-1005P,chr16:21642054-21642160,106
21642294,21642400,chr16,RNU6-196P,chr16:21642294-21642400,106
21879338,21919156,chr16,SMG1P4,chr16:21879338-21919156,39818
50463381,50463498,chr15,RNA5SP395,chr15:50463381-50463498,117
102405742,102405855,chr7,MIR548O,chr7:102405742-102405855,113
102456238,102464863,chr7,ALKBH4,chr7:102456238-102464863,8625
105640168,105640232,chr14,MIR8071-2,chr14:105640168-105640232,64
105647924,105649057,chr14,COPDA1,chr14:105647924-105649057,1133
50494018,50546708,chr15,USP50,chr15:50494018-50546708,52690
100537147,100587417,chr14,BEGAIN,chr14:100537147-100587417,50270
102464956,102473168,chr7,LRWD1,chr7:102464956-102473168,8212
45485294,45497055,chr19,RTN2,chr19:45485294-45497055,11761
21434318,21437558,chr1,CROCCP5,chr1:21434318-21437558,3240
30711277,30723585,chr1,MATN1,chr1:30711277-30723585,12308
21953288,21983660,chr16,UQCRC2,chr16:21953288-21983660,30372
18839599,18859682,chr1,TAS1R2,chr1:18839599-18859682,20083
126072587,126074231,chr8,KNOP1P5,chr8:126072587-126074231,1644
50552473,50686797,chr15,TRPM7,chr15:50552473-50686797,134324
12716110,12728760,chr1,AADACL3,chr1:12716110-12728760,12650
138588235,138914041,chr8,COL22A1,chr8:138588235-138914041,325806
32423214,32426789,chr1,LRRC37A12P,chr1:32423214-32426789,3575
26019884,26036464,chr1,EXTL1,chr1:26019884-26036464,16580
42408373,42657105,chr4,ATP8A1,chr4:42408373-42657105,248732
76710658,76761388,chr14,VASH1-DT,chr14:76710658-76761388,50730
76761468,76783015,chr14,VASH1,chr14:76761468-76783015,21547
74609885,74623738,chr17,CD300E,chr17:74609885-74623738,13853
124673844,124697518,chr11,SPA17,chr11:124673844-124697518,23674
102465742,102465826,chr7,MIR5090,chr7:102465742-102465826,84
102471469,102471531,chr7,MIR4467,chr7:102471469-102471531,62
102479976,102517777,chr7,RASA4B,chr7:102479976-102517777,37801
109542799,109614143,chr2,SEPTIN10,chr2:109542799-109614143,71344
439870,440232,chr1,WBP1LP7,chr1:439870-440232,362
10636604,10796650,chr1,CASZ1,chr1:10636604-10796650,160046
160393148,160400054,chr5,ZBED8,chr5:160393148-160400054,6906
34621093,34663288,chr11,EHF,chr11:34621093-34663288,42195
168616352,168616996,chr5,RPL10P9,chr5:168616352-168616996,644
122675795,122676755,chr5,ARGFXP1,chr5:122675795-122676755,960
134226410,134227827,chr5,PPP2CA-DT,chr5:134226410-134227827,1417
76781733,76786724,chr14,VASH1-AS1,chr14:76781733-76786724,4991
63682336,63741986,chr17,STRADA,chr17:63682336-63741986,59650
76786009,76826246,chr14,ANGEL1,chr14:76786009-76826246,40237
139647299,139683882,chr5,CXXC5,chr5:139647299-139683882,36583
76886377,76886750,chr14,RPL22P2,chr14:76886377-76886750,373
76890263,76890613,chr14,RN7SKP17,chr14:76890263-76890613,350
174513305,174514307,chr5,GAPDHP71,chr5:174513305-174514307,1002
76967518,76967765,chr14,RN7SL356P,chr14:76967518-76967765,247
15571699,15585051,chr1,AGMAT,chr1:15571699-15585051,13352
77024543,77028708,chr14,IRF2BPL,chr14:77024543-77028708,4165
77041064,77069503,chr14,LINC02288,chr14:77041064-77069503,28439
77069169,77076392,chr14,LINC02289,chr14:77069169-77076392,7223
138178719,138187723,chr5,KIF20A,chr5:138178719-138187723,9004
44467641,44473227,chr19,ZNF285B,chr19:44467641-44473227,5586
29205320,29213151,chr19,UQCRFS1,chr19:29205320-29213151,7831
102537918,102572653,chr7,POLR2J3,chr7:102537918-102572653,34735
45001548,45036071,chr3,CLEC3B,chr3:45001548-45036071,34523
76826372,76870304,chr14,LRRC74A,chr14:76826372-76870304,43932
52425863,52426202,chr19,DPPA5P1,chr19:52425863-52426202,339
21524646,21743630,chr10,MLLT10,chr10:21524646-21743630,218984
2184461,2212720,chr1,FAAP20,chr1:2184461-2212720,28259
43007656,43026474,chr19,PSG11,chr19:43007656-43026474,18818
101430411,101431553,chr6,ACTG1P18,chr6:101430411-101431553,1142
172103006,172109982,chr2,DLX2-DT,chr2:172103006-172109982,6976
104063039,104063582,chr3,RAP1BP2,chr3:104063039-104063582,543
163840561,163840852,chr6,RN7SL366P,chr6:163840561-163840852,291
171999943,172082430,chr2,METAP1D,chr2:171999943-172082430,82487
28111173,28111647,chr16,TPRKBP2,chr16:28111173-28111647,474
58526871,58578220,chr11,LPXN,chr11:58526871-58578220,51349
28183318,28183430,chr16,RNY1P10,chr16:28183318-28183430,112
28239693,28240668,chr16,GAPDHP35,chr16:28239693-28240668,975
30414715,30419319,chr6,MICC,chr6:30414715-30419319,4604
28259246,28323849,chr16,SBK1,chr16:28259246-28323849,64603
52524385,52535054,chr3,NT5DC2,chr3:52524385-52535054,10669
30466452,30467994,chr6,TMPOP1,chr6:30466452-30467994,1542
30468882,30470251,chr6,SUCLA2P1,chr6:30468882-30470251,1369
30485940,30486590,chr6,RANP1,chr6:30485940-30486590,650
30489509,30494194,chr6,HLA-E,chr6:30489509-30494194,4685
49289638,49325215,chr19,SLC6A16,chr19:49289638-49325215,35577
28342555,28363508,chr16,NPIPB6,chr16:28342555-28363508,20953
118133377,118152888,chr11,SCN4B,chr11:118133377-118152888,19511
28390982,28391051,chr16,MIR6862-1,chr16:28390982-28391051,69
28413703,28415018,chr16,CDC37P2,chr16:28413703-28415018,1315
50688900,50689193,chr15,RN7SL354P,chr15:50688900-50689193,293
50702266,50765709,chr15,SPPL2A,chr15:50702266-50765709,63443
173477996,173478400,chr2,CBY1P1,chr2:173477996-173478400,404
135510546,135511943,chr2,G3BP1P1,chr2:135510546-135511943,1397
140657900,141002216,chr8,PTK2,chr8:140657900-141002216,344316
103519667,103522833,chr14,CKB,chr14:103519667-103522833,3166
186486253,186509361,chr2,ZC3H15,chr2:186486253-186509361,23108
114257787,114313536,chr11,NNMT,chr11:114257787-114313536,55749
1820267,1836753,chr12,LRTM2,chr12:1820267-1836753,16486
115578642,115626161,chr5,TMED7-TICAM2,chr5:115578642-115626161,47519
102637025,102642791,chr7,UPK3BL1,chr7:102637025-102642791,5766
30516266,30519217,chr6,LINC02569,chr6:30516266-30519217,2951
30557280,30563723,chr6,PRR3,chr6:30557280-30563723,6443
14443440,14500027,chr11,COPB1,chr11:14443440-14500027,56587
145001853,145005789,chr5,NAMPTP2,chr5:145001853-145005789,3936
28456372,28471175,chr16,NPIPB7,chr16:28456372-28471175,14803
48805212,48861817,chr4,OCIAD1,chr4:48805212-48861817,56605
100535374,100586741,chr5,FAM174A,chr5:100535374-100586741,51367
102665368,102671629,chr7,POLR2J2,chr7:102665368-102671629,6261
37556919,37566857,chr1,DNALI1,chr1:37556919-37566857,9938
1929202,1936574,chr12,LINC00940,chr12:1929202-1936574,7372
28499362,28512051,chr16,IL27,chr16:28499362-28512051,12689
102681836,102690469,chr7,RASA4DP,chr7:102681836-102690469,8633
58305319,58315663,chr19,ERVK3-1,chr19:58305319-58315663,10344
1946053,2004535,chr12,DCP1B,chr12:1946053-2004535,58482
116085016,116412762,chr5,COMMD10,chr5:116085016-116412762,327746
136114349,136118149,chr2,CXCR4,chr2:136114349-136118149,3800
56955785,56955864,chr7,MIR4283-1,chr7:56955785-56955864,79
56991888,57009149,chr7,TNRC18P3,chr7:56991888-57009149,17261
21411460,21413293,chr1,PDE4DIPP10,chr1:21411460-21413293,1833
43035869,43041248,chr19,CEACAMP8,chr19:43035869-43041248,5379
30584332,30584417,chr6,MIR877,chr6:30584332-30584417,85
30600413,30618612,chr6,PPP1R10,chr6:30600413-30618612,18199
28553915,28591790,chr16,SGF29,chr16:28553915-28591790,37875
57014285,57020273,chr7,SLC29A4P1,chr7:57014285-57020273,5988
161416297,161425870,chr2,TBR1,chr2:161416297-161425870,9573
103562960,103607523,chr14,COA8,chr14:103562960-103607523,44563
57060590,57061301,chr7,PHKG1P4,chr7:57060590-57061301,711
50798670,50798951,chr15,RPL32P30,chr15:50798670-50798951,281
57067950,57074664,chr7,SEPTIN7P15,chr7:57067950-57074664,6714
46746046,46776988,chr19,FKRP,chr19:46746046-46776988,30942
71675414,71754773,chr3,EIF4E3,chr3:71675414-71754773,79359
89243945,89317261,chr15,FANCI,chr15:89243945-89317261,73316
41027200,41242154,chr1,SCMH1,chr1:41027200-41242154,214954
57167200,57167880,chr7,MTATP6P8,chr7:57167200-57167880,680
57167880,57168651,chr7,MTCO3P10,chr7:57167880-57168651,771
57169143,57169412,chr7,MTND4LP32,chr7:57169143-57169412,269
57169406,57170771,chr7,MTND4P4,chr7:57169406-57170771,1365
176346062,176361807,chr5,KIAA1191,chr5:176346062-176361807,15745
57170974,57172771,chr7,MTND5P6,chr7:57170974-57172771,1797
2018213,2020532,chr12,CACNA1C-IT1,chr12:2018213-2020532,2319
57172772,57173283,chr7,MTND6P29,chr7:57172772-57173283,511
57173357,57174362,chr7,MTCYBP29,chr7:57173357-57174362,1005
57177409,57180052,chr7,GUSBP10,chr7:57177409-57180052,2643
57185788,57186202,chr7,MTND1P4,chr7:57185788-57186202,414
8913896,8941467,chr12,PHC1,chr12:8913896-8941467,27571
57186412,57187441,chr7,MTND2P6,chr7:57186412-57187441,1029
57187892,57189437,chr7,MTCO1P10,chr7:57187892-57189437,1545
57189578,57190226,chr7,MTCO2P10,chr7:57189578-57190226,648
57190461,57191138,chr7,MTATP6P10,chr7:57190461-57191138,677
57191141,57191927,chr7,MTCO3P4,chr7:57191141-57191927,786
28700294,28701540,chr16,CDC37P1,chr16:28700294-28701540,1246
163593396,163736012,chr2,FIGN,chr2:163593396-163736012,142616
28724252,28724321,chr16,MIR6862-2,chr16:28724252-28724321,69
57192695,57194068,chr7,MTND4P5,chr7:57192695-57194068,1373
57194257,57196054,chr7,MTND5P7,chr7:57194257-57196054,1797
57196638,57197772,chr7,MTCYBP5,chr7:57196638-57197772,1134
57200825,57203597,chr7,GUSBP12,chr7:57200825-57203597,2772
112482156,112541739,chr2,TTL,chr2:112482156-112541739,59583
28842411,28846348,chr16,TUFM,chr16:28842411-28846348,3937
57227001,57227066,chr7,RNU7-157P,chr7:57227001-57227066,65
29576479,30191898,chr14,PRKD1,chr14:29576479-30191898,615419
30617840,30626395,chr6,MRPS18B,chr6:30617840-30626395,8555
101357292,101359242,chr3,ZNF90P1,chr3:101357292-101359242,1950
200488958,200519784,chr2,KCTD18,chr2:200488958-200519784,30826
112034843,112081269,chr3,TMPRSS7,chr3:112034843-112081269,46426
57405025,57405090,chr7,MIR3147,chr7:57405025-57405090,65
57422830,57423725,chr7,VN1R28P,chr7:57422830-57423725,895
57424503,57425676,chr7,SAPCD2P2,chr7:57424503-57425676,1173
102538417,102543849,chr7,UPK3BL2,chr7:102538417-102543849,5432
90245174,90311063,chr7,CFAP69,chr7:90245174-90311063,65889
28843919,28844007,chr16,MIR4721,chr16:28843919-28844007,88
30626842,30646823,chr6,ATAT1,chr6:30626842-30646823,19981
28904421,28936526,chr16,RABEP2,chr16:28904421-28936526,32105
13388008,13463297,chr11,BTBD10,chr11:13388008-13463297,75289
68284171,68320051,chr2,CNRIP1,chr2:68284171-68320051,35880
117026698,117027039,chr3,PTMAP8,chr3:117026698-117027039,341
70751123,70751350,chr3,COX6CP6,chr3:70751123-70751350,227
50876712,50877657,chr3,ST13P14,chr3:50876712-50877657,945
50312324,50335558,chr14,DMAC2L,chr14:50312324-50335558,23234
106898889,106900591,chr3,MTND5P16,chr3:106898889-106900591,1702
106895729,106896408,chr3,MTND4LP3,chr3:106895729-106896408,679
130427731,130429225,chr2,KLF2P2,chr2:130427731-130429225,1494
140217651,140220368,chr2,MTND2P19,chr2:140217651-140220368,2717
134319654,134320078,chr2,EDDM3CP,chr2:134319654-134320078,424
106449775,107240671,chr3,LINC00882,chr3:106449775-107240671,790896
113498665,113501155,chr2,FOXD4L1,chr2:113498665-113501155,2490
113657908,113658675,chr2,SNRPA1P1,chr2:113657908-113658675,767
165220577,165241756,chr5,LINC01938,chr5:165220577-165241756,21179
208208135,208208984,chr2,RPSAP27,chr2:208208135-208208984,849
143100930,143101355,chr2,MTCO2P5,chr2:143100930-143101355,425
74754670,74754819,chr2,RPS28P5,chr2:74754670-74754819,149
22861303,22861594,chr19,VN1R88P,chr19:22861303-22861594,291
130273908,130275449,chr2,MTCO1P7,chr2:130273908-130275449,1541
138101878,138107178,chr2,LINC01832,chr2:138101878-138107178,5300
43064209,43083045,chr19,PSG2,chr19:43064209-43083045,18836
58275532,58296817,chr2,LINC01795,chr2:58275532-58296817,21285
119268692,119399688,chr5,TNFAIP8,chr5:119268692-119399688,130996
234050679,234077134,chr2,SPP2,chr2:234050679-234077134,26455
32267751,32378798,chr10,EPC1,chr10:32267751-32378798,111047
55282072,55312562,chr19,BRSK1,chr19:55282072-55312562,30490
80197526,80387757,chr14,DIO2,chr14:80197526-80387757,190231
150190062,150222788,chr5,SLC6A7,chr5:150190062-150222788,32726
18904280,18956676,chr1,IFFO2,chr1:18904280-18956676,52396
32892811,32993316,chr11,QSER1,chr11:32892811-32993316,100505
28931965,28939342,chr16,CD19,chr16:28931965-28939342,7377
59595976,59870776,chr14,RTN1,chr14:59595976-59870776,274800
38838198,38859772,chr1,RRAGC,chr1:38838198-38859772,21574
8940361,8949761,chr12,M6PR,chr12:8940361-8949761,9400
172893763,172894383,chr2,ALDH7A1P2,chr2:172893763-172894383,620
152131555,152131845,chr2,RPL30P2,chr2:152131555-152131845,290
118339075,118342705,chr11,CD3D,chr11:118339075-118342705,3630
90335223,90391453,chr7,GTPBP10,chr7:90335223-90391453,56230
109667128,109668002,chr2,BMS1P19,chr2:109667128-109668002,874
216672105,216695549,chr2,IGFBP5,chr2:216672105-216695549,23444
28095742,28096422,chr1,SPCS2P4,chr1:28095742-28096422,680
132948493,132948718,chr5,ATP6V0E1P1,chr5:132948493-132948718,225
93682838,93683667,chr5,NPM1P27,chr5:93682838-93683667,829
54918231,54967088,chr3,LRTM1,chr3:54918231-54967088,48857
128109486,128110994,chr5,POGLUT2P1,chr5:128109486-128110994,1508
36795527,37034515,chr1,GRIK3,chr1:36795527-37034515,238988
98679402,98681367,chr5,DDX18P4,chr5:98679402-98681367,1965
174561776,174562063,chr5,SUMO2P6,chr5:174561776-174562063,287
98531978,98534681,chr3,GPR15,chr3:98531978-98534681,2703
80626226,80654983,chr5,DHFR,chr5:80626226-80654983,28757
109409990,109723273,chr3,LINC01205,chr3:109409990-109723273,313283
64251530,64269150,chr11,PLCB3,chr11:64251530-64269150,17620
212795300,212819264,chr2,LINC01878,chr2:212795300-212819264,23964
57693205,57696596,chr3,DENND6A-DT,chr3:57693205-57696596,3391
52823935,52825314,chr3,ITIH4-AS1,chr3:52823935-52825314,1379
45224466,45226287,chr3,TMEM158,chr3:45224466-45226287,1821
8950044,9010760,chr12,KLRG1,chr12:8950044-9010760,60716
221592441,221592861,chr2,RPL23P5,chr2:221592441-221592861,420
106902173,106902523,chr3,MTND2P14,chr3:106902173-106902523,350
186488624,186489083,chr2,DPRXP1,chr2:186488624-186489083,459
89701590,89774939,chr10,KIF20B,chr10:89701590-89774939,73349
173485865,173486362,chr2,PPIAP66,chr2:173485865-173486362,497
112332347,112362812,chr3,CD200,chr3:112332347-112362812,30465
137423350,137434406,chr9,NOXA1,chr9:137423350-137434406,11056
21586472,21591187,chr1,LINC02596,chr1:21586472-21591187,4715
142877657,143055833,chr2,KYNU,chr2:142877657-143055833,178176
20111939,20119566,chr1,PLA2G2D,chr1:20111939-20119566,7627
9027532,9029089,chr12,HNRNPA1P34,chr12:9027532-9029089,1557
9036344,9037244,chr12,VDAC2P2,chr12:9036344-9037244,900
9055589,9065070,chr12,LINC00612,chr12:9055589-9065070,9481
37802945,37808208,chr1,YRDC,chr1:37802945-37808208,5263
28958583,28958661,chr16,MIR4517,chr16:28958583-28958661,78
9065163,9068689,chr12,A2M-AS1,chr12:9065163-9068689,3526
9127783,9128645,chr12,KRT17P8,chr12:9127783-9128645,862
9135084,9135591,chr12,BTG1P1,chr12:9135084-9135591,507
28974221,28984548,chr16,SPNS1,chr16:28974221-28984548,10327
31794470,31796175,chr3,ZNF587P1,chr3:31794470-31796175,1705
13303539,13308907,chr1,PRAMEF33,chr1:13303539-13308907,5368
9148840,9208395,chr12,PZP,chr12:9148840-9208395,59555
54396849,54420218,chr14,CDKN3,chr14:54396849-54420218,23369
108125821,108138610,chr3,LINC01215,chr3:108125821-108138610,12789
90383721,90513402,chr7,CLDN12,chr7:90383721-90513402,129681
176447628,176510074,chr5,FAF2,chr5:176447628-176510074,62446
69999550,70518064,chr3,SAMMSON,chr3:69999550-70518064,518514
11637018,11655785,chr1,FBXO2,chr1:11637018-11655785,18767
55072020,55087923,chr19,EPS8L1,chr19:55072020-55087923,15903
145936578,146081791,chr5,SH3RF2,chr5:145936578-146081791,145213
106900854,106901081,chr3,MTCO1P35,chr3:106900854-106901081,227
3898642,3901248,chr9,GLIS3-AS1,chr9:3898642-3901248,2606
4386410,4386556,chr9,RNU6-694P,chr9:4386410-4386556,146
68731766,68953297,chr3,TAFA4,chr3:68731766-68953297,221531
42040597,42041729,chr1,HNRNPFP1,chr1:42040597-42041729,1132
30633632,30633956,chr6,PTMAP1,chr6:30633632-30633956,324
33921693,34049388,chr9,UBAP2,chr9:33921693-34049388,127695
15736258,15741392,chr1,SLC25A34,chr1:15736258-15741392,5134
30647039,30653210,chr6,C6orf136,chr6:30647039-30653210,6171
90466424,91210590,chr7,CDK14,chr7:90466424-91210590,744166
119428949,119468830,chr3,TMEM39A,chr3:119428949-119468830,39881
15614643,15614867,chr1,CD24P1,chr1:15614643-15614867,224
42153410,42155820,chr1,GUCA2B,chr1:42153410-42155820,2410
49942049,49974850,chr10,TIMM23B,chr10:49942049-49974850,32801
17406760,17439677,chr1,RCC2,chr1:17406760-17439677,32917
172325000,172454525,chr5,SH3PXD2B,chr5:172325000-172454525,129525
98134624,98244897,chr10,R3HCC1L,chr10:98134624-98244897,110273
86244753,86278813,chr11,EED,chr11:86244753-86278813,34060
9155881,9156372,chr12,TPT1P12,chr12:9155881-9156372,491
9239467,9239551,chr12,MIR1244-3,chr12:9239467-9239551,84
9239986,9240331,chr12,PTMAP4,chr12:9239986-9240331,345
63096374,63097711,chr3,KRT8P35,chr3:63096374-63097711,1337
9240003,9257960,chr12,LINC00987,chr12:9240003-9257960,17957
114504876,114505187,chr12,RN7SKP216,chr12:114504876-114505187,311
30653119,30673006,chr6,DHX16,chr6:30653119-30673006,19887
114588194,114588802,chr12,OSTF1P1,chr12:114588194-114588802,608
112439312,112469687,chr2,VINAC1P,chr2:112439312-112469687,30375
114353911,114408442,chr12,TBX5,chr12:114353911-114408442,54531
57755450,57930003,chr3,SLMAP,chr3:57755450-57930003,174553
106304755,106305197,chr2,RPL27AP4,chr2:106304755-106305197,442
33750679,33799231,chr9,PRSS3,chr9:33750679-33799231,48552
38708931,38710890,chr1,HSPA5P1,chr1:38708931-38710890,1959
175842887,175843302,chr2,EXTL2P1,chr2:175842887-175843302,415
122954381,122997513,chr10,PSTK,chr10:122954381-122997513,43132
111006015,111523376,chr2,MIR4435-2HG,chr2:111006015-111523376,517361
136129507,136134890,chr5,SMAD5-AS1,chr5:136129507-136134890,5383
35599541,35641526,chr1,PSMB2,chr1:35599541-35641526,41985
163039291,163039599,chr5,MRPL57P6,chr5:163039291-163039599,308
144170873,144485686,chr5,KCTD16,chr5:144170873-144485686,314813
135570679,135579279,chr5,CXCL14,chr5:135570679-135579279,8600
61662929,61766766,chr10,CABCOCO1,chr10:61662929-61766766,103837
57363551,57365405,chr19,TRAPPC2B,chr19:57363551-57365405,1854
52453553,52516882,chr19,ZNF578,chr19:52453553-52516882,63329
175796310,175884021,chr5,CPLX2,chr5:175796310-175884021,87711
128068201,128109245,chr9,SLC25A25,chr9:128068201-128109245,41044
54532692,54545771,chr19,KIR3DX1,chr19:54532692-54545771,13079
87357720,87370695,chr10,NUTM2D,chr10:87357720-87370695,12975
57415296,57415403,chr12,RNU6-879P,chr12:57415296-57415403,107
15490832,15526534,chr1,CASP9,chr1:15490832-15526534,35702
57431116,57433935,chr12,R3HDM2-DT,chr12:57431116-57433935,2819
57434784,57452062,chr12,INHBC,chr12:57434784-57452062,17278
57452323,57459280,chr12,INHBE,chr12:57452323-57459280,6957
127907103,128085855,chr10,PTPRE,chr10:127907103-128085855,178752
30571393,30597179,chr6,ABCF1,chr6:30571393-30597179,25786
90631906,90632568,chr7,TVP23CP1,chr7:90631906-90632568,662
57459785,57472268,chr12,GLI1,chr12:57459785-57472268,12483
91107374,91107793,chr7,PTP4A1P3,chr7:91107374-91107793,419
91264433,91271326,chr7,FZD1,chr7:91264433-91271326,6893
91320128,91321103,chr7,NIPA2P1,chr7:91320128-91321103,975
121575848,121576320,chr5,RPL23AP44,chr5:121575848-121576320,472
90469639,90513397,chr7,PTTG1IP2,chr7:90469639-90513397,43758
132648794,132728769,chr7,FLJ40288,chr7:132648794-132728769,79975
29038655,29052726,chr16,NPIPB10P,chr16:29038655-29052726,14071
45039045,45070956,chr19,CLASRP,chr19:45039045-45070956,31911
29074976,29116718,chr16,RRN3P2,chr16:29074976-29116718,41742
154474972,154478227,chr5,HAND1,chr5:154474972-154478227,3255
116524994,116561179,chr7,CAV1,chr7:116524994-116561179,36185
86278333,86278398,chr11,MIR6755,chr11:86278333-86278398,65
86294760,86295576,chr11,SETP17,chr11:86294760-86295576,816
86324012,86324309,chr11,RN7SL225P,chr11:86324012-86324309,297
86374736,86423109,chr11,CCDC81,chr11:86374736-86423109,48373
32076114,32159728,chr14,ARHGAP5,chr14:32076114-32159728,83614
142399860,142400377,chr7,TRBV10-1,chr7:142399860-142400377,517
142407672,142408136,chr7,TRBV11-1,chr7:142407672-142408136,464
179023804,179035064,chr5,ZNF879,chr5:179023804-179035064,11260
142415224,142415666,chr7,TRBV12-1,chr7:142415224-142415666,442
142424965,142425465,chr7,TRBV10-2,chr7:142424965-142425465,500
142433895,142434394,chr7,TRBV11-2,chr7:142433895-142434394,499
142440883,142441325,chr7,TRBV12-2,chr7:142440883-142441325,442
142450947,142451448,chr7,TRBV6-5,chr7:142450947-142451448,501
142455174,142455635,chr7,TRBV7-4,chr7:142455174-142455635,461
76949751,77040384,chr4,SEPTIN11,chr4:76949751-77040384,90633
142462916,142463581,chr7,TRBV5-4,chr7:142462916-142463581,665
142469537,142470013,chr7,TRBV6-6,chr7:142469537-142470013,476
223957463,223967714,chr2,MRPL44,chr2:223957463-223967714,10251
77086688,77166909,chr5,ZBED3-AS1,chr5:77086688-77166909,80221
142474096,142474567,chr7,TRBV7-5,chr7:142474096-142474567,471
142482548,142483019,chr7,TRBV5-5,chr7:142482548-142483019,471
29381354,29404029,chr16,NPIPB11,chr16:29381354-29404029,22675
34989641,34998900,chr9,DNAJB5,chr9:34989641-34998900,9259
142487863,142488295,chr7,TRBV6-7,chr7:142487863-142488295,432
57472264,57488814,chr12,ARHGAP9,chr12:57472264-57488814,16550
155263458,155263724,chr2,MTCO1P45,chr2:155263458-155263724,266
142492132,142492673,chr7,TRBV7-6,chr7:142492132-142492673,541
142500028,142500534,chr7,TRBV5-6,chr7:142500028-142500534,506
29425800,29447026,chr16,SMG1P6,chr16:29425800-29447026,21226
15617458,15669044,chr1,DDI2,chr1:15617458-15669044,51586
142507382,142507810,chr7,TRBV6-8,chr7:142507382-142507810,428
142511626,142512127,chr7,TRBV7-7,chr7:142511626-142512127,501
142520090,142520556,chr7,TRBV5-7,chr7:142520090-142520556,466
136199114,136200503,chr2,HNRNPKP2,chr2:136199114-136200503,1389
142529290,142529762,chr7,TRBV7-9,chr7:142529290-142529762,472
170783786,170798971,chr2,ERICH2,chr2:170783786-170798971,15185
29454501,29458219,chr16,SLX1B,chr16:29454501-29458219,3718
142535809,142536292,chr7,TRBV13,chr7:142535809-142536292,483
142544212,142544685,chr7,TRBV10-3,chr7:142544212-142544685,473
142554836,142555318,chr7,TRBV11-3,chr7:142554836-142555318,482
142560423,142560931,chr7,TRBV12-3,chr7:142560423-142560931,508
142563740,142564245,chr7,TRBV12-4,chr7:142563740-142564245,505
142580917,142581427,chr7,TRBV12-5,chr7:142580917-142581427,510
140220584,140221485,chr2,MTND1P27,chr2:140220584-140221485,901
98694109,98695490,chr2,YWHAQP5,chr2:98694109-98695490,1381
116672196,116798377,chr7,MET,chr7:116672196-116798377,126181
86432098,86432575,chr11,PTP4A1P6,chr11:86432098-86432575,477
46303698,46316776,chr1,UQCRH,chr1:46303698-46316776,13078
206443532,206621127,chr2,ADAM23,chr2:206443532-206621127,177595
74120255,74150842,chr10,AP3M1,chr10:74120255-74150842,30587
111782195,111871581,chr11,ALG9,chr11:111782195-111871581,89386
21016763,21070872,chr14,NDRG2,chr14:21016763-21070872,54109
38047314,38119025,chr1,MIR3659HG,chr1:38047314-38119025,71711
89305198,89334861,chr15,POLG,chr15:89305198-89334861,29663
37330852,37330996,chr1,RPS29P6,chr1:37330852-37330996,144
29455105,29464963,chr16,SLX1B-SULT1A4,chr16:29455105-29464963,9858
31094987,31095558,chr1,SELENOWP1,chr1:31094987-31095558,571
137086857,137109189,chr9,MAN1B1,chr9:137086857-137109189,22332
67921899,68075301,chr10,HERC4,chr10:67921899-68075301,153402
35869808,35930532,chr1,AGO1,chr1:35869808-35930532,60724
3182626,3195784,chr6,LINC02525,chr6:3182626-3195784,13158
70412941,70561174,chr6,FAM135A,chr6:70412941-70561174,148233
29350746,29370272,chr16,SNX29P2,chr16:29350746-29370272,19526
120684919,120922870,chr4,PRDM5,chr4:120684919-120922870,237951
144439206,144439478,chr5,CKS1BP5,chr5:144439206-144439478,272
29599179,29599265,chr16,MIR3680-2,chr16:29599179-29599265,86
168529305,168530634,chr5,FBLL1,chr5:168529305-168530634,1329
29618785,29636328,chr16,CA5AP1,chr16:29618785-29636328,17543
24786842,24787024,chr5,BTG4P1,chr5:24786842-24787024,182
29662979,29670876,chr16,SPN,chr16:29662979-29670876,7897
47290023,47322066,chr19,C5AR1,chr19:47290023-47322066,32043
29527568,29594966,chr16,SMG1P2,chr16:29527568-29594966,67398
160421855,160428739,chr5,PTTG1,chr5:160421855-160428739,6884
46774883,46788594,chr19,SLC1A5,chr19:46774883-46788594,13711
29613103,29613640,chr16,SLC7A5P1,chr16:29613103-29613640,537
29973868,29992261,chr16,TAOK2,chr16:29973868-29992261,18393
164213539,164214414,chr2,PRPS1P1,chr2:164213539-164214414,875
138501770,138573547,chr2,SPOPL,chr2:138501770-138573547,71777
57197838,57227606,chr3,HESX1,chr3:57197838-57227606,29768
122476958,122477926,chr9,OR1J1,chr9:122476958-122477926,968
122510802,122511743,chr9,OR1J2,chr9:122510802-122511743,941
122519141,122520082,chr9,OR1J4,chr9:122519141-122520082,941
122526358,122527296,chr9,OR1N1,chr9:122526358-122527296,938
12916610,12920482,chr1,PRAMEF7,chr1:12916610-12920482,3872
122553112,122555173,chr9,OR1N2,chr9:122553112-122555173,2061
129242173,129273848,chr2,LINC01854,chr2:129242173-129273848,31675
119698623,119700151,chr2,RPL17P15,chr2:119698623-119700151,1528
122607864,122608800,chr9,OR1H1P,chr9:122607864-122608800,936
122614738,122615682,chr9,OR1Q1,chr9:122614738-122615682,944
72006774,72006975,chr3,UBE2Q2P9,chr3:72006774-72006975,201
122628579,122629573,chr9,OR1B1,chr9:122628579-122629573,994
122661566,122662648,chr9,OR1L1,chr9:122661566-122662648,1082
79792132,79801683,chr17,CBX8,chr17:79792132-79801683,9551
122685933,122688372,chr9,TLK1P1,chr9:122685933-122688372,2439
34975699,34978706,chr1,GPR199P,chr1:34975699-34978706,3007
111817214,111829212,chr11,ALG9-IT1,chr11:111817214-111829212,11998
111864254,111864460,chr11,GNG5P3,chr11:111864254-111864460,206
135897955,135898978,chr2,MANEALP1,chr2:135897955-135898978,1023
95871264,96121154,chr9,ERCC6L2,chr9:95871264-96121154,249890
26152198,26187137,chr7,NFE2L3,chr7:26152198-26187137,34939
111874056,111881243,chr11,FDXACB1,chr11:111874056-111881243,7187
36224432,36305357,chr1,THRAP3,chr1:36224432-36305357,80925
234329483,234329838,chr2,RPS20P12,chr2:234329483-234329838,355
142947300,142948086,chr2,SFXN4P1,chr2:142947300-142948086,786
51385291,51389397,chr3,MANF,chr3:51385291-51389397,4106
157257705,157318491,chr2,GALNT5,chr2:157257705-157318491,60786
111878935,111885975,chr11,C11orf1,chr11:111878935-111885975,7040
137518918,137532494,chr4,PCDH18,chr4:137518918-137532494,13576
82035136,82037709,chr17,DCXR,chr17:82035136-82037709,2573
26201162,26213607,chr7,CBX3,chr7:26201162-26213607,12445
89047442,89048434,chr3,GAPDHP50,chr3:89047442-89048434,992
132060655,132063204,chr5,IL3,chr5:132060655-132063204,2549
119498547,119525090,chr3,TIMMDC1,chr3:119498547-119525090,26543
55090914,55117637,chr19,PPP1R12C,chr19:55090914-55117637,26723
111889199,111889474,chr11,RPL37AP8,chr11:111889199-111889474,275
63506052,63516774,chr11,LGALS12,chr11:63506052-63516774,10722
161580072,161581350,chr2,KRT18P46,chr2:161580072-161581350,1278
142543418,142543975,chr2,UBE2V1P14,chr2:142543418-142543975,557
164321933,164322223,chr2,CYP2C56P,chr2:164321933-164322223,290
216785774,216786144,chr2,RPL31P14,chr2:216785774-216786144,370
158658337,158735002,chr2,PKP4-AS1,chr2:158658337-158735002,76665
17610496,17611583,chr5,TAF11L12,chr5:17610496-17611583,1087
29992330,29996074,chr16,HIRIP3,chr16:29992330-29996074,3744
97081098,97083249,chr2,GPAT2P2,chr2:97081098-97083249,2151
57475445,57517569,chr12,MARS1,chr12:57475445-57517569,42124
176060689,176116015,chr5,FAM153B,chr5:176060689-176116015,55326
56476826,56477987,chr8,SEPTIN10P1,chr8:56476826-56477987,1161
203764295,203765593,chr2,KRT18P39,chr2:203764295-203765593,1298
176065841,176182818,chr4,WDR17,chr4:176065841-176182818,116977
111383752,111384992,chr2,PAFAH1B1P2,chr2:111383752-111384992,1240
1275223,1280420,chr1,LINC01786,chr1:1275223-1280420,5197
42380792,42424232,chr1,RIMKLA,chr1:42380792-42424232,43440
130429827,130441413,chr2,CYP4F62P,chr2:130429827-130441413,11586
49724294,49786542,chr3,IP6K1,chr3:49724294-49786542,62248
112222928,113436939,chr8,CSMD3,chr8:112222928-113436939,1214011
194730595,194761435,chr2,LINC01790,chr2:194730595-194761435,30840
113667478,113668621,chr2,ACRP1,chr2:113667478-113668621,1143
134455759,134719000,chr2,TMEM163,chr2:134455759-134719000,263241
46446600,46451317,chr1,LINC01398,chr1:46446600-46451317,4717
42661716,42706447,chr7,LINC01448,chr7:42661716-42706447,44731
42794906,42802494,chr7,TCP1P1,chr7:42794906-42802494,7588
17372196,17401699,chr1,PADI6,chr1:17372196-17401699,29503
29995715,30005793,chr16,INO80E,chr16:29995715-30005793,10078
63536808,63546462,chr11,PLAAT4,chr11:63536808-63546462,9654
108589705,108694840,chr3,DZIP3,chr3:108589705-108694840,105135
63552770,63563379,chr11,PLAAT2,chr11:63552770-63563379,10609
213276552,213284205,chr2,SPAG16-DT,chr2:213276552-213284205,7653
45506579,45526983,chr19,VASP,chr19:45506579-45526983,20404
9148011,9198906,chr1,MIR34AHG,chr1:9148011-9198906,50895
63624087,63671921,chr11,ATL3,chr11:63624087-63671921,47834
42916828,42932185,chr7,PSMA2,chr7:42916828-42932185,15357
159771851,159904710,chr2,LY75-CD302,chr2:159771851-159904710,132859
17308195,17364004,chr1,PADI4,chr1:17308195-17364004,55809
109095110,109174418,chr6,CEP57L1,chr6:109095110-109174418,79308
3824127,4348392,chr9,GLIS3,chr9:3824127-4348392,524265
63632233,63632720,chr11,IMMP1LP1,chr11:63632233-63632720,487
63681446,63759891,chr11,RTN3,chr11:63681446-63759891,78445
39801414,39817460,chr1,LINC02811,chr1:39801414-39817460,16046
37806979,37809454,chr1,C1orf122,chr1:37806979-37809454,2475
48296457,48321971,chr19,ODAD1,chr19:48296457-48321971,25514
10895761,10895998,chr1,HSPE1P24,chr1:10895761-10895998,237
18065657,18074412,chr1,LINC01654,chr1:18065657-18074412,8755
80841978,80842073,chr15,MIR549A,chr15:80841978-80842073,95
37713880,37765133,chr1,EPHA10,chr1:37713880-37765133,51253
138506095,138543236,chr5,ETF1,chr5:138506095-138543236,37141
80946289,80989828,chr15,MESD,chr15:80946289-80989828,43539
42932376,42948958,chr7,MRPL32,chr7:42932376-42948958,16582
62950430,63125062,chr3,LINC00698,chr3:62950430-63125062,174632
103088664,103089610,chr7,CRYZP1,chr7:103088664-103089610,946
80997417,80997473,chr15,MIR4514,chr15:80997417-80997473,56
113403988,113433992,chr3,CFAP44-AS1,chr3:113403988-113433992,30004
81007033,81149179,chr15,CFAP161,chr15:81007033-81149179,142146
103152007,103152325,chr7,RPL23AP95,chr7:103152007-103152325,318
103262000,103262311,chr7,S100A11P1,chr7:103262000-103262311,311
116709235,116723581,chr3,TUSC7,chr3:116709235-116723581,14346
75641849,75724589,chr4,G3BP2,chr4:75641849-75724589,82740
103312289,103344830,chr7,DNAJC2,chr7:103312289-103344830,32541
63759892,63768775,chr11,ZFTA,chr11:63759892-63768775,8883
31797666,32072113,chr19,LINC01837,chr19:31797666-32072113,274447
19605454,19605933,chr17,MTCO1P39,chr17:19605454-19605933,479
94259298,94301829,chr9,ZNF169,chr9:94259298-94301829,42531
109293788,109316517,chr3,DPPA2,chr3:109293788-109316517,22729
81117635,81118340,chr15,ANP32BP3,chr15:81117635-81118340,705
79915252,79926725,chr17,LINC01979,chr17:79915252-79926725,11473
30005514,30023270,chr16,DOC2A,chr16:30005514-30023270,17756
63797784,63798071,chr11,RN7SL596P,chr11:63797784-63798071,287
48997385,49056145,chr17,IGF2BP1,chr17:48997385-49056145,58760
63813456,63827716,chr11,SPINDOC,chr11:63813456-63827716,14260
84884654,84945798,chr15,SLC28A1,chr15:84884654-84945798,61144
234444590,234454595,chr2,LINC01891,chr2:234444590-234454595,10005
208214724,208222625,chr2,TPT1P2,chr2:208214724-208222625,7901
52704955,52711148,chr3,SPCS1,chr3:52704955-52711148,6193
155264163,155264823,chr2,MTND2P20,chr2:155264163-155264823,660
13245863,13248652,chr1,PRAMEF31P,chr1:13245863-13248652,2789
94287699,94288550,chr9,VDAC1P11,chr9:94287699-94288550,851
63834667,63834943,chr11,ATP5MGP1,chr11:63834667-63834943,276
37996770,38005606,chr1,FHL3,chr1:37996770-38005606,8836
94347234,94347563,chr9,PTMAP12,chr9:94347234-94347563,329
93535468,93535816,chr11,SRP14P2,chr11:93535468-93535816,348
94432631,94433273,chr9,YRDCP1,chr9:94432631-94433273,642
55178172,55189214,chr3,LINC02017,chr3:55178172-55189214,11042
18069935,18106087,chr11,SAAL1,chr11:18069935-18106087,36152
212832161,212832945,chr2,PCED1CP,chr2:212832161-212832945,784
94507738,94507844,chr9,RNU6-669P,chr9:94507738-94507844,106
52495338,52524495,chr3,STAB1,chr3:52495338-52524495,29157
94558720,94593824,chr9,FBP2,chr9:94558720-94593824,35104
138278574,138279210,chr2,RPL15P5,chr2:138278574-138279210,636
176365487,176401865,chr5,ARL10,chr5:176365487-176401865,36378
200510008,200584096,chr2,SGO2,chr2:200510008-200584096,74088
38409051,38426305,chr19,RASGRP4,chr19:38409051-38426305,17254
13161558,13211110,chr10,MCM10,chr10:13161558-13211110,49552
139648999,139649728,chr5,CXXC5-AS1,chr5:139648999-139649728,729
94603133,94640249,chr9,FBP1,chr9:94603133-94640249,37116
157137424,157159019,chr5,MED7,chr5:157137424-157159019,21595
58269855,58280935,chr17,MPO,chr17:58269855-58280935,11080
179060373,179083977,chr5,ZNF354C,chr5:179060373-179083977,23604
38885807,38941830,chr1,RHBDL2,chr1:38885807-38941830,56023
178130996,178150568,chr5,RMND5B,chr5:178130996-178150568,19572
57512688,57512750,chr12,MIR6758,chr12:57512688-57512750,62
57519163,57519259,chr12,MIR616,chr12:57519163-57519259,96
34981535,34985353,chr1,TMEM35B,chr1:34981535-34985353,3818
57520710,57530148,chr12,MBD6,chr12:57520710-57530148,9438
186590056,186680901,chr2,ITGAV,chr2:186590056-186680901,90845
120600811,120714470,chr9,MEGF9,chr9:120600811-120714470,113659
103348601,103348771,chr7,RPS29P16,chr7:103348601-103348771,170
59707192,59842255,chr17,VMP1,chr17:59707192-59842255,135063
103352730,103446207,chr7,SLC26A5,chr7:103352730-103446207,93477
37860697,37947057,chr1,INPP5B,chr1:37860697-37947057,86360
120720673,120721972,chr9,AHCYP2,chr9:120720673-120721972,1299
120751978,120793416,chr9,FBXW2,chr9:120751978-120793416,41438
128504655,128543874,chr9,GLE1,chr9:128504655-128543874,39219
18106583,18106841,chr11,HIGD1AP5,chr11:18106583-18106841,258
142700111,142705127,chr8,LY6K,chr8:142700111-142705127,5016
18112472,18116132,chr11,SAA3P,chr11:18112472-18116132,3660
18153277,18154255,chr11,MRGPRX12P,chr11:18153277-18154255,978
18172837,18174280,chr11,MRGPRX4,chr11:18172837-18174280,1443
18189000,18189621,chr11,GLTPP1,chr11:18189000-18189621,621
18196657,18197337,chr11,MRGPRX13P,chr11:18196657-18197337,680
18209138,18214562,chr11,SLC25A51P4,chr11:18209138-18214562,5424
57591174,57603418,chr12,PIP4K2C,chr12:57591174-57603418,12244
18231355,18236802,chr11,SAA4,chr11:18231355-18236802,5447
143057060,143057816,chr8,AK3P2,chr8:143057060-143057816,756
166028567,166029311,chr5,RPL7P20,chr5:166028567-166029311,744
30075978,30085376,chr16,PPP4C,chr16:30075978-30085376,9398
142727223,142736927,chr8,THEM6,chr8:142727223-142736927,9704
18231423,18248635,chr11,SAA2-SAA4,chr11:18231423-18248635,17212
125265528,125265651,chr5,HMGB1P22,chr5:125265528-125265651,123
103140713,103230305,chr8,BAALC,chr8:103140713-103230305,89592
80351828,80415168,chr17,RNF213-AS1,chr17:80351828-80415168,63340
142770377,143229011,chr5,ARHGAP26,chr5:142770377-143229011,458634
18239223,18248668,chr11,SAA2,chr11:18239223-18248668,9445
64953683,64956546,chr17,SLC16A6P1,chr17:64953683-64956546,2863
110207605,110287365,chr10,MXI1,chr10:110207605-110287365,79760
43145153,43156396,chr1,FAM183A,chr1:43145153-43156396,11243
80036632,80100613,chr17,CCDC40,chr17:80036632-80100613,63981
84938416,84938522,chr15,RNU6-339P,chr15:84938416-84938522,106
70753854,70754573,chr3,HMGB1P36,chr3:70753854-70754573,719
84939617,84939723,chr15,RNU6-796P,chr15:84939617-84939723,106
8411435,8435561,chr6,SLC35B3,chr6:8411435-8435561,24126
142670308,142682725,chr8,PSCA,chr8:142670308-142682725,12417
25333728,25439051,chr15,UBE3A,chr15:25333728-25439051,105323
124965710,125055997,chr3,HEG1,chr3:124965710-125055997,90287
120535745,120813273,chr8,SNTB1,chr8:120535745-120813273,277528
35268709,35422058,chr1,ZMYM4,chr1:35268709-35422058,153349
57604622,57609804,chr12,DTX3,chr12:57604622-57609804,5182
18248389,18248506,chr11,RNA5SP333,chr11:18248389-18248506,117
18261982,18263091,chr11,ST13P5,chr11:18261982-18263091,1109
18266393,18266510,chr11,RNA5SP334,chr11:18266393-18266510,117
55979398,55980103,chr11,OR7E5P,chr11:55979398-55980103,705
55993681,55994625,chr11,OR5F1,chr11:55993681-55994625,944
53715543,53843558,chr8,ATP6V1H,chr8:53715543-53843558,128015
56015017,56015957,chr11,OR5F2P,chr11:56015017-56015957,940
56049785,56055730,chr11,OR5AQ1P,chr11:56049785-56055730,5945
56071111,56072049,chr11,OR5J1P,chr11:56071111-56072049,938
119597875,119629811,chr3,PLA1A,chr3:119597875-119629811,31936
56082801,56084840,chr11,OR5BE1P,chr11:56082801-56084840,2039
56097244,56097384,chr11,OR8I4P,chr11:56097244-56097384,140
56116639,56117256,chr11,OR5BN2P,chr11:56116639-56117256,617
56122373,56123311,chr11,OR8H3,chr11:56122373-56123311,938
56132666,56133494,chr11,OR5BN1P,chr11:56132666-56133494,828
117287353,117425942,chr6,ROS1,chr6:117287353-117425942,138589
57610180,57617245,chr12,ARHGEF25,chr12:57610180-57617245,7065
56142516,56143387,chr11,OR8K4P,chr11:56142516-56143387,871
56159394,56160317,chr11,OR8K5,chr11:56159394-56160317,923
56165500,56165921,chr11,OR5J7P,chr11:56165500-56165921,421
56176618,56177556,chr11,OR5J2,chr11:56176618-56177556,938
56188379,56189251,chr11,OR8V1P,chr11:56188379-56189251,872
55673536,55674675,chr11,OR4V1P,chr11:55673536-55674675,1139
55683239,55684374,chr11,OR4P1P,chr11:55683239-55684374,1135
55714799,55715727,chr11,OR5D2P,chr11:55714799-55715727,928
55723776,55729621,chr11,OR5D3P,chr11:55723776-55729621,5845
58040708,58041660,chr11,VN2R9P,chr11:58040708-58041660,952
58077348,58078603,chr11,OR9L1P,chr11:58077348-58078603,1255
58108720,58109661,chr11,OR9I3P,chr11:58108720-58109661,941
58144495,58145397,chr11,OR9I2P,chr11:58144495-58145397,902
58171098,58171721,chr11,OR5BL1P,chr11:58171098-58171721,623
108047545,108168956,chr4,LEF1,chr4:108047545-108168956,121411
58227882,58228918,chr11,OR10Q1,chr11:58227882-58228918,1036
59912197,59912366,chr17,RPS29P21,chr17:59912197-59912366,169
56740179,56741096,chr11,OR9G3P,chr11:56740179-56741096,917
56743873,56743981,chr11,MIR6128,chr11:56743873-56743981,108
56751023,56751902,chr11,OR9G2P,chr11:56751023-56751902,879
63819433,63830012,chr17,FTSJ3,chr17:63819433-63830012,10579
56775261,56776206,chr11,OR5G1P,chr11:56775261-56776206,945
56790206,56790965,chr11,OR5G4P,chr11:56790206-56790965,759
56801856,56820422,chr11,OR5G5P,chr11:56801856-56820422,18566
109915976,109916940,chr3,NFYBP1,chr3:109915976-109916940,964
71753855,71756496,chr3,GPR27,chr3:71753855-71756496,2641
56819573,56820516,chr11,OR5G3,chr11:56819573-56820516,943
30092314,30096915,chr16,YPEL3,chr16:30092314-30096915,4601
56208985,56215222,chr11,OR8J2,chr11:56208985-56215222,6237
119146151,119160042,chr3,TEX55,chr3:119146151-119160042,13891
56296541,56297471,chr11,OR8I1P,chr11:56296541-56297471,930
56331347,56332488,chr11,FAM8A2P,chr11:56331347-56332488,1141
56335142,56336068,chr11,OR8K2P,chr11:56335142-56336068,926
56357328,56358221,chr11,RPL5P29,chr11:56357328-56358221,893
59391354,59392292,chr11,OR5BB1P,chr11:59391354-59392292,938
59491652,59492581,chr11,OR4D8P,chr11:59491652-59492581,929
59503576,59504511,chr11,OR4D11,chr11:59503576-59504511,935
59531754,59532695,chr11,OR4D7P,chr11:59531754-59532695,941
58365836,58366763,chr11,OR5B1P,chr11:58365836-58366763,927
126103640,126108069,chr3,ALDH1L1-AS1,chr3:126103640-126108069,4429
58387583,58388486,chr11,OR5B15P,chr11:58387583-58388486,903
125712139,125713045,chr3,OR7E29P,chr3:125712139-125713045,906
56667545,56674664,chr11,OR2AH1P,chr11:56667545-56674664,7119
107377439,107378635,chr3,CCDC54,chr3:107377439-107378635,1196
56690465,56690723,chr11,TMEM230P2,chr11:56690465-56690723,258
179944876,180007297,chr2,CWC22,chr2:179944876-180007297,62421
56375624,56376553,chr11,OR8U1,chr11:56375624-56376553,929
116921431,116932238,chr3,LINC00901,chr3:116921431-116932238,10807
56381635,56382589,chr11,OR8L1P,chr11:56381635-56382589,954
112921205,112975103,chr3,CD200R1,chr3:112921205-112975103,53898
56393729,56394648,chr11,OR5AL2P,chr11:56393729-56394648,919
56412696,56413680,chr11,OR5AL1,chr11:56412696-56413680,984
56417258,56418232,chr11,OR8U3,chr11:56417258-56418232,974
56448668,56449592,chr11,OR5M4P,chr11:56448668-56449592,924
56462469,56463401,chr11,OR5M9,chr11:56462469-56463401,932
56476287,56484839,chr11,OR5M2P,chr11:56476287-56484839,8552
57623409,57633239,chr12,B4GALNT1,chr12:57623409-57633239,9830
41787662,41789898,chr6,TOMM6,chr6:41787662-41789898,2236
56500300,56501271,chr11,OR5M7P,chr11:56500300-56501271,971
56512235,56513171,chr11,OR5M6P,chr11:56512235-56513171,936
56526568,56527503,chr11,OR5M5P,chr11:56526568-56527503,935
554850,560738,chr11,LMNTD2,chr11:554850-560738,5888
80602549,80602926,chr17,RPL31P7,chr17:80602549-80602926,377
28994785,29005316,chr6,ZNF311,chr6:28994785-29005316,10531
51177425,51260163,chr17,MBTD1,chr17:51177425-51260163,82738
30104810,30113537,chr16,GDPD3,chr16:30104810-30113537,8727
95413267,95413449,chr9,MT1P1,chr9:95413267-95413449,182
174632932,174633209,chr5,HIGD1AP3,chr5:174632932-174633209,277
147870682,147882191,chr5,SCGB3A2,chr5:147870682-147882191,11509
34179005,34252523,chr9,UBAP1,chr9:34179005-34252523,73518
127968785,128520616,chr6,PTPRK,chr6:127968785-128520616,551831
75415070,75422143,chr3,ALG1L6P,chr3:75415070-75422143,7073
234455157,234455783,chr2,HSPE1P9,chr2:234455157-234455783,626
198299276,198375490,chr2,LINC01923,chr2:198299276-198375490,76214
557595,560107,chr11,LMNTD2-AS1,chr11:557595-560107,2512
38009258,38024820,chr1,UTP11,chr1:38009258-38024820,15562
45082277,45146422,chr3,CDCP1,chr3:45082277-45146422,64145
66507380,66511644,chr5,LINC02229,chr5:66507380-66511644,4264
560404,564025,chr11,RASSF7,chr11:560404-564025,3621
126898864,126902097,chr2,TEX51,chr2:126898864-126902097,3233
168229583,168269415,chr5,CTB-178M22.2,chr5:168229583-168269415,39832
30114105,30123506,chr16,MAPK3,chr16:30114105-30123506,9401
60177327,60422470,chr17,USP32,chr17:60177327-60422470,245143
146084313,146105577,chr5,PLAC8L1,chr5:146084313-146105577,21264
35873270,35873752,chr1,CFAP97P1,chr1:35873270-35873752,482
31981750,31991723,chr3,ZNF860,chr3:31981750-31991723,9973
60690225,60690719,chr3,PPIAP70,chr3:60690225-60690719,494
141923855,141942047,chr5,DELE1,chr5:141923855-141942047,18192
221944223,221944612,chr2,LLPHP3,chr2:221944223-221944612,389
114005833,114088422,chr3,QTRT2,chr3:114005833-114088422,82589
21678298,21783606,chr1,USP48,chr1:21678298-21783606,105308
108407843,108408578,chr4,RPSAP34,chr4:108407843-108408578,735
140520156,140635633,chr8,AGO2,chr8:140520156-140635633,115477
170712451,170714567,chr2,LINC01124,chr2:170712451-170714567,2116
108415220,108416639,chr4,ZACNP1,chr4:108415220-108416639,1419
108417705,108419763,chr4,EXOC7P1,chr4:108417705-108419763,2058
185500660,185535507,chr4,PDLIM3,chr4:185500660-185535507,34847
568089,568198,chr11,MIR210,chr11:568089-568198,109
576470,612222,chr11,PHRF1,chr11:576470-612222,35752
34191555,34191881,chr9,RPL35AP2,chr9:34191555-34191881,326
196189099,196593684,chr2,HECW2,chr2:196189099-196593684,404585
34206134,34206241,chr9,RNA5SP282,chr9:34206134-34206241,107
34282528,34282670,chr9,RNU2-50P,chr9:34282528-34282670,142
34318407,34319655,chr9,SERPINH1P1,chr9:34318407-34319655,1248
34329506,34343711,chr9,NUDT2,chr9:34329506-34343711,14205
57674665,57675250,chr12,RPL13AP23,chr12:57674665-57675250,585
57693955,57721557,chr12,OS9,chr12:57693955-57721557,27602
34366666,34376898,chr9,MYORG,chr9:34366666-34376898,10232
34252380,34329268,chr9,KIF24,chr9:34252380-34329268,76888
91409280,91514829,chr10,HECTD2,chr10:91409280-91514829,105549
111525159,111577844,chr9,ZNF483,chr9:111525159-111577844,52685
119524293,119559614,chr3,CD80,chr3:119524293-119559614,35321
161847063,161899981,chr5,GABRA1,chr5:161847063-161899981,52918
23945286,23980617,chr3,NR1D2,chr3:23945286-23980617,35331
111549722,111599893,chr9,PTGR1,chr9:111549722-111599893,50171
79833156,79839440,chr17,CBX4,chr17:79833156-79839440,6284
101361794,101372707,chr8,NACA4P,chr8:101361794-101372707,10913
126174186,126175014,chr8,RFPL4AP5,chr8:126174186-126175014,828
120635558,120638204,chr8,NCAPGP1,chr8:120635558-120638204,2646
134978827,134979279,chr8,RPL23AP56,chr8:134978827-134979279,452
125091679,125367120,chr8,NSMCE2,chr8:125091679-125367120,275441
74151202,74709963,chr10,ADK,chr10:74151202-74709963,558761
94757955,95158448,chr4,BMPR1B,chr4:94757955-95158448,400493
19615789,19633825,chr17,SLC47A1P2,chr17:19615789-19633825,18036
63880215,63881944,chr17,GH2,chr17:63880215-63881944,1729
40322715,40323279,chr3,PGAM1P3,chr3:40322715-40323279,564
63203218,63203448,chr3,UBL5P3,chr3:63203218-63203448,230
33360497,33361448,chr19,AKR1B1P7,chr19:33360497-33361448,951
45589764,45602212,chr19,GPR4,chr19:45589764-45602212,12448
98497912,98523066,chr3,CLDND1,chr3:98497912-98523066,25154
49335171,49343335,chr19,CD37,chr19:49335171-49343335,8164
30183505,30184957,chr16,CORO1A-AS1,chr16:30183505-30184957,1452
30192932,30194306,chr16,BOLA2B,chr16:30192932-30194306,1374
56436674,56446671,chr8,PENK,chr8:56436674-56446671,9997
30193892,30204310,chr16,SLX1A-SULT1A3,chr16:30193892-30204310,10418
69269984,69401884,chr10,HK1,chr10:69269984-69401884,131900
65635537,66192133,chr17,CEP112,chr17:65635537-66192133,556596
612553,615983,chr11,IRF7,chr11:612553-615983,3430
111602831,111631289,chr9,LRRC37A5P,chr9:111602831-111631289,28458
135625185,135625981,chr8,MAPRE1P1,chr8:135625185-135625981,796
101261541,101262903,chr8,LINC02844,chr8:101261541-101262903,1362
111631334,111654351,chr9,DNAJC25,chr9:111631334-111654351,23017
145052465,145066685,chr8,C8orf33,chr8:145052465-145066685,14220
111631386,111670229,chr9,DNAJC25-GNG10,chr9:111631386-111670229,38843
111661605,111670226,chr9,GNG10,chr9:111661605-111670226,8621
30350773,30355308,chr16,CD2BP2,chr16:30350773-30355308,4535
71062667,71572087,chr4,SLC4A4,chr4:71062667-71572087,509420
103484208,103484539,chr7,RN7SKP86,chr7:103484208-103484539,331
74059576,74062284,chr7,ELN-AS1,chr7:74059576-74062284,2708
111839828,111839934,chr9,RNU6-1013P,chr9:111839828-111839934,106
111896814,111935369,chr9,UGCG,chr9:111896814-111935369,38555
74082933,74122525,chr7,LIMK1,chr7:74082933-74122525,39592
65310851,65432637,chr2,SPRED2,chr2:65310851-65432637,121786
37776670,37779418,chr1,ACTN4P2,chr1:37776670-37779418,2748
35713877,35718894,chr1,C1orf216,chr1:35713877-35718894,5017
43850300,43851611,chr1,SHMT1P1,chr1:43850300-43851611,1311
30357102,30370494,chr16,TBC1D10B,chr16:30357102-30370494,13392
17755333,17827063,chr1,ACTL8,chr1:17755333-17827063,71730
50780340,50781150,chr1,PHBP12,chr1:50780340-50781150,810
84817356,84873479,chr15,ALPK3,chr15:84817356-84873479,56123
40161387,40240921,chr1,RLF,chr1:40161387-40240921,79534
111932100,111932169,chr9,MIR4668,chr9:111932100-111932169,69
46809585,46810183,chr19,HNRNPMP2,chr19:46809585-46810183,598
45076510,45092635,chr19,GEMIN7-AS1,chr19:45076510-45092635,16125
111686171,111795008,chr9,SHOC1,chr9:111686171-111795008,108837
221961737,221963765,chr2,HSPA9P1,chr2:221961737-221963765,2028
616577,626078,chr11,CDHR5,chr11:616577-626078,9501
33208664,33225850,chr19,SLC7A10,chr19:33208664-33225850,17186
197568224,197676045,chr2,RFTN2,chr2:197568224-197676045,107821
57726271,57728356,chr12,AGAP2-AS1,chr12:57726271-57728356,2085
57738013,57750219,chr12,TSPAN31,chr12:57738013-57750219,12206
9848276,9910336,chr1,CTNNBIP1,chr1:9848276-9910336,62060
79819083,79827704,chr17,LINC01977,chr17:79819083-79827704,8621
30182827,30189076,chr16,CORO1A,chr16:30182827-30189076,6249
33858782,34075155,chr15,AVEN,chr15:33858782-34075155,216373
135905881,135986100,chr2,DARS1,chr2:135905881-135986100,80219
63894909,63896661,chr17,CSH1,chr17:63894909-63896661,1752
74191198,74191294,chr7,MIR590,chr7:74191198-74191294,96
33968497,34067458,chr15,CHRM5,chr15:33968497-34067458,98961
103297435,103329511,chr7,PMPCB,chr7:103297435-103329511,32076
98782055,98782628,chr8,RPL19P14,chr8:98782055-98782628,573
48321509,48330553,chr19,EMP3,chr19:48321509-48330553,9044
134477788,134713049,chr8,ZFAT,chr8:134477788-134713049,235261
49326962,49620929,chr15,FAM227B,chr15:49326962-49620929,293967
57747727,57756013,chr12,CDK4,chr12:57747727-57756013,8286
82519713,82644662,chr17,FOXK2,chr17:82519713-82644662,124949
130140610,130144219,chr9,GPRACR,chr9:130140610-130144219,3609
35720218,35769978,chr1,CLSPN,chr1:35720218-35769978,49760
130172404,130237303,chr9,NCS1,chr9:130172404-130237303,64899
19176903,19192591,chr19,BORCS8,chr19:19176903-19192591,15688
111887914,111888741,chr2,EEF1E1P1,chr2:111887914-111888741,827
142854095,142855998,chr2,RRN3P4,chr2:142854095-142855998,1903
130400266,130400565,chr9,RN7SL665P,chr9:130400266-130400565,299
170332085,170408564,chr2,MYO3B-AS1,chr2:170332085-170408564,76479
130444961,130501274,chr9,ASS1,chr9:130444961-130501274,56313
103328570,103370346,chr7,PSMC2,chr7:103328570-103370346,41776
170389493,170422844,chr5,KCNIP1-OT1,chr5:170389493-170422844,33351
174039751,174040240,chr5,RPL12P22,chr5:174039751-174040240,489
89362294,89363487,chr10,IFIT6P,chr10:89362294-89363487,1193
160438594,160487426,chr5,MIR3142HG,chr5:160438594-160487426,48832
89378056,89385205,chr10,IFIT1B,chr10:89378056-89385205,7149
49621037,49656232,chr15,DTWD1,chr15:49621037-49656232,35195
89392546,89406487,chr10,IFIT1,chr10:89392546-89406487,13941
78484882,78503056,chr17,DNAH17-AS1,chr17:78484882-78503056,18174
176810519,176880898,chr5,UNC5A,chr5:176810519-176880898,70379
626309,627181,chr11,SCT,chr11:626309-627181,872
82023305,82031151,chr17,LRRC45,chr17:82023305-82031151,7846
89430299,89556641,chr10,SLC16A12,chr10:89430299-89556641,126342
637269,640706,chr11,DRD4,chr11:637269-640706,3437
45079195,45091518,chr19,GEMIN7,chr19:45079195-45091518,12323
57748618,57748682,chr12,MIR6759,chr12:57748618-57748682,64
57755103,57760411,chr12,MARCHF9,chr12:57755103-57760411,5308
89456064,89468140,chr10,SLC16A12-AS1,chr10:89456064-89468140,12076
12030875,12061785,chr11,LINC02547,chr11:12030875-12061785,30910
72189941,72190576,chr10,RPL15P14,chr10:72189941-72190576,635
67654669,67947713,chr3,SUCLG2-AS1,chr3:67654669-67947713,293044
72216000,72235860,chr10,ANAPC16,chr10:72216000-72235860,19860
12377563,12535356,chr11,PARVA,chr11:12377563-12535356,157793
57762334,57768986,chr12,CYP27B1,chr12:57762334-57768986,6652
58326994,58342332,chr19,ZSCAN22,chr19:58326994-58342332,15338
47113274,47210636,chr19,SAE1,chr19:47113274-47210636,97362
53064283,53065091,chr3,SERBP1P3,chr3:53064283-53065091,808
119298665,119299012,chr3,RPS26P21,chr3:119298665-119299012,347
53088483,53130453,chr3,RFT1,chr3:53088483-53130453,41970
72273919,72276036,chr10,DDIT4,chr10:72273919-72276036,2117
87345664,87399794,chr7,CROT,chr7:87345664-87399794,54130
120346136,120351803,chr2,INHBB,chr2:120346136-120351803,5667
72391964,72392069,chr10,RNU6-805P,chr10:72391964-72392069,105
95885098,95961851,chr5,ELL2,chr5:95885098-95961851,76753
72483245,72483812,chr10,SNX19P4,chr10:72483245-72483812,567
24640166,24640284,chr10,RNA5SP305,chr10:24640166-24640284,118
24908522,24908812,chr10,RN7SKP241,chr10:24908522-24908812,290
17577362,17578212,chr10,PRPF38AP2,chr10:17577362-17578212,850
94726699,95087159,chr9,AOPEP,chr9:94726699-95087159,360460
175923882,176002839,chr2,LNPK,chr2:175923882-176002839,78957
17589032,17617374,chr10,HACD1,chr10:17589032-17617374,28342
20028239,20073890,chr16,GPR139,chr16:20028239-20073890,45651
57768471,57772119,chr12,METTL1,chr12:57768471-57772119,3648
63870930,63871019,chr15,MIR422A,chr15:63870930-63871019,89
55635113,55640309,chr11,OR4P4,chr11:55635113-55640309,5196
30193875,30197561,chr16,SLX1A,chr16:30193875-30197561,3686
55318560,55319465,chr11,OR4A11P,chr11:55318560-55319465,905
63907036,64072033,chr15,DAPK2,chr15:63907036-64072033,164997
55325756,55326673,chr11,OR4A12P,chr11:55325756-55326673,917
83226897,83240804,chr17,RPL23AP87,chr17:83226897-83240804,13907
55367974,55368918,chr11,OR4A15,chr11:55367974-55368918,944
55388529,55389472,chr11,OR4A9P,chr11:55388529-55389472,943
55411526,55411717,chr11,OR4X7P,chr11:55411526-55411717,191
71620978,71621436,chr17,MYL6P5,chr17:71620978-71621436,458
55430478,55432370,chr11,OR4A10P,chr11:55430478-55432370,1892
55444435,55445338,chr11,OR4A17P,chr11:55444435-55445338,903
55466771,55467712,chr11,OR4A13P,chr11:55466771-55467712,941
69244311,69327244,chr17,ABCA5,chr17:69244311-69327244,82933
55475943,55478512,chr11,OR4A50P,chr11:55475943-55478512,2569
7848700,7849626,chr11,OR5E1P,chr11:7848700-7849626,926
176388751,176389761,chr5,HIGD2A,chr5:176388751-176389761,1010
7889182,7889279,chr11,RNU6-943P,chr11:7889182-7889279,97
123994163,123995161,chr11,OR10G6,chr11:123994163-123995161,998
124009655,124010012,chr11,OR10G5P,chr11:124009655-124010012,357
124023013,124023948,chr11,OR10G9,chr11:124023013-124023948,935
17641284,17643878,chr10,STAM-DT,chr10:17641284-17643878,2594
124054793,124055707,chr11,OR10D5P,chr11:124054793-124055707,914
106896483,106896821,chr3,MTND3P6,chr3:106896483-106896821,338
57771492,57782541,chr12,EEF1AKMT3,chr12:57771492-57782541,11049
17644151,17716824,chr10,STAM,chr10:17644151-17716824,72673
57641198,57641286,chr11,MIR130A,chr11:57641198-57641286,88
120722458,120722646,chr3,MTCO2P29,chr3:120722458-120722646,188
29459913,29464966,chr16,SULT1A4,chr16:29459913-29464966,5053
62728069,62740293,chr11,TTC9C,chr11:62728069-62740293,12224
122886941,122892416,chr3,LINC02035,chr3:122886941-122892416,5475
109118252,109151401,chr3,C3orf85,chr3:109118252-109151401,33149
49727376,49744437,chr6,CRISP3,chr6:49727376-49744437,17061
148025683,148137382,chr5,SPINK5,chr5:148025683-148137382,111699
119226486,119290666,chr3,B4GALT4-AS1,chr3:119226486-119290666,64180
98087173,98088102,chr3,OR5AC2,chr3:98087173-98088102,929
62748319,62754184,chr11,ZBTB3,chr11:62748319-62754184,5865
59747277,61251459,chr3,FHIT,chr3:59747277-61251459,1504182
57782761,57808071,chr12,TSFM,chr12:57782761-57808071,25310
62761565,62766710,chr11,POLR2G,chr11:62761565-62766710,5145
54696604,54700905,chr19,LILRP1,chr19:54696604-54700905,4301
64072565,64093857,chr15,CIAO2A,chr15:64072565-64093857,21292
57389850,57402992,chr19,ZNF548,chr19:57389850-57402992,13142
113286930,113441610,chr3,CFAP44,chr3:113286930-113441610,154680
6328375,6331891,chr9,TPD52L3,chr9:6328375-6331891,3516
138288029,138288793,chr2,YWHAEP5,chr2:138288029-138288793,764
216805737,216806129,chr2,FABP5P14,chr2:216805737-216806129,392
101398851,101410660,chr9,ZNF189,chr9:101398851-101410660,11809
13361354,13484365,chr4,RAB28,chr4:13361354-13484365,123011
165469647,165689407,chr2,CSRNP3,chr2:165469647-165689407,219760
17752201,17800868,chr10,TMEM236,chr10:17752201-17800868,48667
150865679,151101887,chr6,MTHFD1L,chr6:150865679-151101887,236208
64094123,64146090,chr15,SNX1,chr15:64094123-64146090,51967
87401696,87480435,chr7,ABCB4,chr7:87401696-87480435,78739
988434,1019932,chr10,GTPBP4,chr10:988434-1019932,31498
62771357,62787342,chr11,TAF6L,chr11:62771357-62787342,15985
55802851,55833337,chr16,CES1,chr16:55802851-55833337,30486
35319261,35347361,chr19,CD22,chr19:35319261-35347361,28100
127885321,127905408,chr9,ST6GALNAC6,chr9:127885321-127905408,20087
222044525,222044994,chr2,RPL23AP28,chr2:222044525-222044994,469
210030572,210064356,chr2,KANSL1L-AS1,chr2:210030572-210064356,33784
69084937,69106092,chr3,ARL6IP5,chr3:69084937-69106092,21155
112736349,112764664,chr2,CKAP2L,chr2:112736349-112764664,28315
62771629,62792006,chr11,TMEM223,chr11:62771629-62792006,20377
57806154,57806260,chr12,RNU6-1083P,chr12:57806154-57806260,106
75347833,75348787,chr3,OR7E66P,chr3:75347833-75348787,954
116645902,116646727,chr3,BZW1P2,chr3:116645902-116646727,825
40554161,40554267,chr12,RNU6-713P,chr12:40554161-40554267,106
62787402,62790400,chr11,TMEM179B,chr11:62787402-62790400,2998
58505136,58537283,chr3,ACOX2,chr3:58505136-58537283,32147
87944885,87950819,chr12,RPS4XP15,chr12:87944885-87950819,5934
87980035,88034037,chr12,C12orf50,chr12:87980035-88034037,54002
62789815,62789885,chr11,MIR6748,chr11:62789815-62789885,70
62792123,62806302,chr11,NXF1,chr11:62792123-62806302,14179
170715337,170718078,chr2,SP5,chr2:170715337-170718078,2741
54968727,55173632,chr17,STXBP4,chr17:54968727-55173632,204905
136329441,136329913,chr2,UBBP1,chr2:136329441-136329913,472
175033778,175034192,chr2,RPL21P31,chr2:175033778-175034192,414
1018910,1025859,chr10,IDI2,chr10:1018910-1025859,6949
172084740,172089677,chr2,DLX1,chr2:172084740-172089677,4937
155829729,155866277,chr4,ASIC5,chr4:155829729-155866277,36548
1022630,1045425,chr10,IDI2-AS1,chr10:1022630-1045425,22795
43671202,43687791,chr6,MRPS18A,chr6:43671202-43687791,16589
155854738,155920406,chr4,TDO2,chr4:155854738-155920406,65668
39769523,39771348,chr1,OXCT2,chr1:39769523-39771348,1825
123416726,123470028,chr8,NTAQ1,chr8:123416726-123470028,53302
45815428,45817324,chr10,FAM25E,chr10:45815428-45817324,1896
37566816,37595937,chr1,GNL2,chr1:37566816-37595937,29121
88033846,88050160,chr12,C12orf29,chr12:88033846-88050160,16314
45856307,45856422,chr10,RNA5SP310,chr10:45856307-45856422,115
46233885,46273557,chr10,ANTXRLP1,chr10:46233885-46273557,39672
81928428,81934998,chr9,SPATA31D4,chr9:81928428-81934998,6570
130275592,130276257,chr2,MTCO2P7,chr2:130275592-130276257,665
53051991,53100873,chr6,FBXO9,chr6:53051991-53100873,48882
46337224,46358714,chr10,AGAP14P,chr10:46337224-46358714,21490
114323098,114326479,chr9,ORM1,chr9:114323098-114326479,3381
46369113,46373563,chr10,FAM25BP,chr10:46369113-46373563,4450
179441982,179861612,chr2,ZNF385B,chr2:179441982-179861612,419630
46375627,46391784,chr10,ANXA8L1,chr10:46375627-46391784,16157
64151715,64157481,chr15,SNX22,chr15:64151715-64157481,5766
109471329,109471812,chr3,PPIAP15,chr3:109471329-109471812,483
156006478,156006988,chr4,FTH1P21,chr4:156006478-156006988,510
127322307,127390670,chr3,LINC02016,chr3:127322307-127390670,68363
66856426,66932141,chr9,ZNF658,chr9:66856426-66932141,75715
155921580,155953912,chr4,CTSO,chr4:155921580-155953912,32332
118900557,119146068,chr3,IGSF11,chr3:118900557-119146068,245511
34792999,34795747,chr1,GJA4,chr1:34792999-34795747,2748
81943500,81950093,chr9,SPATA31D3,chr9:81943500-81950093,6593
82018702,82024107,chr17,CENPX,chr17:82018702-82024107,5405
87503017,87713323,chr7,ABCB1,chr7:87503017-87713323,210306
88051701,88051778,chr12,RNA5SP364,chr12:88051701-88051778,77
69324567,69392558,chr9,FAM189A2,chr9:69324567-69392558,67991
46891639,46892830,chr1,TUBAP8,chr1:46891639-46892830,1191
64165525,64356173,chr15,CSNK1G1,chr15:64165525-64356173,190648
122167738,122203471,chr12,LRRC43,chr12:122167738-122203471,35733
53366656,53368245,chr1,LINC02812,chr1:53366656-53368245,1589
25041136,25047404,chr1,LINC02793,chr1:25041136-25047404,6268
74447427,74607144,chr16,GLG1,chr16:74447427-74607144,159717
50405430,50406024,chr1,FCF1P6,chr1:50405430-50406024,594
31544444,31548427,chr6,ATP6V1G2,chr6:31544444-31548427,3983
62792702,62792771,chr11,MIR6514,chr11:62792702-62792771,69
2321253,2391707,chr1,MORN1,chr1:2321253-2391707,70454
62815966,62816067,chr11,RNU6-118P,chr11:62815966-62816067,101
62832234,62834043,chr11,STX5-DT,chr11:62832234-62834043,1809
62832319,62832803,chr11,TEX54,chr11:62832319-62832803,484
62841619,62841809,chr11,RNU2-2P,chr11:62841619-62841809,190
62852910,62853035,chr11,SNORD22,chr11:62852910-62853035,125
120240064,120294710,chr2,RALB,chr2:120240064-120294710,54646
62854621,62854695,chr11,SNORD28,chr11:62854621-62854695,74
62855292,62855366,chr11,SNORD26,chr11:62855292-62855366,74
62855564,62855632,chr11,SNORD25,chr11:62855564-62855632,68
109992325,109992431,chr4,RNU6-35P,chr4:109992325-109992431,106
31718594,31726714,chr6,MPIG6B,chr6:31718594-31726714,8120
154325568,154445850,chr5,SAP30L-AS1,chr5:154325568-154445850,120282
110045846,110199199,chr4,ELOVL6,chr4:110045846-110199199,153353
122172029,122174221,chr12,IL31,chr12:122172029-122174221,2192
57645087,57649944,chr11,YPEL4,chr11:57645087-57649944,4857
32391698,32483067,chr3,CMTM7,chr3:32391698-32483067,91369
122203681,122208952,chr12,B3GNT4,chr12:122203681-122208952,5271
180300698,180353336,chr5,GFPT2,chr5:180300698-180353336,52638
65668805,65734041,chr9,CBWD5,chr9:65668805-65734041,65236
46398362,46453306,chr10,LINC00842,chr10:46398362-46453306,54944
121639293,121994185,chr8,HAS2-AS1,chr8:121639293-121994185,354892
46415853,46416413,chr10,HNRNPA1P33,chr10:46415853-46416413,560
46461099,46465958,chr10,NPY4R,chr10:46461099-46465958,4859
52994726,52996026,chr1,TUBBP10,chr1:52994726-52996026,1300
2181794,2184389,chr1,PRKCZ-AS1,chr1:2181794-2184389,2595
110117736,110118070,chr4,RN7SL275P,chr4:110117736-110118070,334
68827531,68895432,chr10,STOX1,chr10:68827531-68895432,67901
110251871,110252099,chr4,HSBP1P2,chr4:110251871-110252099,228
110264865,110265017,chr4,RNF14P2,chr4:110264865-110265017,152
122229564,122266494,chr12,VPS33A,chr12:122229564-122266494,36930
110278185,110278291,chr4,RNU6-205P,chr4:110278185-110278291,106
110291644,110293573,chr4,ZBED1P1,chr4:110291644-110293573,1929
54779712,54801323,chr1,TTC22,chr1:54779712-54801323,21611
57667747,57701182,chr11,ZDHHC5,chr11:57667747-57701182,33435
110365733,110565285,chr4,ENPEP,chr4:110365733-110565285,199552
113442718,113515187,chr3,SPICE1,chr3:113442718-113515187,72469
110933263,110934533,chr8,MTCO1P47,chr8:110933263-110934533,1270
121668934,121697600,chr8,LINC02855,chr8:121668934-121697600,28666
53105734,53106358,chr17,MTCO1P40,chr17:53105734-53106358,624
123695302,123697396,chr2,ELOAP1,chr2:123695302-123697396,2094
41261962,41309473,chr8,SFRP1,chr8:41261962-41309473,47511
80219699,80253500,chr17,SLC26A11,chr17:80219699-80253500,33801
170639158,170681437,chr5,KCNIP1-AS1,chr5:170639158-170681437,42279
43300982,43323108,chr1,TIE1,chr1:43300982-43323108,22126
68846805,68846911,chr10,RNU6-697P,chr10:68846805-68846911,106
68901286,68946847,chr10,DDX50,chr10:68901286-68946847,45561
36510709,36593156,chr11,RAG1,chr11:36510709-36593156,82447
66126896,66175485,chr8,TRIM55,chr8:66126896-66175485,48589
234493041,234497081,chr2,ARL4C,chr2:234493041-234497081,4040
36575574,36598279,chr11,RAG2,chr11:36575574-36598279,22705
116218026,116218295,chr5,HMGN2P27,chr5:116218026-116218295,269
109732731,109733136,chr2,SRSF3P6,chr2:109732731-109733136,405
30606601,30694142,chr3,TGFBR2,chr3:30606601-30694142,87541
223751686,223838027,chr2,AP1S3,chr2:223751686-223838027,86341
180601506,180649624,chr5,FLT4,chr5:180601506-180649624,48118
73787872,73865133,chr11,MRPL48,chr11:73787872-73865133,77261
122364782,122365632,chr12,RPL21P1,chr12:122364782-122365632,850
122395542,122400857,chr12,CLIP1-AS1,chr12:122395542-122400857,5315
98453835,98457145,chr12,SLC9A7P1,chr12:98453835-98457145,3310
55151767,55157773,chr19,TNNI3,chr19:55151767-55157773,6006
98590723,98591214,chr12,PPIAP8,chr12:98590723-98591214,491
98599635,98599883,chr12,SNORA53,chr12:98599635-98599883,248
98613405,98645113,chr12,IKBIP,chr12:98613405-98645113,31708
10393186,10419659,chr6,TFAP2A,chr6:10393186-10419659,26473
138307319,138307970,chr2,IDI1P1,chr2:138307319-138307970,651
113919222,113920200,chr3,VPS26AP1,chr3:113919222-113920200,978
41189041,41189236,chr3,MRPS31P1,chr3:41189041-41189236,195
56940040,56960854,chr3,ARHGEF3-AS1,chr3:56940040-56960854,20814
73214222,73227221,chr2,SMYD5,chr2:73214222-73227221,12999
108958248,109118134,chr3,MORC1,chr3:108958248-109118134,159886
87521461,87522410,chr7,HNRNPA1P9,chr7:87521461-87522410,949
98515579,98550351,chr12,TMPO,chr12:98515579-98550351,34772
44796680,44824564,chr7,PPIA,chr7:44796680-44824564,27884
38862493,38873368,chr1,MYCBP,chr1:38862493-38873368,10875
87083562,87317420,chr16,C16orf95,chr16:87083562-87317420,233858
19484403,19629821,chr1,MICOS10,chr1:19484403-19629821,145418
66176376,66178464,chr8,CRH,chr8:66176376-66178464,2088
71319259,71381423,chr10,SLC29A3,chr10:71319259-71381423,62164
125430358,125438403,chr8,TRIB1,chr8:125430358-125438403,8045
14071319,14266773,chr16,MRTFB,chr16:14071319-14266773,195454
47255980,47273701,chr19,CCDC9,chr19:47255980-47273701,17721
206686517,206687362,chr2,VPS26CP1,chr2:206686517-206687362,845
97827248,97827545,chr2,HMGN1P36,chr2:97827248-97827545,297
155269633,155270134,chr2,ATP5F1AP2,chr2:155269633-155270134,501
73832382,73832690,chr11,RN7SKP243,chr11:73832382-73832690,308
73850469,73851211,chr11,MIX23P5,chr11:73850469-73851211,742
108894471,108989372,chr2,EDAR,chr2:108894471-108989372,94901
121612116,121641440,chr8,HAS2,chr8:121612116-121641440,29324
73872667,73876901,chr11,COA4,chr11:73872667-73876901,4234
44826791,44848087,chr7,H2AZ2,chr7:44826791-44848087,21296
142198356,142209003,chr8,LINC00051,chr8:142198356-142209003,10647
71508153,71511873,chr10,CDH23-AS1,chr10:71508153-71511873,3720
123352181,123352643,chr8,DUTP2,chr8:123352181-123352643,462
71711701,71737824,chr10,C10orf105,chr10:71711701-71737824,26123
34865436,34929650,chr1,DLGAP3,chr1:34865436-34929650,64214
110399773,110400511,chr4,RPL7L1P13,chr4:110399773-110400511,738
110415898,110418504,chr4,ZNF969P,chr4:110415898-110418504,2606
71747556,71773520,chr10,VSIR,chr10:71747556-71773520,25964
73876699,73931114,chr11,PAAF1,chr11:73876699-73931114,54415
123319850,123416350,chr8,ATAD2,chr8:123319850-123416350,96500
32951644,32956349,chr3,CCR4,chr3:32951644-32956349,4705
110794403,110797344,chr4,LINC01438,chr4:110794403-110797344,2941
110860582,110860647,chr4,MIR297,chr4:110860582-110860647,65
110945109,110945799,chr4,LYPLA1P2,chr4:110945109-110945799,690
24096269,24103238,chr3,LINC00691,chr3:24096269-24103238,6969
111331412,111331518,chr4,RNU6-289P,chr4:111331412-111331518,106
71790747,71790800,chr10,MIR7152,chr10:71790747-71790800,53
55367466,55368774,chr1,GOT2P1,chr1:55367466-55368774,1308
80134369,80147151,chr17,EIF4A3,chr17:80134369-80147151,12782
48968130,48993310,chr19,GYS1,chr19:48968130-48993310,25180
111998739,112013887,chr3,TAGLN3,chr3:111998739-112013887,15148
45846994,45847594,chr1,TMA16P2,chr1:45846994-45847594,600
71396920,71815947,chr10,CDH23,chr10:71396920-71815947,419027
40620680,40665682,chr1,RIMS3,chr1:40620680-40665682,45002
112068010,112068526,chr4,CCDC34P1,chr4:112068010-112068526,516
112077598,112078400,chr4,TUBB8P3,chr4:112077598-112078400,802
7115736,7128889,chr12,RBP5,chr12:7115736-7128889,13153
112145454,112195256,chr4,FAM241A,chr4:112145454-112195256,49802
86505668,86721122,chr2,RNF103-CHMP3,chr2:86505668-86721122,215454
45880827,46080348,chr6,CLIC5,chr6:45880827-46080348,199521
112229561,112231596,chr4,AP1AR-DT,chr4:112229561-112231596,2035
44848416,44849568,chr7,LINC01952,chr7:44848416-44849568,1152
112231740,112273110,chr4,AP1AR,chr4:112231740-112273110,41370
44876299,44885530,chr7,PURB,chr7:44876299-44885530,9231
203936763,203961577,chr2,ICOS,chr2:203936763-203961577,24814
44881748,44881800,chr7,MIR4657,chr7:44881748-44881800,52
78378649,78425114,chr17,PGS1,chr17:78378649-78425114,46465
44026951,44041892,chr7,RASA4CP,chr7:44026951-44041892,14941
7118785,7118891,chr12,RNU6-485P,chr12:7118785-7118891,106
65872815,65954558,chr3,MAGI1-IT1,chr3:65872815-65954558,81743
44039171,44042306,chr7,LINC00957,chr7:44039171-44042306,3135
125703349,125704312,chr3,OR7E130P,chr3:125703349-125704312,963
7129698,7158945,chr12,CLSTN3,chr12:7129698-7158945,29247
52895910,52927212,chr1,ECHDC2,chr1:52895910-52927212,31302
28379579,28403841,chr16,EIF3CL,chr16:28379579-28403841,24262
230573167,230573809,chr2,TPM3P8,chr2:230573167-230573809,642
108160812,108222435,chr3,IFT57,chr3:108160812-108222435,61623
206737763,206765328,chr2,MDH1B,chr2:206737763-206765328,27565
44044640,44069456,chr7,DBNL,chr7:44044640-44069456,24816
115802363,117139389,chr3,LSAMP,chr3:115802363-117139389,1337026
88382959,88440757,chr16,ZNF469,chr16:88382959-88440757,57798
112274537,112285904,chr4,TIFA,chr4:112274537-112285904,11367
87881546,87936580,chr16,CA5A,chr16:87881546-87936580,55034
49361783,49375116,chr19,DKKL1,chr19:49361783-49375116,13333
112285509,112442621,chr4,ALPK1,chr4:112285509-112442621,157112
127480690,127537817,chr3,LINC01471,chr3:127480690-127537817,57127
62701314,62808344,chr17,MARCHF10,chr17:62701314-62808344,107030
64364304,64387687,chr15,PCLAF,chr15:64364304-64387687,23383
14672548,14694308,chr16,PLA2G10,chr16:14672548-14694308,21760
121380137,121380465,chr8,RPL35AP19,chr8:121380137-121380465,328
5910945,5911236,chr8,RN7SKP159,chr8:5910945-5911236,291
5142411,5142707,chr8,RN7SL318P,chr8:5142411-5142707,296
3700492,3700628,chr8,RNA5SP251,chr8:3700492-3700628,136
54593582,54602381,chr19,LILRA1,chr19:54593582-54602381,8799
9048445,9048518,chr8,MIR4660,chr8:9048445-9048518,73
203772631,203773502,chr2,NPM1P33,chr2:203772631-203773502,871
9072455,9072516,chr8,RNU7-55P,chr8:9072455-9072516,61
234682668,234717764,chr2,LINC01173,chr2:234682668-234717764,35096
9903388,9903472,chr8,MIR124-1,chr8:9903388-9903472,84
8582352,8582655,chr8,RN7SL178P,chr8:8582352-8582655,303
129496297,129496788,chr2,PPIAP65,chr2:129496297-129496788,491
9287472,9287578,chr8,RNU6-1151P,chr8:9287472-9287578,106
9371090,9371195,chr8,RNU6-526P,chr8:9371090-9371195,105
10666978,10667070,chr8,MIR4286,chr8:10666978-10667070,92
10686569,10686687,chr8,RNA5SP252,chr8:10686569-10686687,118
8895813,8895918,chr8,RNU6-682P,chr8:8895813-8895918,105
28688558,28735727,chr16,EIF3C,chr16:28688558-28735727,47169
71109684,71130239,chr2,MCEE,chr2:71109684-71130239,20555
12719132,12719190,chr8,MIR5692A2,chr8:12719132-12719190,58
10825373,10825443,chr8,MIR1322,chr8:10825373-10825443,70
10476223,10476329,chr8,RNU6-729P,chr8:10476223-10476329,106
12727232,12727304,chr8,MIR3926-1,chr8:12727232-12727304,72
9741672,9741768,chr8,MIR597,chr8:9741672-9741768,96
12727237,12727299,chr8,MIR3926-2,chr8:12727237-12727299,62
13536029,13536135,chr8,RNA5SP255,chr8:13536029-13536135,106
16863196,16863496,chr8,RN7SL474P,chr8:16863196-16863496,300
20229779,20229877,chr8,RNU6-892P,chr8:20229779-20229877,98
11035206,11035302,chr8,MIR598,chr8:11035206-11035302,96
13044350,13044456,chr8,RNU6-842P,chr8:13044350-13044456,106
22434391,22434497,chr8,RNU6-336P,chr8:22434391-22434497,106
24076997,24077158,chr8,RNU1-148P,chr8:24076997-24077158,161
14319455,14319516,chr8,RNU7-153P,chr8:14319455-14319516,61
14487776,14487879,chr8,RNU6-397P,chr8:14487776-14487879,103
14853438,14853510,chr8,MIR383,chr8:14853438-14853510,72
195532945,195540287,chr2,LINC01825,chr2:195532945-195540287,7342
27679836,27679935,chr8,RNU6-1086P,chr8:27679836-27679935,99
3063824,3115187,chr6,RIPK1,chr6:3063824-3115187,51363
142592178,142698070,chr5,FGF1,chr5:142592178-142698070,105892
25345402,25345474,chr8,MIR6876,chr8:25345402-25345474,72
27773645,27773748,chr8,RNU6-1276P,chr8:27773645-27773748,103
23600026,23600138,chr8,RNU4-71P,chr8:23600026-23600138,112
29957272,29957348,chr8,MIR3148,chr8:29957272-29957348,76
179814251,179814675,chr2,TXNL4AP1,chr2:179814251-179814675,424
31598099,31598204,chr8,RNA5SP261,chr8:31598099-31598204,105
33580210,33580508,chr8,RN7SL621P,chr8:33580210-33580508,298
224169664,224171537,chr2,USP21P1,chr2:224169664-224171537,1873
30643689,30643802,chr8,RNU5A-3P,chr8:30643689-30643802,113
30043801,30043908,chr8,RNU6-1218P,chr8:30043801-30043908,107
29048494,29048604,chr8,RNA5SP260,chr8:29048494-29048604,110
27610601,27610751,chr8,MIR6843,chr8:27610601-27610751,150
27433370,27433434,chr8,MIR6842,chr8:27433370-27433434,64
32911493,32911598,chr8,RNU6-663P,chr8:32911493-32911598,105
27048853,27048963,chr8,MIR548H4,chr8:27048853-27048963,110
37668898,37669005,chr8,RNU6-607P,chr8:37668898-37669005,107
26136880,26136998,chr8,RNA5SP258,chr8:26136880-26136998,118
33715784,33716070,chr8,RN7SL457P,chr8:33715784-33716070,286
38122374,38122480,chr8,RNU6-988P,chr8:38122374-38122480,106
38166012,38166118,chr8,RNU6-323P,chr8:38166012-38166118,106
41660441,41660508,chr8,MIR486-1,chr8:41660441-41660508,67
41660444,41660507,chr8,MIR486-2,chr8:41660444-41660507,63
41840059,41840339,chr8,RN7SL149P,chr8:41840059-41840339,280
64387748,64455303,chr15,TRIP4,chr15:64387748-64455303,67555
33338867,33338966,chr8,RNU6-528P,chr8:33338867-33338966,99
36309584,36309690,chr8,RNU6-533P,chr8:36309584-36309690,106
214725646,214809683,chr2,BARD1,chr2:214725646-214809683,84037
41426655,41426727,chr8,SNORD65B,chr8:41426655-41426727,72
27886039,27886116,chr8,MIR4287,chr8:27886039-27886116,77
119635526,119636150,chr3,RPL10P7,chr3:119635526-119636150,624
48307927,48308030,chr8,RNU6-295P,chr8:48307927-48308030,103
106896891,106897671,chr3,MTCO3P35,chr3:106896891-106897671,780
47068021,47068323,chr8,RN7SKP32,chr8:47068021-47068323,302
41032892,41032998,chr8,RNU6-356P,chr8:41032892-41032998,106
33513475,33513578,chr8,SNORD13,chr8:33513475-33513578,103
13486294,13486852,chr6,GFOD1-AS1,chr6:13486294-13486852,558
20290174,20290289,chr8,RNA5SP257,chr8:20290174-20290289,115
92883773,92884700,chr12,HNRNPA1P50,chr12:92883773-92884700,927
42881236,42881517,chr8,RN7SL806P,chr8:42881236-42881517,281
13521266,13522045,chr6,RPS4XP7,chr6:13521266-13522045,779
13547704,13548013,chr6,RN7SKP204,chr6:13547704-13548013,309
42896197,42896275,chr8,MIR4469,chr8:42896197-42896275,78
47667771,47667877,chr8,RNU6-665P,chr8:47667771-47667877,106
45001449,45038198,chr19,RELB,chr19:45001449-45038198,36749
32192028,32192153,chr8,RNA5SP262,chr8:32192028-32192153,125
32256496,32256623,chr8,RNA5SP263,chr8:32256496-32256623,127
13615335,13632739,chr6,NOL7,chr6:13615335-13632739,17404
75668931,75670185,chr3,DUX4L26,chr3:75668931-75670185,1254
27701673,27701767,chr8,MIR3622B,chr8:27701673-27701767,94
27701677,27701759,chr8,MIR3622A,chr8:27701677-27701759,82
48316669,48316770,chr8,RNA5SP531,chr8:48316669-48316770,101
49330210,49330547,chr8,RN7SKP294,chr8:49330210-49330547,337
28416448,28416551,chr8,RNU6-178P,chr8:28416448-28416551,103
54152807,54152882,chr8,RNU6ATAC32P,chr8:54152807-54152882,75
125446650,125520202,chr3,SNX4,chr3:125446650-125520202,73552
41271048,41271143,chr8,MIR548AO,chr8:41271048-41271143,95
51907956,51990700,chr1,RAB3B,chr1:51907956-51990700,82744
41298163,41298265,chr8,RNU6-895P,chr8:41298163-41298265,102
53914719,53914824,chr8,RNU6-1331P,chr8:53914719-53914824,105
47979414,47979521,chr8,RNU6-519P,chr8:47979414-47979521,107
47131781,47131887,chr8,RNU6-819P,chr8:47131781-47131887,106
37908738,37909037,chr8,RN7SL709P,chr8:37908738-37909037,299
55745232,55745342,chr8,RNA5SP265,chr8:55745232-55745342,110
69825227,69959097,chr12,MYRFL,chr12:69825227-69959097,133870
58814412,58814552,chr8,RNU4-50P,chr8:58814412-58814552,140
13621498,13711835,chr6,RANBP9,chr6:13621498-13711835,90337
59455885,59456010,chr8,RNA5SP267,chr8:59455885-59456010,125
63609354,63609600,chr8,RN7SKP135,chr8:63609354-63609600,246
61714788,61714859,chr8,MIR4470,chr8:61714788-61714859,71
57289552,57289649,chr8,RNU6-596P,chr8:57289552-57289649,97
54330687,54330895,chr8,RNU105C,chr8:54330687-54330895,208
43679341,43706709,chr17,LINC02594,chr17:43679341-43706709,27368
61631680,61632012,chr8,RN7SKP97,chr8:61631680-61632012,332
56917084,56917190,chr8,RNU6-13P,chr8:56917084-56917190,106
69922751,69923047,chr8,RN7SL675P,chr8:69922751-69923047,296
70077906,70078032,chr8,RNU1-101P,chr8:70077906-70078032,126
55751051,55842830,chr17,PCTP,chr17:55751051-55842830,91779
57126655,57126762,chr8,RNA5SP266,chr8:57126655-57126762,107
69700224,69700495,chr8,RN7SKP29,chr8:69700224-69700495,271
54420468,54420725,chr8,RN7SL250P,chr8:54420468-54420725,257
66501205,66501311,chr8,RNU6-1324P,chr8:66501205-66501311,106
34712737,34859755,chr1,SMIM12,chr1:34712737-34859755,147018
64379149,64379257,chr8,MIR124-2,chr8:64379149-64379257,108
70654578,70654883,chr8,RN7SL19P,chr8:70654578-70654883,305
46831050,46831156,chr8,RNU6-656P,chr8:46831050-46831156,106
70480192,70480487,chr8,RN7SL203P,chr8:70480192-70480487,295
72357728,72357815,chr8,RNA5SP271,chr8:72357728-72357815,87
80560567,80560625,chr8,RNU7-174P,chr8:80560567-80560625,58
68695643,68695779,chr8,RNA5SP269,chr8:68695643-68695779,136
112356135,112370959,chr4,RTEL1P1,chr4:112356135-112370959,14824
69110513,69110574,chr8,RNU7-102P,chr8:69110513-69110574,61
80405516,80405609,chr8,RNU6-1213P,chr8:80405516-80405609,93
69929905,69930022,chr8,RNA5SP270,chr8:69929905-69930022,117
80749561,80749693,chr8,RNU11-6P,chr8:80749561-80749693,132
80776666,80776962,chr8,RN7SL308P,chr8:80776666-80776962,296
112455924,112457785,chr4,TOX4P1,chr4:112455924-112457785,1861
76265543,76265732,chr8,RNU2-54P,chr8:76265543-76265732,189
80585585,80585773,chr8,RNU2-71P,chr8:80585585-80585773,188
79800133,79800195,chr8,RNU7-85P,chr8:79800133-79800195,62
88396437,88396547,chr8,RNA5SP272,chr8:88396437-88396547,110
55902723,55902855,chr8,SNORA1B,chr8:55902723-55902855,132
2930561,2934834,chr4,MFSD10,chr4:2930561-2934834,4273
89900721,89900824,chr8,RNU6-925P,chr8:89900721-89900824,103
93029751,93029839,chr8,MIR8084,chr8:93029751-93029839,88
80241389,80241473,chr8,MIR5708,chr8:80241389-80241473,84
70357347,70357448,chr8,RNY3P14,chr8:70357347-70357448,101
157529132,157529200,chr6,MIR3692,chr6:157529132-157529200,68
84665759,84665865,chr8,RNU6-1040P,chr8:84665759-84665865,106
96431054,96431160,chr8,RNU6-1172P,chr8:96431054-96431160,106
95599114,95599219,chr8,RNU6-690P,chr8:95599114-95599219,105
39897745,39899098,chr1,MYCL-AS1,chr1:39897745-39899098,1353
93267429,93268425,chr5,POLD2P1,chr5:93267429-93268425,996
91205485,91205559,chr8,MIR4661,chr8:91205485-91205559,74
55158939,55177540,chr19,DNAAF3-AS1,chr19:55158939-55177540,18601
80613544,80613826,chr8,RN7SL107P,chr8:80613544-80613826,282
93916022,93916119,chr8,MIR378D2,chr8:93916022-93916119,97
100957883,100958180,chr8,RN7SL685P,chr8:100957883-100958180,297
149345430,149354583,chr5,GRPEL2,chr5:149345430-149354583,9153
64528667,64529671,chr15,GAPDHP61,chr15:64528667-64529671,1004
78398515,78398622,chr8,RNU6-1220P,chr8:78398515-78398622,107
157700387,157945077,chr6,SNX9,chr6:157700387-157945077,244690
98048856,98048962,chr8,RNU6-703P,chr8:98048856-98048962,106
119211732,119240946,chr3,B4GALT4,chr3:119211732-119240946,29214
97358265,97358478,chr8,SNORD3H,chr8:97358265-97358478,213
93441277,93441384,chr8,RNA5SP274,chr8:93441277-93441384,107
101397636,101397933,chr8,RN7SL563P,chr8:101397636-101397933,297
98462944,98463050,chr8,RNU6-748P,chr8:98462944-98463050,106
91594965,91595241,chr8,RN7SKP231,chr8:91594965-91595241,276
7915871,7943165,chr1,TNFRSF9,chr1:7915871-7943165,27294
21123817,21124188,chr19,VN1R81P,chr19:21123817-21124188,371
80204606,80204902,chr8,RN7SL41P,chr8:80204606-80204902,296
98042086,98042217,chr8,SNORA72,chr8:98042086-98042217,131
70180338,70202004,chr12,LINC02821,chr12:70180338-70202004,21666
103384961,103385067,chr8,RNU6-1011P,chr8:103384961-103385067,106
55171196,55180289,chr19,SYT5,chr19:55171196-55180289,9093
103154614,103154689,chr8,MIR3151,chr8:103154614-103154689,75
100004583,100004649,chr8,SNORD77B,chr8:100004583-100004649,66
102421197,102421322,chr8,RNU6ATAC8P,chr8:102421197-102421322,125
70366290,70434292,chr12,KCNMB4,chr12:70366290-70434292,68002
98192205,98192313,chr8,RNU6-914P,chr8:98192205-98192313,108
102533241,102533339,chr8,RNU6-1224P,chr8:102533241-102533339,98
87205408,87240145,chr5,LINC01949,chr5:87205408-87240145,34737
71844735,71844794,chr10,RNU7-38P,chr10:71844735-71844794,59
102125432,102125515,chr8,MIR5680,chr8:102125432-102125515,83
107884494,107884611,chr8,RNA5SP275,chr8:107884494-107884611,117
135930317,135951591,chr5,FBXL21P,chr5:135930317-135951591,21274
100382763,100382845,chr8,MIR4471,chr8:100382763-100382845,82
116022686,116022779,chr8,RNA5SP276,chr8:116022686-116022779,93
118976513,118976619,chr8,RNU6-12P,chr8:118976513-118976619,106
79347469,79355334,chr10,PPIF,chr10:79347469-79355334,7865
123588759,123589046,chr8,RN7SKP155,chr8:123588759-123589046,287
101307367,101307428,chr8,RNU7-67P,chr8:101307367-101307428,61
70443784,70443923,chr12,RNU4-65P,chr12:70443784-70443923,139
50846468,50846837,chr1,MRPS6P2,chr1:50846468-50846837,369
90511128,90511240,chr8,RNA5SP273,chr8:90511128-90511240,112
117017946,117018248,chr8,RN7SL228P,chr8:117017946-117018248,302
95055214,95055320,chr8,RNU6-1209P,chr8:95055214-95055320,106
39895426,39902256,chr1,MYCL,chr1:39895426-39902256,6830
125270604,125270902,chr8,RN7SL329P,chr8:125270604-125270902,298
9067664,9116229,chr12,A2M,chr12:9067664-9116229,48565
117163968,117164255,chr8,RN7SL826P,chr8:117163968-117164255,287
95072914,95072993,chr8,MIR3150A,chr8:95072914-95072993,79
112643493,112643583,chr8,MIR2053,chr8:112643493-112643583,90
128220504,128220803,chr8,RN7SKP226,chr8:128220504-128220803,299
63827152,63832026,chr17,PSMC5,chr17:63827152-63832026,4874
123342414,123342519,chr8,RNU6-875P,chr8:123342414-123342519,105
119325171,119325265,chr8,MIR548AZ,chr8:119325171-119325265,94
123348034,123348130,chr8,MIR548D1,chr8:123348034-123348130,96
101137959,101138313,chr8,RN7SKP249,chr8:101137959-101138313,354
119862662,119862956,chr8,RN7SL396P,chr8:119862662-119862956,294
126671522,126671654,chr8,RNU11-4P,chr8:126671522-126671654,132
73921665,73922196,chr11,ARPC3P4,chr11:73921665-73922196,531
134800520,134800607,chr8,MIR30B,chr8:134800520-134800607,87
123348034,123348130,chr8,MIR548AA1,chr8:123348034-123348130,96
73951026,73970366,chr11,DNAJB13,chr11:73951026-73970366,19340
134804876,134804945,chr8,MIR30D,chr8:134804876-134804945,69
54980628,54992288,chr1,TMEM61,chr1:54980628-54992288,11660
157885114,157892786,chr6,SNX9-AS1,chr6:157885114-157892786,7672
174724582,174730896,chr5,MSX2,chr5:174724582-174730896,6314
100831728,100831860,chr8,RNU4-83P,chr8:100831728-100831860,132
157924402,157924676,chr6,HSPE1P26,chr6:157924402-157924676,274
157934168,157934257,chr6,RNU6-786P,chr6:157934168-157934257,89
135742343,135742495,chr8,RNU1-35P,chr8:135742343-135742495,152
119891132,119891229,chr8,RNA5SP277,chr8:119891132-119891229,97
157981863,158099176,chr6,SYNJ2,chr6:157981863-158099176,117313
130004528,130004601,chr8,RNU7-181P,chr8:130004528-130004601,73
142176339,142176418,chr8,MIR4472-1,chr8:142176339-142176418,79
79382325,79445624,chr10,ZCCHC24,chr10:79382325-79445624,63299
8831007,8831375,chr1,RPL23AP19,chr1:8831007-8831375,368
112148742,112148825,chr8,RNU4-37P,chr8:112148742-112148825,83
133046481,133046581,chr8,MIR7848,chr8:133046481-133046581,100
76966768,76966850,chr8,MIR3149,chr8:76966768-76966850,82
128150116,128150188,chr8,MIR1208,chr8:128150116-128150188,72
130008334,130008453,chr8,MIR5194,chr8:130008334-130008453,119
127795962,127796028,chr8,MIR1204,chr8:127795962-127796028,66
48050659,48091736,chr1,LINC02794,chr1:48050659-48091736,41077
126504763,126504869,chr8,RNU6-869P,chr8:126504763-126504869,106
140732564,140732653,chr8,MIR151A,chr8:140732564-140732653,89
140940562,140940663,chr8,RNA5SP278,chr8:140940562-140940663,101
95072911,95072996,chr8,MIR3150B,chr8:95072911-95072996,85
141786242,141786313,chr8,MIR1302-7,chr8:141786242-141786313,71
130069541,130069652,chr8,RNU6-1255P,chr8:130069541-130069652,111
79499666,79499984,chr10,TPRX1P1,chr10:79499666-79499984,318
125900951,125901054,chr8,RNU6-442P,chr8:125900951-125901054,103
174919082,174995513,chr5,LINC01951,chr5:174919082-174995513,76431
142247585,142247866,chr8,RN7SL260P,chr8:142247585-142247866,281
137105352,137105458,chr8,RNU6-144P,chr8:137105352-137105458,106
124260646,124260752,chr8,RNU6-756P,chr8:124260646-124260752,106
143350172,143350278,chr8,RNU6-220P,chr8:143350172-143350278,106
142716229,142761035,chr5,LINC01844,chr5:142716229-142761035,44806
79544087,79544356,chr10,RPS12P18,chr10:79544087-79544356,269
52939182,52943734,chr8,NPBWR1,chr8:52939182-52943734,4552
79555852,79560407,chr10,SFTPA2,chr10:79555852-79560407,4555
38263130,38269243,chr8,PLPP5,chr8:38263130-38269243,6113
30560644,30560934,chr15,RN7SL796P,chr15:30560644-30560934,290
74000277,74009085,chr11,UCP3,chr11:74000277-74009085,8808
30567822,30571089,chr15,DNM1P50,chr15:30567822-30571089,3267
30572738,30600647,chr15,ULK4P2,chr15:30572738-30600647,27909
47274885,47275723,chr19,INAFM1,chr19:47274885-47275723,838
46967679,46967874,chr1,CYP4A26P,chr1:46967679-46967874,195
45091396,45148077,chr19,PPP1R37,chr19:45091396-45148077,56681
50229662,50321192,chr1,LINC02808,chr1:50229662-50321192,91530
30612724,30612960,chr15,RN7SL628P,chr15:30612724-30612960,236
60114875,60149784,chr1,LINC02778,chr1:60114875-60149784,34909
30616998,30625773,chr15,ARHGAP11B-DT,chr15:30616998-30625773,8775
2937933,2963406,chr4,NOP14,chr4:2937933-2963406,25473
38209034,38214806,chr1,LINC01343,chr1:38209034-38214806,5772
30791573,30801859,chr15,GOLGA8UP,chr15:30791573-30801859,10286
173225836,173226423,chr5,RPL7AP33,chr5:173225836-173226423,587
175972606,175987666,chr5,THOC3-AS1,chr5:175972606-175987666,15060
74171267,74254703,chr11,PPME1,chr11:74171267-74254703,83436
33340686,33341984,chr19,RPS3AP50,chr19:33340686-33341984,1298
79582298,79584877,chr10,MBL3P,chr10:79582298-79584877,2579
44221070,44355260,chr1,ERI3,chr1:44221070-44355260,134190
79595294,79595660,chr10,SFTPA3P,chr10:79595294-79595660,366
30800160,30800396,chr15,RN7SL82P,chr15:30800160-30800396,236
30815271,30844153,chr15,HERC2P10,chr15:30815271-30844153,28882
79610939,79615455,chr10,SFTPA1,chr10:79610939-79615455,4516
44051766,44051829,chr7,MIR6837,chr7:44051766-44051829,63
44062727,44065567,chr7,PGAM2,chr7:44062727-44065567,2840
173607145,173616659,chr5,BOD1,chr5:173607145-173616659,9514
40717112,40740860,chr19,ITPKC,chr19:40717112-40740860,23748
42939310,42940358,chr15,FDPSP4,chr15:42939310-42940358,1048
44072062,44082530,chr7,POLM,chr7:44072062-44082530,10468
42942897,43106113,chr15,UBR1,chr15:42942897-43106113,163216
34758073,34773229,chr19,ZNF599,chr19:34758073-34773229,15156
160401641,160421711,chr5,SLU7,chr5:160401641-160421711,20070
54635722,54638892,chr19,LILRB1-AS1,chr19:54635722-54638892,3170
55181247,55209506,chr19,PTPRH,chr19:55181247-55209506,28259
127571232,127598267,chr3,TPRA1,chr3:127571232-127598267,27035
224499387,224500100,chr2,ANKRD49P1,chr2:224499387-224500100,713
38269704,38382272,chr8,NSD3,chr8:38269704-38382272,112568
172099438,172102900,chr2,DLX2,chr2:172099438-172102900,3462
53214099,53220634,chr1,CZIB,chr1:53214099-53220634,6535
16787235,16788141,chr17,SRP68P1,chr17:16787235-16788141,906
16786489,16804455,chr17,USP32P1,chr17:16786489-16804455,17966
79628757,79632188,chr10,LINC02679,chr10:79628757-79632188,3431
123762171,123763071,chr2,PSMD14P1,chr2:123762171-123763071,900
79661394,79826594,chr10,NUTM2B-AS1,chr10:79661394-79826594,165200
54609181,54623556,chr1,FAM151A,chr1:54609181-54623556,14375
566995,584109,chr16,PIGQ,chr16:566995-584109,17114
152335174,152649826,chr2,FMNL2,chr2:152335174-152649826,314652
2963571,3040760,chr4,GRK4,chr4:2963571-3040760,77189
102395874,102481744,chr12,IGF1,chr12:102395874-102481744,85870
74198748,74198854,chr11,RNA5SP343,chr11:74198748-74198854,106
32039974,32042828,chr17,SH3GL1P1,chr17:32039974-32042828,2854
158001107,158002383,chr6,SYNJ2-IT1,chr6:158001107-158002383,1276
30529688,30542416,chr17,ALOX12P1,chr17:30529688-30542416,12728
46793389,46839778,chr6,MEP1A,chr6:46793389-46839778,46389
141653401,141682230,chr5,ARAP3,chr5:141653401-141682230,28829
128836315,128867373,chr11,KCNJ1,chr11:128836315-128867373,31058
53062052,53085501,chr1,PODN,chr1:53062052-53085501,23449
29625938,29930276,chr17,SSH2,chr17:29625938-29930276,304338
67350772,67356972,chr11,POLD4,chr11:67350772-67356972,6200
32102088,32105916,chr19,LINC01782,chr19:32102088-32105916,3828
45641494,45642840,chr19,EML2-AS1,chr19:45641494-45642840,1346
79682997,79685436,chr10,BEND3P3,chr10:79682997-79685436,2439
34126973,34127423,chr19,CHCHD2P3,chr19:34126973-34127423,450
36027677,36111236,chr6,MAPK14,chr6:36027677-36111236,83559
32675848,32678300,chr19,RGS9BP,chr19:32675848-32678300,2452
86435256,86521792,chr10,WAPL,chr10:86435256-86521792,86536
44073378,44073433,chr7,MIR6838,chr7:44073378-44073433,55
43115702,43116493,chr15,RPS3AP47,chr15:43115702-43116493,791
40740856,40751553,chr19,C19orf54,chr19:40740856-40751553,10697
63142759,63151201,chr12,AVPR1A,chr12:63142759-63151201,8442
44200959,44214294,chr7,YKT6,chr7:44200959-44214294,13335
43123279,43185144,chr15,TMEM62,chr15:43123279-43185144,61865
155311023,155311409,chr2,MTND4P28,chr2:155311023-155311409,386
46843095,46900437,chr1,CYP4Z2P,chr1:46843095-46900437,57342
122019422,122062044,chr12,BCL7A,chr12:122019422-122062044,42622
210088226,210089064,chr2,RPL6P6,chr2:210088226-210089064,838
67362414,67362708,chr11,RN7SKP239,chr11:67362414-67362708,294
67364168,67374177,chr11,CLCF1,chr11:67364168-67374177,10009
183117513,183161680,chr2,NUP35,chr2:183117513-183161680,44167
67395210,67395311,chr11,RNU6-1238P,chr11:67395210-67395311,101
67398181,67421183,chr11,PPP1CA,chr11:67398181-67421183,23002
65278643,65491430,chr12,MSRB3,chr12:65278643-65491430,212787
28790812,28792871,chr19,MAN1A2P1,chr19:28790812-28792871,2059
22742924,22743410,chr19,VN1R87P,chr19:22742924-22743410,486
17859910,17864153,chr19,RPL18A,chr19:17859910-17864153,4243
51577179,51798427,chr1,OSBPL9,chr1:51577179-51798427,221248
86488446,86488549,chr10,RNU6-780P,chr10:86488446-86488549,103
94865852,94873129,chr10,CYP2C58P,chr10:94865852-94873129,7277
94882554,94883343,chr10,RPL7AP52,chr10:94882554-94883343,789
94938658,94990091,chr10,CYP2C9,chr10:94938658-94990091,51433
43131008,43131686,chr15,SPCS2P1,chr15:43131008-43131686,678
112463966,112499472,chr3,BTLA,chr3:112463966-112499472,35506
28878405,28904466,chr16,ATP2A1,chr16:28878405-28904466,26061
71097774,71202203,chr17,CASC17,chr17:71097774-71202203,104429
43185118,43197177,chr15,CCNDBP1,chr15:43185118-43197177,12059
18127220,18127309,chr7,MIR1302-6,chr7:18127220-18127309,89
18807993,18808279,chr7,RN7SKP266,chr7:18807993-18808279,286
18892096,18899433,chr7,HDAC9-AS1,chr7:18892096-18899433,7337
18948898,18949762,chr7,NPM1P13,chr7:18948898-18949762,864
77193369,77199848,chr7,FGL2,chr7:77193369-77199848,6479
55719627,55732121,chr17,TMEM100,chr17:55719627-55732121,12494
52708444,52770946,chr3,NEK4,chr3:52708444-52770946,62502
3044101,3044207,chr4,RNU6-204P,chr4:3044101-3044207,106
2728105,2844308,chr7,GNA12,chr7:2728105-2844308,116203
3049094,3074538,chr4,HTT-AS,chr4:3049094-3074538,25444
130276507,130277187,chr2,MTATP6P7,chr2:130276507-130277187,680
138412066,138413318,chr2,RNF14P1,chr2:138412066-138413318,1252
29606283,29617237,chr19,POP4,chr19:29606283-29617237,10954
136544712,136545542,chr2,SMC4P1,chr2:136544712-136545542,830
58345175,58353093,chr17,SUPT4H1,chr17:58345175-58353093,7918
94940253,94941121,chr10,MTND4P20,chr10:94940253-94941121,868
95007126,95007556,chr10,CYP2C59P,chr10:95007126-95007556,430
3244369,3271738,chr4,MSANTD1,chr4:3244369-3271738,27369
95009674,95009812,chr10,CYP2C60P,chr10:95009674-95009812,138
159698586,159937766,chr5,LINC01847,chr5:159698586-159937766,239180
67403915,67410089,chr11,TBC1D10C,chr11:67403915-67410089,6174
95036772,95069497,chr10,CYP2C8,chr10:95036772-95069497,32725
160563120,160852214,chr5,ATP10B,chr5:160563120-160852214,289094
83090048,83137075,chr4,PLAC8,chr4:83090048-83137075,47027
179001756,179002760,chr2,RPS6P2,chr2:179001756-179002760,1004
2944035,2947091,chr7,CARD11-AS1,chr7:2944035-2947091,3056
2999094,2999394,chr7,RN7SKP130,chr7:2999094-2999394,300
48958554,48968596,chr17,GIP,chr17:48958554-48968596,10042
74199652,74229834,chr7,LAT2,chr7:74199652-74229834,30182
104694518,104695462,chr9,OR13D1,chr9:104694518-104695462,944
180967248,181076585,chr2,UBE2E3,chr2:180967248-181076585,109337
111327229,111330224,chr9,OR2K2,chr9:111327229-111330224,2995
21304326,21305313,chr9,IFNA5,chr9:21304326-21305313,987
38434347,38435664,chr8,RPS20P22,chr8:38434347-38435664,1317
25676969,25678444,chr9,TUSC1,chr9:25676969-25678444,1475
38510834,38560939,chr8,C8orf86,chr8:38510834-38560939,50105
41131306,41199261,chr9,CBWD6,chr9:41131306-41199261,67955
112140898,112294227,chr3,SLC9C1,chr3:112140898-112294227,153329
44557484,44561262,chr17,FZD2,chr17:44557484-44561262,3778
38600661,38601200,chr8,RNF5P1,chr8:38600661-38601200,539
77722872,77728559,chr17,LINC01987,chr17:77722872-77728559,5687
4364164,4364453,chr17,RN7SL774P,chr17:4364164-4364453,289
4056756,4056876,chr17,RNA5SP434,chr17:4056756-4056876,120
67428460,67435401,chr11,RPS6KB2,chr11:67428460-67435401,6941
4969702,4969771,chr17,MIR6864,chr17:4969702-4969771,69
4970086,4970150,chr17,MIR6865,chr17:4970086-4970150,64
139931172,139933942,chr8,C8orf17,chr8:139931172-139933942,2770
6600944,6601051,chr17,RNA5SP435,chr17:6600944-6601051,107
127960633,127960695,chr8,MIR1205,chr8:127960633-127960695,62
15782341,15782455,chr17,RNA5SP436,chr17:15782341-15782455,114
50057548,50083611,chr12,ASIC1,chr12:50057548-50083611,26063
127999131,127999294,chr8,RNVU1-32,chr8:127999131-127999294,163
17578631,17578739,chr17,RNU6-468P,chr17:17578631-17578739,108
128008898,128008956,chr8,MIR1206,chr8:128008898-128008956,58
17813480,17813545,chr17,MIR6777,chr17:17813480-17813545,65
17813836,17813931,chr17,MIR33B,chr17:17813836-17813931,95
19112419,19112636,chr17,SNORD3D,chr17:19112419-19112636,217
128010382,128010611,chr8,RNU4-25P,chr8:128010382-128010611,229
128049152,128049238,chr8,MIR1207,chr8:128049152-128049238,86
6655440,6655509,chr17,MIR4520-1,chr17:6655440-6655509,69
127946559,127948723,chr8,LINC02912,chr8:127946559-127948723,2164
41966582,41997497,chr19,ATP1A3,chr19:41966582-41997497,30915
6655449,6655502,chr17,MIR4520-2,chr17:6655449-6655502,53
21229334,21229628,chr17,RN7SL426P,chr17:21229334-21229628,294
16691798,16691907,chr17,RNU6-405P,chr17:16691798-16691907,109
16710059,16710361,chr17,RN7SL620P,chr17:16710059-16710361,302
83261536,83284914,chr4,COQ2,chr4:83261536-83284914,23378
30360463,30360566,chr17,RNU6-990P,chr17:30360463-30360566,103
11576257,11582817,chr8,LINC00208,chr8:11576257-11582817,6560
27293910,27293996,chr17,MIR4522,chr17:27293910-27293996,86
95183653,95184217,chr10,PAWRP1,chr10:95183653-95184217,564
31713753,31713853,chr17,RNU6-1134P,chr17:31713753-31713853,100
30246757,30246820,chr17,SNORD63,chr17:30246757-30246820,63
31963805,31963933,chr17,RNA5SP437,chr17:31963805-31963933,128
95194200,95228928,chr10,ACSM6,chr10:95194200-95228928,34728
30288071,30288177,chr17,RNU6-1267P,chr17:30288071-30288177,106
34120056,34120167,chr17,RNA5SP438,chr17:34120056-34120167,111
11790005,11790386,chr8,SUB1P1,chr8:11790005-11790386,381
36404826,36404932,chr17,RNU6-1192P,chr17:36404826-36404932,106
18340814,18340886,chr17,MIR6778,chr17:18340814-18340886,72
38144201,38144287,chr17,RNA5SP526,chr17:38144201-38144287,86
36110150,36110447,chr17,RN7SL301P,chr17:36110150-36110447,297
40161933,40162001,chr17,MIR6866,chr17:40161933-40162001,68
40193597,40193663,chr17,MIR6867,chr17:40193597-40193663,66
40027542,40027645,chr17,SNORD124,chr17:40027542-40027645,103
40026332,40026409,chr17,MIR6884,chr17:40026332-40026409,77
30702504,30702775,chr17,RN7SL316P,chr17:30702504-30702775,271
38851524,38851659,chr17,SNORA21B,chr17:38851524-38851659,135
40374089,40374176,chr17,RNA5SP441,chr17:40374089-40374176,87
38852863,38852994,chr17,SNORA21,chr17:38852863-38852994,131
30861843,30861938,chr17,RNU6-298P,chr17:30861843-30861938,95
29388560,29388683,chr17,RNU4-34P,chr17:29388560-29388683,123
39726495,39726561,chr17,MIR4728,chr17:39726495-39726561,66
11795573,11839304,chr8,FDFT1,chr8:11795573-11839304,43731
29424762,29424867,chr17,RNU6-711P,chr17:29424762-29424867,105
29445300,29445400,chr17,RNU6-1034P,chr17:29445300-29445400,100
29390662,29390730,chr17,MIR4523,chr17:29390662-29390730,68
39546104,39546244,chr17,RNU6-233P,chr17:39546104-39546244,140
15574019,15574198,chr17,SNORA74,chr17:15574019-15574198,179
36491199,36491322,chr17,RNA5SP439,chr17:36491199-36491322,123
41718154,41718260,chr17,RNA5SP442,chr17:41718154-41718260,106
41730127,41730405,chr17,RN7SL399P,chr17:41730127-41730405,278
30059052,30059147,chr17,RNY4P13,chr17:30059052-30059147,95
30117079,30117172,chr17,MIR423,chr17:30117079-30117172,93
43395993,43396091,chr17,RNU6-1137P,chr17:43395993-43396091,98
43445507,43445613,chr17,RNU6-406P,chr17:43445507-43445613,106
43473585,43473690,chr17,RNU6-971P,chr17:43473585-43473690,105
95594598,95595372,chr10,RPS3AP36,chr10:95594598-95595372,774
42891338,42891435,chr17,RNU6-287P,chr17:42891338-42891435,97
46921124,46921249,chr17,RNU6ATAC3P,chr17:46921124-46921249,125
95605941,95656711,chr10,ALDH18A1,chr10:95605941-95656711,50770
42823880,42823943,chr17,MIR6781,chr17:42823880-42823943,63
170861870,171300015,chr5,RANBP17,chr5:170861870-171300015,438145
43387226,43387417,chr17,RNU2-4P,chr17:43387226-43387417,191
43444806,43444885,chr17,MIR2117,chr17:43444806-43444885,79
30117086,30117160,chr17,MIR3184,chr17:30117086-30117160,74
46973017,46973100,chr17,MIR5089,chr17:46973017-46973100,83
47041825,47042105,chr17,RN7SL270P,chr17:47041825-47042105,280
43412427,43412530,chr17,RNU6-470P,chr17:43412427-43412530,103
110682286,110683154,chr3,RPSAP29,chr3:110682286-110683154,868
48156427,48156511,chr17,MIR1203,chr17:48156427-48156511,84
48765554,48765847,chr17,RN7SL125P,chr17:48765554-48765847,293
83292461,83335153,chr4,HPSE,chr4:83292461-83335153,42692
47259358,47259420,chr17,RNU7-186P,chr17:47259358-47259420,62
48724408,48724475,chr17,MIR3185,chr17:48724408-48724475,67
136899076,136900076,chr3,RAD51AP1P1,chr3:136899076-136900076,1000
48632490,48632559,chr17,MIR196A1,chr17:48632490-48632559,69
38914979,38915042,chr17,MIR6779,chr17:38914979-38915042,63
48037161,48037247,chr17,MIR152,chr17:48037161-48037247,86
48196680,48196786,chr17,RNU6-1152P,chr17:48196680-48196786,106
43233787,43233977,chr17,RNU2-1,chr17:43233787-43233977,190
112532510,112562046,chr3,ATG3,chr3:112532510-112562046,29536
50768650,50768730,chr17,MIR8059,chr17:50768650-50768730,80
48088678,48088784,chr17,RNU6-1201P,chr17:48088678-48088784,106
36127809,36144524,chr6,MAPK13,chr6:36127809-36144524,16715
48579838,48579947,chr17,MIR10A,chr17:48579838-48579947,109
59847438,59847544,chr17,RNU6-450P,chr17:59847438-59847544,106
48949361,48949520,chr17,RNU1-42P,chr17:48949361-48949520,159
60043025,60043105,chr17,MIR4737,chr17:60043025-60043105,80
60231516,60231646,chr17,SCARNA20,chr17:60231516-60231646,130
66895491,66895572,chr17,RNA5SP446,chr17:66895491-66895572,81
49288346,49288454,chr17,MIR6129,chr17:49288346-49288454,108
58666537,58666697,chr17,RNU1-108P,chr17:58666537-58666697,160
49036352,49036455,chr17,RNU6-826P,chr17:49036352-49036455,103
58835899,58835994,chr17,RNU6-518P,chr17:58835899-58835994,95
66364029,66364320,chr17,RN7SL735P,chr17:66364029-66364320,291
58677574,58677737,chr17,RNU1-52P,chr17:58677574-58677737,163
64780759,64780824,chr17,MIR6080,chr17:64780759-64780824,65
64825765,64825819,chr17,RNU7-115P,chr17:64825765-64825819,54
58679527,58679690,chr17,RNVU1-34,chr17:58679527-58679690,163
95711779,95877266,chr10,ENTPD1,chr10:95711779-95877266,165487
66638271,66638374,chr17,RNU6-928P,chr17:66638271-66638374,103
64822030,64822102,chr17,MIR4315-2,chr17:64822030-64822102,72
66639269,66639383,chr17,RNA5SP445,chr17:66639269-66639383,114
66787072,66787168,chr17,MIR634,chr17:66787072-66787168,96
54770949,54771277,chr17,RN7SKP14,chr17:54770949-54771277,328
72663823,72664152,chr17,RN7SKP180,chr17:72663823-72664152,329
71298156,71298218,chr17,RNU7-155P,chr17:71298156-71298218,62
58335976,58336022,chr17,MIR4736,chr17:58335976-58336022,46
62005737,62006016,chr17,RN7SL800P,chr17:62005737-62006016,279
55551810,55551920,chr17,RNU6-1249P,chr17:55551810-55551920,110
66267743,66267848,chr17,RNA5SP444,chr17:66267743-66267848,105
67268110,67268228,chr17,RNA5SP447,chr17:67268110-67268228,118
80419418,80419493,chr17,MIR4730,chr17:80419418-80419493,75
64871504,64871784,chr17,RN7SL404P,chr17:64871504-64871784,280
67457023,67457290,chr17,RN7SL756P,chr17:67457023-67457290,267
78532813,78533055,chr17,RN7SL454P,chr17:78532813-78533055,242
67471489,67471585,chr17,MIR548D2,chr17:67471489-67471585,96
67471489,67471585,chr17,MIR548AA2,chr17:67471489-67471585,96
59841266,59841337,chr17,MIR21,chr17:59841266-59841337,71
181086076,181409321,chr2,LINC01934,chr2:181086076-181409321,323245
80098828,80098877,chr17,MIR1268B,chr17:80098828-80098877,49
58331232,58331318,chr17,MIR142,chr17:58331232-58331318,86
78370852,78371135,chr17,RN7SL236P,chr17:78370852-78371135,283
74748613,74748699,chr17,MIR3615,chr17:74748613-74748699,86
42950526,42964498,chr17,AARSD1,chr17:42950526-42964498,13972
31180138,31191605,chr16,FUS,chr16:31180138-31191605,11467
202075410,202117062,chr2,KIAA2012-AS1,chr2:202075410-202117062,41652
68145004,68145630,chr3,COPS8P2,chr3:68145004-68145630,626
105235290,105396097,chr12,C12orf75,chr12:105235290-105396097,160807
122739999,122793831,chr3,HSPBAP1,chr3:122739999-122793831,53832
67431367,67435399,chr11,RPS6KB2-AS1,chr11:67431367-67435399,4032
67435510,67437682,chr11,PTPRCAP,chr11:67435510-67437682,2172
159803355,159904756,chr2,LY75,chr2:159803355-159904756,101401
36146698,36197205,chr6,BRPF3-AS1,chr6:36146698-36197205,50507
67435510,67443821,chr11,CORO1B,chr11:67435510-67443821,8311
51391285,51397908,chr3,RBM15B,chr3:51391285-51397908,6623
125724539,125725445,chr3,OR7E93P,chr3:125724539-125725445,906
36196744,36232790,chr6,BRPF3,chr6:36196744-36232790,36046
43267904,43268388,chr15,ATP5PDP1,chr15:43267904-43268388,484
119173517,119205143,chr3,UPK1B,chr3:119173517-119205143,31626
43276271,43302255,chr15,TGM7,chr15:43276271-43302255,25984
98247690,98268194,chr10,LOXL4,chr10:98247690-98268194,20504
52079704,52108255,chr12,SMIM41,chr12:52079704-52108255,28551
43323649,43330582,chr15,LCMT2,chr15:43323649-43330582,6933
10412315,10420595,chr12,KLRC3,chr12:10412315-10420595,8280
43197227,43221018,chr15,EPB42,chr15:43197227-43221018,23791
98383565,98415182,chr10,PYROXD2,chr10:98383565-98415182,31617
74231499,74254458,chr7,RFC2,chr7:74231499-74254458,22959
42950526,42980528,chr17,PTGES3L-AARSD1,chr17:42950526-42980528,30002
133181409,133214832,chr12,ZNF268,chr12:133181409-133214832,33423
137880295,137882237,chr3,HSPA8P9,chr3:137880295-137882237,1942
67451301,67452729,chr11,GPR152,chr11:67451301-67452729,1428
98395218,98395307,chr10,MIR1287,chr10:98395218-98395307,89
23805955,23891640,chr3,UBE2E1,chr3:23805955-23891640,85685
98416198,98446935,chr10,HPS1,chr10:98416198-98446935,30737
67461710,67469272,chr11,TMEM134,chr11:67461710-67469272,7562
155311697,155313427,chr2,MTND5P30,chr2:155311697-155313427,1730
211298941,211299189,chr2,RPS27P10,chr2:211298941-211299189,248
181887851,181891663,chr2,ITPRID2-DT,chr2:181887851-181891663,3812
209771832,209999300,chr2,UNC80,chr2:209771832-209999300,227468
62806860,62832051,chr11,STX5,chr11:62806860-62832051,25191
31167457,31225143,chr19,LINC01791,chr19:31167457-31225143,57686
108822770,108855005,chr3,TRAT1,chr3:108822770-108855005,32235
51314032,51314107,chr15,MIR7973-2,chr15:51314032-51314107,75
51314034,51314109,chr15,MIR7973-1,chr15:51314034-51314109,75
51341655,51408005,chr15,GLDN,chr15:51341655-51408005,66350
36315761,36336888,chr6,BNIP5,chr6:36315761-36336888,21127
34734155,34745378,chr19,ZNF181,chr19:34734155-34745378,11223
98431292,98431360,chr10,MIR4685,chr10:98431292-98431360,68
104474939,104480274,chr10,LINC02620,chr10:104474939-104480274,5335
83407343,83455855,chr4,HELQ,chr4:83407343-83455855,48512
104641290,105265242,chr10,SORCS3,chr10:104641290-105265242,623952
119497678,119498181,chr3,TIMMDC1-DT,chr3:119497678-119498181,503
109101456,109110342,chr3,MORC1-AS1,chr3:109101456-109110342,8886
56669814,56671129,chr16,MT1H,chr16:56669814-56671129,1315
40309707,40312424,chr3,EIF1B,chr3:40309707-40312424,2717
86220265,86259657,chr9,C9orf153,chr9:86220265-86259657,39392
36354091,36387800,chr6,ETV7,chr6:36354091-36387800,33709
104664608,104666200,chr10,SORCS3-AS1,chr10:104664608-104666200,1592
119829404,119892556,chr10,MCMBP,chr10:119829404-119892556,63152
56589074,56591088,chr16,MT3,chr16:56589074-56591088,2014
111592900,111595346,chr3,ZBED2,chr3:111592900-111595346,2446
70384604,70414657,chr9,KLF9,chr9:70384604-70414657,30053
2162763,2162953,chr9,RNU2-25P,chr9:2162763-2162953,190
2228961,2229241,chr9,RN7SL592P,chr9:2228961-2229241,280
35358460,35360489,chr19,FFAR3,chr19:35358460-35360489,2029
2720469,2844095,chr9,PUM3,chr9:2720469-2844095,123626
127193131,127198185,chr3,C3orf56,chr3:127193131-127198185,5054
24096512,24097360,chr3,NPM1P23,chr3:24096512-24097360,848
283164,287215,chr16,PDIA2,chr16:283164-287215,4051
130212823,130273806,chr3,COL6A4P2,chr3:130212823-130273806,60983
54643889,54670359,chr19,LILRB4,chr19:54643889-54670359,26470
67717931,67744531,chr17,NOL11,chr17:67717931-67744531,26600
67648338,67665406,chr12,DYRK2,chr12:67648338-67665406,17068
83455932,83469735,chr4,MRPS18C,chr4:83455932-83469735,13803
72996803,73069198,chr3,PPP4R2,chr3:72996803-73069198,72395
74289407,74405935,chr7,CLIP2,chr7:74289407-74405935,116528
105107324,105169130,chr12,WASHC4,chr12:105107324-105169130,61806
119892730,119944657,chr10,SEC23IP,chr10:119892730-119944657,51927
51447711,51622833,chr15,DMXL2,chr15:51447711-51622833,175122
7977481,7977708,chr11,COX6CP5,chr11:7977481-7977708,227
8011278,8016520,chr11,CASC23,chr11:8011278-8016520,5242
3018445,3022383,chr16,TNFRSF12A,chr16:3018445-3022383,3938
8019244,8106243,chr11,TUB,chr11:8019244-8106243,86999
2875442,2876427,chr9,GPS2P1,chr9:2875442-2876427,985
2900320,2900804,chr9,ATP5PDP2,chr9:2900320-2900804,484
121851882,121852833,chr5,FTMT,chr5:121851882-121852833,951
132317369,132368298,chr3,ACP3,chr3:132317369-132368298,50929
41276280,41282846,chr9,PTGER4P2-CDK2AP2P2,chr9:41276280-41282846,6566
67740669,67740799,chr17,SNORA38B,chr17:67740669-67740799,130
67774591,67777324,chr17,RPSAP67,chr17:67774591-67777324,2733
41280460,41280787,chr9,CDK2AP2P1,chr9:41280460-41280787,327
83459517,83523348,chr4,ABRAXAS1,chr4:83459517-83523348,63831
41292887,41294125,chr9,MYO5BP1,chr9:41292887-41294125,1238
174045706,174243501,chr5,NSG2,chr5:174045706-174243501,197795
67784753,67785293,chr17,RPL17P41,chr17:67784753-67785293,540
41340823,41355538,chr9,CDRT15P6,chr9:41340823-41355538,14715
136612024,136617181,chr9,LINC01451,chr9:136612024-136617181,5157
67977698,67977972,chr17,RN7SL622P,chr17:67977698-67977972,274
68095068,68095757,chr17,FBXO36P1,chr17:68095068-68095757,689
131576770,131740076,chr9,RAPGEF1,chr9:131576770-131740076,163306
3022625,3024286,chr16,HCFC1R1,chr16:3022625-3024286,1661
68125777,68152468,chr17,LRRC37A16P,chr17:68125777-68152468,26691
119958513,119958592,chr10,MIR4682,chr10:119958513-119958592,79
119997086,119997709,chr10,NACAP2,chr10:119997086-119997709,623
74487428,74487540,chr7,RNA5SP233,chr7:74487428-74487540,112
2906142,3043867,chr7,CARD11,chr7:2906142-3043867,137725
89414568,89421605,chr10,IFIT5,chr10:89414568-89421605,7037
68134675,68135604,chr17,SH3GL1P3,chr17:68134675-68135604,929
36386831,36393462,chr6,ETV7-AS1,chr6:36386831-36393462,6631
68152776,68159043,chr17,RDM1P3,chr17:68152776-68159043,6267
89205629,89207317,chr10,CH25H,chr10:89205629-89207317,1688
146639700,146639769,chr6,RNU6-906P,chr6:146639700-146639769,69
146802359,146803824,chr6,KATNBL1P6,chr6:146802359-146803824,1465
68198921,68199596,chr17,ARHGAP27P2,chr17:68198921-68199596,675
89213569,89414557,chr10,LIPA,chr10:89213569-89414557,200988
223855716,223945357,chr2,WDFY1,chr2:223855716-223945357,89641
50155045,50189075,chr3,SEMA3F,chr3:50155045-50189075,34030
68420948,68457513,chr17,WIPI1,chr17:68420948-68457513,36565
8060038,8069373,chr11,TUB-AS1,chr11:8060038-8069373,9335
40348456,40380439,chr19,PLD3,chr19:40348456-40380439,31983
146598967,146815462,chr6,ADGB,chr6:146598967-146815462,216495
126245035,126245282,chr11,RN7SL351P,chr11:126245035-126245282,247
126262938,126269144,chr11,SRPRA,chr11:126262938-126269144,6206
83477524,83478424,chr4,SLC25A14P1,chr4:83477524-83478424,900
83502699,83503034,chr4,RPL30P5,chr4:83502699-83503034,335
168092537,168187736,chr4,ANXA10,chr4:168092537-168187736,95199
82968888,82977153,chr5,ST13P12,chr5:82968888-82977153,8265
134735464,134918710,chr2,CCNT2-AS1,chr2:134735464-134918710,183246
15060033,15094311,chr16,RRN3,chr16:15060033-15094311,34278
143277931,143435512,chr5,NR3C1,chr5:143277931-143435512,157581
41667168,41705834,chr7,INHBA,chr7:41667168-41705834,38666
158862311,158863285,chr2,OR7E28P,chr2:158862311-158863285,974
214810181,214963575,chr2,SNHG31,chr2:214810181-214963575,153394
157379724,157380414,chr2,FAM133DP,chr2:157379724-157380414,690
119156243,119158751,chr2,C1QL2,chr2:119156243-119158751,2508
68424451,68424548,chr17,MIR635,chr17:68424451-68424548,97
215996329,216082955,chr2,PECR,chr2:215996329-216082955,86626
41693884,41779388,chr7,INHBA-AS1,chr7:41693884-41779388,85504
168216291,168318883,chr4,DDX60,chr4:168216291-168318883,102592
19648136,19685760,chr17,ALDH3A2,chr17:19648136-19685760,37624
42113365,42113620,chr7,HMGN2P30,chr7:42113365-42113620,255
142760415,142763943,chr7,PRSS3P1,chr7:142760415-142763943,3528
142778642,142779537,chr7,WBP1LP1,chr7:142778642-142779537,895
142786213,142786224,chr7,TRBD1,chr7:142786213-142786224,11
142786880,142786927,chr7,TRBJ1-1,chr7:142786880-142786927,47
142787017,142787064,chr7,TRBJ1-2,chr7:142787017-142787064,47
142787630,142787679,chr7,TRBJ1-3,chr7:142787630-142787679,49
142788225,142788275,chr7,TRBJ1-4,chr7:142788225-142788275,50
142788498,142788547,chr7,TRBJ1-5,chr7:142788498-142788547,49
95659823,95694143,chr10,TCTN3,chr10:95659823-95694143,34320
142788988,142789040,chr7,TRBJ1-6,chr7:142788988-142789040,52
142791694,142793368,chr7,TRBC1,chr7:142791694-142793368,1674
142796365,142796414,chr7,TRBJ2-1,chr7:142796365-142796414,49
142796560,142796610,chr7,TRBJ2-2,chr7:142796560-142796610,50
142796697,142796742,chr7,TRBJ2-2P,chr7:142796697-142796742,45
142796847,142796895,chr7,TRBJ2-3,chr7:142796847-142796895,48
126278257,126278577,chr11,RPL35AP26,chr11:126278257-126278577,320
142796998,142797047,chr7,TRBJ2-4,chr7:142796998-142797047,49
205949091,205950145,chr2,PPIAP68,chr2:205949091-205950145,1054
142797119,142797166,chr7,TRBJ2-5,chr7:142797119-142797166,47
126304060,126350005,chr11,DCPS,chr11:126304060-126350005,45945
142797239,142797291,chr7,TRBJ2-6,chr7:142797239-142797291,52
142797456,142797502,chr7,TRBJ2-7,chr7:142797456-142797502,46
142801041,142802748,chr7,TRBC2,chr7:142801041-142802748,1707
142812586,142813399,chr7,TRBV30,chr7:142812586-142813399,813
185547135,185547818,chr2,ELF2P4,chr2:185547135-185547818,683
129923177,129946703,chr2,LINC01856,chr2:129923177-129946703,23526
142855061,142871094,chr7,EPHB6,chr7:142855061-142871094,16033
48653211,48682238,chr12,KANSL2,chr12:48653211-48682238,29027
37433219,37482827,chr6,CMTR1,chr6:37433219-37482827,49608
143091362,143768352,chr2,ARHGAP15,chr2:143091362-143768352,676990
6215786,6257983,chr9,IL33,chr9:6215786-6257983,42197
126355640,126440344,chr11,ST3GAL4,chr11:126355640-126440344,84704
58999676,59000494,chr1,PHBP3,chr1:58999676-59000494,818
43281877,43285617,chr1,C1orf210,chr1:43281877-43285617,3740
39214199,39214672,chr3,DSTNP4,chr3:39214199-39214672,473
54976159,54976371,chr4,RPL38P3,chr4:54976159-54976371,212
65893816,65925297,chr3,MAGI1-AS1,chr3:65893816-65925297,31481
55031965,55032071,chr4,RNU6-410P,chr4:55031965-55032071,106
112030931,112031649,chr3,RFKP2,chr3:112030931-112031649,718
36764445,36764551,chr8,RNA5SP264,chr8:36764445-36764551,106
55063738,55064026,chr4,RN7SL424P,chr4:55063738-55064026,288
55078481,55125595,chr4,KDR,chr4:55078481-55125595,47114
54047749,54048793,chr3,CABYRP1,chr3:54047749-54048793,1044
58295080,58406147,chr16,GINS3,chr16:58295080-58406147,111067
54756898,54764523,chr1,PARS2,chr1:54756898-54764523,7625
36887456,36890576,chr8,TPT1P8,chr8:36887456-36890576,3120
109178143,109216965,chr3,LINC00488,chr3:109178143-109216965,38822
37482938,37499893,chr6,CCDC167,chr6:37482938-37499893,16955
75167704,75176656,chr8,LINC02886,chr8:75167704-75176656,8952
137723774,137724543,chr3,NPM1P17,chr3:137723774-137724543,769
75302296,75302574,chr8,HIGD1AP6,chr8:75302296-75302574,278
52842511,52894998,chr1,ZYG11A,chr1:52842511-52894998,52487
75356437,75362268,chr3,OR7E22P,chr3:75356437-75362268,5831
75376709,75377014,chr8,PKMP4,chr8:75376709-75377014,305
119314293,119322760,chr3,ARHGAP31-AS1,chr3:119314293-119322760,8467
75120409,75352327,chr8,CASC9,chr8:75120409-75352327,231918
111360685,111484745,chr9,ECPAS,chr9:111360685-111484745,124060
37555365,37555422,chr6,MIR4462,chr6:37555365-37555422,57
37630679,37699306,chr6,MDGA1,chr6:37630679-37699306,68627
133191039,133231690,chr8,CCN4,chr8:133191039-133231690,40651
50205246,50221486,chr3,SLC38A3,chr3:50205246-50221486,16240
853634,981318,chr16,LMF1,chr16:853634-981318,127684
51561866,51594897,chr1,CALR4P,chr1:51561866-51594897,33031
20810702,20916911,chr12,SLCO1B3,chr12:20810702-20916911,106209
89327307,89377473,chr10,IFIT3,chr10:89327307-89377473,50166
216859458,216860064,chr2,TNP1,chr2:216859458-216860064,606
133325997,133326404,chr8,RPL32P20,chr8:133325997-133326404,407
52726453,52827336,chr1,ZYG11B,chr1:52726453-52827336,100883
48617798,48733148,chr2,GTF2A1L,chr2:48617798-48733148,115350
41653220,41896762,chr8,ANK1,chr8:41653220-41896762,243542
142871208,142885745,chr7,TRPV6,chr7:142871208-142885745,14537
73812501,73874591,chr10,CAMK2G,chr10:73812501-73874591,62090
54647944,54648853,chr19,VN1R105P,chr19:54647944-54648853,909
19063994,19113030,chr19,SLC25A42,chr19:19063994-19113030,49036
55215624,55215919,chr4,RN7SL822P,chr4:55215624-55215919,295
80079532,80081122,chr4,KPNA2P1,chr4:80079532-80081122,1590
80161129,80162011,chr4,RPSAP39,chr4:80161129-80162011,882
55868254,55950119,chr1,LINC01755,chr1:55868254-55950119,81865
13574227,13615158,chr6,SIRT5,chr6:13574227-13615158,40931
79587302,79588130,chr4,OR7E94P,chr4:79587302-79588130,828
79663761,79696837,chr4,LINC02469,chr4:79663761-79696837,33076
79827471,79877770,chr4,PCAT4,chr4:79827471-79877770,50299
133400056,133475222,chr3,BFSP2,chr3:133400056-133475222,75166
26859806,26860632,chr4,STIM2-AS1,chr4:26859806-26860632,826
2857680,2877174,chr12,FOXM1,chr12:2857680-2877174,19494
40750637,40765389,chr19,SNRPA,chr19:40750637-40765389,14752
26873561,26874349,chr4,PIMREGP4,chr4:26873561-26874349,788
60865259,61462788,chr1,NFIA,chr1:60865259-61462788,597529
79901146,80125454,chr4,ANTXR2,chr4:79901146-80125454,224308
36243203,36313955,chr6,PNPLA1,chr6:36243203-36313955,70752
55324203,55330756,chr16,IRX6,chr16:55324203-55330756,6553
111732497,111976517,chr3,PHLDB2,chr3:111732497-111976517,244020
142908101,142933746,chr7,TRPV5,chr7:142908101-142933746,25645
4796968,4802880,chr16,ROGDI,chr16:4796968-4802880,5912
186827475,186849208,chr2,ZSWIM2,chr2:186827475-186849208,21733
48180770,48255946,chr19,CARD8,chr19:48180770-48255946,75176
51681492,51721026,chr15,SCG3,chr15:51681492-51721026,39534
123066151,123073481,chr2,LINC01826,chr2:123066151-123073481,7330
214280638,214281452,chr2,RPL5P8,chr2:214280638-214281452,814
216859948,216871643,chr2,LINC01921,chr2:216859948-216871643,11695
130277184,130277957,chr2,MTCO3P7,chr2:130277184-130277957,773
132915557,132931494,chr2,NCKAP5-AS1,chr2:132915557-132931494,15937
210187126,210225447,chr2,ACADL,chr2:210187126-210225447,38321
32741391,32747198,chr6,HLA-DQA2,chr6:32741391-32747198,5807
142941114,142962363,chr7,KEL,chr7:142941114-142962363,21249
32749912,32749979,chr6,MIR3135B,chr6:32749912-32749979,67
32756098,32763532,chr6,HLA-DQB2,chr6:32756098-32763532,7434
49366584,49527425,chr12,SPATS2,chr12:49366584-49527425,160841
174923090,174923945,chr5,NIFKP2,chr5:174923090-174923945,855
129424782,129461076,chr5,ADAMTS19-AS1,chr5:129424782-129461076,36294
168706567,168720884,chr5,SLIT3-AS2,chr5:168706567-168720884,14317
32812763,32820466,chr6,HLA-DOB,chr6:32812763-32820466,7703
180899077,180950906,chr5,BTNL8,chr5:180899077-180950906,51829
180692104,180916939,chr2,SCHLAP1,chr2:180692104-180916939,224835
224378698,224402107,chr2,FAM124B,chr2:224378698-224402107,23409
51723011,51751585,chr15,LYSMD2,chr15:51723011-51751585,28574
104535749,104536856,chr9,OR13C3,chr9:104535749-104536856,1107
143629133,143656179,chr2,ARHGAP15-AS1,chr2:143629133-143656179,27046
137205685,137219361,chr9,NDOR1,chr9:137205685-137219361,13676
223704621,223705338,chr2,MLXP1,chr2:223704621-223705338,717
230690065,230700529,chr2,LINC01907,chr2:230690065-230700529,10464
143047213,143047580,chr7,OR9P1P,chr7:143047213-143047580,367
143062330,143063585,chr7,OR6W1P,chr7:143062330-143063585,1255
113005459,113008044,chr2,IL36A,chr2:113005459-113008044,2585
143132077,143139739,chr7,PIP,chr7:143132077-143139739,7662
33310962,33866121,chr15,RYR3,chr15:33310962-33866121,555159
53220663,53224253,chr1,CZIB-DT,chr1:53220663-53224253,3590
43709392,43727343,chr1,ST3GAL3-AS1,chr1:43709392-43727343,17951
27203508,27221768,chr16,KDM8,chr16:27203508-27221768,18260
32840717,32844679,chr6,PSMB8,chr6:32840717-32844679,3962
62194849,62212328,chr1,L1TD1,chr1:62194849-62212328,17479
142939343,142940868,chr7,LLCFC1,chr7:142939343-142940868,1525
181891730,181930738,chr2,ITPRID2,chr2:181891730-181930738,39008
123230120,123230741,chr7,LYPLA1P1,chr7:123230120-123230741,621
123452193,123535077,chr7,IQUB,chr7:123452193-123535077,82884
52020131,52055191,chr1,TXNDC12,chr1:52020131-52055191,35060
19737984,19748943,chr17,ALDH3A1,chr17:19737984-19748943,10959
4777606,4788398,chr16,SEPTIN12,chr16:4777606-4788398,10792
32844078,32846500,chr6,PSMB8-AS1,chr6:32844078-32846500,2422
126083659,126095349,chr3,SLC41A3-AS1,chr3:126083659-126095349,11690
166905222,166926370,chr5,LINC01947,chr5:166905222-166926370,21148
138347648,138405534,chr3,MRAS,chr3:138347648-138405534,57886
21509397,21578410,chr1,ALPL,chr1:21509397-21578410,69013
32844136,32859851,chr6,PSMB9,chr6:32844136-32859851,15715
38474668,38608354,chr5,LIFR,chr5:38474668-38608354,133686
123457988,123458094,chr7,RNU6-296P,chr7:123457988-123458094,106
123536997,123557904,chr7,NDUFA5,chr7:123536997-123557904,20907
111686053,111757107,chr12,ACAD10,chr12:111686053-111757107,71054
1049858,1057552,chr9,DMRT2,chr9:1049858-1057552,7694
32879171,32879848,chr6,PPP1R2P1,chr6:32879171-32879848,677
32896416,32896490,chr6,HLA-Z,chr6:32896416-32896490,74
73413515,73452297,chr6,CGAS,chr6:73413515-73452297,38782
58633946,58666834,chr3,FAM3D,chr3:58633946-58666834,32888
21663968,21761935,chr16,OTOA,chr16:21663968-21761935,97967
26087281,26098343,chr6,HFE,chr6:26087281-26098343,11062
49734641,49762379,chr10,OGDHL,chr10:49734641-49762379,27738
129036621,129072082,chr9,MIGA2,chr9:129036621-129072082,35461
40524878,40574685,chr3,ZNF621,chr3:40524878-40574685,49807
52050918,52052683,chr1,TXNDC12-AS1,chr1:52050918-52052683,1765
37956975,37990075,chr1,SF3A3,chr1:37956975-37990075,33100
128257909,128659185,chr5,FBN2,chr5:128257909-128659185,401276
123584859,123624957,chr7,ASB15-AS1,chr7:123584859-123624957,40098
126543947,126610948,chr11,KIRREL3-AS1,chr11:126543947-126610948,67001
10556966,10611689,chr11,LYVE1,chr11:10556966-10611689,54723
19770829,19867936,chr17,ULK2,chr17:19770829-19867936,97107
123655866,123664290,chr7,LMOD2,chr7:123655866-123664290,8424
123681943,123749003,chr7,WASL,chr7:123681943-123749003,67060
26070754,26104258,chr4,LINC02357,chr4:26070754-26104258,33504
49771841,49773299,chr10,MAPK6P6,chr10:49771841-49773299,1458
49815096,49815562,chr10,RPL21P89,chr10:49815096-49815562,466
26481396,26490484,chr4,CCKAR,chr4:26481396-26490484,9088
49942056,50011654,chr10,TIMM23B-AGAP6,chr10:49942056-50011654,69598
10751246,10801625,chr11,CTR9,chr11:10751246-10801625,50379
50305586,50625163,chr10,SGMS1,chr10:50305586-50625163,319577
141738249,141747560,chr3,RNF7,chr3:141738249-141747560,9311
123749068,123751166,chr7,WASL-DT,chr7:123749068-123751166,2098
123790605,123790711,chr7,RNU6-11P,chr7:123790605-123790711,106
123814139,123829252,chr7,HYAL6P,chr7:123814139-123829252,15113
55346213,55373100,chr4,SRD5A3,chr4:55346213-55373100,26887
123828983,123877481,chr7,HYAL4,chr7:123828983-123877481,48498
59131932,59296491,chr1,FGGY-DT,chr1:59131932-59296491,164559
142872356,142879846,chr8,CYP11B1,chr8:142872356-142879846,7490
24998847,25030946,chr4,LGI2,chr4:24998847-25030946,32099
125528858,125595497,chr3,OSBPL11,chr3:125528858-125595497,66639
4553386,4666674,chr9,SPATA6L,chr9:4553386-4666674,113288
100602363,100608175,chr7,PCOLCE,chr7:100602363-100608175,5812
62038842,62039111,chr1,LAMTOR5P1,chr1:62038842-62039111,269
55039447,55064852,chr1,PCSK9,chr1:55039447-55064852,25405
52393931,52406335,chr12,KRT82,chr12:52393931-52406335,12404
10797050,10808940,chr11,EIF4G2,chr11:10797050-10808940,11890
100612102,100615384,chr7,MOSPD3,chr7:100612102-100615384,3282
136148917,136197241,chr3,MSL2,chr3:136148917-136197241,48324
146837727,146878220,chr2,LINC01911,chr2:146837727-146878220,40493
25160641,25201440,chr4,SEPSECS-AS1,chr4:25160641-25201440,40799
25160663,25279204,chr4,PI4K2B,chr4:25160663-25279204,118541
75040077,75209839,chr12,KCNC2,chr12:75040077-75209839,169762
64078361,64087363,chr3,LINC00994,chr3:64078361-64087363,9002
50590652,50590712,chr10,RNU7-107P,chr10:50590652-50590712,60
50629532,50631075,chr10,SHQ1P1,chr10:50629532-50631075,1543
112524187,112525201,chr3,OR7E100P,chr3:112524187-112525201,1014
140902194,140902651,chr3,RPL23AP41,chr3:140902194-140902651,457
123067025,123225227,chr3,PDIA5,chr3:123067025-123225227,158202
87642607,87642954,chr10,RPS26P38,chr10:87642607-87642954,347
87659613,87747705,chr10,PAPSS2,chr10:87659613-87747705,88092
150552532,150572221,chr2,LINC01920,chr2:150552532-150572221,19689
55372710,55373316,chr1,MTCO2P34,chr1:55372710-55373316,606
105334027,105337475,chr2,C2orf49-DT,chr2:105334027-105337475,3448
65154480,65154650,chr1,RPS29P7,chr1:65154480-65154650,170
176338637,176339077,chr2,PPIAP67,chr2:176338637-176339077,440
143093056,143094164,chr2,MTCYBP11,chr2:143093056-143094164,1108
38474825,38516520,chr1,LINC01685,chr1:38474825-38516520,41695
25120014,25160550,chr4,SEPSECS,chr4:25120014-25160550,40536
195737703,196068837,chr2,DNAH7,chr2:195737703-196068837,331134
33473386,33513185,chr8,TTI2,chr8:33473386-33513185,39799
100620416,100642779,chr7,TFR2,chr7:100620416-100642779,22363
55938714,55939280,chr1,PIGQP1,chr1:55938714-55939280,566
54715861,54742657,chr1,TTC4,chr1:54715861-54742657,26796
31215962,31217135,chr16,PYDC1,chr16:31215962-31217135,1173
19840126,19840515,chr17,NDUFB4P3,chr17:19840126-19840515,389
30199228,30204310,chr16,SULT1A3,chr16:30199228-30204310,5082
39757182,39788865,chr1,BMP8B,chr1:39757182-39788865,31683
8797135,8797194,chr9,RNU7-185P,chr9:8797135-8797194,59
136946230,137011085,chr3,IL20RB,chr3:136946230-137011085,64855
71609599,71667725,chr12,ZFC3H1,chr12:71609599-71667725,58126
8858127,8864772,chr9,PTPRD-AS1,chr9:8858127-8864772,6645
87751512,87841361,chr10,ATAD1,chr10:87751512-87841361,89849
57618108,57618393,chr17,RN7SL449P,chr17:57618108-57618393,285
57685529,57685592,chr17,RNU7-134P,chr17:57685529-57685592,63
57744495,57745299,chr17,CCDC182,chr17:57744495-57745299,804
9090898,9091245,chr9,RPS26P3,chr9:9090898-9091245,347
9442060,9442380,chr9,RN7SL5P,chr9:9442060-9442380,320
57789449,57789732,chr17,RN7SKP94,chr17:57789449-57789732,283
44118821,44135140,chr1,KLF17,chr1:44118821-44135140,16319
57834781,57850056,chr17,MRPS23,chr17:57834781-57850056,15275
10613202,10620420,chr9,PTPRD-AS2,chr9:10613202-10620420,7218
65714334,65842322,chr8,PDE7A,chr8:65714334-65842322,127988
56494761,56645301,chr1,PLPP3,chr1:56494761-56645301,150540
92210207,92293854,chr9,IARS1,chr9:92210207-92293854,83647
18377778,18389647,chr17,EVPLL,chr17:18377778-18389647,11869
112561709,112585579,chr3,SLC35A5,chr3:112561709-112585579,23870
15469865,15601552,chr4,CC2D2A,chr4:15469865-15601552,131687
176006145,176007387,chr5,OR1X1P,chr5:176006145-176007387,1242
87267883,87391931,chr5,RASA1,chr5:87267883-87391931,124048
40230317,40285536,chr19,AKT2,chr19:40230317-40285536,55219
87817928,87845612,chr10,CFL1P1,chr10:87817928-87845612,27684
87832818,87833098,chr10,RN7SL78P,chr10:87832818-87833098,280
18393480,18400961,chr17,TBC1D3P4,chr17:18393480-18400961,7481
87859158,87863533,chr10,KLLN,chr10:87859158-87863533,4375
87945502,87946024,chr10,RPL11P3,chr10:87945502-87946024,522
37611350,37634892,chr1,RSPO1,chr1:37611350-37634892,23542
61901684,62096944,chr10,ARID5B,chr10:61901684-62096944,195260
18411159,18414380,chr17,LINC02076,chr17:18411159-18414380,3221
47781982,47832780,chr6,OPN5,chr6:47781982-47832780,50798
18415728,18425097,chr17,KRT17P5,chr17:18415728-18425097,9369
121987323,122022247,chr3,ILDR1,chr3:121987323-122022247,34924
18418195,18418306,chr17,YWHAEP2,chr17:18418195-18418306,111
18426861,18431848,chr17,KRT17P2,chr17:18426861-18431848,4987
73422259,73422696,chr10,RPL26P6,chr10:73422259-73422696,437
100643097,100656448,chr7,ACTL6B,chr7:100643097-100656448,13351
73423579,73433561,chr10,MSS51,chr10:73423579-73433561,9982
224703764,224716365,chr2,CCDC195,chr2:224703764-224716365,12601
182909115,183038858,chr2,NCKAP1,chr2:182909115-183038858,129743
96907224,96953780,chr12,NEDD1,chr12:96907224-96953780,46556
18432051,18442895,chr17,KRT16P1,chr17:18432051-18442895,10844
11242653,11243552,chr16,HNRNPCP4,chr16:11242653-11243552,899
37534449,37554293,chr1,SNIP1,chr1:37534449-37554293,19844
73436433,73496024,chr10,PPP3CB,chr10:73436433-73496024,59591
11249619,11381662,chr16,RMI2,chr16:11249619-11381662,132043
48149203,48150005,chr6,HNRNPA3P4,chr6:48149203-48150005,802
48213604,48214794,chr6,RBMXP1,chr6:48213604-48214794,1190
135195083,135195995,chr6,MYB-AS1,chr6:135195083-135195995,912
135239160,135239256,chr6,MIR548A2,chr6:135239160-135239256,96
18450244,18475920,chr17,KRT16P4,chr17:18450244-18475920,25676
100673567,100679174,chr7,GNB2,chr7:100673567-100679174,5607
18460391,18463055,chr17,TNPO1P2,chr17:18460391-18463055,2664
133245603,133257207,chr3,TMEM108-AS1,chr3:133245603-133257207,11604
52772194,52772648,chr1,RPS13P2,chr1:52772194-52772648,454
11267748,11269533,chr16,TNP2,chr16:11267748-11269533,1785
56585612,56586242,chr1,RPL23AP85,chr1:56585612-56586242,630
64984608,64986087,chr1,SLC2A3P2,chr1:64984608-64986087,1479
109701456,109702218,chr3,DIMT1P1,chr3:109701456-109702218,762
18476737,18494945,chr17,LGALS9C,chr17:18476737-18494945,18208
23878981,23879498,chr3,ARL4AP4,chr3:23878981-23879498,517
10801467,10801608,chr11,SNORD97,chr11:10801467-10801608,141
138434586,138481686,chr3,ESYT3,chr3:138434586-138481686,47100
11273199,11273629,chr16,PRM3,chr16:11273199-11273629,430
10812074,10858796,chr11,ZBED5,chr11:10812074-10858796,46722
11275639,11276480,chr16,PRM2,chr16:11275639-11276480,841
53196792,53214197,chr1,CPT2,chr1:53196792-53214197,17405
135283407,135498434,chr6,AHI1,chr6:135283407-135498434,215027
17497088,17570573,chr8,SLC7A2,chr8:17497088-17570573,73485
11280841,11281330,chr16,PRM1,chr16:11280841-11281330,489
11020883,11183611,chr11,LINC02752,chr11:11020883-11183611,162728
11306440,11306527,chr16,MIR548H2,chr16:11306440-11306527,87
7970251,8001862,chr11,EIF3F,chr11:7970251-8001862,31611
42176539,42335877,chr1,FOXJ3,chr1:42176539-42335877,159338
100486646,100519864,chr10,SEC31B,chr10:100486646-100519864,33218
11668455,11679152,chr16,SNN,chr16:11668455-11679152,10697
136336236,136752403,chr3,STAG1,chr3:136336236-136752403,416167
81016792,81035759,chr16,CENPN-AS1,chr16:81016792-81035759,18967
120936102,120936654,chr11,HMGB1P42,chr11:120936102-120936654,552
121024125,121113108,chr11,TBCEL-TECTA,chr11:121024125-121113108,88983
30009730,30017030,chr11,KCNA4,chr11:30009730-30017030,7300
81035842,81047350,chr16,ATMIN,chr16:81035842-81047350,11508
30231014,30235261,chr11,FSHB,chr11:30231014-30235261,4247
64206678,64223891,chr11,FERMT3,chr11:64206678-64223891,17213
114442299,115845780,chr2,DPP10,chr2:114442299-115845780,1403481
81081945,81096395,chr16,GCSH,chr16:81081945-81096395,14450
18497095,18506313,chr17,NOS2P2,chr17:18497095-18506313,9218
18527557,18528461,chr17,SRP68P2,chr17:18527557-18528461,904
180945756,180945907,chr5,RPS29P12,chr5:180945756-180945907,151
18634247,18644427,chr17,TBC1D28,chr17:18634247-18644427,10180
176880869,176899346,chr5,HK3,chr5:176880869-176899346,18477
100706121,100707486,chr7,POP7,chr7:100706121-100707486,1365
100720468,100723700,chr7,EPO,chr7:100720468-100723700,3232
89933331,90003228,chr8,NBN,chr8:89933331-90003228,69897
53046969,53064379,chr12,TNS2,chr12:53046969-53064379,17410
64223799,64226254,chr11,TRPT1,chr11:64223799-64226254,2455
140314163,140314550,chr4,NDUFB4P9,chr4:140314163-140314550,387
140366240,140366861,chr4,RPL14P3,chr4:140366240-140366861,621
100733595,100797797,chr7,ZAN,chr7:100733595-100797797,64202
140388453,140427661,chr4,CLGN,chr4:140388453-140427661,39208
18677261,18677757,chr17,UBE2SP2,chr17:18677261-18677757,496
52408282,52553487,chr1,TUT4,chr1:52408282-52553487,145205
81100875,81220370,chr16,PKD1L2,chr16:81100875-81220370,119495
180684766,180686546,chr5,LINC02222,chr5:180684766-180686546,1780
18744026,18779349,chr17,FBXW10,chr17:18744026-18779349,35323
149348116,149357642,chr5,GRPEL2-AS1,chr5:149348116-149357642,9526
178694605,178697695,chr5,MSANTD5,chr5:178694605-178697695,3090
154941073,154969411,chr5,MRPL22,chr5:154941073-154969411,28338
140442262,140498377,chr4,MGAT4D,chr4:140442262-140498377,56115
100523740,100530000,chr10,NDUFB8,chr10:100523740-100530000,6260
110289233,110738956,chr5,TMEM232,chr5:110289233-110738956,449723
108472112,108498384,chr11,POGLUT3,chr11:108472112-108498384,26272
18781111,18806714,chr17,TVP23B,chr17:18781111-18806714,25603
140524168,140553770,chr4,ELMOD2,chr4:140524168-140553770,29602
208266255,208358746,chr2,PIKFYVE,chr2:208266255-208358746,92491
100529072,100559998,chr10,HIF1AN,chr10:100529072-100559998,30926
64269830,64284704,chr11,BAD,chr11:64269830-64284704,14874
140559431,140568961,chr4,UCP1,chr4:140559431-140568961,9530
125310881,125311350,chr3,DUTP1,chr3:125310881-125311350,469
113747033,113812056,chr3,ATP6V1A,chr3:113747033-113812056,65023
64305497,64316743,chr11,ESRRA,chr11:64305497-64316743,11246
100157906,100259278,chr8,SPAG1,chr8:100157906-100259278,101372
140577925,140578222,chr4,RN7SL152P,chr4:140577925-140578222,297
100735396,100829944,chr10,PAX2,chr10:100735396-100829944,94548
140641840,140645489,chr4,TNRC18P1,chr4:140641840-140645489,3649
38966744,39032922,chr4,TMEM156,chr4:38966744-39032922,66178
157266079,157395595,chr5,CYFIP2,chr5:157266079-157395595,129516
18840618,18840920,chr17,RN7SL627P,chr17:18840618-18840920,302
18511262,18521252,chr17,USP32P2,chr17:18511262-18521252,9990
18511221,18551705,chr17,FAM106A,chr17:18511221-18551705,40484
109673843,109674124,chr4,HIGD1AP14,chr4:109673843-109674124,281
109688622,109703583,chr4,CASP6,chr4:109688622-109703583,14961
34092561,34093310,chr19,RPS4XP21,chr19:34092561-34093310,749
34542462,34545395,chr19,ZNF807P,chr19:34542462-34545395,2933
35629030,35637686,chr19,RBM42,chr19:35629030-35637686,8656
81106533,81106639,chr16,RNU6-1191P,chr16:81106533-81106639,106
88176502,88176593,chr11,MIR3166,chr11:88176502-88176593,91
88408179,88409223,chr11,GAPDHP70,chr11:88408179-88409223,1044
81238689,81291142,chr16,BCO1,chr16:81238689-81291142,52453
88504576,88524054,chr11,GRM5-AS1,chr11:88504576-88524054,19478
7549058,7557890,chr17,TNFSF12,chr17:7549058-7557890,8832
75370448,75371342,chr3,OR7E55P,chr3:75370448-75371342,894
73621713,73626796,chr3,PDZRN3-AS1,chr3:73621713-73626796,5083
88265069,88359684,chr11,CTSC,chr11:88265069-88359684,94615
42752620,42796392,chr8,CHRNA6,chr8:42752620-42796392,43772
145684572,145685092,chr3,GM2AP1,chr3:145684572-145685092,520
141865012,141865279,chr3,HMGN2P25,chr3:141865012-141865279,267
100802565,100827523,chr7,EPHB4,chr7:100802565-100827523,24958
109709989,109730070,chr4,PLA2G12A,chr4:109709989-109730070,20081
123490820,123585053,chr3,HACD2,chr3:123490820-123585053,94233
64745095,64833232,chr1,RAVER2,chr1:64745095-64833232,88137
81385018,81385093,chr16,MIR4720,chr16:81385018-81385093,75
111633672,111635089,chr3,NT5C3AP2,chr3:111633672-111635089,1417
81476023,81476519,chr16,PPIAP51,chr16:81476023-81476519,496
71771655,71785206,chr3,PROK2,chr3:71771655-71785206,13551
79611117,79666158,chr8,STMN2,chr8:79611117-79666158,55041
81533902,81533966,chr16,MIR7854,chr16:81533902-81533966,64
81611348,81611408,chr16,MIR6504,chr16:81611348-81611408,60
109815047,109815410,chr4,GAR1-DT,chr4:109815047-109815410,363
70010751,70065945,chr16,PDXDC2P,chr16:70010751-70065945,55194
7549099,7561601,chr17,TNFSF12-TNFSF13,chr17:7549099-7561601,12502
109815510,109824740,chr4,GAR1,chr4:109815510-109824740,9230
40593633,40594353,chr1,GTF2F2P2,chr1:40593633-40594353,720
44137821,44141631,chr1,KLF18,chr1:44137821-44141631,3810
58575433,58577252,chr1,TACSTD2,chr1:58575433-58577252,1819
120392293,120450993,chr3,FSTL1,chr3:120392293-120450993,58700
63322567,63325128,chr1,FOXD3,chr1:63322567-63325128,2561
70030346,70030422,chr16,MIR1972-2,chr16:70030346-70030422,76
100912963,100965134,chr10,SLF2,chr10:100912963-100965134,52171
70114332,70162537,chr16,PDPR,chr16:70114332-70162537,48205
113221544,113264492,chr9,SLC31A1,chr9:113221544-113264492,42948
62190522,62190926,chr1,RPS15AP7,chr1:62190522-62190926,404
51707138,51708137,chr1,GAPDHP51,chr1:51707138-51708137,999
47688463,47704029,chr1,LINC01738,chr1:47688463-47704029,15566
7561919,7571969,chr17,SENP3,chr17:7561919-7571969,10050
61741998,61742424,chr1,PATJ-DT,chr1:61741998-61742424,426
69215835,69249477,chr1,LINC02791,chr1:69215835-69249477,33642
46994382,46994502,chr1,CYP4A43P,chr1:46994382-46994502,120
109827972,109849123,chr4,RRH,chr4:109827972-109849123,21151
113255835,113275572,chr9,CDC26,chr9:113255835-113275572,19737
214411054,214578976,chr2,VWC2L,chr2:214411054-214578976,167922
63159083,63317274,chr1,LINC00466,chr1:63159083-63317274,158191
113275642,113294009,chr9,PRPF4,chr9:113275642-113294009,18367
57227726,57278105,chr3,APPL1,chr3:57227726-57278105,50379
1554051,1572271,chr11,DUSP8,chr11:1554051-1572271,18220
109848107,109872315,chr4,LRIT3,chr4:109848107-109872315,24208
11769639,11787345,chr8,NEIL2,chr8:11769639-11787345,17706
32581190,32587453,chr19,PDCD5,chr19:32581190-32587453,6263
1571353,1599184,chr11,KRTAP5-AS1,chr11:1571353-1599184,27831
120013077,120179119,chr2,EPB41L5,chr2:120013077-120179119,166042
109879070,109879897,chr4,KRT19P3,chr4:109879070-109879897,827
100821027,100821264,chr7,RN7SL750P,chr7:100821027-100821264,237
1584342,1585283,chr11,KRTAP5-1,chr11:1584342-1585283,941
1597177,1598294,chr11,KRTAP5-2,chr11:1597177-1598294,1117
99511012,99542303,chr4,C4orf17,chr4:99511012-99542303,31291
1607565,1608463,chr11,KRTAP5-3,chr11:1607565-1608463,898
100826820,100867010,chr7,SLC12A9,chr7:100826820-100867010,40190
1629775,1630707,chr11,KRTAP5-5,chr11:1629775-1630707,932
1665597,1667856,chr11,FAM99A,chr11:1665597-1667856,2259
1683269,1685629,chr11,FAM99B,chr11:1683269-1685629,2360
1688297,1689056,chr11,LINC02708,chr11:1688297-1689056,759
1697195,1697755,chr11,KRTAP5-6,chr11:1697195-1697755,560
1732406,1750595,chr11,IFITM10,chr11:1732406-1750595,18189
61248945,61253510,chr1,NFIA-AS1,chr1:61248945-61253510,4565
43330672,43354569,chr15,ADAL,chr15:43330672-43354569,23897
100969518,100985871,chr10,SEMA4G,chr10:100969518-100985871,16353
7563287,7578715,chr17,SENP3-EIF4A1,chr17:7563287-7578715,15428
53226900,53238518,chr1,MAGOH,chr1:53226900-53238518,11618
7574713,7574847,chr17,SNORA48,chr17:7574713-7574847,134
7576811,7576952,chr17,SNORD10,chr17:7576811-7576952,141
99564081,99623997,chr4,MTTP,chr4:99564081-99623997,59916
7577955,7578091,chr17,SNORA67,chr17:7577955-7578091,136
68496676,68538627,chr1,DEPDC1-AS1,chr1:68496676-68538627,41951
7579491,7582111,chr17,CD68,chr17:7579491-7582111,2620
74234700,74321540,chr8,JPH1,chr8:74234700-74321540,86840
55226638,55228784,chr19,TMEM86B,chr19:55226638-55228784,2146
69055838,69229607,chr1,LINC01707,chr1:69055838-69229607,173769
113297093,113303376,chr9,RNF183,chr9:113297093-113303376,6283
1752752,1764573,chr11,CTSD,chr11:1752752-1764573,11821
70219574,70246612,chr16,SMG1P7,chr16:70219574-70246612,27038
1021522,1021628,chr19,RNU6-2,chr19:1021522-1021628,106
145456005,145456844,chr4,NMNAT1P4,chr4:145456005-145456844,839
48096092,48182428,chr1,SKINT1L,chr1:48096092-48182428,86336
71973,72110,chr19,MIR1302-11,chr19:71973-72110,137
893484,893590,chr19,RNU6-9,chr19:893484-893590,106
223158,223261,chr19,RNU6-1076P,chr19:223158-223261,103
2595019,2595291,chr19,RN7SL121P,chr19:2595019-2595291,272
2630715,2630793,chr19,MIR7850,chr19:2630715-2630793,78
145481194,145559176,chr4,SMAD1,chr4:145481194-145559176,77982
1616492,1616595,chr19,RNU6-1223P,chr19:1616492-1616595,103
2503047,2503141,chr19,RNU6-993P,chr19:2503047-2503141,94
4932687,4932740,chr19,MIR4747,chr19:4932687-4932740,53
4770670,4770779,chr19,MIR7-3,chr19:4770670-4770779,109
10403458,10403538,chr19,MIR1181,chr19:10403458-10403538,80
113313222,113340298,chr9,WDR31,chr9:113313222-113340298,27076
15145215,15145318,chr19,RNU6-782P,chr19:15145215-15145318,103
15449548,15449608,chr19,MIR1470,chr19:15449548-15449608,60
63597353,63602428,chr15,FBXL22,chr15:63597353-63602428,5075
16539688,16539984,chr19,RN7SL146P,chr19:16539688-16539984,296
63547082,63550636,chr1,DLEU2L,chr1:63547082-63550636,3554
18957957,18958258,chr19,RN7SL70P,chr19:18957957-18958258,301
19435063,19435158,chr19,MIR640,chr19:19435063-19435158,95
74548543,74548617,chr8,MIR5681A,chr8:74548543-74548617,74
19232855,19232947,chr19,RNU6-1028P,chr19:19232855-19232947,92
74548550,74548609,chr8,MIR5681B,chr8:74548550-74548609,59
20399272,20399354,chr19,MIR1270,chr19:20399272-20399354,82
74599775,74823313,chr8,MIR2052HG,chr8:74599775-74823313,223538
17862588,17862720,chr19,SNORA68,chr19:17862588-17862720,132
21113128,21113236,chr19,RNA5SP469,chr19:21113128-21113236,108
70246778,70251940,chr16,EXOSC6,chr16:70246778-70251940,5162
29001670,29001775,chr19,RNA5SP470,chr19:29001670-29001775,105
50960745,50974634,chr1,CDKN2C,chr1:50960745-50974634,13889
22555261,22555367,chr19,RNU6-1179P,chr19:22555261-22555367,106
7583529,7592789,chr17,MPDU1,chr17:7583529-7592789,9260
22601485,22601707,chr19,RN7SL860P,chr19:22601485-22601707,222
24004358,24004507,chr19,RNA5-8SP4,chr19:24004358-24004507,149
70276069,70276352,chr16,RN7SL279P,chr16:70276069-70276352,283
29233090,29233385,chr19,RN7SL340P,chr19:29233090-29233385,295
31787148,31787255,chr19,RNU6-967P,chr19:31787148-31787255,107
31655356,31655461,chr19,RNA5SP471,chr19:31655356-31655461,105
33927364,33927625,chr19,RN7SL150P,chr19:33927364-33927625,261
68054309,68198603,chr15,PIAS1,chr15:68054309-68198603,144294
32608337,32608469,chr19,SNORA68B,chr19:32608337-32608469,132
32655016,32655308,chr19,RN7SL789P,chr19:32655016-32655308,292
32243965,32244083,chr19,RNA5SP472,chr19:32243965-32244083,118
113648385,113696646,chr3,USF3,chr3:113648385-113696646,48261
34421988,34422311,chr19,RN7SL154P,chr19:34421988-34422311,323
35345513,35345627,chr19,MIR5196,chr19:35345513-35345627,114
70289663,70335305,chr16,DDX19B,chr16:70289663-70335305,45642
35414881,35415149,chr19,RN7SL491P,chr19:35414881-35415149,268
32862800,32863092,chr19,RN7SKP22,chr19:32862800-32863092,292
74603244,74604244,chr8,PCBP2P2,chr8:74603244-74604244,1000
40299478,40299584,chr19,RNU6-945P,chr19:40299478-40299584,106
40282543,40282641,chr19,MIR641,chr19:40282543-40282641,98
74705693,74705747,chr8,MIR2052,chr8:74705693-74705747,54
41869627,41869698,chr19,MIR6797,chr19:41869627-41869698,71
43660500,43660776,chr19,RN7SL368P,chr19:43660500-43660776,276
45436654,45436704,chr19,MIR6088,chr19:45436654-45436704,50
17801345,17861069,chr8,MTUS1-DT,chr8:17801345-17861069,59724
44653686,44653732,chr19,MIR4531,chr19:44653686-44653732,46
45047458,45047561,chr19,RNU6-611P,chr19:45047458-45047561,103
46306470,46306577,chr19,RNU6-924P,chr19:46306470-46306577,107
45638994,45639087,chr19,MIR330,chr19:45638994-45639087,93
47226942,47227021,chr19,MIR3190,chr19:47226942-47227021,79
47226944,47227019,chr19,MIR3191,chr19:47226944-47227019,75
44758657,44758721,chr19,MIR8085,chr19:44758657-44758721,64
49308797,49308868,chr19,MIR4324,chr19:49308797-49308868,71
52281797,52281893,chr19,MIR643,chr19:52281797-52281893,96
52222020,52222098,chr19,MIR6801,chr19:52222020-52222098,78
54868939,54869045,chr19,RNU6-222P,chr19:54868939-54869045,106
54645309,54645383,chr19,MIR8061,chr19:54645309-54645383,74
55123225,55123292,chr19,MIR7975,chr19:55123225-55123292,67
137764315,137766334,chr3,SOX14,chr3:137764315-137766334,2019
55230885,55230952,chr19,MIR6804,chr19:55230885-55230952,67
55239912,55239976,chr19,MIR6802,chr19:55239912-55239976,64
17864380,17910365,chr8,FGL1,chr8:17864380-17910365,45985
58386770,58386858,chr19,MIR4754,chr19:58386770-58386858,88
55245186,55245250,chr19,MIR6803,chr19:55245186-55245250,64
58483749,58483843,chr19,RNU6-1337P,chr19:58483749-58483843,94
58490797,58491075,chr19,RN7SL693P,chr19:58490797-58491075,278
58334688,58334751,chr19,MIR6806,chr19:58334688-58334751,63
150870376,150905439,chr3,MINDY4B,chr3:150870376-150905439,35063
58363438,58363562,chr19,RNA5SP473,chr19:58363438-58363562,124
100867387,100873454,chr7,TRIP6,chr7:100867387-100873454,6067
19338775,19485539,chr1,CAPZB,chr1:19338775-19485539,146764
145497073,145502971,chr4,SMAD1-AS2,chr4:145497073-145502971,5898
145514615,145517118,chr4,SMAD1-AS1,chr4:145514615-145517118,2503
39083913,39111493,chr19,ACP7,chr19:39083913-39111493,27580
145624159,145626035,chr4,NCOA4P3,chr4:145624159-145626035,1876
145680146,145771032,chr4,C4orf51,chr4:145680146-145771032,90886
113349541,113371233,chr9,BSPRY,chr9:113349541-113371233,21692
63423596,63550051,chr3,SYNPR-AS1,chr3:63423596-63550051,126455
138123713,138132390,chr3,A4GNT,chr3:138123713-138132390,8677
145599042,145660033,chr4,MMAA,chr4:145599042-145660033,60991
113373419,113376986,chr9,HDHD3,chr9:113373419-113376986,3567
111478737,111478943,chr3,ATP6V0CP2,chr3:111478737-111478943,206
150150538,150150944,chr3,RPL32P9,chr3:150150538-150150944,406
130167790,130168030,chr3,ENPP7P3,chr3:130167790-130168030,240
113386312,113401290,chr9,ALAD,chr9:113386312-113401290,14978
117678693,117691005,chr3,LINC02024,chr3:117678693-117691005,12312
39125770,39182816,chr19,PAK4,chr19:39125770-39182816,57046
98390666,98391631,chr3,OR5K3,chr3:98390666-98391631,965
141918252,141919021,chr3,ATP1B3-AS1,chr3:141918252-141919021,769
149738472,149752495,chr3,COMMD2,chr3:149738472-149752495,14023
100974985,100975084,chr10,MIR608,chr10:100974985-100975084,99
100987367,100994403,chr10,TWNK,chr10:100987367-100994403,7036
630858,664196,chr12,NINJ2-AS1,chr12:630858-664196,33338
109740694,109801999,chr4,CFI,chr4:109740694-109801999,61305
100868036,100868107,chr7,MIR6875,chr7:100868036-100868107,71
100875103,100888664,chr7,SRRT,chr7:100875103-100888664,13561
674801,684127,chr12,LINC02455,chr12:674801-684127,9326
781133,781258,chr12,RNU4ATAC16P,chr12:781133-781258,125
170601662,170602228,chr2,HMGB1P4,chr2:170601662-170602228,566
66435075,66466738,chr11,MRPL11,chr11:66435075-66466738,31663
216081866,216102783,chr2,TMEM169,chr2:216081866-216102783,20917
911736,990053,chr12,RAD52,chr12:911736-990053,78317
113407235,113410675,chr9,POLE3,chr9:113407235-113410675,3440
65319563,65670495,chr4,EPHA5,chr4:65319563-65670495,350932
111070071,111275563,chr3,NECTIN3,chr3:111070071-111275563,205492
65234460,65300618,chr15,PARP16,chr15:65234460-65300618,66158
18055992,18084998,chr8,ASAH1,chr8:18055992-18084998,29006
113410054,113429690,chr9,C9orf43,chr9:113410054-113429690,19636
138601599,138617469,chr2,LINC02631,chr2:138601599-138617469,15870
100996618,101007836,chr10,LZTS2,chr10:100996618-101007836,11218
66466327,66477337,chr11,PELI3,chr11:66466327-66477337,11010
167123904,167140955,chr2,XIRP2-AS1,chr2:167123904-167140955,17051
153370612,153371064,chr2,RPL23AP29,chr2:153370612-153371064,452
39196964,39201884,chr19,NCCRP1,chr19:39196964-39201884,4920
42158701,42208307,chr15,VPS39,chr15:42158701-42208307,49606
161096231,161160224,chr2,TANK-AS1,chr2:161096231-161160224,63993
195994259,195995680,chr2,E2F3P2,chr2:195994259-195995680,1421
39236433,39237293,chr19,IFNL3P1,chr19:39236433-39237293,860
39254916,39255269,chr19,MSRB1P1,chr19:39254916-39255269,353
179101678,179264832,chr2,SESTD1,chr2:179101678-179264832,163154
39264382,39265817,chr19,IFNL4P1,chr19:39264382-39265817,1435
118943073,118948241,chr3,IGSF11-AS1,chr3:118943073-118948241,5168
39296407,39298673,chr19,IFNL1,chr19:39296407-39298673,2266
111674676,111846447,chr3,PLCXD2,chr3:111674676-111846447,171771
152936323,152979671,chr4,FHDC1,chr4:152936323-152979671,43348
101007679,101032295,chr10,PDZD7,chr10:101007679-101032295,24616
53328233,53336509,chr1,LINC01771,chr1:53328233-53336509,8276
10829752,10830308,chr9,IMP3P1,chr9:10829752-10830308,556
61789143,61789426,chr9,RN7SL722P,chr9:61789143-61789426,283
68375327,68375663,chr1,ELOCP18,chr1:68375327-68375663,336
61854148,62096920,chr9,FAM27C,chr9:61854148-62096920,242772
39328353,39342372,chr19,GMFG,chr19:39328353-39342372,14019
59987269,60073770,chr1,C1orf87,chr1:59987269-60073770,86501
182890060,182917936,chr4,DCTD,chr4:182890060-182917936,27876
64092236,64445476,chr3,PRICKLE2,chr3:64092236-64445476,353240
7588178,7590094,chr17,SOX15,chr17:7588178-7590094,1916
7591230,7614897,chr17,FXR2,chr17:7591230-7614897,23667
61898805,61911022,chr9,FAM242E,chr9:61898805-61911022,12217
194129354,194130266,chr2,GLULP6,chr2:194129354-194130266,912
66510606,66533613,chr11,BBS1,chr11:66510606-66533613,23007
143094233,143094715,chr2,MTND6P11,chr2:143094233-143094715,482
45016399,45306209,chr1,ZSWIM5,chr1:45016399-45306209,289810
67717411,67719178,chr9,FAM27E3,chr9:67717411-67719178,1767
180872867,180873414,chr2,FTH1P20,chr2:180872867-180873414,547
67725690,67725902,chr9,FAM27B,chr9:67725690-67725902,212
130251568,130252559,chr2,MED15P5,chr2:130251568-130252559,991
101061989,101068131,chr10,KAZALD1,chr10:101061989-101068131,6142
67791499,67791782,chr9,RN7SL787P,chr9:67791499-67791782,283
67832765,67920552,chr9,ANKRD20A1,chr9:67832765-67920552,87787
112736447,112749319,chr3,LINC02042,chr3:112736447-112749319,12872
126656133,126696667,chr2,GYPC,chr2:126656133-126696667,40534
68635705,68637024,chr3,PSMC1P1,chr3:68635705-68637024,1319
148076432,148089134,chr3,LINC02032,chr3:148076432-148089134,12702
159448556,159466291,chr5,LINC01845,chr5:159448556-159466291,17735
113142350,113167819,chr3,LINC02044,chr3:113142350-113167819,25469
127537937,127540485,chr3,LINC02034,chr3:127537937-127540485,2548
149463779,149464114,chr3,FKBP1AP4,chr3:149463779-149464114,335
116360024,116370090,chr3,LSAMP-AS1,chr3:116360024-116370090,10066
157081738,157088547,chr3,LINC02029,chr3:157081738-157088547,6809
58415384,58546802,chr1,OMA1,chr1:58415384-58546802,131418
89283694,89309271,chr10,IFIT2,chr10:89283694-89309271,25577
126531200,126595362,chr5,ALDH7A1,chr5:126531200-126595362,64162
113588748,113590189,chr3,SIDT1-AS1,chr3:113588748-113590189,1441
145824257,145824739,chr3,RPL21P39,chr3:145824257-145824739,482
136959125,136982196,chr3,IL20RB-AS1,chr3:136959125-136982196,23071
112133423,112135359,chr3,TBILA,chr3:112133423-112135359,1936
28289258,28289350,chr10,MIR8086,chr10:28289258-28289350,92
28303300,28307658,chr10,MPP7-DT,chr10:28303300-28307658,4358
28338554,28340942,chr10,ZNF101P1,chr10:28338554-28340942,2388
152389937,152390630,chr2,NUDCP1,chr2:152389937-152390630,693
28433008,28495813,chr10,LINC02652,chr10:28433008-28495813,62805
28436201,28437078,chr10,RPSAP10,chr10:28436201-28437078,877
130539095,130549883,chr2,PRSS40B,chr2:130539095-130549883,10788
28442575,28442896,chr10,RN7SKP39,chr10:28442575-28442896,321
28522652,28533066,chr10,WAC-AS1,chr10:28522652-28533066,10414
7613946,7633382,chr17,SHBG,chr17:7613946-7633382,19436
214847128,214847445,chr2,RPL10P6,chr2:214847128-214847445,317
196260024,196264204,chr2,HECW2-AS1,chr2:196260024-196264204,4180
146706617,146945882,chr4,TTC29,chr4:146706617-146945882,239265
39369153,39369448,chr19,RN7SL566P,chr19:39369153-39369448,295
147393422,147510293,chr3,ZIC1,chr3:147393422-147510293,116871
39385629,39391154,chr19,PAF1,chr19:39385629-39391154,5525
67869947,67870053,chr9,RNU6-368P,chr9:67869947-67870053,106
143094789,143096555,chr2,MTND5P24,chr2:143094789-143096555,1766
28532493,28623112,chr10,WAC,chr10:28532493-28623112,90619
131647990,131767404,chr2,C2orf27A,chr2:131647990-131767404,119414
20658309,20995955,chr9,FOCAD,chr9:20658309-20995955,337646
66999350,67054148,chr1,SLC35D1,chr1:66999350-67054148,54798
140505611,140508789,chr3,CLSTN2-AS1,chr3:140505611-140508789,3178
193256483,193257757,chr2,SLC44A3P1,chr2:193256483-193257757,1274
214510196,214536890,chr2,VWC2L-IT1,chr2:214510196-214536890,26694
88494440,88546681,chr15,DET1,chr15:88494440-88546681,52241
128064778,128153914,chr3,RUVBL1,chr3:128064778-128153914,89136
241776822,241804287,chr2,GAL3ST2,chr2:241776822-241804287,27465
6976185,7018477,chr12,LPCAT3,chr12:6976185-7018477,42292
53073110,53073389,chr1,HIGD1AP11,chr1:53073110-53073389,279
160099667,160200313,chr2,ITGB6,chr2:160099667-160200313,100646
108620569,108630412,chr4,RPL34,chr4:108620569-108630412,9843
24823637,24978723,chr15,SNRPN,chr15:24823637-24978723,155086
100888721,100889715,chr7,UFSP1,chr7:100888721-100889715,994
70315442,70346806,chr16,DDX19A-DT,chr16:70315442-70346806,31364
100906291,100906572,chr7,RN7SL549P,chr7:100906291-100906572,281
100928370,100928540,chr7,RPS29P15,chr7:100928370-100928540,170
39391303,39400641,chr19,MED29,chr19:39391303-39400641,9338
100679507,100694250,chr7,GIGYF1,chr7:100679507-100694250,14743
53242364,53328469,chr1,LRP8,chr1:53242364-53328469,86105
127965306,128039953,chr4,ABHD18,chr4:127965306-128039953,74647
70346861,70373383,chr16,DDX19A,chr16:70346861-70373383,26522
39406847,39409412,chr19,ZFP36,chr19:39406847-39409412,2565
39409623,39409678,chr19,MIR4530,chr19:39409623-39409678,55
39412669,39428415,chr19,PLEKHG2,chr19:39412669-39428415,15746
78776342,78916365,chr4,BMP2K,chr4:78776342-78916365,140023
143176327,143177617,chr3,PBX2P1,chr3:143176327-143177617,1290
136609050,136609602,chr3,HMGN1P10,chr3:136609050-136609602,552
151873643,151884619,chr3,SUCNR1,chr3:151873643-151884619,10976
120596328,120602507,chr3,NDUFB4,chr3:120596328-120602507,6179
7080214,7092540,chr12,C1R,chr12:7080214-7092540,12326
66520637,66546235,chr11,ZDHHC24,chr11:66520637-66546235,25598
138494344,138594538,chr3,CEP70,chr3:138494344-138594538,100194
6329411,6348981,chr7,FAM220A,chr7:6329411-6348981,19570
140257286,140385728,chr4,SCOC,chr4:140257286-140385728,128442
6365441,6365770,chr7,RPSAP73,chr7:6365441-6365770,329
66546395,66563334,chr11,ACTN3,chr11:66546395-66563334,16939
6374527,6403967,chr7,RAC1,chr7:6374527-6403967,29440
20999509,21031640,chr9,HACD4,chr9:20999509-21031640,32131
24630954,24634267,chr14,GZMB,chr14:24630954-24634267,3313
21058771,21059323,chr9,IFNNP1,chr9:21058771-21059323,552
21077104,21077942,chr9,IFNB1,chr9:21077104-21077942,838
21106543,21106836,chr9,IFNWP4,chr9:21106543-21106836,293
26857601,27025381,chr4,STIM2,chr4:26857601-27025381,167780
21140632,21141832,chr9,IFNW1,chr9:21140632-21141832,1200
21165637,21166660,chr9,IFNA21,chr9:21165637-21166660,1023
39433137,39435949,chr19,RPS16,chr19:39433137-39435949,2812
32551144,32568621,chr9,SMIM27,chr9:32551144-32568621,17477
70375977,70439237,chr16,ST3GAL2,chr16:70375977-70439237,63260
6409126,6484190,chr7,DAGLB,chr7:6409126-6484190,75064
136440096,136483759,chr9,SEC16A,chr9:136440096-136483759,43663
63761899,64226433,chr14,SYNE2,chr14:63761899-64226433,464534
70444674,70444912,chr16,RPS27P26,chr16:70444674-70444912,238
39436156,39476670,chr19,SUPT5H,chr19:39436156-39476670,40514
70445293,70445399,chr16,RNU6-23P,chr16:70445293-70445399,106
47354860,47378547,chr11,SPI1,chr11:47354860-47378547,23687
194187379,194188309,chr2,HNRNPA1P47,chr2:194187379-194188309,930
70454595,70480274,chr16,FCSK,chr16:70454595-70480274,25679
187001876,187003377,chr2,IMPDH1P7,chr2:187001876-187003377,1501
156011530,156254950,chr2,LINC01876,chr2:156011530-156254950,243420
87674860,87702233,chr6,AKIRIN2,chr6:87674860-87702233,27373
87845650,87845947,chr6,RN7SL183P,chr6:87845650-87845947,297
47400970,47401042,chr11,MIR4487,chr11:47400970-47401042,72
88047841,88066838,chr6,SPACA1,chr6:88047841-88066838,18997
120211727,120212862,chr2,MTCO3P43,chr2:120211727-120212862,1135
47407132,47416496,chr11,SLC39A13,chr11:47407132-47416496,9364
129939848,129940217,chr2,RPL22P7,chr2:129939848-129940217,369
210290150,210315174,chr2,MYL1,chr2:210290150-210315174,25024
7188685,7218574,chr12,PEX5,chr12:7188685-7218574,29889
88275882,88276989,chr6,ACTBP8,chr6:88275882-88276989,1107
6445953,6484190,chr7,KDELR2,chr7:6445953-6484190,38237
87590067,87667453,chr6,ORC3,chr6:87590067-87667453,77386
3181342,3200445,chr9,LINC01231,chr9:3181342-3200445,19103
7626234,7627876,chr17,SAT2,chr17:7626234-7627876,1642
143096839,143098007,chr2,MTND4P22,chr2:143096839-143098007,1168
173973779,174006140,chr5,C5orf47,chr5:173973779-174006140,32361
111611639,111884690,chr2,ANAPC1,chr2:111611639-111884690,273051
151057210,151076526,chr7,SLC4A2,chr7:151057210-151076526,19316
3218297,3526004,chr9,RFX3,chr9:3218297-3526004,307707
173232109,173235311,chr5,NKX2-5,chr5:173232109-173235311,3202
47437764,47449143,chr11,RAPSN,chr11:47437764-47449143,11379
28652630,28652755,chr10,RNU4ATAC6P,chr10:28652630-28652755,125
28658987,28659467,chr10,TPRKBP1,chr10:28658987-28659467,480
28667919,28668025,chr10,RNU6-1067P,chr10:28667919-28668025,106
28677510,28682932,chr10,BAMBI,chr10:28677510-28682932,5422
159865080,159973012,chr5,ADRA1B,chr5:159865080-159973012,107932
7646627,7657770,chr17,ATP1B2,chr17:7646627-7657770,11143
43796142,43804427,chr15,HYPK,chr15:43796142-43804427,8285
28760699,28760803,chr10,RNU6-270P,chr10:28760699-28760803,104
143332605,143333239,chr5,RPL7P21,chr5:143332605-143333239,634
28789188,28796113,chr10,LINC00837,chr10:28789188-28796113,6925
148192872,148280098,chr3,LINC02045,chr3:148192872-148280098,87226
157161846,157166264,chr5,FAM71B,chr5:157161846-157166264,4418
7705202,7711372,chr17,EFNB3,chr17:7705202-7711372,6170
133083073,133088491,chr10,ADGRA1-AS1,chr10:133083073-133088491,5418
131325092,131381656,chr3,NUDT16-DT,chr3:131325092-131381656,56564
58865175,59097419,chr15,RNF111,chr15:58865175-59097419,232244
133144612,133145304,chr10,RPL5P28,chr10:133144612-133145304,692
177022696,177081189,chr5,ZNF346,chr5:177022696-177081189,58493
133230217,133231558,chr10,UTF1,chr10:133230217-133231558,1341
133237855,133241928,chr10,VENTX,chr10:133237855-133241928,4073
47557534,47557833,chr11,RN7SL652P,chr11:47557534-47557833,299
7754320,7754976,chr17,RPL29P2,chr17:7754320-7754976,656
47565336,47584562,chr11,NDUFS3,chr11:47565336-47584562,19226
3062669,3063607,chr17,OR1D5,chr17:3062669-3063607,938
138643874,138644694,chr3,PPIAP72,chr3:138643874-138644694,820
133246478,133247891,chr10,MIR202HG,chr10:133246478-133247891,1413
98879276,98929133,chr4,EIF4E,chr4:98879276-98929133,49857
3153889,3154882,chr17,OR1P1,chr17:3153889-3154882,993
156019646,156037647,chr3,VN2R1P,chr3:156019646-156037647,18001
3116427,3117374,chr17,OR1E3,chr17:3116427-3117374,947
28061967,28062068,chr17,Vault,chr17:28061967-28062068,101
156441157,156446905,chr3,KCNAB1-AS1,chr3:156441157-156446905,5748
28116239,28116406,chr17,RPS29P22,chr17:28116239-28116406,167
133247511,133247620,chr10,MIR202,chr10:133247511-133247620,109
147276768,147277252,chr3,RPL21P71,chr3:147276768-147277252,484
149229356,149291800,chr3,CPHL1P,chr3:149229356-149291800,62444
133262420,133276868,chr10,ADAM8,chr10:133262420-133276868,14448
28226563,28228065,chr17,PYY2,chr17:28226563-28228065,1502
28232590,28235281,chr17,ERVE-1,chr17:28232590-28235281,2691
143342246,143347071,chr3,SLC9A9-AS1,chr3:143342246-143347071,4825
28275986,28317783,chr17,KRT18P55,chr17:28275986-28317783,41797
160755602,161078902,chr3,PPM1L,chr3:160755602-161078902,323300
70523791,70577670,chr16,SF3B3,chr16:70523791-70577670,53879
28319200,28328685,chr17,TMEM97,chr17:28319200-28328685,9485
24544104,24646191,chr6,KIAA0319,chr6:24544104-24646191,102087
180692832,180693763,chr5,OR2AI1P,chr5:180692832-180693763,931
119294383,119420714,chr3,ARHGAP31,chr3:119294383-119420714,126331
183071040,183072486,chr2,KRT8P10,chr2:183071040-183072486,1446
158320683,158409773,chr5,LINC02227,chr5:158320683-158409773,89090
47565430,47573461,chr11,PTPMT1,chr11:47565430-47573461,8031
100562993,100576739,chr2,PDCL3,chr2:100562993-100576739,13746
40679915,40693735,chr5,PTGER4,chr5:40679915-40693735,13820
470291,746105,chr9,KANK1,chr9:470291-746105,275814
28335602,28347009,chr17,TNFAIP1,chr17:28335602-28347009,11407
149551947,149634968,chr5,ARHGEF37,chr5:149551947-149634968,83021
47572197,47578976,chr11,KBTBD4,chr11:47572197-47578976,6779
214697727,214698059,chr2,ENSAP3,chr2:214697727-214698059,332
222424543,222562621,chr2,SGPP2,chr2:222424543-222562621,138078
149162410,149221829,chr3,CP,chr3:149162410-149221829,59419
17577198,17607972,chr4,LAP3,chr4:17577198-17607972,30774
238848032,238910534,chr2,TWIST2,chr2:238848032-238910534,62502
193276668,193277614,chr2,DNAJC17P1,chr2:193276668-193277614,946
65722205,65871725,chr5,NLN,chr5:65722205-65871725,149520
134797169,134797879,chr2,VDAC2P4,chr2:134797169-134797879,710
119476428,119487346,chr2,SCTR-AS1,chr2:119476428-119487346,10918
47576471,47576588,chr11,RNU5E-10P,chr11:47576471-47576588,117
47586678,47589194,chr11,FAM180B,chr11:47586678-47589194,2516
47589667,47594411,chr11,C1QTNF4,chr11:47589667-47594411,4744
98793846,98936259,chr2,CRACDL,chr2:98793846-98936259,142413
47617315,47642607,chr11,MTCH2,chr11:47617315-47642607,25292
28346633,28357527,chr17,POLDIP2,chr17:28346633-28357527,10894
70853239,71053658,chr15,LRRC49,chr15:70853239-71053658,200419
133308914,133313162,chr10,ZNF511,chr10:133308914-133313162,4248
143098123,143098417,chr2,MTND4LP12,chr2:143098123-143098417,294
84491985,84499292,chr4,NKX6-1,chr4:84491985-84499292,7307
222452400,222453126,chr2,NANOGP2,chr2:222452400-222453126,726
208031383,208031953,chr2,RPL9P14,chr2:208031383-208031953,570
24704861,24719998,chr6,C6orf62,chr6:24704861-24719998,15137
82422565,82430462,chr4,HNRNPDL,chr4:82422565-82430462,7897
193730555,193730689,chr2,SEC61GP1,chr2:193730555-193730689,134
70529509,70529588,chr16,SNORD111B,chr16:70529509-70529588,79
70538005,70538098,chr16,SNORD111,chr16:70538005-70538098,93
39480412,39493785,chr19,TIMM50,chr19:39480412-39493785,13373
133309410,133352529,chr10,ZNF511-PRAP1,chr10:133309410-133352529,43119
24721658,24751960,chr6,LINC02828,chr6:24721658-24751960,30302
158968640,159232659,chr2,TANC1,chr2:158968640-159232659,264019
133324072,133336935,chr10,CALY,chr10:133324072-133336935,12863
28357642,28363683,chr17,TMEM199,chr17:28357642-28363683,6041
177051714,177052963,chr5,ZNF346-IT1,chr5:177051714-177052963,1249
24774931,24786099,chr6,GMNN,chr6:24774931-24786099,11168
70251983,70289707,chr16,AARS1,chr16:70251983-70289707,37724
175290731,175291252,chr5,ARL2BPP6,chr5:175290731-175291252,521
179793980,179796647,chr5,LTC4S,chr5:179793980-179796647,2667
133344643,133344906,chr10,BANF1P2,chr10:133344643-133344906,263
133347368,133352683,chr10,PRAP1,chr10:133347368-133352683,5315
47716494,47767443,chr11,FNBP4,chr11:47716494-47767443,50949
133355158,133358025,chr10,FUOM,chr10:133355158-133358025,2867
28360654,28360734,chr17,MIR4723,chr17:28360654-28360734,80
28367284,28373091,chr17,VTN,chr17:28367284-28373091,5807
206939518,206969474,chr2,CPO,chr2:206939518-206969474,29956
172543403,172559202,chr5,LINC01944,chr5:172543403-172559202,15799
149545383,149545810,chr5,RPL29P14,chr5:149545383-149545810,427
47804296,47804402,chr11,RNA5SP340,chr11:47804296-47804402,106
47841324,47841682,chr11,YPEL5P2,chr11:47841324-47841682,358
74311362,74324705,chr11,P4HA3-AS1,chr11:74311362-74324705,13343
133362485,133373354,chr10,ECHS1,chr10:133362485-133373354,10869
119223831,119265652,chr2,STEAP3,chr2:119223831-119265652,41821
74330316,74398433,chr11,PGM2L1,chr11:74330316-74398433,68117
151437046,151492379,chr5,SLC36A1,chr5:151437046-151492379,55333
26477872,26478533,chr6,BTN1A1P1,chr6:26477872-26478533,661
137998735,138033655,chr3,CLDN18,chr3:137998735-138033655,34920
26519351,26519458,chr6,RNU6-502P,chr6:26519351-26519458,107
26521709,26527404,chr6,HCG11,chr6:26521709-26527404,5695
26538366,26546933,chr6,HMGN4,chr6:26538366-26546933,8567
39498895,39508481,chr19,DLL3,chr19:39498895-39508481,9586
133371556,133371663,chr10,MIR3944,chr10:133371556-133371663,107
28247444,28248289,chr17,PPY2P,chr17:28247444-28248289,845
133379261,133391694,chr10,PAOX,chr10:133379261-133391694,12433
27837880,27838375,chr6,H2AC15,chr6:27837880-27838375,495
27864062,27864401,chr6,H2BC16P,chr6:27864062-27864401,339
27865317,27865798,chr6,H2AC16,chr6:27865317-27865798,481
74354443,74355720,chr11,HNRNPA1P40,chr11:74354443-74355720,1277
27866792,27867588,chr6,H1-5,chr6:27866792-27867588,796
27871845,27872346,chr6,H3C11,chr6:27871845-27872346,501
1464186,1492686,chr17,MYO1C,chr17:1464186-1492686,28500
27873148,27873534,chr6,H4C13,chr6:27873148-27873534,386
27890315,27893106,chr6,H3C12,chr6:27890315-27893106,2791
74399237,74399333,chr11,MIR548AL,chr11:74399237-74399333,96
216498825,216579180,chr2,RPL37A,chr2:216498825-216579180,80355
74482250,74482542,chr11,CYCSP27,chr11:74482250-74482542,292
27892699,27893185,chr6,H2AC17,chr6:27892699-27893185,486
27893425,27893891,chr6,H2BC17,chr6:27893425-27893891,466
74490519,74493724,chr11,LIPT2,chr11:74490519-74493724,3205
27897504,27897566,chr6,RNU7-26P,chr6:27897504-27897566,62
138160988,138174921,chr3,DBR1,chr3:138160988-138174921,13933
27911185,27912396,chr6,OR2B2,chr6:27911185-27912396,1211
30031713,30033003,chr6,ETF1P1,chr6:30031713-30033003,1290
128627172,128627275,chr7,RNU6-177P,chr7:128627172-128627275,103
30058899,30064909,chr6,POLR1H,chr6:30058899-30064909,6010
39530987,39532852,chr19,EID2B,chr19:39530987-39532852,1865
74454841,74467729,chr11,KCNE3,chr11:74454841-74467729,12888
128655962,128658791,chr7,CICP14,chr7:128655962-128658791,2829
39534463,39535021,chr19,TDGF1P7,chr19:39534463-39535021,558
111676736,111677433,chr3,PLCXD2-AS1,chr3:111676736-111677433,697
39538707,39540161,chr19,EID2,chr19:39538707-39540161,1454
128693450,128693924,chr7,IMP3P2,chr7:128693450-128693924,474
135959275,135959590,chr3,NDUFS6P1,chr3:135959275-135959590,315
128697439,128697556,chr7,RNA5SP242,chr7:128697439-128697556,117
128697710,128697744,chr7,RNA5SP243,chr7:128697710-128697744,34
122680839,122730840,chr3,PARP14,chr3:122680839-122730840,50001
128739292,128773400,chr7,CALU,chr7:128739292-128773400,34108
39588955,39589125,chr19,RPS29P24,chr19:39588955-39589125,170
39590981,39591151,chr19,RPS29P25,chr19:39590981-39591151,170
46410329,46413564,chr19,CCDC8,chr19:46410329-46413564,3235
46466491,46471563,chr19,PNMA8A,chr19:46466491-46471563,5072
66563464,66568879,chr11,CTSF,chr11:66563464-66568879,5415
46486906,46495879,chr19,PNMA8B,chr19:46486906-46495879,8973
46558641,46559642,chr19,GAPDHP38,chr19:46558641-46559642,1001
199269500,199471266,chr2,SATB2,chr2:199269500-199471266,201766
87473335,87531061,chr4,SPARCL1,chr4:87473335-87531061,57726
46601074,46610782,chr19,CALM3,chr19:46601074-46610782,9708
109713825,109770495,chr12,FAM222A,chr12:109713825-109770495,56670
136155549,136155996,chr3,TDGF1P6,chr3:136155549-136155996,447
138061990,138115818,chr3,DZIP1L,chr3:138061990-138115818,53828
49454168,49539538,chr10,ERCC6,chr10:49454168-49539538,85370
109734166,109773508,chr12,FAM222A-AS1,chr12:109734166-109773508,39342
175440036,175444182,chr5,DRD1,chr5:175440036-175444182,4146
109833348,109833436,chr12,MIR4497,chr12:109833348-109833436,88
109866214,109866509,chr12,RN7SL441P,chr12:109866214-109866509,295
178711512,178730659,chr5,ZNF354A,chr5:178711512-178730659,19147
62545582,62545679,chr12,RNU6-399P,chr12:62545582-62545679,97
62601751,62603690,chr12,LINC01465,chr12:62601751-62603690,1939
30066709,30070333,chr6,PPP1R11,chr6:30066709-30070333,3624
62602752,62622213,chr12,MIRLET7IHG,chr12:62602752-62622213,19461
62603686,62603769,chr12,MIRLET7I,chr12:62603686-62603769,83
62658823,62659225,chr12,RPL32P26,chr12:62658823-62659225,402
109783087,109833406,chr12,TRPV4,chr12:109783087-109833406,50319
150852484,151080726,chr3,CLRN1-AS1,chr3:150852484-151080726,228242
49551308,49552652,chr10,HMGB1P50,chr10:49551308-49552652,1344
126704240,126960420,chr3,CHCHD6,chr3:126704240-126960420,256180
180982273,180982611,chr5,ARPP19P1,chr5:180982273-180982611,338
49609095,49667942,chr10,CHAT,chr10:49609095-49667942,58847
30102897,30113090,chr6,TRIM31,chr6:30102897-30113090,10193
54053584,54112519,chr1,TCEANC2,chr1:54053584-54112519,58935
163503114,163519354,chr5,MAT2B,chr5:163503114-163519354,16240
128761338,128761598,chr7,RN7SL81P,chr7:128761338-128761598,260
128790757,128822132,chr7,CCDC136,chr7:128790757-128822132,31375
222503883,222504843,chr2,GAPDHP49,chr2:222503883-222504843,960
191949043,192194933,chr2,TMEFF2,chr2:191949043-192194933,245890
52032103,52033810,chr1,KTI12,chr1:52032103-52033810,1707
46620468,46625089,chr19,PTGIR,chr19:46620468-46625089,4621
125344085,125344797,chr3,DNAJB6P7,chr3:125344085-125344797,712
156111432,156114198,chr3,MRE11P1,chr3:156111432-156114198,2766
53946085,53968168,chr1,LRRC42,chr1:53946085-53968168,22083
149318498,149334414,chr3,TM4SF18,chr3:149318498-149334414,15916
30105240,30114724,chr6,TRIM31-AS1,chr6:30105240-30114724,9484
30136124,30148735,chr6,TRIM40,chr6:30136124-30148735,12611
185363872,185395924,chr4,LRP2BP,chr4:185363872-185395924,32052
21405401,21440499,chr15,POTEB3,chr15:21405401-21440499,35098
46647551,46661182,chr19,DACT3,chr19:46647551-46661182,13631
30151943,30161211,chr6,TRIM10,chr6:30151943-30161211,9268
46688797,46689068,chr19,RN7SL364P,chr19:46688797-46689068,271
46709293,46709345,chr19,MIR320E,chr19:46709293-46709345,52
39306566,39320863,chr19,LRFN1,chr19:39306566-39320863,14297
164670878,164686076,chr3,LINC01323,chr3:164670878-164686076,15198
151949571,152270449,chr5,LINC01933,chr5:151949571-152270449,320878
6463777,6467221,chr19,CRB3,chr19:6463777-6467221,3444
141660536,141729405,chr3,LINC02618,chr3:141660536-141729405,68869
130021553,130022520,chr3,OR7E129P,chr3:130021553-130022520,967
154651656,154652423,chr3,SYPL1P1,chr3:154651656-154652423,767
121758881,121765427,chr4,SMIM43,chr4:121758881-121765427,6546
62189131,62189953,chr1,PIGPP2,chr1:62189131-62189953,822
63228315,63616924,chr3,SYNPR,chr3:63228315-63616924,388609
176905005,177022633,chr5,UIMC1,chr5:176905005-177022633,117628
72274552,72275159,chr1,GDI2P2,chr1:72274552-72275159,607
180938830,180939298,chr2,RPL27AP3,chr2:180938830-180939298,468
48089368,48089634,chr1,CYP46A4P,chr1:48089368-48089634,266
209808804,209809580,chr2,SNAI1P1,chr2:209808804-209809580,776
65092392,65092614,chr1,MRPS21P1,chr1:65092392-65092614,222
181961212,181962478,chr2,KRT18P29,chr2:181961212-181962478,1266
30163206,30172693,chr6,TRIM15,chr6:30163206-30172693,9487
73305609,73355253,chr1,LINC01360,chr1:73305609-73355253,49644
130278036,130278376,chr2,MTND3P15,chr2:130278036-130278376,340
89608789,89655467,chr15,KIF7,chr15:89608789-89655467,46678
159932006,160062615,chr2,PLA2R1,chr2:159932006-160062615,130609
6467207,6482557,chr19,DENND1C,chr19:6467207-6482557,15350
76758124,76779267,chr1,LINC02567,chr1:76758124-76779267,21143
128850162,128862626,chr7,FLNC-AS1,chr7:128850162-128862626,12464
128862856,128865847,chr7,ATP6V1F,chr7:128862856-128865847,2991
112738672,112739106,chr4,RPL32P13,chr4:112738672-112739106,434
62236165,62319434,chr1,KANK4,chr1:62236165-62319434,83269
112788083,112788878,chr4,RPL7AP30,chr4:112788083-112788878,795
128866330,128872047,chr7,ATP6V1FNB,chr7:128866330-128872047,5717
30186798,30188614,chr6,PAIP1P1,chr6:30186798-30188614,1816
31353872,31357188,chr6,HLA-B,chr6:31353872-31357188,3316
112973272,113071962,chr4,ANK2-AS1,chr4:112973272-113071962,98690
128937457,128950038,chr7,IRF5,chr7:128937457-128950038,12581
113106863,113106955,chr4,MIR1243,chr4:113106863-113106955,92
113152282,113152362,chr4,MIR8082,chr4:113152282-113152362,80
113419840,113420136,chr4,RN7SL184P,chr4:113419840-113420136,296
116552473,116568264,chr3,LINC00903,chr3:116552473-116568264,15791
113420323,113420486,chr4,RNU1-138P,chr4:113420323-113420486,163
158666675,158672255,chr4,C4orf46,chr4:158666675-158672255,5580
89664367,89679427,chr15,PLIN1,chr15:89664367-89679427,15060
130265760,130434123,chr9,HMCN2,chr9:130265760-130434123,168363
158671968,158710742,chr4,ETFDH,chr4:158671968-158710742,38774
57450183,57450299,chr11,RNA5SP341,chr11:57450183-57450299,116
107840228,107882250,chr3,LINC00635,chr3:107840228-107882250,42022
57451690,57452022,chr11,RN7SKP259,chr11:57451690-57452022,332
57528085,57528365,chr11,RN7SL605P,chr11:57528085-57528365,280
57460528,57477534,chr11,RTN4RL2,chr11:57460528-57477534,17006
139494256,139496116,chr5,NCOA4P4,chr5:139494256-139496116,1860
150601080,150659207,chr5,SYNPO,chr5:150601080-150659207,58127
77979175,78017964,chr1,DNAJB4,chr1:77979175-78017964,38789
49610310,49612720,chr10,SLC18A3,chr10:49610310-49612720,2410
49679651,49710261,chr10,C10orf53,chr10:49679651-49710261,30610
57484534,57515780,chr11,SLC43A1,chr11:57484534-57515780,31246
18200924,18201205,chr8,MTND4LP26,chr8:18200924-18201205,281
89677764,89690783,chr15,PEX11A,chr15:89677764-89690783,13019
138946724,139293557,chr5,SIL1,chr5:138946724-139293557,346833
37776526,37858106,chr10,ZNF248,chr10:37776526-37858106,81580
62855068,62857134,chr8,XRCC6P4,chr8:62855068-62857134,2066
62863082,62864181,chr8,SRPK2P,chr8:62863082-62864181,1099
62436297,62451804,chr1,USP1,chr1:62436297-62451804,15507
63048553,63086053,chr8,TTPA,chr8:63048553-63086053,37500
210324759,210469246,chr2,LANCL1-AS1,chr2:210324759-210469246,144487
1494577,1516742,chr17,INPP5K,chr17:1494577-1516742,22165
89687937,89688243,chr15,RPL36AP43,chr15:89687937-89688243,306
63136223,63138084,chr8,TARDBPP4,chr8:63136223-63138084,1861
63167725,63168442,chr8,YTHDF3-DT,chr8:63167725-63168442,717
230725143,230725403,chr2,BANF1P3,chr2:230725143-230725403,260
122370530,122395703,chr9,PTGS1,chr9:122370530-122395703,25173
41828092,41837581,chr15,JMJD7,chr15:41828092-41837581,9489
216590426,216606938,chr2,LINC01280,chr2:216590426-216606938,16512
63168553,63212786,chr8,YTHDF3,chr8:63168553-63212786,44233
101151660,101155412,chr2,TBC1D8-AS1,chr2:101151660-101155412,3752
152116801,152175763,chr2,STAM2,chr2:152116801-152175763,58962
6494319,6502848,chr19,TUBB4A,chr19:6494319-6502848,8529
46005088,46030623,chr10,NCOA4,chr10:46005088-46030623,25535
57528464,57530803,chr11,TIMM10,chr11:57528464-57530803,2339
57551656,57568284,chr11,UBE2L6,chr11:57551656-57568284,16628
41828095,41848155,chr15,JMJD7-PLA2G4B,chr15:41828095-41848155,20060
44243408,44244273,chr1,ERI3-IT1,chr1:44243408-44244273,865
75443054,75465497,chr16,TMEM170A,chr16:75443054-75465497,22443
78170481,78171237,chr1,RNFT1P2,chr1:78170481-78171237,756
147922179,147923421,chr5,EEF1GP2,chr5:147922179-147923421,1242
180494379,180578358,chr5,CNOT6,chr5:180494379-180578358,83979
107254691,107365873,chr2,LINC01789,chr2:107254691-107365873,111182
57576292,57577080,chr11,RPS4XP13,chr11:57576292-57577080,788
77282019,77559966,chr1,AK5,chr1:77282019-77559966,277947
130570829,130584161,chr2,PRSS40A,chr2:130570829-130584161,13332
129966592,129980466,chr2,RAB6C-AS1,chr2:129966592-129980466,13874
75472052,75495445,chr16,CHST6,chr16:75472052-75495445,23393
57712593,57740973,chr11,TMX2,chr11:57712593-57740973,28380
214931542,215138626,chr2,ABCA12,chr2:214931542-215138626,207084
6531026,6535924,chr19,TNFSF9,chr19:6531026-6535924,4898
75566375,75577881,chr16,GABARAPL2,chr16:75566375-75577881,11506
63234634,63234911,chr8,RN7SL135P,chr8:63234634-63234911,277
74824534,74855029,chr8,PI15,chr8:74824534-74855029,30495
6562123,6563848,chr19,CLIC4P2,chr19:6562123-6563848,1725
128970734,128971029,chr7,RN7SL306P,chr7:128970734-128971029,295
129028889,129030527,chr7,ODCP,chr7:129028889-129030527,1638
129055223,129057239,chr7,TPI1P2,chr7:129055223-129057239,2016
6583183,6604103,chr19,CD70,chr19:6583183-6604103,20920
1604374,1604672,chr17,RN7SL105P,chr17:1604374-1604672,298
75647773,75761872,chr16,TERF2IP,chr16:75647773-75761872,114099
57718044,57718530,chr11,PPIAP42,chr11:57718044-57718530,486
159263290,159286036,chr5,UBLCP1,chr5:159263290-159286036,22746
1646145,1649866,chr17,RILP,chr17:1646145-1649866,3721
129117513,129117827,chr7,CYCSP20,chr7:129117513-129117827,314
79521080,79522203,chr1,ADH5P2,chr1:79521080-79522203,1123
68514375,68514669,chr1,TXNP2,chr1:68514375-68514669,294
129144707,129169699,chr7,TSPAN33,chr7:129144707-129169699,24992
57597387,57619171,chr11,SERPING1,chr11:57597387-57619171,21784
6593329,6594055,chr19,RPL7P50,chr19:6593329-6594055,726
48295373,48472208,chr1,SPATA6,chr1:48295373-48472208,176835
75693893,75701461,chr16,DUXB,chr16:75693893-75701461,7568
75698531,75698816,chr16,RN7SL520P,chr16:75698531-75698816,285
75709056,75709815,chr16,ATP5PBP7,chr16:75709056-75709815,759
6677704,6730562,chr19,C3,chr19:6677704-6730562,52858
75714131,75726490,chr16,CPHXL,chr16:75714131-75726490,12359
9564390,9564497,chr16,RNA5SP403,chr16:9564390-9564497,107
9600097,9600228,chr16,RNA5SP404,chr16:9600097-9600228,131
41848146,41894053,chr15,SPTBN5,chr15:41848146-41894053,45907
1650629,1684867,chr17,PRPF8,chr17:1650629-1684867,34238
10111382,10112885,chr16,IMPDH1P11,chr16:10111382-10112885,1503
10221775,10222073,chr16,RN7SL493P,chr16:10221775-10222073,298
129164849,129164961,chr7,RNY1P11,chr7:129164849-129164961,112
133913677,133917269,chr5,WSPAR,chr5:133913677-133917269,3592
129188633,129213545,chr7,SMO,chr7:129188633-129213545,24912
10496272,10496374,chr16,RNU6-633P,chr16:10496272-10496374,102
55984009,56191118,chr16,GNAO1-DT,chr16:55984009-56191118,207109
149371324,149404202,chr5,IL17B,chr5:149371324-149404202,32878
74320613,74518007,chr8,GDAP1,chr8:74320613-74518007,197394
49364066,49396089,chr10,DRGX,chr10:49364066-49396089,32023
16436943,16513745,chr10,PTER,chr10:16436943-16513745,76802
170763350,170814047,chr5,GABRP,chr5:170763350-170814047,50697
56191390,56357444,chr16,GNAO1,chr16:56191390-56357444,166054
23439075,23442377,chr10,OTUD1,chr10:23439075-23442377,3302
79512533,79516440,chr10,EIF5AL1,chr10:79512533-79516440,3907
158709127,158723396,chr4,PPID,chr4:158709127-158723396,14269
123148136,123150672,chr10,HMX2,chr10:123148136-123150672,2536
49818279,49970203,chr10,PARG,chr10:49818279-49970203,151924
41960949,42264100,chr7,GLI3,chr7:41960949-42264100,303151
158794590,158794696,chr4,RNU6-128P,chr4:158794590-158794696,106
87785920,87786371,chr4,CHCHD2P7,chr4:87785920-87786371,451
24950955,24956721,chr8,NEFL,chr8:24950955-24956721,5766
87799554,87812435,chr4,IBSP,chr4:87799554-87812435,12881
122675130,122676104,chr9,OR1L3,chr9:122675130-122676104,974
77979542,78138444,chr1,GIPC2,chr1:77979542-78138444,158902
121567057,121785530,chr9,DAB2IP,chr9:121567057-121785530,218473
87891843,87894015,chr4,HSP90AB3P,chr4:87891843-87894015,2172
24953796,24953867,chr8,MIR6841,chr8:24953796-24953867,71
109850945,109880541,chr12,GLTP,chr12:109850945-109880541,29596
88000237,88000401,chr4,RNU1-36P,chr4:88000237-88000401,164
88007635,88077777,chr4,PKD2,chr4:88007635-88077777,70142
129290983,129291275,chr8,RN7SKP206,chr8:129290983-129291275,292
118162806,118176639,chr11,SCN2B,chr11:118162806-118176639,13833
129484057,129484142,chr8,MIR3686,chr8:129484057-129484142,85
68428822,68449954,chr1,RPE65,chr1:68428822-68449954,21132
129728744,129730445,chr8,MTRF1LP2,chr8:129728744-129730445,1701
129748196,129786624,chr8,GSDMC,chr8:129748196-129786624,38428
62597520,62606313,chr1,ANGPTL3,chr1:62597520-62606313,8793
124211707,124215828,chr11,OR8G3P,chr11:124211707-124215828,4121
41851913,41852029,chr15,RNA5SP393,chr15:41851913-41852029,116
41866495,41866551,chr15,MIR4310,chr15:41866495-41866551,56
44537125,44563029,chr15,EIF3J,chr15:44537125-44563029,25904
20363685,20383782,chr11,HTATIP2,chr11:20363685-20383782,20097
18358443,18358967,chr12,NDFIP1P1,chr12:18358443-18358967,524
18493051,18493723,chr12,ZKSCAN7P1,chr12:18493051-18493723,672
121815674,122093606,chr9,TTLL11,chr9:121815674-122093606,277932
18683169,18738100,chr12,PLCZ1,chr12:18683169-18738100,54931
128634199,129683770,chr8,CCDC26,chr8:128634199-129683770,1049571
35638247,35642296,chr10,FZD8,chr10:35638247-35642296,4049
67701475,67833467,chr1,GNG12,chr1:67701475-67833467,131992
119571802,119597029,chr10,TIAL1,chr10:119571802-119597029,25227
88090150,88231628,chr4,ABCG2,chr4:88090150-88231628,141478
6577434,6589374,chr7,ZDHHC4,chr7:6577434-6589374,11940
114060127,114078328,chr9,AMBP,chr9:114060127-114078328,18201
73104792,73106282,chr1,KRT8P21,chr1:73104792-73106282,1490
31863192,31879046,chr6,SLC44A4,chr6:31863192-31879046,15854
176629572,176637931,chr2,LINC01116,chr2:176629572-176637931,8359
65248219,65415871,chr1,DNAJC6,chr1:65248219-65415871,167652
141958328,141990292,chr5,RNF14,chr5:141958328-141990292,31964
100591150,100591324,chr2,HMGN2P22,chr2:100591150-100591324,174
6736712,6736778,chr19,MIR6791,chr19:6736712-6736778,66
63461404,63491194,chr11,PLAAT5,chr11:63461404-63491194,29790
6737925,6751530,chr19,TRIP10,chr19:6737925-6751530,13605
56192614,56194518,chr16,GNAO1-AS1,chr16:56192614-56194518,1904
205993721,206086303,chr2,INO80D,chr2:205993721-206086303,92582
56245520,56245623,chr16,MIR3935,chr16:56245520-56245623,103
56361452,56425545,chr16,AMFR,chr16:56361452-56425545,64093
1702816,1710377,chr17,TLCD2,chr17:1702816-1710377,7561
44728988,44767829,chr15,TRIM69,chr15:44728988-44767829,38841
114086126,114099292,chr9,KIF12,chr9:114086126-114099292,13166
1713903,1713987,chr17,MIR22,chr17:1713903-1713987,84
1742836,1755265,chr17,SERPINF2,chr17:1742836-1755265,12429
68460731,68615334,chr11,PPP6R3,chr11:68460731-68615334,154603
206765357,206796189,chr2,FASTKD2,chr2:206765357-206796189,30832
88201703,88201810,chr4,RNU6-818P,chr4:88201703-88201810,107
88206427,88206552,chr4,RNU6ATAC31P,chr4:88206427-88206552,125
88226729,88226829,chr4,RNU6-1298P,chr4:88226729-88226829,100
7460028,7460118,chr4,MIR4274,chr4:7460028-7460118,90
65147549,65232145,chr1,AK4,chr1:65147549-65232145,84596
7754077,7778928,chr4,AFAP1-AS1,chr4:7754077-7778928,24851
7758714,7939926,chr4,AFAP1,chr4:7758714-7939926,181212
88627063,88652180,chr9,LINC02843,chr9:88627063-88652180,25117
65420587,65436007,chr1,LEPROT,chr1:65420587-65436007,15420
54542325,54571080,chr7,VSTM2A,chr7:54542325-54571080,28755
138777832,138778810,chr3,GAPDHP39,chr3:138777832-138778810,978
35791003,35809732,chr9,NPR2,chr9:35791003-35809732,18729
18692762,18694096,chr12,PSMC1P9,chr12:18692762-18694096,1334
146921795,146927429,chr3,LINC02010,chr3:146921795-146927429,5634
59650764,59736002,chr10,SLC16A9,chr10:59650764-59736002,85238
56451521,56479104,chr16,OGFOD1,chr16:56451521-56479104,27583
18738119,18739188,chr12,CAPZA3,chr12:18738119-18739188,1069
78180866,78182046,chr4,SERBP1P5,chr4:78180866-78182046,1180
172641263,172691540,chr5,NEURL1B,chr5:172641263-172691540,50277
151814073,151828488,chr3,AADAC,chr3:151814073-151828488,14415
103928456,104052667,chr14,TDRD9,chr14:103928456-104052667,124211
78379197,78379514,chr4,MICOS10P4,chr4:78379197-78379514,317
18242961,18648416,chr12,PIK3C2G,chr12:18242961-18648416,405455
78551747,78610451,chr4,ANXA3,chr4:78551747-78610451,58704
72301472,72301829,chr1,RPL31P12,chr1:72301472-72301829,357
72765031,72791282,chr1,LINC02796,chr1:72765031-72791282,26251
216107464,216206303,chr2,XRCC5,chr2:216107464-216206303,98839
32115264,32128253,chr6,ATF6B,chr6:32115264-32128253,12989
1762029,1777565,chr17,SERPINF1,chr17:1762029-1777565,15536
52709122,52709442,chr1,NDUFS5P3,chr1:52709122-52709442,320
60912675,61056885,chr1,NFIA-AS2,chr1:60912675-61056885,144210
14518557,14774897,chr10,FAM107B,chr10:14518557-14774897,256340
139475533,139482935,chr5,STING1,chr5:139475533-139482935,7402
24573268,24694193,chr7,PALS2,chr7:24573268-24694193,120925
64470129,64693058,chr1,CACHD1,chr1:64470129-64693058,222929
144262673,144262737,chr8,MIR7112,chr8:144262673-144262737,64
144266453,144268481,chr8,SCX,chr8:144266453-144268481,2028
144291591,144314720,chr8,HSF1,chr8:144291591-144314720,23129
161083883,161105411,chr3,B3GALNT1,chr3:161083883-161105411,21528
73683966,73714514,chr15,CD276,chr15:73683966-73714514,30548
35869463,35870401,chr9,OR13J1,chr9:35869463-35870401,938
87810642,87837225,chr9,FBP2P1,chr9:87810642-87837225,26583
87816465,87817970,chr9,ELF2P3,chr9:87816465-87817970,1505
87825146,87825968,chr9,NPAP1P7,chr9:87825146-87825968,822
87844154,87847314,chr9,CTSLP8,chr9:87844154-87847314,3160
87882877,87888903,chr9,SPATA31E1,chr9:87882877-87888903,6026
95442980,95517057,chr9,PTCH1,chr9:95442980-95517057,74077
1779485,1830634,chr17,SMYD4,chr17:1779485-1830634,51149
75627474,75648643,chr16,KARS1,chr16:75627474-75648643,21169
14145049,14974777,chr7,DGKB,chr7:14145049-14974777,829728
63523372,63572693,chr1,EFCAB7,chr1:63523372-63572693,49321
223596940,223602361,chr2,SCG2,chr2:223596940-223602361,5421
104865268,104896747,chr14,CEP170B,chr14:104865268-104896747,31479
87439523,87459044,chr2,LINC01943,chr2:87439523-87459044,19521
120212935,120213275,chr2,MTND3P10,chr2:120212935-120213275,340
1829702,1900082,chr17,RPA1,chr17:1829702-1900082,70380
32128707,32130288,chr6,FKBPL,chr6:32128707-32130288,1581
73635216,73715214,chr1,LINC02238,chr1:73635216-73715214,79998
158695916,159099916,chr5,EBF1,chr5:158695916-159099916,404000
32148359,32153083,chr6,PRRT1,chr6:32148359-32153083,4724
206040432,206040845,chr2,RPL27P8,chr2:206040432-206040845,413
84925583,84997113,chr1,MCOLN2,chr1:84925583-84997113,71530
144314584,144326910,chr8,DGAT1,chr8:144314584-144326910,12326
120464335,120466218,chr2,LINC01101,chr2:120464335-120466218,1883
192749845,192776899,chr2,PCGEM1,chr2:192749845-192776899,27054
90963682,91005026,chr12,EPYC,chr12:90963682-91005026,41344
78057323,78544269,chr4,FRAS1,chr4:78057323-78544269,486946
131983937,131994161,chr2,LINC01945,chr2:131983937-131994161,10224
175184215,175184607,chr2,RPS15AP14,chr2:175184215-175184607,392
216156342,216156811,chr2,POLHP1,chr2:216156342-216156811,469
91102629,91111494,chr12,LUM,chr12:91102629-91111494,8865
73752317,73770613,chr15,INSYN1-AS1,chr15:73752317-73770613,18296
104853287,104858574,chr2,POU3F3,chr2:104853287-104858574,5287
32153441,32163678,chr6,PPT2,chr6:32153441-32163678,10237
131722417,131751669,chr2,NBEAP2,chr2:131722417-131751669,29252
157414619,157488961,chr2,CYTIP,chr2:157414619-157488961,74342
91140484,91183217,chr12,DCN,chr12:91140484-91183217,42733
60419609,60479160,chr15,ICE2,chr15:60419609-60479160,59551
23969874,24006408,chr14,DHRS4L2,chr14:23969874-24006408,36534
18658429,18682228,chr17,ZNF286B,chr17:18658429-18682228,23799
20743333,20754501,chr17,RNFT1P3,chr17:20743333-20754501,11168
6752160,6767463,chr19,SH2D3A,chr19:6752160-6767463,15303
116953238,117230176,chr7,ST7,chr7:116953238-117230176,276938
20771058,20771427,chr17,HNRNPA1P19,chr17:20771058-20771427,369
20775642,20776905,chr17,OLA1P2,chr17:20775642-20776905,1263
20784645,20785725,chr17,SCDP1,chr17:20784645-20785725,1080
76867480,77067546,chr1,ST6GALNAC5,chr1:76867480-77067546,200066
20814620,20844257,chr17,ABHD17AP6,chr17:20814620-20844257,29637
20894532,20894638,chr17,RNU6-1178P,chr17:20894532-20894638,106
20901939,20902680,chr17,RNASEH1P1,chr17:20901939-20902680,741
20956682,20958404,chr17,SPECC1P2,chr17:20956682-20958404,1722
72030291,72041310,chr17,LINC01152,chr17:72030291-72041310,11019
81314944,81390809,chr16,GAN,chr16:81314944-81390809,75865
80408013,80483379,chr5,ZFYVE16,chr5:80408013-80483379,75366
72072333,72103035,chr17,LINC02097,chr17:72072333-72103035,30702
62784132,62865516,chr1,ATG4C,chr1:62784132-62865516,81384
72121020,72126416,chr17,SOX9,chr17:72121020-72126416,5396
129825126,129877664,chr2,LINC02572,chr2:129825126-129877664,52538
6661253,6670588,chr19,TNFSF14,chr19:6661253-6670588,9335
72342692,72355136,chr17,LINC02003,chr17:72342692-72355136,12444
72021851,72058073,chr17,ROCR,chr17:72021851-72058073,36222
58059,76355,chr16,RHBDF1,chr16:58059-76355,18296
161136908,161236230,chr2,TANK,chr2:161136908-161236230,99322
144317246,144317315,chr8,MIR6848,chr8:144317246-144317315,69
144330565,144336482,chr8,SCRT1,chr8:144330565-144336482,5917
804940,805001,chr19,MIR4745,chr19:804940-805001,61
813584,813653,chr19,MIR3187,chr19:813584-813653,69
144352219,144354914,chr8,TMEM249,chr8:144352219-144354914,2695
45815410,45863194,chr19,SYMPK,chr19:45815410-45863194,47784
72067099,72237203,chr17,SOX9-AS1,chr17:72067099-72237203,170104
144355431,144359376,chr8,FBXL6,chr8:144355431-144359376,3945
72793104,72854475,chr1,LINC02797,chr1:72793104-72854475,61371
87608529,87616873,chr4,DSPP,chr4:87608529-87616873,8344
65298755,65298980,chr1,COX6CP13,chr1:65298755-65298980,225
84271,138677,chr16,NPRL3,chr16:84271-138677,54406
64972225,65002489,chr1,LINC01359,chr1:64972225-65002489,30264
107867807,107867910,chr4,RNU6-733P,chr4:107867807-107867910,103
107931549,107953461,chr4,CYP2U1,chr4:107931549-107953461,21912
32153845,32171978,chr6,PPT2-EGFL8,chr6:32153845-32171978,18133
45844881,45847067,chr17,SPPL2C,chr17:45844881-45847067,2186
60558080,60558401,chr15,CYCSP38,chr15:60558080-60558401,321
89690811,89743638,chr15,WDR93,chr15:89690811-89743638,52827
45895783,45898798,chr17,MAPT-IT1,chr17:45895783-45898798,3015
113015607,113016098,chr12,IMMP1LP2,chr12:113015607-113016098,491
45999250,45999694,chr17,STH,chr17:45999250-45999694,444
120438090,120440737,chr12,COX6A1,chr12:120438090-120440737,2647
49510817,49510900,chr17,MIR6165,chr17:49510817-49510900,83
84085741,84086233,chr1,TXN2P1,chr1:84085741-84086233,492
66042500,66050718,chr1,PDE4B-AS1,chr1:66042500-66050718,8218
102251080,102431258,chr4,SLC39A8,chr4:102251080-102431258,180178
75918873,75932404,chr1,ASB17,chr1:75918873-75932404,13531
120443964,120446384,chr12,TRIAP1,chr12:120443964-120446384,2420
49598884,49678163,chr17,SPOP,chr17:49598884-49678163,79279
68282388,68282622,chr1,COX6B1P7,chr1:68282388-68282622,234
47497894,47498341,chr1,RPL21P24,chr1:47497894-47498341,447
120446444,120463749,chr12,GATC,chr12:120446444-120463749,17305
144373101,144393242,chr8,ADCK5,chr8:144373101-144393242,20141
1039152,1049119,chr10,IDI1,chr10:1039152-1049119,9967
32164595,32168281,chr6,EGFL8,chr6:32164595-32168281,3686
120450437,120450803,chr12,RPL31P52,chr12:120450437-120450803,366
78889764,79282124,chr1,ADGRL4,chr1:78889764-79282124,392360
120461672,120469748,chr12,SRSF9,chr12:120461672-120469748,8076
105209286,105315589,chr14,BRF1,chr14:105209286-105315589,106303
104122058,104126385,chr10,SFR1,chr10:104122058-104126385,4327
120469850,120498493,chr12,DYNLL1,chr12:120469850-120498493,28643
101781325,101783413,chr10,NPM3,chr10:101781325-101783413,2088
102873183,102895780,chr2,LINC01796,chr2:102873183-102895780,22597
89714232,89714338,chr15,RNU6-132P,chr15:89714232-89714338,106
89752296,89753493,chr15,MRPL15P1,chr15:89752296-89753493,1197
89760591,89778754,chr15,MESP2,chr15:89760591-89778754,18163
101479390,101486822,chr2,LINC01870,chr2:101479390-101486822,7432
159462417,159463256,chr2,CAPZA1P2,chr2:159462417-159463256,839
180988846,181006727,chr5,BTNL3,chr5:180988846-181006727,17881
235882362,235882493,chr2,TMSB10P1,chr2:235882362-235882493,131
89784895,89815401,chr15,ANPEP,chr15:89784895-89815401,30506
64270062,64289500,chr11,GPR137,chr11:64270062-64289500,19438
112368369,112434488,chr2,RGPD8,chr2:112368369-112434488,66119
144393229,144409335,chr8,CPSF1,chr8:144393229-144409335,16106
102348392,102348691,chr4,RN7SL728P,chr4:102348392-102348691,299
32168212,32178096,chr6,AGPAT1,chr6:32168212-32178096,9884
101784443,101818465,chr10,OGA,chr10:101784443-101818465,34022
93733220,93741600,chr5,POU5F2,chr5:93733220-93741600,8380
173707614,173746279,chr5,LINC01484,chr5:173707614-173746279,38665
142728,154503,chr16,HBZ,chr16:142728-154503,11775
120503279,120534434,chr12,COQ5,chr12:120503279-120534434,31155
102501331,102617302,chr4,NFKB1,chr4:102501331-102617302,115971
153892,166764,chr16,HBM,chr16:153892-166764,12872
179797597,179806952,chr5,MGAT4B,chr5:179797597-179806952,9355
163122,165156,chr16,HBZP1,chr16:163122-165156,2034
168679,169334,chr16,HBAP1,chr16:168679-169334,655
172876,173710,chr16,HBA2,chr16:172876-173710,834
176680,177522,chr16,HBA1,chr16:176680-177522,842
120522664,120523443,chr12,RPL29P24,chr12:120522664-120523443,779
114391443,114400511,chr11,C11orf71,chr11:114391443-114400511,9068
120578764,120581402,chr12,POP5,chr12:120578764-120581402,2638
114400030,114414203,chr11,RBM7,chr11:114400030-114414203,14173
180459,181179,chr16,HBQ1,chr16:180459-181179,720
38874069,38881587,chr1,GJA9,chr1:38874069-38881587,7518
68017710,68017817,chr16,RNU6-359P,chr16:68017710-68017817,107
68020916,68023232,chr16,DDX28,chr16:68020916-68023232,2316
45863989,45873797,chr19,FOXA3,chr19:45863989-45873797,9808
84076331,84077931,chr1,PRKACB-DT,chr1:84076331-84077931,1600
45883608,45886141,chr19,IRF2BP1,chr19:45883608-45886141,2533
68084751,68229259,chr16,NFATC3,chr16:68084751-68229259,144508
45890023,45902613,chr19,MYPOP,chr19:45890023-45902613,12590
120594015,120594548,chr12,RPL11P5,chr12:120594015-120594548,533
48892130,48892228,chr12,RNU6-600P,chr12:48892130-48892228,98
48903418,48903813,chr12,RPL32P27,chr12:48903418-48903813,395
47550196,47550753,chr1,ATP6V0E1P4,chr1:47550196-47550753,557
45913214,45914778,chr19,NANOS2,chr19:45913214-45914778,1564
45995461,46021318,chr19,CCDC61,chr19:45995461-46021318,25857
48904110,48931840,chr12,CCDC65,chr12:48904110-48931840,27730
39692182,39763914,chr1,PPIE,chr1:39692182-39763914,71732
159003975,159004320,chr2,BTF3L4P2,chr2:159003975-159004320,345
238554541,238740849,chr2,LINC01937,chr2:238554541-238740849,186308
13276652,13387266,chr11,ARNTL,chr11:13276652-13387266,110614
187341964,187448460,chr2,CALCRL,chr2:187341964-187448460,106496
48921518,48926474,chr12,FKBP11,chr12:48921518-48926474,4956
89830599,89894638,chr15,AP3S2,chr15:89830599-89894638,64039
46018932,46019049,chr19,MIR769,chr19:46018932-46019049,117
46019153,46023053,chr19,PGLYRP1,chr19:46019153-46023053,3900
136862208,136951606,chr3,NCK1,chr3:136862208-136951606,89398
46120067,46124688,chr19,IGFL3,chr19:46120067-46124688,4621
101818800,101828885,chr10,KCNIP2-AS1,chr10:101818800-101828885,10085
32170030,32170116,chr6,MIR6721,chr6:32170030-32170116,86
32178405,32180793,chr6,RNF5,chr6:32178405-32180793,2388
46136746,46137547,chr19,TGIF1P1,chr19:46136746-46137547,801
101825974,101843920,chr10,KCNIP2,chr10:101825974-101843920,17946
45767796,45772504,chr19,DM1-AS,chr19:45767796-45772504,4708
34379019,34397828,chr9,C9orf24,chr9:34379019-34397828,18809
165772904,165837462,chr3,BCHE,chr3:165772904-165837462,64558
144394149,144394230,chr8,MIR939,chr8:144394149-144394230,81
144400086,144400165,chr8,MIR1234,chr8:144400086-144400165,79
144400277,144400345,chr8,MIR6849,chr8:144400277-144400345,68
48965340,48971735,chr12,WNT10B,chr12:48965340-48971735,6395
45782947,45792845,chr19,DMWD,chr19:45782947-45792845,9898
34398184,34458570,chr9,FAM219A,chr9:34398184-34458570,60386
144409742,144416844,chr8,SLC39A4,chr8:144409742-144416844,7102
32179816,32179876,chr6,MIR6833,chr6:32179816-32179876,60
32184733,32190202,chr6,PBX2,chr6:32184733-32190202,5469
45795713,45815308,chr19,RSPH6A,chr19:45795713-45815308,19595
151733916,151761339,chr3,AADACL2,chr3:151733916-151761339,27423
177519789,177554563,chr5,FAM193B,chr5:177519789-177554563,34774
95196449,95197357,chr2,SLC2AXP1,chr2:95196449-95197357,908
48325080,48326123,chr1,PPP1R8P1,chr1:48325080-48326123,1043
48975543,48975646,chr12,RNU6-940P,chr12:48975543-48975646,103
182140036,182523192,chr2,PDE1A,chr2:182140036-182523192,383156
48995149,48999375,chr12,DDN,chr12:48995149-48999375,4226
86468368,86500259,chr1,CLCA1,chr1:86468368-86500259,31891
159902045,160225299,chr3,IL12A-AS1,chr3:159902045-160225299,323254
49064676,49070025,chr12,RHEBL1,chr12:49064676-49070025,5349
32190766,32195523,chr6,GPSM3,chr6:32190766-32195523,4757
89834308,89912882,chr15,ARPIN-AP3S2,chr15:89834308-89912882,78574
93184122,93320572,chr9,WNK2,chr9:93184122-93320572,136450
37809574,37859592,chr1,MTF1,chr1:37809574-37859592,50018
49086656,49094801,chr12,DHH,chr12:49086656-49094801,8145
166161203,166161968,chr3,MTCO3P38,chr3:166161203-166161968,765
9523223,9538645,chr19,ZNF426,chr19:9523223-9538645,15422
154121003,154257827,chr3,ARHGEF26,chr3:154121003-154257827,136824
144423601,144428563,chr8,VPS28,chr8:144423601-144428563,4962
102630770,102760994,chr4,MANBA,chr4:102630770-102760994,130224
32194843,32224067,chr6,NOTCH4,chr6:32194843-32224067,29224
89850637,89850721,chr15,MIR5094,chr15:89850637-89850721,84
89883931,89884030,chr15,MIR5009,chr15:89883931-89884030,99
89886485,89886591,chr15,RNU6-1111P,chr15:89886485-89886591,106
49127782,49131397,chr12,TUBA1B,chr12:49127782-49131397,3615
89895006,89912952,chr15,ARPIN,chr15:89895006-89912952,17946
52004809,52069059,chr14,NID2,chr14:52004809-52069059,64250
181329049,181331839,chr5,CICP15,chr5:181329049-181331839,2790
157625679,157671480,chr5,SOX30,chr5:157625679-157671480,45801
9604680,9621236,chr19,ZNF561,chr19:9604680-9621236,16556
64833229,65067754,chr1,JAK1,chr1:64833229-65067754,234525
89897576,89897637,chr15,RNU7-111P,chr15:89897576-89897637,61
49700934,49709014,chr17,SLC35B1,chr17:49700934-49709014,8080
60347134,60402883,chr15,ANXA2,chr15:60347134-60402883,55749
128830406,128859274,chr7,FLNC,chr7:128830406-128859274,28868
175477062,175529742,chr5,SFXN1,chr5:175477062-175529742,52680
143381338,143382161,chr3,SLC9A9-AS2,chr3:143381338-143382161,823
147590996,147591835,chr3,NPM1P28,chr3:147590996-147591835,839
160100850,160102793,chr3,BRD7P2,chr3:160100850-160102793,1943
48935723,48957487,chr12,ARF3,chr12:48935723-48957487,21764
141051347,141148611,chr3,SPSB4,chr3:141051347-141148611,97264
196967017,197311173,chr2,ANKRD44,chr2:196967017-197311173,344156
163115429,163116186,chr3,RPS6P4,chr3:163115429-163116186,757
32288526,32371912,chr6,TSBP1,chr6:32288526-32371912,83386
149369022,149377692,chr3,TM4SF1,chr3:149369022-149377692,8670
23520857,23556192,chr14,ZFHX2,chr14:23520857-23556192,35335
149982181,149983308,chr3,TMEM183BP,chr3:149982181-149983308,1127
138101478,138102917,chr3,KRT8P36,chr3:138101478-138102917,1439
23568038,23578790,chr14,JPH4,chr14:23568038-23578790,10752
6709452,6709552,chr12,RNU6-781P,chr12:6709452-6709552,100
148279682,148401084,chr3,LINC02046,chr3:148279682-148401084,121402
169013227,169037998,chr5,SLIT3-AS1,chr5:169013227-169037998,24771
6724014,6731875,chr12,COPS7A,chr12:6724014-6731875,7861
9641807,9675100,chr19,ZNF562,chr19:9641807-9675100,33293
168249522,168830599,chr3,EGFEM1P,chr3:168249522-168830599,581077
115169218,115504957,chr11,CADM1,chr11:115169218-115504957,335739
132582606,132590252,chr9,BARHL1,chr9:132582606-132590252,7646
181471963,181472430,chr5,RPL23AP45,chr5:181471963-181472430,467
91271323,91417844,chr14,CCDC88C,chr14:91271323-91417844,146521
163437569,163446151,chr5,CCNG1,chr5:163437569-163446151,8582
132592997,132670401,chr9,DDX31,chr9:132592997-132670401,77404
183078559,183100008,chr2,DUSP19,chr2:183078559-183100008,21449
49710332,49789180,chr17,FAM117A,chr17:49710332-49789180,78848
130081831,130113227,chr3,ALG1L2,chr3:130081831-130113227,31396
9683294,9684073,chr19,RPS4XP22,chr19:9683294-9684073,779
170952850,170953897,chr3,KLF7P1,chr3:170952850-170953897,1047
152339695,152340990,chr3,TMEM14EP,chr3:152339695-152340990,1295
9751993,9793180,chr19,ZNF846,chr19:9751993-9793180,41187
225399710,225654018,chr2,NYAP2,chr2:225399710-225654018,254308
144262045,144291438,chr8,BOP1,chr8:144262045-144291438,29393
171815586,171900749,chr3,TMEM212-AS1,chr3:171815586-171900749,85163
87338511,87339035,chr2,IGKV3OR2-268,chr2:87338511-87339035,524
143265222,143848485,chr3,SLC9A9,chr3:143265222-143848485,583263
133160219,133226412,chr10,KNDC1,chr10:133160219-133226412,66193
102727274,102730721,chr4,LRRC37A15P,chr4:102727274-102730721,3447
102728746,102730171,chr4,KRT8P46,chr4:102728746-102730171,1425
125710969,125765842,chr2,LINC01889,chr2:125710969-125765842,54873
228475224,228841689,chr2,LINC01807,chr2:228475224-228841689,366465
26171151,26201529,chr7,HNRNPA2B1,chr7:26171151-26201529,30378
101420560,101449664,chr9,ALDOB,chr9:101420560-101449664,29104
170751805,170752788,chr2,EIF2S2P4,chr2:170751805-170752788,983
111940302,111941036,chr2,RTRAFP1,chr2:111940302-111941036,734
102794383,102868896,chr4,UBE2D3,chr4:102794383-102868896,74513
131794961,131801661,chr2,CDRT15P3,chr2:131794961-131801661,6700
187415552,187415818,chr2,GAPDHP59,chr2:187415552-187415818,266
189879609,190203484,chr2,C2orf88,chr2:189879609-190203484,323875
9774497,9774960,chr19,UBE2L4,chr19:9774497-9774960,463
24232422,24239242,chr14,GMPR2,chr14:24232422-24239242,6820
9810267,9827816,chr19,FBXL12,chr19:9810267-9827816,17549
166691187,166691712,chr3,PSAT1P4,chr3:166691187-166691712,525
150741125,150763477,chr3,SIAH2,chr3:150741125-150763477,22352
49788648,49835026,chr17,KAT7,chr17:49788648-49835026,46378
162486541,162486949,chr3,TOMM22P6,chr3:162486541-162486949,408
161308425,161411717,chr2,PSMD14,chr2:161308425-161411717,103292
97904489,97922500,chr9,TRMO,chr9:97904489-97922500,18011
156924119,156924710,chr5,APOOP1,chr5:156924119-156924710,591
131026850,131350465,chr3,NEK11,chr3:131026850-131350465,323615
139035148,139035987,chr5,RPL12P21,chr5:139035148-139035987,839
157671533,157680158,chr5,C5orf52,chr5:157671533-157680158,8625
14966668,14972351,chr11,CALCA,chr11:14966668-14972351,5683
94825961,94826694,chr5,RPL7P18,chr5:94825961-94826694,733
9820141,9820455,chr19,RPL10P15,chr19:9820141-9820455,314
155013755,155018141,chr5,KIF4B,chr5:155013755-155018141,4386
35673928,35681159,chr9,CA9,chr9:35673928-35681159,7231
9834079,9835013,chr19,PIN1-DT,chr19:9834079-9835013,934
14852032,14852944,chr19,OR7A8P,chr19:14852032-14852944,912
47615699,47626395,chr19,BICRA-AS1,chr19:47615699-47626395,10696
178977587,178996206,chr5,GRM6,chr5:178977587-178996206,18619
47713422,47743134,chr19,EHD2,chr19:47713422-47743134,29712
101770109,101780371,chr10,FGF8,chr10:101770109-101780371,10262
173689459,173705849,chr5,LINC01942,chr5:173689459-173705849,16390
133663560,133739955,chr9,SARDH,chr9:133663560-133739955,76395
234952017,235055714,chr2,SH3BP4,chr2:234952017-235055714,103697
144333957,144361286,chr8,SLC52A2,chr8:144333957-144361286,27329
129904465,130186634,chr5,CHSY3,chr5:129904465-130186634,282169
47745546,47757058,chr19,NOP53,chr19:47745546-47757058,11512
32325219,32326178,chr6,HNRNPA1P2,chr6:32325219-32326178,959
32352877,32352983,chr6,RNU6-603P,chr6:32352877-32352983,106
73974672,73982843,chr11,UCP2,chr11:73974672-73982843,8171
32439878,32445046,chr6,HLA-DRA,chr6:32439878-32445046,5168
56511567,56606232,chr5,C5orf67,chr5:56511567-56606232,94665
95391366,95450454,chr5,FAM81B,chr5:95391366-95450454,59088
42155406,42181338,chr6,GUCA1A,chr6:42155406-42181338,25932
30676389,30687895,chr6,PPP1R18,chr6:30676389-30687895,11506
18170477,18223689,chr8,NAT1,chr8:18170477-18223689,53212
116056925,116276803,chr10,GFRA1,chr10:116056925-116276803,219878
94979151,94980893,chr5,MCTP1-AS1,chr5:94979151-94980893,1742
147880726,147906538,chr5,C5orf46,chr5:147880726-147906538,25812
161424332,161985282,chr2,SLC4A10,chr2:161424332-161985282,560950
83865024,83999150,chr1,TTLL7,chr1:83865024-83999150,134126
30696806,30697535,chr6,RPL7P4,chr6:30696806-30697535,729
180590105,180591499,chr5,SCGB3A1,chr5:180590105-180591499,1394
30703067,30713184,chr6,MDC1-AS1,chr6:30703067-30713184,10117
18370607,18371484,chr8,NATP,chr8:18370607-18371484,877
30717435,30725538,chr6,TUBB,chr6:30717435-30725538,8103
70270690,70385312,chr11,PPFIA1,chr11:70270690-70385312,114622
152618965,153223543,chr5,LINC01470,chr5:152618965-153223543,604578
53225724,53251637,chr8,OPRK1,chr8:53225724-53251637,25913
30727709,30742732,chr6,FLOT1,chr6:30727709-30742732,15023
47755853,47755962,chr19,SNORD23,chr19:47755853-47755962,109
47757036,47768840,chr19,NOP53-AS1,chr19:47757036-47768840,11804
132813302,132816786,chr5,SOWAHA,chr5:132813302-132816786,3484
47794467,47794890,chr19,RPL23AP80,chr19:47794467-47794890,423
47801243,47819051,chr19,TPRX1,chr19:47801243-47819051,17808
134928393,134928527,chr5,MTND3P25,chr5:134928393-134928527,134
141207166,141308305,chr8,SLC45A4,chr8:141207166-141308305,101139
49795343,49795669,chr17,SRP14P3,chr17:49795343-49795669,326
47819779,47843330,chr19,CRX,chr19:47819779-47843330,23551
86889569,86889733,chr10,RNU1-19P,chr10:86889569-86889733,164
86935540,86969481,chr10,MMRN2,chr10:86935540-86969481,33941
34929559,34958964,chr5,DNAJC21,chr5:34929559-34958964,29405
49966075,49966176,chr17,RNU6-1313P,chr17:49966075-49966176,101
49968970,49974959,chr17,DLX4,chr17:49968970-49974959,5989
49990005,49995224,chr17,DLX3,chr17:49990005-49995224,5219
57803841,57814913,chr19,ZNF552,chr19:57803841-57814913,11072
86958599,86963258,chr10,SNCG,chr10:86958599-86963258,4659
6772512,6778455,chr12,LAG3,chr12:6772512-6778455,5943
81189593,81222999,chr17,CEP131,chr17:81189593-81222999,33406
154657294,154657563,chr3,DYNLL1P5,chr3:154657294-154657563,269
86965345,86971311,chr10,ADIRF-AS1,chr10:86965345-86971311,5966
57819721,57846238,chr19,ZNF587B,chr19:57819721-57846238,26517
141340505,141344621,chr8,LINC01300,chr8:141340505-141344621,4116
139517434,139539829,chr3,RBP1,chr3:139517434-139539829,22395
86968432,86983934,chr10,ADIRF,chr10:86968432-86983934,15502
141356470,141367286,chr8,GPR20,chr8:141356470-141367286,10816
57826461,57826778,chr19,FKBP1AP1,chr19:57826461-57826778,317
6783854,6784161,chr12,RN7SL380P,chr12:6783854-6784161,307
57849859,57865117,chr19,ZNF587,chr19:57849859-57865117,15258
141459075,141460031,chr8,HNRNPA1P38,chr8:141459075-141460031,956
6786858,6820799,chr12,CD4,chr12:6786858-6820799,33941
55980240,55980540,chr8,RN7SL798P,chr8:55980240-55980540,300
56022019,56022313,chr8,RN7SL323P,chr8:56022019-56022313,294
56073835,56073901,chr8,SNORD54,chr8:56073835-56073901,66
56074592,56075274,chr8,CERNA3,chr8:56074592-56075274,682
56101199,56102267,chr8,NPM1P21,chr8:56101199-56102267,1068
56112942,56113982,chr8,MOS,chr8:56112942-56113982,1040
128161251,128204383,chr9,CIZ1,chr9:128161251-128204383,43132
56160909,56211324,chr8,PLAG1,chr8:56160909-56211324,50415
86992253,87000435,chr10,BMS1P3,chr10:86992253-87000435,8182
68209442,68209778,chr16,RPS12P27,chr16:68209442-68209778,336
67685201,67688334,chr1,GADD45A,chr1:67685201-67688334,3133
57900296,57916610,chr19,ZNF417,chr19:57900296-57916610,16314
168858659,168859130,chr3,RPL21P43,chr3:168858659-168859130,471
87001636,87009905,chr10,AGAP11,chr10:87001636-87009905,8269
137771660,137780882,chr3,LINC01210,chr3:137771660-137780882,9222
68229033,68238102,chr16,ESRP2,chr16:68229033-68238102,9069
87020294,87024730,chr10,FAM25A,chr10:87020294-87024730,4436
56211686,56218809,chr8,CHCHD7,chr8:56211686-56218809,7123
57940833,57947706,chr19,ZNF256,chr19:57940833-57947706,6873
87041238,87041341,chr10,RNU6-529P,chr10:87041238-87041341,103
87094161,87191465,chr10,SHLD2,chr10:87094161-87191465,97304
57958437,57974534,chr19,C19orf18,chr19:57958437-57974534,16097
43650149,43705518,chr1,KDM4A,chr1:43650149-43705518,55369
132750819,132807241,chr5,SEPTIN8,chr5:132750819-132807241,56422
49888175,49888230,chr19,MIR4750,chr19:49888175-49888230,55
49889654,49929539,chr19,IL4I1,chr19:49889654-49929539,39885
87154041,87154369,chr10,RN7SL733P,chr10:87154041-87154369,328
172505508,172523475,chr3,TNFSF10,chr3:172505508-172523475,17967
30743199,30744548,chr6,IER3,chr6:30743199-30744548,1349
27504174,27543207,chr10,RAB18,chr10:27504174-27543207,39033
30743790,30792250,chr6,HCG20,chr6:30743790-30792250,48460
68233426,68233499,chr16,MIR6773,chr16:68233426-68233499,73
30751038,30751289,chr6,RN7SL353P,chr6:30751038-30751289,251
30839526,30848159,chr6,LINC02570,chr6:30839526-30848159,8633
3223324,3231730,chr6,TUBB2B,chr6:3223324-3231730,8406
83979118,83984300,chr1,TTLL7-IT1,chr1:83979118-83984300,5182
68245304,68261058,chr16,PLA2G15,chr16:68245304-68261058,15754
71794232,71837012,chr1,NEGR1-IT1,chr1:71794232-71837012,42780
89394033,89394665,chr1,CAPNS1P1,chr1:89394033-89394665,632
58882868,58931897,chr1,LINC02777,chr1:58882868-58931897,49029
3231403,3303373,chr6,PSMG4,chr6:3231403-3303373,71970
163109152,163361563,chr3,LINC01192,chr3:163109152-163361563,252411
6821624,6829972,chr12,GPR162,chr12:6821624-6829972,8348
31500085,31509648,chr1,LDC1P,chr1:31500085-31509648,9563
133237175,133302022,chr8,NDRG1,chr8:133237175-133302022,64847
208160740,208163589,chr2,CRYGA,chr2:208160740-208163589,2849
120213344,120213631,chr2,MTND4LP14,chr2:120213344-120213631,287
195569628,195572970,chr2,LINC01827,chr2:195569628-195572970,3342
85649417,85708433,chr1,ZNHIT6,chr1:85649417-85708433,59016
3268962,3457050,chr6,SLC22A23,chr6:3268962-3457050,188088
103494241,103495842,chr2,CRLF3P1,chr2:103494241-103495842,1601
121101243,121191490,chr11,TECTA,chr11:121101243-121191490,90247
240435663,240468076,chr2,GPC1,chr2:240435663-240468076,32413
78229599,78369464,chr1,MGC27382,chr1:78229599-78369464,139865
68264516,68301823,chr16,SLC7A6,chr16:68264516-68301823,37307
6828407,6839847,chr12,P3H3,chr12:6828407-6839847,11440
49933064,49933137,chr19,MIR4751,chr19:49933064-49933137,73
49948985,49961172,chr19,SIGLEC11,chr19:49948985-49961172,12187
54641754,54710266,chr1,MROH7,chr1:54641754-54710266,68512
33376108,33674102,chr11,KIAA1549L,chr11:33376108-33674102,297994
162768936,162797972,chr2,KCNH7-AS1,chr2:162768936-162797972,29036
130866250,130916479,chr11,SNX19,chr11:130866250-130916479,50229
49976468,50025946,chr19,VRK3,chr19:49976468-50025946,49478
133087924,133131675,chr10,ADGRA1,chr10:133087924-133131675,43751
230864639,230879248,chr2,ITM2C,chr2:230864639-230879248,14609
81239305,81241310,chr17,NDUFAF8,chr17:81239305-81241310,2005
112149865,112215377,chr10,GPAM,chr10:112149865-112215377,65512
81244811,81295547,chr17,SLC38A10,chr17:81244811-81295547,50736
166569693,166570763,chr3,LINC01326,chr3:166569693-166570763,1070
166160777,166161119,chr3,MTND3P7,chr3:166160777-166161119,342
149938997,149939799,chr3,NPM1P29,chr3:149938997-149939799,802
138796851,138797240,chr3,RPL23AP40,chr3:138796851-138797240,389
170086732,170181749,chr3,PHC3,chr3:170086732-170181749,95017
6839954,6847393,chr12,GNB3,chr12:6839954-6847393,7439
3153497,3157544,chr6,TUBB2A,chr6:3153497-3157544,4047
42155406,42180056,chr6,GUCA1ANB,chr6:42155406-42180056,24650
68284223,68284318,chr16,RNU6-1262P,chr16:68284223-68284318,95
68284503,68310946,chr16,SLC7A6OS,chr16:68284503-68310946,26443
150670658,150672390,chr5,MYOZ3-AS1,chr5:150670658-150672390,1732
75084326,75206267,chr6,COL12A1,chr6:75084326-75206267,121941
73400487,73598189,chr11,FAM168A,chr11:73400487-73598189,197702
173888349,173961980,chr5,CPEB4,chr5:173888349-173961980,73631
68329387,68329529,chr16,RNU4-30P,chr16:68329387-68329529,142
68358327,68448508,chr16,SMPD3,chr16:68358327-68448508,90181
81311270,81330674,chr17,TMEM105,chr17:81311270-81330674,19404
216610342,216610959,chr2,PSMB3P2,chr2:216610342-216610959,617
228753324,228753786,chr2,RPL7L1P10,chr2:228753324-228753786,462
81339183,81345966,chr17,RENO1,chr17:81339183-81345966,6783
81400716,81400778,chr17,MIR4740,chr17:81400716-81400778,62
112283400,112305038,chr10,TECTB,chr10:112283400-112305038,21638
81451104,81451188,chr17,MIR3186,chr17:81451104-81451188,84
81480523,81481570,chr17,LINC01971,chr17:81480523-81481570,1047
14877440,14892231,chr11,CYP2R1,chr11:14877440-14892231,14791
170990823,171231314,chr2,TLK1,chr2:170990823-171231314,240491
81539885,81553961,chr17,FAAP100,chr17:81539885-81553961,14076
112299612,112299688,chr10,MIR6715B,chr10:112299612-112299688,76
112299612,112299690,chr10,MIR6715A,chr10:112299612-112299690,78
112308181,112356574,chr10,GUCY2GP,chr10:112308181-112356574,48393
102837047,102837099,chr4,RNU7-151P,chr4:102837047-102837099,52
67452406,67461752,chr11,CABP4,chr11:67452406-67461752,9346
143184917,143223874,chr4,USP38,chr4:143184917-143223874,38957
6873389,6884741,chr12,RPL13P5,chr12:6873389-6884741,11352
16922915,16934839,chr17,TBC1D27P,chr17:16922915-16934839,11924
68477237,68477570,chr16,RPL35AP33,chr16:68477237-68477570,333
6873569,6914241,chr12,LRRC23,chr12:6873569-6914241,40672
68535515,68535658,chr16,RNU4-36P,chr16:68535515-68535658,143
31318495,31529814,chr10,ZEB1,chr10:31318495-31529814,211319
112961247,113278436,chr11,NCAM1,chr11:112961247-113278436,317189
16929816,16972118,chr17,TNFRSF13B,chr17:16929816-16972118,42302
83899115,83951445,chr16,MLYCD,chr16:83899115-83951445,52330
90851122,90855253,chr1,LINC01763,chr1:90851122-90855253,4131
78303884,78540701,chr1,PTGFR,chr1:78303884-78540701,236817
23047062,23057538,chr14,CDH24,chr14:23047062-23057538,10476
87212669,87264741,chr1,LINC02801,chr1:87212669-87264741,52072
83931311,83966332,chr16,OSGIN1,chr16:83931311-83966332,35021
52573114,52573816,chr1,EEF1GP7,chr1:52573114-52573816,702
87328880,87348923,chr1,LMO4,chr1:87328880-87348923,20043
141228726,141367753,chr3,PXYLP1,chr3:141228726-141367753,139027
16988329,16990177,chr17,LINC02090,chr17:16988329-16990177,1848
80411231,80488095,chr5,FAM151B-DT,chr5:80411231-80488095,76864
17076038,17077752,chr17,MPRIP-AS1,chr17:17076038-17077752,1714
143343460,143343535,chr4,MIR3139,chr4:143343460-143343535,75
17170083,17170189,chr17,RNU6-767P,chr17:17170083-17170189,106
17178414,17178749,chr17,RN7SL775P,chr17:17178414-17178749,335
6200733,6239937,chr4,JAKMIP1-DT,chr4:6200733-6239937,39204
17200995,17206333,chr17,PLD6,chr17:17200995-17206333,5338
173642519,173658194,chr5,LINC01863,chr5:173642519-173658194,15675
150485818,150558211,chr5,NDST1,chr5:150485818-150558211,72393
107201372,107564261,chr7,COG5,chr7:107201372-107564261,362889
52404602,52420836,chr1,PRPF38A,chr1:52404602-52420836,16234
17212212,17237188,chr17,FLCN,chr17:17212212-17237188,24976
36298564,36320637,chr14,MBIP,chr14:36298564-36320637,22073
139495941,139606699,chr4,SETD7,chr4:139495941-139606699,110758
84039918,84040033,chr16,RNA5SP432,chr16:84039918-84040033,115
84117051,84117571,chr16,MBTPS1-DT,chr16:84117051-84117571,520
84122141,84145192,chr16,HSDL1,chr16:84122141-84145192,23051
85156889,85201016,chr1,SYDE2,chr1:85156889-85201016,44127
77088989,77219430,chr1,PIGK,chr1:77088989-77219430,130441
17242010,17242886,chr17,ACTG1P24,chr17:17242010-17242886,876
139546266,139546727,chr4,FTH1P24,chr4:139546266-139546727,461
178922064,178922716,chr5,PIGFP1,chr5:178922064-178922716,652
6884682,6885786,chr12,DSTNP2,chr12:6884682-6885786,1104
88381957,88382725,chr5,RPS3AP22,chr5:88381957-88382725,768
17246616,17281273,chr17,COPS3,chr17:17246616-17281273,34657
235147016,235147500,chr2,CEP19P1,chr2:235147016-235147500,484
139665768,139740745,chr4,MGST2,chr4:139665768-139740745,74977
208142573,208146158,chr2,CRYGB,chr2:208142573-208146158,3585
179911651,180072113,chr5,RNF130,chr5:179911651-180072113,160462
84145287,84178767,chr16,DNAAF1,chr16:84145287-84178767,33480
6913745,6923698,chr12,ENO2,chr12:6913745-6923698,9953
158853755,158854576,chr2,OR7E89P,chr2:158853755-158854576,821
216217045,216220192,chr2,LINC01963,chr2:216217045-216220192,3147
189917254,189917758,chr2,TERF1P6,chr2:189917254-189917758,504
218859805,218874233,chr2,WNT6,chr2:218859805-218874233,14428
53974969,53976031,chr1,HNRNPA3P12,chr1:53974969-53976031,1062
76074746,76634603,chr1,ST6GALNAC3,chr1:76074746-76634603,559857
136818647,136855888,chr3,SLC35G2,chr3:136818647-136855888,37241
36995023,36995585,chr10,ARL6IP1P2,chr10:36995023-36995585,562
37135237,37135343,chr10,RNU6-811P,chr10:37135237-37135343,106
92044496,92106621,chr14,ATXN3,chr14:92044496-92106621,62125
139685127,139685427,chr4,RN7SKP237,chr4:139685127-139685427,300
37248118,37347031,chr10,LINC00993,chr10:37248118-37347031,98913
139698144,139698554,chr4,H3P16,chr4:139698144-139698554,410
60097415,60097976,chr1,PGBD4P8,chr1:60097415-60097976,561
7192538,7742836,chr4,SORCS2,chr4:7192538-7742836,550298
81080790,81081171,chr1,MTND2P30,chr1:81080790-81081171,381
81098267,81099005,chr1,RPL7P10,chr1:81098267-81099005,738
84191138,84197168,chr16,ADAD2,chr16:84191138-84197168,6030
158645822,158672648,chr3,LXN,chr3:158645822-158672648,26826
207074137,207167267,chr2,KLF7,chr2:207074137-207167267,93130
151028422,151047782,chr7,ABCB8,chr7:151028422-151047782,19360
87620803,88685204,chr1,PKN2-AS1,chr1:87620803-88685204,1064401
37297398,37297689,chr10,RN7SL314P,chr10:37297398-37297689,291
37337415,37338871,chr10,TMEM161BP1,chr10:37337415-37338871,1456
37348616,37349572,chr10,VN1R53P,chr10:37348616-37349572,956
133278635,133318823,chr10,TUBGCP2,chr10:133278635-133318823,40188
50025714,50053414,chr19,ZNF473,chr19:50025714-50053414,27700
79325008,79346445,chr1,LINC02792,chr1:79325008-79346445,21437
42162690,42164745,chr1,GUCA2A,chr1:42162690-42164745,2055
145523538,145524415,chr3,LARP7P4,chr3:145523538-145524415,877
172039578,172401669,chr3,FNDC3B,chr3:172039578-172401669,362091
106315544,106349456,chr4,AIMP1,chr4:106315544-106349456,33912
55066359,55215364,chr1,USP24,chr1:55066359-55215364,149005
202073255,202205188,chr2,KIAA2012,chr2:202073255-202205188,131933
156919292,156963226,chr5,TIMD4,chr5:156919292-156963226,43934
84009667,84042795,chr16,SLC38A8,chr16:84009667-84042795,33128
31259967,31332892,chr16,ITGAM,chr16:31259967-31332892,72925
163152251,163153307,chr2,RPL7P61,chr2:163152251-163153307,1056
97056402,97057358,chr5,SETP22,chr5:97056402-97057358,956
85327608,85379014,chr8,CA1,chr8:85327608-85379014,51406
179806398,179838078,chr5,SQSTM1,chr5:179806398-179838078,31680
49969600,49975819,chr19,SIGLEC16,chr19:49969600-49975819,6219
112932625,112933171,chr2,CDK8P2,chr2:112932625-112933171,546
64234584,64239264,chr11,VEGFB,chr11:64234584-64239264,4680
50511600,50514690,chr19,ASPDH,chr19:50511600-50514690,3090
241072169,241102332,chr2,MTERF4,chr2:241072169-241102332,30163
60159687,60160822,chr11,LINC02705,chr11:60159687-60160822,1135
6924463,6942321,chr12,ATN1,chr12:6924463-6942321,17858
60209071,60209156,chr11,MIR6503,chr11:60209071-60209156,85
60492778,60507430,chr11,MS4A12,chr11:60492778-60507430,14652
50516892,50568435,chr19,LRRC4B,chr19:50516892-50568435,51543
112424428,112447572,chr10,ZDHHC6,chr10:112424428-112447572,23144
60515392,60542721,chr11,MS4A13,chr11:60515392-60542721,27329
50621307,50639881,chr19,SYT3,chr19:50621307-50639881,18574
51709062,51709940,chr1,SLC25A6P3,chr1:51709062-51709940,878
79054945,79056055,chr1,PSAT1P3,chr1:79054945-79056055,1110
6942978,6946003,chr12,C12orf57,chr12:6942978-6946003,3025
17303335,17347663,chr17,NT5M,chr17:17303335-17347663,44328
125261794,125367207,chr9,GAPVD1,chr9:125261794-125367207,105413
60185657,60318080,chr11,MS4A4A,chr11:60185657-60318080,132423
175059361,175060031,chr3,EEF1B2P8,chr3:175059361-175060031,670
192774082,192774416,chr2,RPS17P8,chr2:192774082-192774416,334
157162663,157163932,chr3,KRT18P34,chr3:157162663-157163932,1269
50649445,50659310,chr19,C19orf81,chr19:50649445-50659310,9865
164714095,164831480,chr3,LINC01324,chr3:164714095-164831480,117385
230907318,230961066,chr2,GPR55,chr2:230907318-230961066,53748
62454298,62688386,chr1,DOCK7,chr1:62454298-62688386,234088
6943816,6943878,chr12,RNU7-1,chr12:6943816-6943878,62
17383377,17384012,chr17,RPL13P12,chr17:17383377-17384012,635
56097390,56097504,chr4,RNA5SP161,chr4:56097390-56097504,114
17456427,17457259,chr17,TSEN15P1,chr17:17456427-17457259,832
56288485,56288584,chr4,RNU6-197P,chr4:56288485-56288584,99
164978898,165078496,chr3,SI,chr3:164978898-165078496,99598
178938677,178939223,chr5,ZNF454-DT,chr5:178938677-178939223,546
56320719,56321334,chr4,MRPL22P1,chr4:56320719-56321334,615
17476994,17493221,chr17,MED9,chr17:17476994-17493221,16227
50758382,50759192,chr19,GPR32P1,chr19:50758382-50759192,810
6946468,6961316,chr12,PTPN6,chr12:6946468-6961316,14848
149358037,149369653,chr5,PCYOX1L,chr5:149358037-149369653,11616
50770464,50771732,chr19,GPR32,chr19:50770464-50771732,1268
56338287,56387508,chr4,AASDH,chr4:56338287-56387508,49221
50790415,50795219,chr19,ACP4,chr19:50790415-50795219,4804
17494437,17496395,chr17,RASD1,chr17:17494437-17496395,1958
210617571,210619876,chr2,CPS1-IT1,chr2:210617571-210619876,2305
50799032,50799122,chr19,SNORD88B,chr19:50799032-50799122,90
50799442,50799532,chr19,SNORD88A,chr19:50799442-50799532,90
151186188,151186595,chr2,FABP5P10,chr2:151186188-151186595,407
50802328,50802418,chr19,SNORD88C,chr19:50802328-50802418,90
50808874,50818880,chr19,LINC01869,chr19:50808874-50818880,10006
47253827,47313743,chr17,ITGB3,chr17:47253827-47313743,59916
195575977,195737702,chr2,SLC39A10,chr2:195575977-195737702,161725
50819146,50823787,chr19,KLK1,chr19:50819146-50823787,4641
66682164,66811464,chr7,RABGEF1,chr7:66682164-66811464,129300
70389426,70390626,chr10,CEP57L1P1,chr10:70389426-70390626,1200
75252924,75284948,chr6,TMEM30A,chr6:75252924-75284948,32024
70404145,70428618,chr10,EIF4EBP2,chr10:70404145-70428618,24473
169861303,169980495,chr5,INSYN2B,chr5:169861303-169980495,119192
70431936,70447951,chr10,NODAL,chr10:70431936-70447951,16015
136975298,137598379,chr5,SPOCK1,chr5:136975298-137598379,623081
50825289,50837213,chr19,KLK15,chr19:50825289-50837213,11924
31355134,31382999,chr16,ITGAX,chr16:31355134-31382999,27865
70485336,70486325,chr10,YY1P1,chr10:70485336-70486325,989
102770502,102780628,chr11,MMP10,chr11:102770502-102780628,10126
129835233,129973053,chr10,EBF3,chr10:129835233-129973053,137820
41869927,41872241,chr5,OXCT1-AS1,chr5:41869927-41872241,2314
97840912,97923497,chr5,LINC02234,chr5:97840912-97923497,82585
42998273,43002959,chr17,RPL27,chr17:42998273-43002959,4686
132673986,132682678,chr5,IL4,chr5:132673986-132682678,8692
65711996,65719604,chr11,KAT5,chr11:65711996-65719604,7608
107580246,107629170,chr7,BCAP29,chr7:107580246-107629170,48924
15828206,15836328,chr19,UCA1,chr19:15828206-15836328,8122
112541915,112579818,chr2,POLR1B,chr2:112541915-112579818,37903
130020025,130110830,chr10,C10orf143,chr10:130020025-130110830,90805
137569,139067,chr17,SCGB1C2,chr17:137569-139067,1498
130106046,130108481,chr10,CTAGE7P,chr10:130106046-130108481,2435
130131770,130132241,chr10,PPIAP32,chr10:130131770-130132241,471
134967907,135011696,chr5,CATSPER3,chr5:134967907-135011696,43789
130136391,130184521,chr10,GLRX3,chr10:130136391-130184521,48130
7686071,7703502,chr17,WRAP53,chr17:7686071-7703502,17431
75319101,75319980,chr6,HMGB1P39,chr6:75319101-75319980,879
75428407,75428473,chr6,MIR4463,chr6:75428407-75428473,66
75465123,75465570,chr6,UBE2V1P15,chr6:75465123-75465570,447
75473738,75473894,chr6,RNU1-34P,chr6:75473738-75473894,156
35213956,35253079,chr6,SCUBE3,chr6:35213956-35253079,39123
17632088,17632684,chr5,TAF11L13,chr5:17632088-17632684,596
153489615,153813869,chr5,GRIA1,chr5:153489615-153813869,324254
15871667,15871852,chr19,CYP4F36P,chr19:15871667-15871852,185
15821796,15823796,chr19,ZNF861P,chr19:15821796-15823796,2000
35258909,35295985,chr6,ZNF76,chr6:35258909-35295985,37076
15827005,15835853,chr19,LINC01764,chr19:15827005-15835853,8848
13586939,13630859,chr10,PRPF18,chr10:13586939-13630859,43920
170864875,170870208,chr3,RPL22L1,chr3:170864875-170870208,5333
31393335,31426505,chr16,ITGAD,chr16:31393335-31426505,33170
36334453,36379201,chr19,ZFP14,chr19:36334453-36379201,44748
42541155,42555195,chr8,SMIM19,chr8:42541155-42555195,14040
36383120,36418644,chr19,ZFP82,chr19:36383120-36418644,35524
172889357,173141235,chr3,SPATA16,chr3:172889357-173141235,251878
38178245,38230670,chr7,STARD3NL,chr7:38178245-38230670,52425
36489649,36491040,chr19,ZNF566-AS1,chr19:36489649-36491040,1391
36496916,36498159,chr19,CTBP2P7,chr19:36496916-36498159,1243
36510687,36528271,chr19,ZNF260,chr19:36510687-36528271,17584
6963246,6964447,chr12,MIR200CHG,chr12:6963246-6964447,1201
6963699,6963766,chr12,MIR200C,chr12:6963699-6963766,67
6964097,6964191,chr12,MIR141,chr12:6964097-6964191,94
6967337,6967606,chr12,SCARNA12,chr12:6967337-6967606,269
6970913,6997428,chr12,EMG1,chr12:6970913-6997428,26515
49132460,49176840,chr17,B4GALNT2,chr17:49132460-49176840,44380
115408496,115809673,chr8,TRPS1,chr8:115408496-115809673,401177
36534774,36605276,chr19,ZNF529,chr19:36534774-36605276,70502
31427731,31428360,chr16,COX6A2,chr16:31427731-31428360,629
169447867,169477052,chr3,MECOM-AS1,chr3:169447867-169477052,29185
56356135,56356932,chr4,RPL7AP31,chr4:56356135-56356932,797
13591460,13592323,chr10,RPL6P24,chr10:13591460-13592323,863
31432593,31443160,chr16,ZNF843,chr16:31432593-31443160,10567
56393362,56435615,chr4,PPAT,chr4:56393362-56435615,42253
94318198,94328644,chr9,NUTM2F,chr9:94318198-94328644,10446
11011708,11012006,chr19,RN7SL192P,chr19:11011708-11012006,298
31458080,31467166,chr16,ARMC5,chr16:31458080-31467166,9086
138187248,138298384,chr3,ARMC8,chr3:138187248-138298384,111136
11089462,11133820,chr19,LDLR,chr19:11089462-11133820,44358
34579487,34639318,chr17,TMEM132E,chr17:34579487-34639318,59831
6867119,6870948,chr12,TPI1,chr12:6867119-6870948,3829
14081843,14398983,chr9,NFIB,chr9:14081843-14398983,317140
35297818,35321771,chr6,DEF6,chr6:35297818-35321771,23953
65714005,65720818,chr11,RNASEH2C,chr11:65714005-65720818,6813
99876958,99919531,chr7,TRIM4,chr7:99876958-99919531,42573
43006740,43014456,chr17,IFI35,chr17:43006740-43014456,7716
31471585,31477960,chr16,TGFB1I1,chr16:31471585-31477960,6375
74097040,74099196,chr4,CXCL2,chr4:74097040-74099196,2156
35342558,35428191,chr6,PPARD,chr6:35342558-35428191,85633
74308470,74316789,chr4,EPGN,chr4:74308470-74316789,8319
13727796,13727916,chr10,RNA5SP301,chr10:13727796-13727916,120
65726939,65728214,chr11,KRT8P26,chr11:65726939-65728214,1275
22440819,22541142,chr8,PPP3CC,chr8:22440819-22541142,100323
130344816,130368730,chr7,CPA5,chr7:130344816-130368730,23914
65773898,65780976,chr11,AP5B1,chr11:65773898-65780976,7078
112374116,112428379,chr10,ACSL5,chr10:112374116-112428379,54263
65787063,65797214,chr11,OVOL1,chr11:65787063-65797214,10151
236165236,236168386,chr2,GBX2,chr2:236165236-236168386,3150
65789051,65790868,chr11,OVOL1-AS1,chr11:65789051-65790868,1817
21197954,21214176,chr17,TMEM11,chr17:21197954-21214176,16222
159056005,159056859,chr2,GSTM3P2,chr2:159056005-159056859,854
111443485,111599676,chr12,ATXN2,chr12:111443485-111599676,156191
65823022,65862026,chr11,CFL1,chr11:65823022-65862026,39004
187464230,187565760,chr2,TFPI,chr2:187464230-187565760,101530
45784280,45835828,chr17,CRHR1,chr17:45784280-45835828,51548
35443044,35449847,chr6,MKRN6P,chr6:35443044-35449847,6803
35452338,35467102,chr6,FANCE,chr6:35452338-35467102,14764
35468401,35470785,chr6,RPL10A,chr6:35468401-35470785,2384
107989714,108035241,chr4,HADH,chr4:107989714-108035241,45527
35470508,35470579,chr6,MIR7111,chr6:35470508-35470579,71
35473597,35497079,chr6,TEAD3,chr6:35473597-35497079,23482
65833834,65856896,chr11,SNX32,chr11:65833834-65856896,23062
79817349,79817450,chr15,RNU6-667P,chr15:79817349-79817450,101
79833585,79897379,chr15,MTHFS,chr15:79833585-79897379,63794
164448161,164467879,chr5,LINC02143,chr5:164448161-164467879,19718
130293822,130294405,chr2,RPL19P4,chr2:130293822-130294405,583
161500885,161507705,chr2,AHCTF1P1,chr2:161500885-161507705,6820
163446526,163460102,chr5,NUDCD2,chr5:163446526-163460102,13576
132416805,132646582,chr2,GPR39,chr2:132416805-132646582,229777
130730697,130734207,chr7,KLF14,chr7:130730697-130734207,3510
207120884,207122044,chr2,KLF7-IT1,chr2:207120884-207122044,1160
66628881,66649067,chr7,KCTD7,chr7:66628881-66649067,20186
241551424,241574131,chr2,BOK,chr2:241551424-241574131,22707
150475531,150485968,chr5,NDST1-AS1,chr5:150475531-150485968,10437
79845150,79923754,chr15,ST20-MTHFS,chr15:79845150-79923754,78604
167284799,168264157,chr5,TENM2,chr5:167284799-168264157,979358
43034194,43085788,chr8,FNTA,chr8:43034194-43085788,51594
79898840,79923702,chr15,ST20,chr15:79898840-79923702,24862
176495255,176819180,chr2,LINC01117,chr2:176495255-176819180,323925
65857126,65867653,chr11,MUS81,chr11:65857126-65867653,10527
79922771,79926993,chr15,ST20-AS1,chr15:79922771-79926993,4222
203867771,203873965,chr2,CTLA4,chr2:203867771-203873965,6194
35497874,35512896,chr6,TULP1,chr6:35497874-35512896,15022
98211439,98215457,chr7,BHLHA15,chr7:98211439-98215457,4018
99027440,99144108,chr7,SMURF1,chr7:99027440-99144108,116668
80059568,80138393,chr15,ZFAND6,chr15:80059568-80138393,78825
11113474,11113534,chr19,MIR6886,chr19:11113474-11113534,60
14863714,14867358,chr19,OR7A2P,chr19:14863714-14867358,3644
40369846,40369907,chr19,MIR6796,chr19:40369846-40369907,61
40379271,40390181,chr19,HIPK4,chr19:40379271-40390181,10910
40421589,40425992,chr19,SERTAD1,chr19:40421589-40425992,4403
89592747,89592827,chr10,MIR107,chr10:89592747-89592827,80
130337933,130342699,chr2,CCDC115,chr2:130337933-130342699,4766
40440844,40444335,chr19,SERTAD3,chr19:40440844-40444335,3491
43073474,43073618,chr8,RNU1-124P,chr8:43073474-43073618,144
42997563,42997681,chr10,MIR5100,chr10:42997563-42997681,118
42871521,42874060,chr10,LINC02623,chr10:42871521-42874060,2539
42979017,42981507,chr10,LINC01264,chr10:42979017-42981507,2490
43140464,43202855,chr8,HGSNAT,chr8:43140464-43202855,62391
40443436,40444087,chr19,SERTAD3-AS1,chr19:40443436-40444087,651
146110566,146182696,chr5,LARS1,chr5:146110566-146182696,72130
43077064,43130351,chr10,RET,chr10:43077064-43130351,53287
42902086,42919563,chr19,PSG6,chr19:42902086-42919563,17477
161340816,161341326,chr2,MXRA7P1,chr2:161340816-161341326,510
229003886,229004400,chr2,RPL17P14,chr2:229003886-229004400,514
31483002,31490860,chr16,SLC5A2,chr16:31483002-31490860,7858
171783405,171999859,chr2,SLC25A12,chr2:171783405-171999859,216454
2096429,2099593,chr19,IZUMO4,chr19:2096429-2099593,3164
75980790,76005942,chr4,SDAD1-AS1,chr4:75980790-76005942,25152
76001275,76007509,chr4,CXCL9,chr4:76001275-76007509,6234
65879809,65883741,chr11,CTSW,chr11:65879809-65883741,3932
6794134,6826770,chr7,CCZ1B,chr7:6794134-6826770,32636
76011184,76112802,chr4,ART3,chr4:76011184-76112802,101618
35664717,35664789,chr6,MIR5690,chr6:35664717-35664789,72
158972871,159000202,chr6,RSPH3,chr6:158972871-159000202,27331
43219960,43220809,chr8,VN1R46P,chr8:43219960-43220809,849
159034468,159045152,chr6,TAGAP,chr6:159034468-159045152,10684
43270198,43271960,chr8,AFG3L2P1,chr8:43270198-43271960,1762
31489471,31509309,chr16,RUSF1,chr16:31489471-31509309,19838
43292483,43363518,chr8,POTEA,chr8:43292483-43363518,71035
99271168,99350062,chr6,FAXC,chr6:99271168-99350062,78894
210002565,210022260,chr2,RPE,chr2:210002565-210022260,19695
91949731,91950034,chr11,TUBB4BP4,chr11:91949731-91950034,303
92161106,92161889,chr11,RPL7AP57,chr11:92161106-92161889,783
92336032,92336496,chr11,NDUFB11P1,chr11:92336032-92336496,464
92366496,92367250,chr11,PGAM1P9,chr11:92366496-92367250,754
99369401,99394195,chr6,COQ3,chr6:99369401-99394195,24794
92498152,92498935,chr11,RPS3AP42,chr11:92498152-92498935,783
4905989,4959213,chr7,MMD2,chr7:4905989-4959213,53224
92913227,92915644,chr11,LINC02746,chr11:92913227-92915644,2417
99397629,99425331,chr6,PNISR,chr6:99397629-99425331,27702
92937441,92937666,chr11,SNRPGP16,chr11:92937441-92937666,225
43303376,43303482,chr8,RNU6-104P,chr8:43303376-43303482,106
42124978,42155044,chr17,RAB5C,chr17:42124978-42155044,30066
92969651,92985066,chr11,MTNR1B,chr11:92969651-92985066,15415
49054311,49076093,chr8,PPDPFL,chr8:49054311-49076093,21782
43136824,43138334,chr10,CSGALNACT2-DT,chr10:43136824-43138334,1510
93052395,93052827,chr11,RPL26P31,chr11:93052395-93052827,432
43138445,43185302,chr10,CSGALNACT2,chr10:43138445-43185302,46857
39202825,39204263,chr19,SYCN,chr19:39202825-39204263,1438
93144174,93197991,chr11,SLC36A4,chr11:93144174-93197991,53817
14583084,14612035,chr19,CLEC17A,chr19:14583084-14612035,28951
110873263,111038470,chr9,LPAR1,chr9:110873263-111038470,165207
43194535,43267065,chr10,RASGEF1A,chr10:43194535-43267065,72530
22118236,22357154,chr7,RAPGEF5,chr7:22118236-22357154,238918
99432325,99521728,chr6,USP45,chr6:99432325-99521728,89403
737628,1708476,chr8,DLGAP2,chr8:737628-1708476,970848
31527900,31528803,chr16,AHSP,chr16:31527900-31528803,903
3636459,3663103,chr17,CTNS,chr17:3636459-3663103,26644
43323665,43327932,chr10,LINC02633,chr10:43323665-43327932,4267
43341786,43341910,chr10,RNU6ATAC11P,chr10:43341786-43341910,124
69778962,69779838,chr10,RPL5P26,chr10:69778962-69779838,876
110365248,110579880,chr9,SVEP1,chr9:110365248-110579880,214632
31542748,31553604,chr16,LINC02190,chr16:31542748-31553604,10856
76021118,76023497,chr4,CXCL10,chr4:76021118-76023497,2379
69801880,69964275,chr10,COL13A1,chr10:69801880-69964275,162395
31546805,31547737,chr16,VN1R64P,chr16:31546805-31547737,932
31554105,31554912,chr16,VN1R65P,chr16:31554105-31554912,807
92224818,92896473,chr11,FAT3,chr11:92224818-92896473,671655
31563082,31567716,chr16,FRG2KP,chr16:31563082-31567716,4634
49340595,49362457,chr19,TEAD2,chr19:49340595-49362457,21862
76033682,76041415,chr4,CXCL11,chr4:76033682-76041415,7733
31568386,31569475,chr16,YBX3P1,chr16:31568386-31569475,1089
31601593,31603531,chr16,ZNF720P1,chr16:31601593-31603531,1938
31648307,31649222,chr16,VN1R66P,chr16:31648307-31649222,915
29858357,29863414,chr16,CDIPT,chr16:29858357-29863414,5057
22298594,22298706,chr7,RNA5SP227,chr7:22298594-22298706,112
22510616,22511999,chr7,EEF1A1P6,chr7:22510616-22511999,1383
22725395,22727620,chr7,IL6-AS1,chr7:22725395-22727620,2225
76114659,76148444,chr4,NUP54,chr4:76114659-76148444,33785
22725884,22732002,chr7,IL6,chr7:22725884-22732002,6118
43093498,43131180,chr8,POMK,chr8:43093498-43131180,37682
132162058,132244526,chr9,NTNG2,chr9:132162058-132244526,82468
102789401,102798160,chr11,MMP1,chr11:102789401-102798160,8759
133205277,133209250,chr9,OBP2B,chr9:133205277-133209250,3973
48724763,48728750,chr17,HOXB13,chr17:48724763-48728750,3987
30368148,30368646,chr11,RPL12P30,chr11:30368148-30368646,498
30384493,30586872,chr11,MPPED2,chr11:30384493-30586872,202379
15565483,15619704,chr17,CDRT1,chr17:15565483-15619704,54221
110668779,110806558,chr9,MUSK,chr9:110668779-110806558,137779
166181313,166181820,chr3,MCUR1P2,chr3:166181313-166181820,507
22747675,22748804,chr7,MTCYBP42,chr7:22747675-22748804,1129
141876124,141926549,chr3,ATP1B3,chr3:141876124-141926549,50425
22856613,22856686,chr7,SNORD93,chr7:22856613-22856686,73
22881893,22882390,chr7,RPL12P10,chr7:22881893-22882390,497
79960892,79971196,chr15,BCL2A1,chr15:79960892-79971196,10304
100889994,100896974,chr7,ACHE,chr7:100889994-100896974,6980
71669520,71670297,chr11,RPS3AP41,chr11:71669520-71670297,777
132775358,132848807,chr8,PHF20L1,chr8:132775358-132848807,73449
49575871,49583827,chr17,NXPH3,chr17:49575871-49583827,7956
71690453,71690657,chr11,SNRPCP14,chr11:71690453-71690657,204
64963022,64990310,chr15,SPG21,chr15:64963022-64990310,27288
71711740,71781183,chr11,ENPP7P8,chr11:71711740-71781183,69443
39461486,39564907,chr17,CDK12,chr17:39461486-39564907,103421
125746279,125749867,chr11,PATE1,chr11:125746279-125749867,3588
125776113,125778828,chr11,PATE2,chr11:125776113-125778828,2715
136752630,136755780,chr3,STAG1-DT,chr3:136752630-136755780,3150
166160021,166160370,chr3,MTND4P17,chr3:166160021-166160370,349
169709295,169709765,chr3,SDHDP3,chr3:169709295-169709765,470
125788127,125791600,chr11,PATE3,chr11:125788127-125791600,3473
29863593,29868053,chr16,CDIPTOSP,chr16:29863593-29868053,4460
158644527,158695581,chr3,GFM1,chr3:158644527-158695581,51054
125833316,125840072,chr11,PATE4,chr11:125833316-125840072,6756
131125586,131234663,chr9,NUP214,chr9:131125586-131234663,109077
101815904,102283958,chr7,CUX1,chr7:101815904-102283958,468054
99520976,99589899,chr6,TSTD3,chr6:99520976-99589899,68923
235494043,236131800,chr2,AGAP1,chr2:235494043-236131800,637757
76214040,76283783,chr4,FAM47E,chr4:76214040-76283783,69743
125883614,125900646,chr11,HYLS1,chr11:125883614-125900646,17032
29900375,29919864,chr16,ASPHD1,chr16:29900375-29919864,19489
77881348,77889539,chr1,NEXN-AS1,chr1:77881348-77889539,8191
99542387,99568825,chr6,CCNC,chr6:99542387-99568825,26438
125893485,125903221,chr11,PUS3,chr11:125893485-125903221,9736
71395943,72282539,chr1,NEGR1,chr1:71395943-72282539,886596
55158661,55166722,chr19,DNAAF3,chr19:55158661-55166722,8061
125903348,125943702,chr11,DDX25,chr11:125903348-125943702,40354
88577880,88578201,chr1,RPL36AP10,chr1:88577880-88578201,321
83445967,83480024,chr1,LINC01712,chr1:83445967-83480024,34057
76251721,76311129,chr4,FAM47E-STBD1,chr4:76251721-76311129,59408
47941506,47949308,chr17,PNPO,chr17:47941506-47949308,7802
46394317,46413848,chr1,FAAH,chr1:46394317-46413848,19531
76306733,76311130,chr4,STBD1,chr4:76306733-76311130,4397
29905012,29926236,chr16,KCTD13,chr16:29905012-29926236,21224
76344550,76345590,chr4,SNX5P1,chr4:76344550-76345590,1040
76356610,76356715,chr4,RNU6-1000P,chr4:76356610-76356715,105
76158737,76234536,chr4,SCARB2,chr4:76158737-76234536,75799
171843349,171938715,chr3,TMEM212,chr3:171843349-171938715,95366
119557086,119673453,chr8,ENPP2,chr8:119557086-119673453,116367
150659885,150703971,chr3,ERICH6,chr3:150659885-150703971,44086
88935773,88992953,chr1,KYAT3,chr1:88935773-88992953,57180
65001512,65029639,chr15,MTFMT,chr15:65001512-65029639,28127
22625075,22690665,chr12,ETNK1,chr12:22625075-22690665,65590
29926836,29928933,chr16,KCTD13-DT,chr16:29926836-29928933,2097
2100988,2164468,chr19,AP3D1,chr19:2100988-2164468,63480
30064164,30070457,chr16,ALDOA,chr16:30064164-30070457,6293
155870650,155944020,chr3,GMPS,chr3:155870650-155944020,73370
65045387,65053397,chr15,SLC51B,chr15:65045387-65053397,8010
126067539,126068601,chr11,NAP1L1P1,chr11:126067539-126068601,1062
75957833,75958130,chr12,RN7SL734P,chr12:75957833-75958130,297
4143168,4187310,chr17,CYB5D2,chr17:4143168-4187310,44142
76030494,76031378,chr12,PHLDA1-AS1,chr12:76030494-76031378,884
76032658,76033897,chr12,PHLDA1-DT,chr12:76032658-76033897,1239
65053337,65076690,chr15,RASL12,chr15:65053337-65076690,23353
126202096,126211692,chr11,RPUSD4,chr11:126202096-126211692,9596
52633168,52669683,chr1,SHISAL2A,chr1:52633168-52669683,36515
195582794,195584031,chr2,AHCYP5,chr2:195582794-195584031,1237
76036585,76084735,chr12,NAP1L1,chr12:76036585-76084735,48150
80283352,80283970,chr1,HMGB1P18,chr1:80283352-80283970,618
86571181,86696311,chr1,CLCA4-AS1,chr1:86571181-86696311,125130
3510502,3557812,chr17,TRPV3,chr17:3510502-3557812,47310
93866284,93879918,chr1,DNTTIP2,chr1:93866284-93879918,13634
65117379,65133808,chr15,PDCD7,chr15:65117379-65133808,16429
178194481,178402893,chr2,OSBPL6,chr2:178194481-178402893,208412
167065831,167066320,chr3,PPIAP74,chr3:167065831-167066320,489
126214260,126214478,chr11,RNU4-86P,chr11:126214260-126214478,218
141470634,141471902,chr3,KRT18P35,chr3:141470634-141471902,1268
9573670,9593457,chr11,WEE1,chr11:9573670-9593457,19787
172560888,172595607,chr3,LINC02068,chr3:172560888-172595607,34719
175773145,175776333,chr3,NAALADL2-AS1,chr3:175773145-175776333,3188
167958744,167959082,chr3,HMGN2P26,chr3:167958744-167959082,338
65148219,65185342,chr15,CLPX,chr15:65148219-65185342,37123
80451083,80452004,chr1,HNRNPA1P64,chr1:80451083-80452004,921
128153481,128408646,chr3,EEFSEC,chr3:128153481-128408646,255165
86346824,86396342,chr1,ODF2L,chr1:86346824-86396342,49518
60906789,60909742,chr11,PRPF19-DT,chr11:60906789-60909742,2953
60913166,60914052,chr11,TMEM109-DT,chr11:60913166-60914052,886
176415439,176867838,chr3,LINC01208,chr3:176415439-176867838,452399
60914158,60923443,chr11,TMEM109,chr11:60914158-60923443,9285
174302944,174303287,chr3,ANAPC15P2,chr3:174302944-174303287,343
60924460,60937159,chr11,TMEM132A,chr11:60924460-60937159,12699
170996347,171026743,chr3,SLC2A2,chr3:170996347-171026743,30396
44678420,44700928,chr4,GUF1,chr4:44678420-44700928,22508
60971680,61020377,chr11,CD6,chr11:60971680-61020377,48697
65194760,65211473,chr15,CILP,chr15:65194760-65211473,16713
44682200,44726588,chr4,GNPDA2,chr4:44682200-44726588,44388
177592203,177597242,chr5,TMED9,chr5:177592203-177597242,5039
165186720,165197109,chr3,SLITRK3,chr3:165186720-165197109,10389
130034553,130035539,chr3,OR7E21P,chr3:130034553-130035539,986
65229861,65229967,chr15,RNU6-686P,chr15:65229861-65229967,106
65285461,65285591,chr15,SNORA24B,chr15:65285461-65285591,130
65296051,65296166,chr15,RNU5A-1,chr15:65296051-65296166,115
130111669,130201336,chr3,LINC02021,chr3:130111669-130201336,89667
23562062,23562131,chr15,MIR4508,chr15:23562062-23562131,69
23643549,23647867,chr15,MAGEL2,chr15:23643549-23647867,4318
23685400,23687305,chr15,NDN,chr15:23685400-23687305,1905
23777437,23777543,chr15,RNU6-741P,chr15:23777437-23777543,106
177441910,177767379,chr3,LINC00578,chr3:177441910-177767379,325469
69278328,69298795,chr15,PAQR5-DT,chr15:69278328-69298795,20467
38386207,38409527,chr8,LETM2,chr8:38386207-38409527,23320
151173981,151180617,chr5,PDGFRL2P,chr5:151173981-151180617,6636
69298912,69407780,chr15,PAQR5,chr15:69298912-69407780,108868
130140031,130141950,chr5,HSPA8P4,chr5:130140031-130141950,1919
74114174,74303099,chr4,MTHFD2L,chr4:74114174-74303099,188925
170495627,170496636,chr3,KRT8P13,chr3:170495627-170496636,1009
169003022,169038416,chr3,LINC01997,chr3:169003022-169038416,35394
178204533,178211163,chr5,HNRNPAB,chr5:178204533-178211163,6630
140941830,140980995,chr3,SLC25A36,chr3:140941830-140980995,39165
69396904,69415029,chr15,KIF23-AS1,chr15:69396904-69415029,18125
50505998,50511220,chr19,JOSD2,chr19:50505998-50511220,5222
134903232,134917912,chr9,FCN1,chr9:134903232-134917912,14680
69452814,69456205,chr15,RPLP1,chr15:69452814-69456205,3391
1771890,1773150,chr16,MRPS34,chr16:1771890-1773150,1260
128411751,128437351,chr9,CERCAM,chr9:128411751-128437351,25600
43525187,43623666,chr1,PTPRF,chr1:43525187-43623666,98479
45733439,45764541,chr19,MEIOSIN,chr19:45733439-45764541,31102
3769089,3772228,chr19,RAX2,chr19:3769089-3772228,3139
1776712,1793700,chr16,SPSB3,chr16:1776712-1793700,16988
153158938,153159683,chr2,ATP5PBP4,chr2:153158938-153159683,745
23221599,23250394,chr19,ZNF724,chr19:23221599-23250394,28795
60985061,60985167,chr11,RNU6-933P,chr11:60985061-60985167,106
183260642,183261046,chr2,LIN28AP1,chr2:183260642-183261046,404
189923336,189924216,chr2,HNRNPCP2,chr2:189923336-189924216,880
1569268,1628886,chr17,SLC43A2,chr17:1569268-1628886,59618
60937060,60952653,chr11,SLC15A3,chr11:60937060-60952653,15593
170357678,170396835,chr3,SKIL,chr3:170357678-170396835,39157
210431249,210477652,chr2,LANCL1,chr2:210431249-210477652,46403
69458522,69461806,chr15,LINC02896,chr15:69458522-69461806,3284
45407334,45478828,chr19,ERCC1,chr19:45407334-45478828,71494
112818032,113384221,chr4,ANK2,chr4:112818032-113384221,566189
69414246,69448427,chr15,KIF23,chr15:69414246-69448427,34181
151314972,151347590,chr5,SLC36A2,chr5:151314972-151347590,32618
22419444,22727613,chr7,STEAP1B,chr7:22419444-22727613,308169
3599595,3600706,chr11,OR7E117P,chr11:3599595-3600706,1111
3638512,3642316,chr11,ART5,chr11:3638512-3642316,3804
152835131,152841439,chr3,P2RY1,chr3:152835131-152841439,6308
138825063,138826329,chr3,EEF1A1P25,chr3:138825063-138826329,1266
175079307,175115242,chr3,NAALADL2-AS3,chr3:175079307-175115242,35935
180100795,180209211,chr5,RASGEF1C,chr5:180100795-180209211,108416
123851987,124120061,chr8,FER1L6,chr8:123851987-124120061,268074
3645128,3664416,chr11,ART1,chr11:3645128-3664416,19288
106090505,106112576,chr7,SYPL1,chr7:106090505-106112576,22071
180868141,180982753,chr3,FXR1,chr3:180868141-180982753,114612
1782932,1789186,chr16,NUBP2,chr16:1782932-1789186,6254
3665587,3671384,chr11,CHRNA10,chr11:3665587-3671384,5797
66946501,66962591,chr8,TCF24,chr8:66946501-66962591,16090
40015361,40017813,chr17,CSF3,chr17:40015361-40017813,2452
76611376,76906114,chr9,PRUNE2,chr9:76611376-76906114,294738
67043079,67083783,chr8,COPS5,chr8:67043079-67083783,40704
3671083,3797792,chr11,NUP98,chr11:3671083-3797792,126709
106125371,106126700,chr7,DCAF13P1,chr7:106125371-106126700,1329
106208167,106208267,chr7,RNU6-392P,chr7:106208167-106208267,100
106315225,106315743,chr7,LARP1BP2,chr7:106315225-106315743,518
46652915,46678190,chr6,SLC25A27,chr6:46652915-46678190,25275
177554824,177555364,chr5,FAM193B-DT,chr5:177554824-177555364,540
106248298,106285966,chr7,NAMPT,chr7:106248298-106285966,37668
4987789,5070314,chr5,LINC01020,chr5:4987789-5070314,82525
40058290,40093867,chr17,THRA,chr17:40058290-40093867,35577
137877782,138124624,chr9,CACNA1B,chr9:137877782-138124624,246842
46687875,46704319,chr6,TDRD6,chr6:46687875-46704319,16444
170928464,170967130,chr2,GORASP2,chr2:170928464-170967130,38666
46704201,46735693,chr6,PLA2G7,chr6:46704201-46735693,31492
178895898,178933212,chr5,ZFP2,chr5:178895898-178933212,37314
14433053,14471867,chr19,PKN1,chr19:14433053-14471867,38814
67099302,67099425,chr8,RNA5SP268,chr8:67099302-67099425,123
67173511,67343781,chr8,ARFGEF1,chr8:67173511-67343781,170270
9511333,9518086,chr5,SEMA5A-AS1,chr5:9511333-9518086,6753
39571478,39572639,chr5,CFAP53P1,chr5:39571478-39572639,1161
181378695,181379038,chr5,WBP1LP4,chr5:181378695-181379038,343
238510690,238555054,chr2,LINC01107,chr2:238510690-238555054,44364
46852522,46954943,chr6,ADGRF5,chr6:46852522-46954943,102421
169583636,169604778,chr5,SPDL1,chr5:169583636-169604778,21142
128091200,128195677,chr2,UGGT1,chr2:128091200-128195677,104477
136903167,136903294,chr7,MIR490,chr7:136903167-136903294,127
136938280,136938553,chr7,KRT8P51,chr7:136938280-136938553,273
1790413,1794971,chr16,IGFALS,chr16:1790413-1794971,4558
136868652,137020255,chr7,CHRM2,chr7:136868652-137020255,151603
17042457,17217679,chr17,MPRIP,chr17:17042457-17217679,175222
1795620,1827157,chr16,HAGH,chr16:1795620-1827157,31537
138876359,138876465,chr7,RNU6-1272P,chr7:138876359-138876465,106
139025706,139036042,chr7,ZC3HAV1L,chr7:139025706-139036042,10336
139043515,139132122,chr7,ZC3HAV1,chr7:139043515-139132122,88607
46903471,46909078,chr6,ADGRF5-AS1,chr6:46903471-46909078,5607
94374569,94461042,chr9,MFSD14B,chr9:94374569-94461042,86473
31897785,31945672,chr6,C2,chr6:31897785-31945672,47887
175718231,175718670,chr3,UBE2V1P2,chr3:175718231-175718670,439
150541998,150603228,chr3,SERP1,chr3:150541998-150603228,61230
35561831,35563899,chr9,FAM166B,chr9:35561831-35563899,2068
21804946,21852125,chr19,ZNF43,chr19:21804946-21852125,47179
54849627,54887195,chr1,DHCR24,chr1:54849627-54887195,37568
173778527,173809039,chr5,LINC01485,chr5:173778527-173809039,30512
67343975,67345087,chr8,ARFGEF1-DT,chr8:67343975-67345087,1112
172828736,172829176,chr3,ATP5MC1P4,chr3:172828736-172829176,440
141600276,141600579,chr3,YWHAQP6,chr3:141600276-141600579,303
130529419,130529889,chr5,ARL2BPP4,chr5:130529419-130529889,470
143684452,143713898,chr8,ZNF707,chr8:143684452-143713898,29446
95440044,95440687,chr5,RTRAFP2,chr5:95440044-95440687,643
177971316,177972281,chr5,SUDS3P1,chr5:177971316-177972281,965
139133744,139191986,chr7,TTC26,chr7:139133744-139191986,58242
35649295,35650931,chr9,SIT1,chr9:35649295-35650931,1636
39718984,39721513,chr5,INTS6P1,chr5:39718984-39721513,2529
163483065,163494058,chr5,HMMR-AS1,chr5:163483065-163494058,10993
139448560,139462743,chr5,ECSCR,chr5:139448560-139462743,14183
46838136,46850846,chr19,AP2S1,chr19:46838136-46850846,12710
171058414,171460408,chr3,TNIK,chr3:171058414-171460408,401994
35609982,35646810,chr9,CD72,chr9:35609982-35646810,36828
158127957,158133988,chr2,UPP2-IT1,chr2:158127957-158133988,6031
160347754,160370641,chr5,C1QTNF2,chr5:160347754-160370641,22887
130313934,130314411,chr2,TEKT4P3,chr2:130313934-130314411,477
145826285,145827830,chr2,METAP2P1,chr2:145826285-145827830,1545
153337705,153357422,chr2,LINC01850,chr2:153337705-153357422,19717
73228010,73233239,chr2,PRADC1,chr2:73228010-73233239,5229
151212150,151270440,chr5,GM2A,chr5:151212150-151270440,58290
1878285,1884233,chr16,LINC00254,chr16:1878285-1884233,5948
1889114,1890434,chr16,LINC02124,chr16:1889114-1890434,1320
5069192,5078311,chr5,LINC02121,chr5:5069192-5078311,9119
1911475,1918415,chr16,HS3ST6,chr16:1911475-1918415,6940
153420677,153421957,chr2,TUBAP13,chr2:153420677-153421957,1280
41883173,41930150,chr19,ARHGEF1,chr19:41883173-41930150,46977
236567787,236582354,chr2,ACKR3,chr2:236567787-236582354,14567
150690792,150701077,chr5,RBM22,chr5:150690792-150701077,10285
70687439,70801160,chr16,VAC14,chr16:70687439-70801160,113721
159689217,159690291,chr2,RPS3AP13,chr2:159689217-159690291,1074
127257290,127294166,chr2,ERCC3,chr2:127257290-127294166,36876
3714772,3714875,chr11,RNU6-1143P,chr11:3714772-3714875,103
3781395,3781456,chr11,RNU7-50P,chr11:3781395-3781456,61
84668375,85095751,chr9,NTRK2,chr9:84668375-85095751,427376
3797724,3826371,chr11,PGAP2,chr11:3797724-3826371,28647
86288704,86320711,chr1,LINC02795,chr1:86288704-86320711,32007
154190730,154420984,chr5,GALNT10,chr5:154190730-154420984,230254
90892992,90893612,chr1,PHKA1P1,chr1:90892992-90893612,620
86552625,86553342,chr1,CDCA4P2,chr1:86552625-86553342,717
85729233,86156943,chr1,COL24A1,chr1:85729233-86156943,427710
70755035,70773251,chr16,VAC14-AS1,chr16:70755035-70773251,18216
76139567,76139671,chr12,RNU6-1271P,chr12:76139567-76139671,104
4307763,4360028,chr12,TIGAR,chr12:4307763-4360028,52265
70852698,70852814,chr16,RNU6ATAC25P,chr16:70852698-70852814,116
87050202,87094843,chr10,GLUD1,chr10:87050202-87094843,44641
10627501,10694930,chr16,TEKT5,chr16:10627501-10694930,67429
52010999,52019095,chr15,MAPK6-DT,chr15:52010999-52019095,8096
4368227,4379712,chr12,FGF23,chr12:4368227-4379712,11485
143696154,143698413,chr8,LINC02878,chr8:143696154-143698413,2259
159227715,159245127,chr5,LINC01932,chr5:159227715-159245127,17412
143706694,143708109,chr8,CCDC166,chr8:143706694-143708109,1415
10718633,10719762,chr16,MTCYBP33,chr16:10718633-10719762,1129
52179999,52206915,chr15,CERNA1,chr15:52179999-52206915,26916
10719833,10720015,chr16,MTND6P33,chr16:10719833-10720015,182
4269771,4305353,chr12,CCND2,chr12:4269771-4305353,35582
10720015,10721464,chr16,MTND5P33,chr16:10720015-10721464,1449
10721698,10723068,chr16,MTND4P34,chr16:10721698-10723068,1370
143716340,143722458,chr8,MAPK15,chr8:143716340-143722458,6118
10723065,10723355,chr16,MTND4LP24,chr16:10723065-10723355,290
52192322,52295804,chr15,MYO5C,chr15:52192322-52295804,103482
10723424,10723766,chr16,MTND3P13,chr16:10723424-10723766,342
151181052,151224093,chr5,CCDC69,chr5:151181052-151224093,43041
10723836,10724617,chr16,MTCO3P24,chr16:10723836-10724617,781
10724620,10725296,chr16,MTATP6P24,chr16:10724620-10725296,676
139228221,139228605,chr7,MZT1P2,chr7:139228221-139228605,384
10743786,10769351,chr16,NUBP1,chr16:10743786-10769351,25565
139230356,139308236,chr7,UBN2,chr7:139230356-139308236,77880
55743122,55757264,chr12,GDF11,chr12:55743122-55757264,14142
55752463,55817724,chr12,SARNP,chr12:55752463-55817724,65261
76083383,76353939,chr5,SV2C,chr5:76083383-76353939,270556
139315291,139315394,chr7,RNU6-206P,chr7:139315291-139315394,103
122081720,122081781,chr7,RNU7-154P,chr7:122081720-122081781,61
143723933,143738234,chr8,FAM83H,chr8:143723933-143738234,14301
122301303,122310691,chr7,FEZF1,chr7:122301303-122310691,9388
33441156,33447596,chr9,AQP3,chr9:33441156-33447596,6440
143733083,143733153,chr8,MIR4664,chr8:143733083-143733153,70
143790920,143815773,chr8,SCRIB,chr8:143790920-143815773,24853
33467869,33467935,chr9,MIR6851,chr9:33467869-33467935,66
167954020,168247595,chr2,STK39,chr2:167954020-168247595,293575
122064583,122144308,chr7,AASS,chr7:122064583-122144308,79725
33524251,33573013,chr9,ANKRD18B,chr9:33524251-33573013,48762
8619178,8620310,chr5,MTCYBP37,chr5:8619178-8620310,1132
16574907,16629062,chr19,MED26,chr19:16574907-16629062,54155
10760919,10818794,chr16,TVP23A,chr16:10760919-10818794,57875
163460203,163491941,chr5,HMMR,chr5:163460203-163491941,31738
55818041,55821879,chr12,ORMDL2,chr12:55818041-55821879,3838
7661779,7687538,chr17,TP53,chr17:7661779-7687538,25759
54998933,55017172,chr1,BSND,chr1:54998933-55017172,18239
135561756,135566955,chr9,PAEP,chr9:135561756-135566955,5199
9835257,9849689,chr19,PIN1,chr19:9835257-9849689,14432
52602371,52609051,chr1,GPX7,chr1:52602371-52609051,6680
133264968,133285445,chr2,NCKAP5-AS2,chr2:133264968-133285445,20477
55835433,55842966,chr12,MMP19,chr12:55835433-55842966,7533
94820342,94895246,chr1,SLC44A3,chr1:94820342-94895246,74904
241675747,241686944,chr2,DTYMK,chr2:241675747-241686944,11197
52277117,52277200,chr15,MIR1266,chr15:52277117-52277200,83
52505191,52505862,chr15,EEF1B2P1,chr15:52505191-52505862,671
43543311,43580473,chr19,XRCC1,chr19:43543311-43580473,37162
52547045,52569883,chr15,ARPP19,chr15:52547045-52569883,22838
10928891,10942468,chr16,DEXI,chr16:10928891-10942468,13577
3826978,3840959,chr11,RHOG,chr11:3826978-3840959,13981
3854318,3855509,chr11,STIM1-AS1,chr11:3854318-3855509,1191
23388493,23453189,chr16,COG7,chr16:23388493-23453189,64696
3856062,3856141,chr11,MIR4687,chr11:3856062-3856141,79
3892398,3892887,chr11,PPIAP40,chr11:3892398-3892887,489
3972881,3974237,chr11,HNRNPA1P76,chr11:3972881-3974237,1356
4018948,4019118,chr11,RPS29P20,chr11:4018948-4019118,170
135574935,135587112,chr9,LINC01502,chr9:135574935-135587112,12177
55870048,55872602,chr12,OLA1P3,chr12:55870048-55872602,2554
4094707,4138932,chr11,RRM1,chr11:4094707-4138932,44225
55900300,55900618,chr12,GSTP1P1,chr12:55900300-55900618,318
135588002,135591975,chr9,PAEPP1,chr9:135588002-135591975,3973
135623648,135639540,chr9,GLT6D1,chr9:135623648-135639540,15892
55927319,55954027,chr12,DGKA,chr12:55927319-55954027,26708
135663309,135666961,chr9,LCN9,chr9:135663309-135666961,3652
95025677,95053992,chr2,MAL,chr2:95025677-95053992,28315
136881912,136926607,chr9,TRAF2,chr9:136881912-136926607,44695
31934474,31941724,chr6,C2-AS1,chr6:31934474-31941724,7250
23412380,23416680,chr16,RN7SKP23,chr16:23412380-23416680,4300
31945650,31952084,chr6,CFB,chr6:31945650-31952084,6434
52885595,52886470,chr15,RPSAP55,chr15:52885595-52886470,875
208269343,208269957,chr2,MYL6BP1,chr2:208269343-208269957,614
52937139,52938518,chr15,EEF1A1P22,chr15:52937139-52938518,1379
47220822,47232766,chr19,BBC3,chr19:47220822-47232766,11944
112773925,112784493,chr2,IL1A,chr2:112773925-112784493,10568
101270817,101277500,chr15,SELENOS,chr15:101270817-101277500,6683
23463542,23521995,chr16,GGA2,chr16:23463542-23521995,58453
7096216,7097675,chr10,LINC02665,chr10:7096216-7097675,1459
7295106,7295290,chr10,COX6CP17,chr10:7295106-7295290,184
7486703,7486809,chr10,RNU6-535P,chr10:7486703-7486809,106
121410916,121411200,chr10,RN7SKP167,chr10:121410916-121411200,284
17597232,17597828,chr5,TAF11L10,chr5:17597232-17597828,596
136842478,136848801,chr9,AJM1,chr9:136842478-136848801,6323
178859953,178888122,chr5,ZNF354B,chr5:178859953-178888122,28169
16324826,16328685,chr19,KLF2,chr19:16324826-16328685,3859
121478332,121598458,chr10,FGFR2,chr10:121478332-121598458,120126
159768628,159798255,chr2,CD302,chr2:159768628-159798255,29627
128683424,128696400,chr9,SET,chr9:128683424-128696400,12976
49906825,49929763,chr19,NUP62,chr19:49906825-49929763,22938
14664664,14699850,chr5,OTULIN,chr5:14664664-14699850,35186
207260445,207270690,chr2,LINC01802,chr2:207260445-207270690,10245
210021421,210171409,chr2,KANSL1L,chr2:210021421-210171409,149988
122567117,122583384,chr9,OR1L8,chr9:122567117-122583384,16267
4137116,4138257,chr11,RRM1-AS1,chr11:4137116-4138257,1141
113876282,114056593,chr9,ZNF618,chr9:113876282-114056593,180311
4146112,4151104,chr11,OR55B1P,chr11:4146112-4151104,4992
177600132,177610330,chr5,B4GALT7,chr5:177600132-177610330,10198
4179675,4202663,chr11,LINC02749,chr11:4179675-4202663,22988
4210354,4212091,chr11,RDXP1,chr11:4210354-4212091,1737
3854527,4093210,chr11,STIM1,chr11:3854527-4093210,238683
101295419,101305737,chr15,SNRPA1-DT,chr15:101295419-101305737,10318
101334437,101337428,chr15,PCSK6-AS1,chr15:101334437-101337428,2991
77773865,77774864,chr1,ACTG1P21,chr1:77773865-77774864,999
65076746,65079948,chr15,KBTBD13,chr15:65076746-65079948,3202
82903183,83166815,chr1,LINC01362,chr1:82903183-83166815,263632
39064710,39288315,chr9,CNTNAP3,chr9:39064710-39288315,223605
101175727,101252048,chr15,CHSY1,chr15:101175727-101252048,76321
77847110,77848802,chr1,NSRP1P1,chr1:77847110-77848802,1692
178208471,178232802,chr5,PHYKPL,chr5:178208471-178232802,24331
88684222,88836255,chr1,PKN2,chr1:88684222-88836255,152033
102293103,102293187,chr7,MIR4285,chr7:102293103-102293187,84
143812957,143813042,chr8,MIR937,chr8:143812957-143813042,85
31952087,31959038,chr6,NELFE,chr6:31952087-31959038,6951
102337316,102339115,chr7,PMS2P12,chr7:102337316-102339115,1799
23500905,23501630,chr16,CCNYL7,chr16:23500905-23501630,725
102363872,102426676,chr7,PRKRIP1,chr7:102363872-102426676,62804
143816344,143829352,chr8,PUF60,chr8:143816344-143829352,13008
23520754,23557731,chr16,EARS2,chr16:23520754-23557731,36977
101562536,101562974,chr15,SNRPCP18,chr15:101562536-101562974,438
38915266,38930763,chr19,SARS2,chr19:38915266-38930763,15497
101602786,101614531,chr15,LINC02348,chr15:101602786-101614531,11745
101621444,101652391,chr15,TM2D3,chr15:101621444-101652391,30947
103471381,103989658,chr7,RELN,chr7:103471381-103989658,518277
12674421,12944737,chr11,TEAD1,chr11:12674421-12944737,270316
60852260,60852743,chr2,RPL21P33,chr2:60852260-60852743,483
131646704,131648372,chr2,GRAMD4P8,chr2:131646704-131648372,1668
123356170,123380324,chr9,CRB2,chr9:123356170-123380324,24154
57860532,57880905,chr1,DAB1-AS1,chr1:57860532-57880905,20373
23537061,23537556,chr16,SUB1P4,chr16:23537061-23537556,495
208360631,208361369,chr2,ARPC1BP1,chr2:208360631-208361369,738
130278757,130280110,chr2,MTND4P27,chr2:130278757-130280110,1353
23557721,23574389,chr16,UBFD1,chr16:23557721-23574389,16668
68178857,68256237,chr2,PPP3R1,chr2:68178857-68256237,77380
101648206,101648312,chr15,RNU6-807P,chr15:101648206-101648312,106
101653596,101724473,chr15,TARS3,chr15:101653596-101724473,70877
93927714,93928302,chr1,MTCO1P21,chr1:93927714-93928302,588
123402525,123402603,chr9,MIR601,chr9:123402525-123402603,78
123485529,123485622,chr9,MIR7150,chr9:123485529-123485622,93
73173193,73175143,chr5,TMEM174,chr5:73173193-73175143,1950
123843036,123843686,chr9,PIGFP2,chr9:123843036-123843686,650
12961541,12989597,chr11,LINC00958,chr11:12961541-12989597,28056
124001670,124033301,chr9,LHX2,chr9:124001670-124033301,31631
89407679,89426243,chr1,GBP1P1,chr1:89407679-89426243,18564
23581014,23596316,chr16,NDUFAB1,chr16:23581014-23596316,15302
87353521,87371683,chr1,LINC01364,chr1:87353521-87371683,18162
218059155,218065729,chr2,CXCR2P1,chr2:218059155-218065729,6574
63262113,63262707,chr1,RPSAP65,chr1:63262113-63262707,594
13001090,13009159,chr11,RASSF10-DT,chr11:13001090-13009159,8069
50665899,50846519,chr5,PARP8,chr5:50665899-50846519,180620
13009316,13012119,chr11,RASSF10,chr11:13009316-13012119,2803
86547078,86580754,chr1,CLCA4,chr1:86547078-86580754,33676
70398404,70436584,chr11,CTTN,chr11:70398404-70436584,38180
183607442,183608119,chr2,CACYBPP2,chr2:183607442-183608119,677
984332,998438,chr19,WDR18,chr19:984332-998438,14106
123379654,123930152,chr9,DENND1A,chr9:123379654-123930152,550498
168231921,168232220,chr2,PHF5GP,chr2:168231921-168232220,299
23603160,23641310,chr16,PALB2,chr16:23603160-23641310,38150
95274449,95291308,chr2,PROM2,chr2:95274449-95291308,16859
55217645,55324691,chr1,MIR4422HG,chr1:55217645-55324691,107046
94418389,94518666,chr1,ABCD3,chr1:94418389-94518666,100277
23641466,23677472,chr16,DCTN5,chr16:23641466-23677472,36006
131373636,131500197,chr9,PRRC2B,chr9:131373636-131500197,126561
101289784,101525202,chr15,PCSK6,chr15:101289784-101525202,235418
31956839,31956940,chr6,MIR1236,chr6:31956839-31956940,101
31959117,31969751,chr6,SKIV2L,chr6:31959117-31969751,10634
23677656,23690367,chr16,PLK1,chr16:23677656-23690367,12711
70626441,70635658,chr11,SHANK2-AS1,chr11:70626441-70635658,9217
70646165,70647562,chr11,SHANK2-AS2,chr11:70646165-70647562,1397
143833583,143840973,chr8,NRBP2,chr8:143833583-143840973,7390
70862790,70865115,chr11,SHANK2-AS3,chr11:70862790-70865115,2325
160256986,160399880,chr3,IFT80,chr3:160256986-160399880,142894
70872270,70872368,chr11,MIR3664,chr11:70872270-70872368,98
6618835,6635960,chr12,LPAR5,chr12:6618835-6635960,17125
71382601,71423423,chr11,ACTE1P,chr11:71382601-71423423,40822
54641786,54742308,chr1,MROH7-TTC4,chr1:54641786-54742308,100522
82689559,82689768,chr11,RPS28P7,chr11:82689559-82689768,209
6638075,6647433,chr12,ACRBP,chr12:6638075-6647433,9358
82729940,82733864,chr11,FAM181B,chr11:82729940-82733864,3924
82781502,82817741,chr11,LINC02734,chr11:82781502-82817741,36239
82805354,82806509,chr11,RBMXP3,chr11:82805354-82806509,1155
82822936,82970584,chr11,PRCP,chr11:82822936-82970584,147648
104126341,104208047,chr7,ORC5,chr7:104126341-104208047,81706
151247940,151261863,chr2,RBM43,chr2:151247940-151261863,13923
45527427,45602212,chr19,OPA3,chr19:45527427-45602212,74785
16479061,16496167,chr19,CALR3,chr19:16479061-16496167,17106
214854,465259,chr9,DOCK8,chr9:214854-465259,250405
42430329,42456253,chr1,ZMYND12,chr1:42430329-42456253,25924
230415942,230545606,chr2,SP100,chr2:230415942-230545606,129664
1678256,1702280,chr16,JPT2,chr16:1678256-1702280,24024
39268396,39270188,chr19,IFNL2,chr19:39268396-39270188,1792
143837756,143837816,chr8,MIR6845,chr8:143837756-143837816,60
94974405,95072951,chr1,ALG14,chr1:94974405-95072951,98546
143857324,143878467,chr8,EPPK1,chr8:143857324-143878467,21143
143945191,143945279,chr8,MIR661,chr8:143945191-143945279,88
57363477,57379565,chr19,ZNF547,chr19:57363477-57379565,16088
77562416,77683419,chr1,ZZZ3,chr1:77562416-77683419,121003
143977153,144012772,chr8,PARP10,chr8:143977153-144012772,35619
128772485,128775794,chr7,OPN1SW,chr7:128772485-128775794,3309
19201409,19203414,chr19,NR2C2AP,chr19:19201409-19203414,2005
1614590,1615325,chr7,TFAMP1,chr7:1614590-1615325,735
6650301,6663142,chr12,ING4,chr12:6650301-6663142,12841
1738630,1742291,chr7,ELFN1-AS1,chr7:1738630-1742291,3661
1844180,1844253,chr7,MIR4655,chr7:1844180-1844253,73
2234195,2242205,chr7,MRM2,chr7:2234195-2242205,8010
10871553,10923075,chr19,CARM1,chr19:10871553-10923075,51522
2251770,2354318,chr7,SNX8,chr7:2251770-2354318,102548
31969810,31972290,chr6,DXO,chr6:31969810-31972290,2480
1734985,1735066,chr16,MIR3177,chr16:1734985-1735066,81
53851719,53889798,chr1,YIPF1,chr1:53851719-53889798,38079
2339150,2426699,chr16,ABCA17P,chr16:2339150-2426699,87549
170222424,170305977,chr3,PRKCI,chr3:170222424-170305977,83553
2257515,2257577,chr7,MIR6836,chr7:2257515-2257577,62
2287915,2288428,chr7,IMMP1LP3,chr7:2287915-2288428,513
2383698,2388652,chr7,KIF19BP,chr7:2383698-2388652,4954
2429394,2458854,chr16,CCNF,chr16:2429394-2458854,29460
2403588,2448484,chr7,CHST12,chr7:2403588-2448484,44896
1815793,2233243,chr7,MAD1L1,chr7:1815793-2233243,417450
67660155,67661013,chr1,HNRNPCP9,chr1:67660155-67661013,858
94650544,94651378,chr1,KATNBL1P2,chr1:94650544-94651378,834
40690380,40692066,chr1,NFYC-AS1,chr1:40690380-40692066,1686
54007298,54018186,chr1,LDLRAD1,chr1:54007298-54018186,10888
40393766,40414793,chr19,PRX,chr19:40393766-40414793,21027
180413008,180476778,chr3,LINC02053,chr3:180413008-180476778,63770
168902194,168924590,chr3,LINC02082,chr3:168902194-168924590,22396
31982057,32002681,chr6,C4A,chr6:31982057-32002681,20624
2445392,2445457,chr16,MIR6767,chr16:2445392-2445457,65
2460086,2464963,chr16,TEDC2,chr16:2460086-2464963,4877
136250340,136337896,chr3,PCCB,chr3:136250340-136337896,87556
82835509,82837222,chr11,EIF2S2P6,chr11:82835509-82837222,1713
82899975,82958277,chr11,DDIAS,chr11:82899975-82958277,58302
48740852,48746909,chr19,IZUMO1,chr19:48740852-48746909,6057
34759740,34762327,chr1,GJB4,chr1:34759740-34762327,2587
43269983,43274002,chr1,TMEM125,chr1:43269983-43274002,4019
143990056,143993415,chr8,GRINA,chr8:143990056-143993415,3359
177707981,177783398,chr5,FAM153A,chr5:177707981-177783398,75417
6765516,6770952,chr12,PTMS,chr12:6765516-6770952,5436
48755524,48758333,chr19,FGF21,chr19:48755524-48758333,2809
50417550,50423443,chr1,DMRTA2,chr1:50417550-50423443,5893
48793152,48793258,chr19,RNU6-317P,chr19:48793152-48793258,106
5871753,5872050,chr7,RN7SL556P,chr7:5871753-5872050,297
5879827,5886363,chr7,OCM,chr7:5879827-5886363,6536
48795062,48811029,chr19,BCAT2,chr19:48795062-48811029,15967
82973133,83071923,chr11,RAB30,chr11:82973133-83071923,98790
41506365,42035925,chr1,HIVEP3,chr1:41506365-42035925,529560
5898725,5926550,chr7,CCZ1,chr7:5898725-5926550,27825
56923133,56934408,chr12,SDR9C7,chr12:56923133-56934408,11275
144012280,144047114,chr8,SPATC1,chr8:144012280-144047114,34834
56994492,56998447,chr12,GPR182,chr12:56994492-56998447,3955
144051266,144063965,chr8,OPLAH,chr8:144051266-144063965,12699
86634273,86655376,chr1,CLCA3P,chr1:86634273-86655376,21103
56998836,57006546,chr12,ZBTB39,chr12:56998836-57006546,7710
57010000,57028883,chr12,TAC3,chr12:57010000-57028883,18883
30752137,30892081,chr7,INMT-MINDY4,chr7:30752137-30892081,139944
86704570,86748184,chr1,SH3GLB1,chr1:86704570-86748184,43614
2463967,2464038,chr16,MIR6768,chr16:2463967-2464038,71
2464950,2468213,chr16,TEDC2-AS1,chr16:2464950-2468213,3263
2471297,2474145,chr16,NTN3,chr16:2471297-2474145,2848
88129305,88138475,chr9,SPATA31C2,chr9:88129305-88138475,9170
30771417,30892387,chr7,MINDY4,chr7:30771417-30892387,120970
92000087,92115413,chr9,SPTLC1,chr9:92000087-92115413,115326
7572824,7579006,chr17,EIF4A1,chr17:7572824-7579006,6182
2513952,2520218,chr16,ATP6V0C,chr16:2513952-2520218,6266
144057321,144057380,chr8,MIR6846,chr8:144057321-144057380,59
144078648,144080648,chr8,EXOSC4,chr8:144078648-144080648,2000
144079874,144079942,chr8,MIR6847,chr8:144079874-144079942,68
83041464,83041598,chr11,SNORA70E,chr11:83041464-83041598,134
83106580,83106961,chr11,COX5BP4,chr11:83106580-83106961,381
83111060,83111442,chr11,C1DP5,chr11:83111060-83111442,382
144082590,144086216,chr8,GPAA1,chr8:144082590-144086216,3626
75780,76143,chr11,WBP1LP10,chr11:75780-76143,363
30911853,30925517,chr7,AQP1,chr7:30911853-30925517,13664
86649,87586,chr11,OR4F2P,chr11:86649-87586,937
123312,126123,chr11,CICP23,chr11:123312-126123,2811
127204,139612,chr11,LINC01001,chr11:127204-139612,12408
13281035,13285174,chr1,PRAMEF8,chr1:13281035-13285174,4139
2530035,2531417,chr16,CEMP1,chr16:2530035-2531417,1382
55202966,55319113,chr15,RAB27A,chr15:55202966-55319113,116147
2531922,2532005,chr16,MIR3178,chr16:2531922-2532005,83
2537979,2603188,chr16,PDPK1,chr16:2537979-2603188,65209
152999,153102,chr11,RNU6-447P,chr11:152999-153102,103
193078,194575,chr11,SCGB1C1,chr11:193078-194575,1497
209336,209406,chr11,MIR6743,chr11:209336-209406,70
135136916,135531218,chr2,ZRANB3,chr2:135136916-135531218,394302
30938669,30993254,chr7,GHRHR,chr7:30938669-30993254,54585
215030,236931,chr11,SIRT3,chr11:215030-236931,21901
61681046,61725423,chr1,TM2D1,chr1:61681046-61725423,44377
177836434,177837646,chr5,OR1X5P,chr5:177836434-177837646,1212
178006348,178086529,chr5,FAM153CP,chr5:178006348-178086529,80181
278407,285388,chr11,NLRP6,chr11:278407-285388,6981
50398825,50399773,chr1,HMGB1P45,chr1:50398825-50399773,948
31999976,32003521,chr6,C4A-AS1,chr6:31999976-32003521,3545
32005636,32008451,chr6,CYP21A1P,chr6:32005636-32008451,2815
32008614,32012472,chr6,TNXA,chr6:32008614-32012472,3858
48813018,48836510,chr19,HSD17B14,chr19:48813018-48836510,23492
32013270,32013787,chr6,STK19B,chr6:32013270-32013787,517
52927276,53051698,chr1,SCP2,chr1:52927276-53051698,124422
32014795,32035418,chr6,C4B,chr6:32014795-32035418,20623
289126,296107,chr11,PGGHG,chr11:289126-296107,6981
121074660,121177729,chr9,CNTRL,chr9:121074660-121177729,103069
144095039,144097525,chr8,CYC1,chr8:144095039-144097525,2486
57028517,57051198,chr12,MYO1A,chr12:57028517-57051198,22681
144098633,144108124,chr8,SHARPIN,chr8:144098633-144108124,9491
55317184,55319161,chr15,PIGBOS1,chr15:55317184-55319161,1977
126109761,126118023,chr2,LINC01941,chr2:126109761-126118023,8262
48837097,48868617,chr19,PLEKHA4,chr19:48837097-48868617,31520
31052308,31111479,chr7,ADCYAP1R1,chr7:31052308-31111479,59171
130282085,130282606,chr2,MTND6P8,chr2:130282085-130282606,521
227979955,228181687,chr2,SPHKAP,chr2:227979955-228181687,201732
55318960,55355648,chr15,PIGB,chr15:55318960-55355648,36688
298200,299526,chr11,IFITM5,chr11:298200-299526,1326
369499,382117,chr11,B4GALNT4,chr11:369499-382117,12618
7389727,7394842,chr17,PLSCR3,chr17:7389727-7394842,5115
171587093,171587259,chr2,RPL21P38,chr2:171587093-171587259,166
144104461,144107611,chr8,MAF1,chr8:144104461-144107611,3150
55372940,55373034,chr15,MIR628,chr15:55372940-55373034,94
392614,404908,chr11,PKP3,chr11:392614-404908,12294
55180806,55197049,chr15,RSL24D1,chr15:55180806-55197049,16243
158874642,158875670,chr2,OR7E90P,chr2:158874642-158875670,1028
238426742,238452250,chr2,ASB1,chr2:238426742-238452250,25508
2616121,2643296,chr16,PDPK2P,chr16:2616121-2643296,27175
95165432,95184317,chr2,ZNF2,chr2:95165432-95184317,18885
405716,417455,chr11,SIGIRR,chr11:405716-417455,11739
48872421,48876058,chr19,PPP1R15A,chr19:48872421-48876058,3637
8314246,10613002,chr9,PTPRD,chr9:8314246-10613002,2298756
48880967,48898744,chr19,TULP2,chr19:48880967-48898744,17777
144107726,144118328,chr8,WDR97,chr8:144107726-144118328,10602
2475051,2509560,chr16,TBC1D24,chr16:2475051-2509560,34509
99173572,99250075,chr7,KPNA7,chr7:99173572-99250075,76503
57055643,57088063,chr12,NEMP1,chr12:57055643-57088063,32420
44114680,44124358,chr7,POLD2,chr7:44114680-44124358,9678
215942584,216034096,chr2,MREG,chr2:215942584-216034096,91512
50461469,50471150,chr1,FAF1-AS1,chr1:50461469-50471150,9681
93922574,93923945,chr1,MTND4P11,chr1:93922574-93923945,1371
57089043,57095476,chr12,NAB2,chr12:57089043-57095476,6433
144137774,144140851,chr8,HGH1,chr8:144137774-144140851,3077
174438573,175810548,chr3,NAALADL2,chr3:174438573-175810548,1371975
7389734,7404097,chr17,TMEM256-PLSCR3,chr17:7389734-7404097,14363
48900312,48923372,chr19,NUCB1,chr19:48900312-48923372,23060
93561741,93847150,chr1,BCAR3,chr1:93561741-93847150,285409
137007234,137028915,chr9,ABCA2,chr9:137007234-137028915,21681
230515023,230515638,chr2,HMGB1P3,chr2:230515023-230515638,615
236391074,236392388,chr2,IQCA1-AS1,chr2:236391074-236392388,1314
417933,442011,chr11,ANO9,chr11:417933-442011,24078
41230839,41281887,chr15,CHP1,chr15:41230839-41281887,51048
144141214,144143664,chr8,TSSK5P,chr8:144141214-144143664,2450
7402975,7404097,chr17,TMEM256,chr17:7402975-7404097,1122
62500218,62511894,chr2,TMEM17,chr2:62500218-62511894,11676
7404874,7419860,chr17,NLGN2,chr17:7404874-7419860,14986
94813311,94881746,chr8,INTS8,chr8:94813311-94881746,68435
57095408,57132139,chr12,STAT6,chr12:57095408-57132139,36731
168666559,168667423,chr3,RPSAP33,chr3:168666559-168667423,864
15594387,15643154,chr16,MARF1,chr16:15594387-15643154,48767
130282679,130283329,chr2,MTCYBP8,chr2:130282679-130283329,650
134055256,134057648,chr3,LINC02000,chr3:134055256-134057648,2392
208121607,208124524,chr2,CRYGD,chr2:208121607-208124524,2917
130089433,130094304,chr3,LINC02014,chr3:130089433-130094304,4871
182938074,182985953,chr3,DCUN1D1,chr3:182938074-182985953,47879
7420324,7421632,chr17,SPEM1,chr17:7420324-7421632,1308
440399,440693,chr11,RN7SL838P,chr11:440399-440693,294
7425616,7427568,chr17,SPEM2,chr17:7425616-7427568,1952
73218281,73242427,chr11,P2RY2,chr11:73218281-73242427,24146
130280299,130282105,chr2,MTND5P29,chr2:130280299-130282105,1806
228352120,228353215,chr2,SNF8P1,chr2:228352120-228353215,1095
7428857,7432820,chr17,SPEM3,chr17:7428857-7432820,3963
41283990,41309737,chr15,OIP5-AS1,chr15:41283990-41309737,25747
236407846,236409077,chr2,RPL3P5,chr2:236407846-236409077,1231
7435435,7437679,chr17,TMEM102,chr17:7435435-7437679,2244
73248779,73249867,chr11,OR8R1P,chr11:73248779-73249867,1088
151341772,151378449,chr7,NUB1,chr7:151341772-151378449,36677
73307235,73309361,chr11,ARHGEF17-AS1,chr11:73307235-73309361,2126
168771951,168786961,chr2,CERS6-AS1,chr2:168771951-168786961,15010
32032713,32036258,chr6,C4B-AS1,chr6:32032713-32036258,3545
7438273,7444937,chr17,FGF11,chr17:7438273-7444937,6664
73264498,73305103,chr11,P2RY6,chr11:73264498-73305103,40605
172603440,172604006,chr3,SLC31A1P1,chr3:172603440-172604006,566
32038327,32041644,chr6,CYP21A2,chr6:32038327-32041644,3317
165150006,165158062,chr3,LINC02023,chr3:165150006-165158062,8056
146069440,146163653,chr3,PLOD2,chr3:146069440-146163653,94213
93924743,93925385,chr1,MTCO3P21,chr1:93924743-93925385,642
14692129,14692613,chr1,TBCAP2,chr1:14692129-14692613,484
90711539,90717302,chr1,BARHL2,chr1:90711539-90717302,5763
41309273,41332591,chr15,OIP5,chr15:41309273-41332591,23318
48910930,48918891,chr19,NUCB1-AS1,chr19:48910930-48918891,7961
95510059,95782342,chr1,LINC02607,chr1:95510059-95782342,272283
48933699,48944969,chr19,DHDH,chr19:48933699-48944969,11270
200305881,200482264,chr2,SPATS2L,chr2:200305881-200482264,176383
7445061,7457710,chr17,CHRNB1,chr17:7445061-7457710,12649
41320794,41381050,chr15,NUSAP1,chr15:41320794-41381050,60256
40132764,40133448,chr1,OAZ1P1,chr1:40132764-40133448,684
48965309,48966879,chr19,FTL,chr19:48965309-48966879,1570
44213455,44220681,chr1,DMAP1,chr1:44213455-44220681,7226
94048287,94081202,chr14,DDX24,chr14:94048287-94081202,32915
310041,315272,chr11,IFITM1,chr11:310041-315272,5231
123597946,123599452,chr11,SF3A3P2,chr11:123597946-123599452,1506
15611030,15611095,chr16,MIR6506,chr16:15611030-15611095,65
123629187,123655244,chr11,SCN3B,chr11:123629187-123655244,26057
15643294,15643372,chr16,MIR484,chr16:15643294-15643372,78
37106734,37172741,chr19,ZNF585A,chr19:37106734-37172741,66007
38392702,38398661,chr9,ALDH1B1,chr9:38392702-38398661,5959
15643267,15734691,chr16,NDE1,chr16:15643267-15734691,91424
7855066,7856099,chr17,TMEM88,chr17:7855066-7856099,1033
38406528,38424454,chr9,IGFBPL1,chr9:38406528-38424454,17926
143183419,143184435,chr7,TAS2R39,chr7:143183419-143184435,1016
38452782,38454070,chr9,ARMC8P1,chr9:38452782-38454070,1288
7857746,7862282,chr17,CYB5D1,chr17:7857746-7862282,4536
38478471,38479350,chr9,TCEA1P3,chr9:38478471-38479350,879
38486859,38488338,chr9,GAS2L1P1,chr9:38486859-38488338,1479
38504447,38505482,chr9,VN1R48P,chr9:38504447-38505482,1035
143222037,143223079,chr7,TAS2R40,chr7:143222037-143223079,1042
38527097,38527912,chr9,FAM220BP,chr9:38527097-38527912,815
143244093,143270854,chr7,GSTK1,chr7:143244093-143270854,26761
38540569,38577207,chr9,FAM95C,chr9:38540569-38577207,36638
37181579,37218153,chr19,ZNF585B,chr19:37181579-37218153,36574
7906122,7906260,chr17,SCARNA21,chr17:7906122-7906260,138
141709016,141709832,chr3,TPT1P3,chr3:141709016-141709832,816
7930345,7932123,chr17,TRAPPC1,chr17:7930345-7932123,1778
182644214,182655880,chr3,LINC02031,chr3:182644214-182655880,11666
32078508,32078628,chr6,RNA5SP206,chr6:32078508-32078628,120
26124145,26139116,chr6,H2AC6,chr6:26124145-26139116,14971
61187559,61550976,chr14,PRKCH,chr14:61187559-61550976,363417
166160414,166160704,chr3,MTND4LP10,chr3:166160414-166160704,290
26195554,26196633,chr6,H1-12P,chr6:26195554-26196633,1079
172425850,172427089,chr3,BZW1P1,chr3:172425850-172427089,1239
38566260,38568211,chr9,SNX18P3,chr9:38566260-38568211,1951
151751443,151928175,chr3,AADACL2-AS1,chr3:151751443-151928175,176732
38571358,38620596,chr9,ANKRD18A,chr9:38571358-38620596,49238
123723914,123741675,chr11,ZNF202,chr11:123723914-123741675,17761
153384934,153980186,chr3,LINC02006,chr3:153384934-153980186,595252
26196784,26197286,chr6,H3C4,chr6:26196784-26197286,502
170448639,170860993,chr3,SLC7A14-AS1,chr3:170448639-170860993,412354
26198784,26199293,chr6,H2AC7,chr6:26198784-26199293,509
26216975,26217483,chr6,H2AC8,chr6:26216975-26217483,508
94925972,94949378,chr8,TP53INP1,chr8:94925972-94949378,23406
169483671,169484080,chr3,RPL22P1,chr3:169483671-169484080,409
26219045,26219240,chr6,H3C5P,chr6:26219045-26219240,195
7932101,7949920,chr17,CNTROB,chr17:7932101-7949920,17819
26233122,26233255,chr6,H2AC9P,chr6:26233122-26233255,133
130199708,130199918,chr3,SNRPCP8,chr3:130199708-130199918,210
26234212,26234987,chr6,H1-3,chr6:26234212-26234987,775
26240393,26240793,chr6,H4C6,chr6:26240393-26240793,400
181711925,181714436,chr3,SOX2,chr3:181711925-181714436,2511
26246611,26246996,chr6,H4C7,chr6:26246611-26246996,385
26250142,26250635,chr6,H3C7,chr6:26250142-26250635,493
26272021,26272701,chr6,H2AC10P,chr6:26272021-26272701,680
26272931,26273412,chr6,H2BC10,chr6:26272931-26273412,481
182793503,182921629,chr3,ATP11B,chr3:182793503-182921629,128126
26321876,26322292,chr6,H3C9P,chr6:26321876-26322292,416
109984765,110023742,chr1,AHCYL1,chr1:109984765-110023742,38977
179933805,179934196,chr5,RPS15AP18,chr5:179933805-179934196,391
1309310,1309377,chr5,MIR4457,chr5:1309310-1309377,67
1708785,1708868,chr5,MIR4277,chr5:1708785-1708868,83
26365159,26378320,chr6,BTN3A2,chr6:26365159-26378320,13161
1510762,1510856,chr5,MIR6075,chr5:1510762-1510856,94
5126046,5126337,chr5,RN7SKP73,chr5:5126046-5126337,291
8460925,8460999,chr5,MIR4458,chr5:8460925-8460999,74
7980146,7980304,chr5,RNU1-76P,chr5:7980146-7980304,158
66628487,66667231,chr8,VCPIP1,chr8:66628487-66667231,38744
9548836,9548905,chr5,SNORD123,chr5:9548836-9548905,69
9760907,9761013,chr5,RNA5SP177,chr5:9760907-9761013,106
7047227,7047336,chr5,RNA5SP176,chr5:7047227-7047336,109
38620474,38624990,chr9,FAM201A,chr9:38620474-38624990,4516
9053816,9053895,chr5,MIR4636,chr5:9053816-9053895,79
11027200,11027307,chr5,RNU6-429P,chr5:11027200-11027307,107
15935182,15935260,chr5,MIR887,chr5:15935182-15935260,78
12297399,12297504,chr5,RNU6-679P,chr5:12297399-12297504,105
17345616,17345955,chr5,RN7SKP133,chr5:17345616-17345955,339
16853994,16854114,chr5,RNA5SP179,chr5:16853994-16854114,120
41387218,41409403,chr15,NDUFAF1,chr15:41387218-41409403,22185
16033229,16033356,chr5,RNA5SP178,chr5:16033229-16033356,127
16941843,16941951,chr5,RNU6-660P,chr5:16941843-16941951,108
38643042,38643768,chr9,YWHABP1,chr9:38643042-38643768,726
38680006,38680104,chr9,RNU6-765P,chr9:38680006-38680104,98
18547312,18547605,chr5,RN7SL58P,chr5:18547312-18547605,293
17156971,17157071,chr5,RNA5SP180,chr5:17156971-17157071,100
123763927,123764089,chr11,RNU1-21P,chr11:123763927-123764089,162
120792403,120801787,chr9,B3GALT9,chr9:120792403-120801787,9384
17240611,17240715,chr5,RNU6-1003P,chr5:17240611-17240715,104
66667615,66685564,chr8,C8orf44,chr8:66667615-66685564,17949
123839035,123841930,chr11,OR6M2P,chr11:123839035-123841930,2895
18236123,18236196,chr5,SNORD81,chr5:18236123-18236196,73
10478037,10478145,chr5,MIR6131,chr5:10478037-10478145,108
123861822,123862521,chr11,OR6M3P,chr11:123861822-123862521,699
14825929,14826012,chr5,MIR4637,chr5:14825929-14826012,83
34891605,34905139,chr19,LINC00904,chr19:34891605-34905139,13534
83643602,83725390,chr11,DLG2-AS2,chr11:83643602-83725390,81788
26012889,26013025,chr5,RNU4-43P,chr5:26012889-26013025,136
25701217,25701324,chr5,RNU6-374P,chr5:25701217-25701324,107
66667596,66860472,chr8,C8orf44-SGK3,chr8:66667596-66860472,192876
19230435,19374281,chr9,DENND4C,chr9:19230435-19374281,143846
29948828,29949130,chr5,RN7SKP207,chr5:29948828-29949130,302
32234766,32234875,chr5,RNU6-1079P,chr5:32234766-32234875,109
32309662,32309768,chr5,RNU6-378P,chr5:32309662-32309768,106
83814571,83815263,chr11,LDHAL6DP,chr11:83814571-83815263,692
32394378,32394475,chr5,MIR579,chr5:32394378-32394475,97
24811481,24811548,chr5,SNORD29,chr5:24811481-24811548,67
84545131,84546846,chr11,HNRNPA1P72,chr11:84545131-84546846,1715
27111569,27111674,chr5,RNU6-738P,chr5:27111569-27111674,105
31820564,31820638,chr5,RNU6-358P,chr5:31820564-31820638,74
31832439,31832535,chr5,RNU6-760P,chr5:31832439-31832535,96
31936102,31936159,chr5,MIR4279,chr5:31936102-31936159,57
28624657,28624763,chr5,RNU6-909P,chr5:28624657-28624763,106
37619985,37620088,chr5,RNU6-1190P,chr5:37619985-37620088,103
37700331,37700437,chr5,RNU6-484P,chr5:37700331-37700437,106
34905315,34908188,chr19,LINC01838,chr19:34905315-34908188,2873
38557502,38557561,chr5,MIR3650,chr5:38557502-38557561,59
34923299,34926812,chr19,ZNF30-AS1,chr19:34923299-34926812,3513
41448742,41448844,chr15,RNU6-1169P,chr15:41448742-41448844,102
35632963,35633024,chr5,RNU7-130P,chr5:35632963-35633024,61
40911067,40911128,chr5,RNU7-161P,chr5:40911067-40911128,61
85020785,85021655,chr11,HNRNPCP6,chr11:85020785-85021655,870
66712734,66862022,chr8,SGK3,chr8:66712734-66862022,149288
41493393,41503551,chr15,ITPKA,chr15:41493393-41503551,10158
34956354,34964229,chr19,ZNF792,chr19:34956354-34964229,7875
40269558,40269719,chr5,RNU1-150P,chr5:40269558-40269719,161
40832656,40832735,chr5,SNORD72,chr5:40832656-40832735,79
51055353,51055459,chr5,RNU6-480P,chr5:51055353-51055459,106
85509938,85510044,chr11,RNU6-1292P,chr11:85509938-85510044,106
715118,719655,chr16,METRN,chr16:715118-719655,4537
51167541,51167647,chr5,RNU6-1296P,chr5:51167541-51167647,106
44716193,44716486,chr5,RN7SL383P,chr5:44716193-44716486,293
53912020,53912123,chr5,RNU6-272P,chr5:53912020-53912123,103
85628573,85636539,chr11,TMEM126B,chr11:85628573-85636539,7966
53951504,53951599,chr5,MIR581,chr5:53951504-53951599,95
54048007,54048308,chr5,RN7SL801P,chr5:54048007-54048308,301
44066624,44066731,chr5,RNU6-381P,chr5:44066624-44066731,107
34998233,35000170,chr19,GRAMD1A-AS1,chr19:34998233-35000170,1937
56260333,56260446,chr5,RNA5SP185,chr5:56260333-56260446,113
51886688,51886769,chr5,RNA5SP182,chr5:51886688-51886769,81
56297564,56297689,chr5,RNU6ATAC2P,chr5:56297564-56297689,125
35042902,35106307,chr19,HPN-AS1,chr19:35042902-35106307,63405
55170532,55170622,chr5,MIR449A,chr5:55170532-55170622,90
55170646,55170742,chr5,MIR449B,chr5:55170646-55170742,96
55172262,55172353,chr5,MIR449C,chr5:55172262-55172353,91
55777469,55777587,chr5,RNA5SP183,chr5:55777469-55777587,118
62146665,62146946,chr5,RN7SKP157,chr5:62146665-62146946,281
143255264,143287997,chr7,TMEM139-AS1,chr7:143255264-143287997,32733
56125671,56125770,chr5,RNU6-299P,chr5:56125671-56125770,99
56146739,56146846,chr5,RNA5SP184,chr5:56146739-56146846,107
55508850,55508926,chr5,MIR5687,chr5:55508850-55508926,76
143279957,143288048,chr7,TMEM139,chr7:143279957-143288048,8091
41503637,41513887,chr15,LTK,chr15:41503637-41513887,10250
68970439,68970752,chr5,RN7SKP251,chr5:68970439-68970752,313
68159061,68159146,chr5,RNU6-1232P,chr5:68159061-68159146,85
64539504,64539792,chr5,RN7SL169P,chr5:64539504-64539792,288
64573569,64573670,chr5,RNU6-294P,chr5:64573569-64573670,101
720581,722590,chr16,ANTKMT,chr16:720581-722590,2009
65604661,65604761,chr5,RNU6-540P,chr5:65604661-65604761,100
35122700,35122764,chr19,MIR6887,chr19:35122700-35122764,64
61664145,61664239,chr5,RNU6-913P,chr5:61664145-61664239,94
72169467,72169540,chr5,MIR4803,chr5:72169467-72169540,73
72314397,72314688,chr5,RN7SL153P,chr5:72314397-72314688,291
35124513,35142451,chr19,LGI4,chr19:35124513-35142451,17938
73828012,73828073,chr5,RNU7-196P,chr5:73828012-73828073,61
94896949,94927223,chr1,CNN3,chr1:94896949-94927223,30274
76091708,76091801,chr5,RNA5SP186,chr5:76091708-76091801,93
69160808,69160939,chr5,SNORA50D,chr5:69160808-69160939,131
74317986,74318285,chr5,RN7SL814P,chr5:74317986-74318285,299
59703606,59703703,chr5,MIR582,chr5:59703606-59703703,97
75709495,75709599,chr5,RNU6-680P,chr5:75709495-75709599,104
60304047,60304151,chr5,RNU6-806P,chr5:60304047-60304151,104
83803554,83803685,chr5,RNU4-11P,chr5:83803554-83803685,131
76948791,76948870,chr5,RNU6ATAC36P,chr5:76948791-76948870,79
82078427,82078724,chr5,RN7SL378P,chr5:82078427-82078724,297
83685866,83686018,chr5,RN7SKP295,chr5:83685866-83686018,152
83703448,83703543,chr5,RNU6-620P,chr5:83703448-83703543,95
83064204,83064337,chr5,SCARNA18,chr5:83064204-83064337,133
90016621,90016720,chr5,MIR3660,chr5:90016621-90016720,99
87102603,87102846,chr5,RN7SKP34,chr5:87102603-87102846,243
87114879,87114954,chr5,MIR4280,chr5:87114879-87114954,75
87294189,87294473,chr5,RN7SL629P,chr5:87294189-87294473,284
87299687,87299797,chr5,RNU6-606P,chr5:87299687-87299797,110
87420341,87420447,chr5,RNU6-727P,chr5:87420341-87420447,106
84196883,84196989,chr5,RNU6-448P,chr5:84196883-84196989,106
86663144,86663250,chr5,RNU6-804P,chr5:86663144-86663250,106
79170234,79170335,chr5,RNY3P1,chr5:79170234-79170335,101
82840155,82840224,chr5,MIR3977,chr5:82840155-82840224,69
143288215,143307696,chr7,CASP2,chr7:143288215-143307696,19481
93620696,93620788,chr5,MIR2277,chr5:93620696-93620788,92
23125295,23183674,chr14,SLC7A8,chr14:23125295-23183674,58379
97175950,97176113,chr5,RNU1-73P,chr5:97175950-97176113,163
80365726,80365832,chr5,RNU6-211P,chr5:80365726-80365832,106
86620497,86620575,chr5,SNORD138,chr5:86620497-86620575,78
88274258,88274376,chr5,RNA5SP187,chr5:88274258-88274376,118
77080434,77080571,chr5,SNORA47,chr5:77080434-77080571,137
101581830,101582128,chr5,RN7SL802P,chr5:101581830-101582128,298
100816482,100816565,chr5,MIR548P,chr5:100816482-100816565,83
88666853,88666939,chr5,MIR9-2,chr5:88666853-88666939,86
100153672,100153779,chr5,RNU6-1119P,chr5:100153672-100153779,107
44155028,44155301,chr1,OOSP1P1,chr1:44155028-44155301,273
100733058,100733386,chr5,RN7SKP62,chr5:100733058-100733386,328
729760,741329,chr16,CIAO3,chr16:729760-741329,11569
102302504,102302810,chr5,RN7SKP68,chr5:102302504-102302810,306
146066344,146069185,chr3,LNCSRLR,chr3:146066344-146069185,2841
26383096,26394874,chr6,BTN2A2,chr6:26383096-26394874,11778
91270727,91270867,chr5,RNU4-90P,chr5:91270727-91270867,140
96079138,96079212,chr5,MIR583,chr5:96079138-96079212,74
96210121,96210227,chr5,RNU6-524P,chr5:96210121-96210227,106
109014834,109014940,chr5,RNU6-47P,chr5:109014834-109014940,106
109699500,109699834,chr5,RN7SKP230,chr5:109699500-109699834,334
95521369,95521475,chr5,RNU6-308P,chr5:95521369-95521475,106
111719769,111720061,chr5,RN7SKP57,chr5:111719769-111720061,292
112778363,112778469,chr5,RNU6-482P,chr5:112778363-112778469,106
102131007,102131135,chr5,RNA5SP188,chr5:102131007-102131135,128
154272546,154324487,chr3,DHX36,chr3:154272546-154324487,51941
85647967,85656547,chr11,TMEM126A,chr11:85647967-85656547,8580
104098874,104099038,chr5,RNU1-140P,chr5:104098874-104099038,164
104260531,104260826,chr5,RN7SL255P,chr5:104260531-104260826,295
104780288,104780389,chr5,RNU6-334P,chr5:104780288-104780389,101
114253513,114253754,chr5,RN7SKP89,chr5:114253513-114253754,241
107571161,107965180,chr1,VAV3,chr1:107571161-107965180,394019
98889731,98889833,chr5,RNU6-402P,chr5:98889731-98889833,102
116188455,116188552,chr5,RNU6-644P,chr5:116188455-116188552,97
115774319,115774502,chr5,RNU2-49P,chr5:115774319-115774502,183
118974586,118974670,chr5,MIR1244-2,chr5:118974586-118974670,84
123070782,123071080,chr5,RN7SL711P,chr5:123070782-123071080,298
119306343,119306631,chr5,RN7SL174P,chr5:119306343-119306631,288
8002615,8020342,chr17,GUCY2D,chr17:8002615-8020342,17727
110513829,110513915,chr5,MIR548F3,chr5:110513829-110513915,86
112161485,112161617,chr5,SNORA13,chr5:112161485-112161617,132
126755316,126755417,chr5,RNU6-752P,chr5:126755316-126755417,101
119007571,119007668,chr5,RNU6-373P,chr5:119007571-119007668,97
119138859,119138965,chr5,RNU6-701P,chr5:119138859-119138965,106
119154637,119154716,chr5,MIR5706,chr5:119154637-119154716,79
125350868,125351131,chr5,RN7SKP117,chr5:125350868-125351131,263
113493835,113493960,chr5,RNU4ATAC13P,chr5:113493835-113493960,125
130386621,130386680,chr5,RNU7-53P,chr5:130386621-130386680,59
120337549,120337653,chr5,RNU6-718P,chr5:120337549-120337653,104
105922994,105923108,chr5,RNA5SP189,chr5:105922994-105923108,114
129397062,129397147,chr5,MIR4460,chr5:129397062-129397147,85
123022487,123022783,chr5,RN7SL689P,chr5:123022487-123022783,296
85683848,85686195,chr11,CCDC89,chr11:85683848-85686195,2347
126553302,126553402,chr5,RNU6-290P,chr5:126553302-126553402,100
120710698,120710840,chr5,RNU4-69P,chr5:120710698-120710840,142
129974891,129975001,chr5,RNU6ATAC10P,chr5:129974891-129975001,110
130114409,130114510,chr5,RNA5SP191,chr5:130114409-130114510,101
134225757,134225852,chr5,MIR3661,chr5:134225757-134225852,95
136969200,136969306,chr5,RNA5SP193,chr5:136969200-136969306,106
133427596,133427706,chr5,MIR1289-2,chr5:133427596-133427706,110
83455012,85627922,chr11,DLG2,chr11:83455012-85627922,2172910
139717985,139718090,chr5,RNU6-236P,chr5:139717985-139718090,105
137647572,137647649,chr5,MIR874,chr5:137647572-137647649,77
118758211,118758274,chr5,RNU7-34P,chr5:118758211-118758274,63
143679860,143679971,chr5,MIR5197,chr5:143679860-143679971,111
144140879,144141166,chr5,RN7SL87P,chr5:144140879-144141166,287
144535354,144535670,chr5,RN7SKP246,chr5:144535354-144535670,316
8039034,8049134,chr17,ALOX15B,chr17:8039034-8049134,10100
143542514,143542587,chr5,RNU7-156P,chr5:143542514-143542587,73
35143250,35154302,chr19,FXYD7,chr19:35143250-35154302,11052
146245191,146245253,chr5,RNU7-180P,chr5:146245191-146245253,62
135802985,135803075,chr5,MIR5692C1,chr5:135802985-135803075,90
149430646,149430733,chr5,MIR145,chr5:149430646-149430733,87
149428918,149429023,chr5,MIR143,chr5:149428918-149429023,105
53802771,55627942,chr10,PCDH15,chr10:53802771-55627942,1825171
149606637,149606741,chr5,RNU6-588P,chr5:149606637-149606741,104
151477459,151477577,chr5,RNA5SP197,chr5:151477459-151477577,118
143290615,143290910,chr7,RN7SL535P,chr7:143290615-143290910,295
151522087,151522148,chr5,MIR6499,chr5:151522087-151522148,61
143298516,143298814,chr7,RN7SL481P,chr7:143298516-143298814,298
157579497,157579599,chr5,RNU6-390P,chr5:157579497-157579599,102
143312684,143313061,chr7,HINT1P1,chr7:143312684-143313061,377
154349428,154349725,chr5,RN7SL655P,chr5:154349428-154349725,297
149732825,149732890,chr5,MIR378A,chr5:149732825-149732890,65
153755382,153755680,chr5,RN7SL177P,chr5:153755382-153755680,298
160474402,160474483,chr5,MIR3142,chr5:160474402-160474483,81
160485352,160485450,chr5,MIR146A,chr5:160485352-160485450,98
139012329,139012441,chr5,RNA5SP194,chr5:139012329-139012441,112
162477891,162477993,chr5,RNU6-164P,chr5:162477891-162477993,102
143353400,143362770,chr7,FAM131B,chr7:143353400-143362770,9370
157809098,157809204,chr5,RNU6-260P,chr5:157809098-157809204,106
149722070,149722372,chr5,RN7SL868P,chr5:149722070-149722372,302
154347106,154347247,chr5,MIR1294,chr5:154347106-154347247,141
170866835,170867144,chr5,RN7SL623P,chr5:170866835-170867144,309
165609441,165609679,chr5,RN7SKP60,chr5:165609441-165609679,238
168560896,168560973,chr5,MIR103A1,chr5:168560896-168560973,77
168560904,168560965,chr5,MIR103B1,chr5:168560904-168560965,61
19375715,19380236,chr9,RPS6,chr9:19375715-19380236,4521
157976766,157976956,chr5,RNU2-48P,chr5:157976766-157976956,190
169552449,169552555,chr5,RNU6-477P,chr5:169552449-169552555,106
173362134,173362240,chr5,RNU6-500P,chr5:173362134-173362240,106
168768146,168768255,chr5,MIR218-2,chr5:168768146-168768255,109
169263601,169263694,chr5,MIR585,chr5:169263601-169263694,93
170028488,170028566,chr5,MIR378E,chr5:170028488-170028566,78
35154730,35169881,chr19,FXYD5,chr19:35154730-35169881,15151
173292517,173292619,chr5,RNA5SP200,chr5:173292517-173292619,102
174751734,174751787,chr5,MIR4634,chr5:174751734-174751787,53
176367946,176368031,chr5,MIR1271,chr5:176367946-176368031,85
159318042,159318167,chr5,RNU4ATAC2P,chr5:159318042-159318167,125
164935162,164935268,chr5,RNU6-209P,chr5:164935162-164935268,106
173347455,173347536,chr5,MIR8056,chr5:173347455-173347536,81
178884715,178884879,chr5,RNU1-39P,chr5:178884715-178884879,164
163796065,163796165,chr5,RNU6-168P,chr5:163796065-163796165,100
172662165,172662263,chr5,MIR5003,chr5:172662165-172662263,98
180729586,180729737,chr5,RNU1-17P,chr5:180729586-180729737,151
181043403,181043484,chr5,MIR8089,chr5:181043403-181043484,81
41517176,41544269,chr15,RPAP1,chr15:41517176-41544269,27093
180444509,180444612,chr5,RNU6-525P,chr5:180444509-180444612,103
180015303,180015397,chr5,MIR340,chr5:180015303-180015397,94
181007281,181007384,chr5,RNU6-1036P,chr5:181007281-181007384,103
179798278,179798346,chr5,MIR1229,chr5:179798278-179798346,68
179845832,179846152,chr5,RN7SKP150,chr5:179845832-179846152,320
177379235,177398848,chr5,SLC34A1,chr5:177379235-177398848,19613
19383217,19383887,chr9,NDUFA5P3,chr9:19383217-19383887,670
760734,768865,chr16,MSLN,chr16:760734-768865,8131
19409009,19452505,chr9,ACER2,chr9:19409009-19452505,43496
19460926,19464524,chr9,MAP1LC3BP1,chr9:19460926-19464524,3598
19705338,19705655,chr9,C11orf98P1,chr9:19705338-19705655,317
143363899,143364229,chr7,FAM131B-AS1,chr7:143363899-143364229,330
143381295,143391111,chr7,ZYX,chr7:143381295-143391111,9816
19507452,19789037,chr9,SLC24A2,chr9:19507452-19789037,281585
8063936,8072533,chr17,ALOXE3P1,chr17:8063936-8072533,8597
8072636,8087716,chr17,ALOX12B,chr17:8072636-8087716,15080
177400109,177400661,chr5,PFN3,chr5:177400109-177400661,552
177403204,177442901,chr5,GRK6,chr5:177403204-177442901,39697
26402237,26415208,chr6,BTN3A1,chr6:26402237-26415208,12971
5629025,5776557,chr9,RIC1,chr9:5629025-5776557,147532
8088056,8088147,chr17,MIR4314,chr17:8088056-8088147,91
8120592,8124106,chr17,HES7,chr17:8120592-8124106,3514
41557027,41557435,chr15,ELOCP2,chr15:41557027-41557435,408
66767400,66768005,chr8,PTTG3P,chr8:66767400-66768005,605
58047889,58049335,chr1,HNRNPA1P6,chr1:58047889-58049335,1446
41557675,41583589,chr15,TYRO3,chr15:41557675-41583589,25914
96446930,96448318,chr1,EEF1A1P11,chr1:96446930-96448318,1388
66870749,66922048,chr8,MCMDC2,chr8:66870749-66922048,51299
82970820,82986208,chr1,LINC01361,chr1:82970820-82986208,15388
8140472,8156506,chr17,PER1,chr17:8140472-8156506,16034
57605847,57606206,chr1,RPS20P5,chr1:57605847-57606206,359
77853355,77853893,chr1,HSPE1P25,chr1:77853355-77853893,538
64939152,64942746,chr14,GPX2,chr14:64939152-64942746,3594
97077743,97995000,chr1,DPYD,chr1:97077743-97995000,917257
90396502,90408268,chr14,CALM1,chr14:90396502-90408268,11766
143382686,143382800,chr7,MIR6892,chr7:143382686-143382800,114
143390289,143408856,chr7,EPHA1,chr7:143390289-143408856,18567
177037405,177047923,chr3,TBL1XR1-AS1,chr3:177037405-177047923,10518
177297161,177298386,chr3,ASS1P7,chr3:177297161-177298386,1225
132721750,132874223,chr3,NPHP3-AS1,chr3:132721750-132874223,152473
148166344,148167298,chr3,HNRNPA1P20,chr3:148166344-148167298,954
95117355,95197607,chr1,TLCD4,chr1:95117355-95197607,80252
175234861,175271096,chr3,NAALADL2-AS2,chr3:175234861-175271096,36235
178526505,178937352,chr3,KCNMB2-AS1,chr3:178526505-178937352,410847
26440472,26453415,chr6,BTN3A3,chr6:26440472-26453415,12943
52943536,52943930,chr1,H3P2,chr1:52943536-52943930,394
769428,783370,chr16,MSLNL,chr16:769428-783370,13942
169083499,169663775,chr3,MECOM,chr3:169083499-169663775,580276
12920320,12920404,chr19,MIR5695,chr19:12920320-12920404,84
47782722,47833132,chr12,HDAC7,chr12:47782722-47833132,50410
38043829,38046793,chr1,POU3F1,chr1:38043829-38046793,2964
770183,770277,chr16,MIR662,chr16:770183-770277,94
143437034,143437973,chr7,TAS2R62P,chr7:143437034-143437973,939
12922479,12934037,chr19,FARSA,chr19:12922479-12934037,11558
143443453,143444409,chr7,TAS2R60,chr7:143443453-143444409,956
89821014,89936611,chr1,LRRC8D,chr1:89821014-89936611,115597
143477873,143478796,chr7,TAS2R41,chr7:143477873-143478796,923
143488462,143489402,chr7,OR2R1P,chr7:143488462-143489402,940
143509256,143519469,chr7,OR10AC1,chr7:143509256-143519469,10213
143545186,143546735,chr7,PAICSP5,chr7:143545186-143546735,1549
143571801,143574387,chr7,CTAGE15,chr7:143571801-143574387,2586
143574746,143574848,chr7,RNU6-162P,chr7:143574746-143574848,102
143598039,143604839,chr7,TCAF1P1,chr7:143598039-143604839,6800
66922467,66922555,chr8,SNORD87,chr8:66922467-66922555,88
89490719,89557766,chr16,SPG7,chr16:89490719-89557766,67047
406428,477967,chr8,FBXO25,chr8:406428-477967,71539
143639230,143647646,chr7,TCAF2C,chr7:143639230-143647646,8416
101236865,101243713,chr1,S1PR1,chr1:101236865-101243713,6848
31215622,31224445,chr15,LINC02352,chr15:31215622-31224445,8823
31326835,31435665,chr15,KLF13,chr15:31326835-31435665,108830
91940840,92110673,chr7,AKAP9,chr7:91940840-92110673,169833
34515938,34539704,chr14,EAPP,chr14:34515938-34539704,23766
85018082,85048500,chr1,MCOLN3,chr1:85018082-85048500,30418
177446445,177456286,chr5,PRR7,chr5:177446445-177456286,9841
5855781,5856426,chr9,AK4P4,chr9:5855781-5856426,645
31420128,31420662,chr15,UBE2CP4,chr15:31420128-31420662,534
5890889,5910606,chr9,MLANA,chr9:5890889-5910606,19717
78863247,78863729,chr15,RPL21P116,chr15:78863247-78863729,482
78898840,78898936,chr15,RNU6-415P,chr15:78898840-78898936,96
78959906,79090780,chr15,RASGRF1,chr15:78959906-79090780,130874
21209136,21269494,chr14,HNRNPC,chr14:21209136-21269494,60358
177483394,177497606,chr5,PDLIM7,chr5:177483394-177497606,14212
8144994,8145071,chr17,MIR6883,chr17:8144994-8145071,77
8159149,8163546,chr17,VAMP2,chr17:8159149-8163546,4397
118757518,118783420,chr6,SELENOKP3,chr6:118757518-118783420,25902
118894152,118909171,chr6,ASF1A,chr6:118894152-118909171,15019
5749832,5879537,chr9,ERMP1,chr9:5749832-5879537,129705
114260050,114261226,chr2,SEPHS1P7,chr2:114260050-114261226,1176
118813442,118935162,chr6,MCM9,chr6:118813442-118935162,121720
12930522,12933296,chr19,FARSA-AS1,chr19:12930522-12933296,2774
12940484,12940540,chr19,MIR6515,chr19:12940484-12940540,56
98077000,98077468,chr1,NFU1P2,chr1:98077000-98077468,468
124680722,124680916,chr2,MTND5P22,chr2:124680722-124680916,194
189930277,189931010,chr2,RNF11P1,chr2:189930277-189931010,733
109086585,109121565,chr8,TRHR,chr8:109086585-109121565,34980
8172457,8176399,chr17,TMEM107,chr17:8172457-8176399,3942
12945855,12953642,chr19,RAD23A,chr19:12945855-12953642,7787
230886474,230904693,chr2,GCSIR,chr2:230886474-230904693,18219
109113679,109206781,chr1,ELAPOR1,chr1:109113679-109206781,93102
109334324,109345954,chr8,ENY2,chr8:109334324-109345954,11630
216257865,216372483,chr2,MARCHF4,chr2:216257865-216372483,114618
207821288,208025527,chr2,PLEKHM3,chr2:207821288-208025527,204239
137953348,137957966,chr7,CREB3L2-AS1,chr7:137953348-137957966,4618
8173454,8173587,chr17,SNORD118,chr17:8173454-8173587,133
8186945,8187004,chr17,MIR4521,chr17:8186945-8187004,59
137381037,137847092,chr7,DGKI,chr7:137381037-137847092,466055
8188345,8190180,chr17,BORCS6,chr17:8188345-8190180,1835
93091976,93092760,chr6,COPS5P1,chr6:93091976-93092760,784
8204733,8210600,chr17,AURKB,chr17:8204733-8210600,5867
93240020,93419687,chr6,EPHA7,chr6:93240020-93419687,179667
215611563,215848954,chr2,LINC00607,chr2:215611563-215848954,237391
109470131,109471117,chr8,MAPK6P5,chr8:109470131-109471117,986
12953119,12957223,chr19,GADD45GIP1,chr19:12953119-12957223,4104
109240919,109334121,chr8,NUDCD1,chr8:109240919-109334121,93202
55312801,55334048,chr19,TMEM150B,chr19:55312801-55334048,21247
114828432,114833548,chr2,DPP10-AS3,chr2:114828432-114833548,5116
219903900,219904923,chr2,LINC01803,chr2:219903900-219904923,1023
100177563,100221488,chr7,STAG3,chr7:100177563-100221488,43925
236324147,236507535,chr2,IQCA1,chr2:236324147-236507535,183388
100509752,100559784,chr8,ANKRD46,chr8:100509752-100559784,50032
78921058,78949574,chr15,CTSH,chr15:78921058-78949574,28516
55339853,55348121,chr19,KMT5C,chr19:55339853-55348121,8268
319676,329475,chr11,IFITM3,chr11:319676-329475,9799
177494995,177503647,chr5,PDLIM7-AS1,chr5:177494995-177503647,8652
177511577,177516961,chr5,DDX41,chr5:177511577-177516961,5384
34478622,34478905,chr9,RN7SKP24,chr9:34478622-34478905,283
34621074,34629045,chr9,ARID3C,chr9:34621074-34629045,7971
73618346,73618597,chr6,RPS27P15,chr6:73618346-73618597,251
78133420,78133522,chr11,RNU6-126P,chr11:78133420-78133522,102
8224815,8248056,chr17,CTC1,chr17:8224815-8248056,23241
77878720,77994671,chr11,INTS4,chr11:77878720-77994671,115951
75395188,75395320,chr3,LSP1P2,chr3:75395188-75395320,132
100550724,100551713,chr8,GAPDHP62,chr8:100550724-100551713,989
34652162,34661902,chr9,IL11RA,chr9:34652162-34661902,9740
100572889,100663415,chr8,SNX31,chr8:100572889-100663415,90526
185282941,185489094,chr3,MAP3K13,chr3:185282941-185489094,206153
73461578,73509236,chr6,MTO1,chr6:73461578-73509236,47658
55349306,55354719,chr19,COX6B2,chr19:55349306-55354719,5413
241544403,241558977,chr2,BOK-AS1,chr2:241544403-241558977,14574
98346188,98398601,chr2,CNGA3,chr2:98346188-98398601,52413
100683488,100683574,chr8,RNU6-1092P,chr8:100683488-100683574,86
100702968,100703024,chr8,MIR7705,chr8:100702968-100703024,56
100739802,100739927,chr8,RNU6ATAC41P,chr8:100739802-100739927,125
100776512,100776865,chr8,RPS20P23,chr8:100776512-100776865,353
207529737,207605988,chr2,CREB1,chr2:207529737-207605988,76251
55354908,55363260,chr19,FAM71E2,chr19:55354908-55363260,8352
113161006,113221458,chr9,FKBP15,chr9:113161006-113221458,60452
100685816,100722809,chr8,PABPC1,chr8:100685816-100722809,36993
55364382,55370463,chr19,IL11,chr19:55364382-55370463,6081
47826854,47837898,chr12,LINC02354,chr12:47826854-47837898,11044
78015715,78046191,chr11,KCTD14,chr11:78015715-78046191,30476
47841537,47943048,chr12,VDR,chr12:47841537-47943048,101511
94148988,94275068,chr1,ARHGAP29,chr1:94148988-94275068,126080
55376826,55378246,chr19,TMEM190,chr19:55376826-55378246,1420
78016971,78079865,chr11,NDUFC2-KCTD14,chr11:78016971-78079865,62894
8247618,8270491,chr17,PFAS,chr17:8247618-8270491,22873
157259742,157533619,chr3,VEPH1,chr3:157259742-157533619,273877
55379244,55384292,chr19,TMEM238,chr19:55379244-55384292,5048
78063861,78068351,chr11,THRSP,chr11:78063861-78068351,4490
55385932,55403250,chr19,RPL28,chr19:55385932-55403250,17318
78068297,78079862,chr11,NDUFC2,chr11:78068297-78079862,11565
116563594,116663829,chr7,COMETT,chr7:116563594-116663829,100235
149993118,150000654,chr5,TIGD6,chr5:149993118-150000654,7536
6595072,6603616,chr11,RRP8,chr11:6595072-6603616,8544
22889371,23014130,chr7,FAM126A,chr7:22889371-23014130,124759
150000046,150053142,chr5,HMGXB3,chr5:150000046-150053142,53096
6603708,6610874,chr11,ILK,chr11:6603708-6610874,7166
23100214,23105703,chr7,KLHL7-DT,chr7:23100214-23105703,5489
150021567,150021921,chr5,RPS20P4,chr5:150021567-150021921,354
23129178,23129841,chr7,AK3P3,chr7:23129178-23129841,663
150053291,150113372,chr5,CSF1R,chr5:150053291-150113372,60081
113078331,113087778,chr7,GPR85,chr7:113078331-113087778,9447
55388181,55388242,chr19,MIR6805,chr19:55388181-55388242,61
55399745,55407788,chr19,UBE2S,chr19:55399745-55407788,8043
2242226,2251146,chr7,NUDT1,chr7:2242226-2251146,8920
8287763,8295400,chr17,SLC25A35,chr17:8287763-8295400,7637
47963569,47968878,chr12,TMEM106C,chr12:47963569-47968878,5309
108502358,108503455,chr1,ST13P21,chr1:108502358-108503455,1097
95937901,96022890,chr1,LINC02790,chr1:95937901-96022890,84989
55452985,55462343,chr19,ISOC2,chr19:55452985-55462343,9358
122795069,122881139,chr3,SLC49A4,chr3:122795069-122881139,86070
190055700,190062729,chr2,MSTN,chr2:190055700-190062729,7029
8288654,8290092,chr17,RANGRF,chr17:8288654-8290092,1438
120211054,120211715,chr2,MTATP6P26,chr2:120211054-120211715,661
208466238,208466626,chr2,H3P9,chr2:208466238-208466626,388
153477338,153478762,chr2,RPRM,chr2:153477338-153478762,1424
143119771,143124014,chr3,CHST2,chr3:143119771-143124014,4243
208128137,208129828,chr2,CRYGC,chr2:208128137-208129828,1691
20110739,20122199,chr14,OR4K17,chr14:20110739-20122199,11460
35490111,35561898,chr9,RUSC2,chr9:35490111-35561898,71787
180827977,180829850,chr3,FLYWCH1P1,chr3:180827977-180829850,1873
147386967,147387453,chr3,ZIC4-AS1,chr3:147386967-147387453,486
63593411,63660245,chr1,PGM1,chr1:63593411-63660245,66834
39230231,39388513,chr14,MIA2,chr14:39230231-39388513,158282
173396284,174286644,chr3,NLGN1,chr3:173396284-174286644,890360
55475983,55476482,chr19,ZNF628-DT,chr19:55475983-55476482,499
55476617,55484487,chr19,ZNF628,chr19:55476617-55484487,7870
8310241,8322514,chr17,ARHGEF15,chr17:8310241-8322514,12273
233059967,233207903,chr2,INPP5D,chr2:233059967-233207903,147936
55485188,55487568,chr19,NAT14,chr19:55485188-55487568,2380
44565804,44575051,chr7,DDX56,chr7:44565804-44575051,9247
83980798,84004074,chr9,RMI1,chr9:83980798-84004074,23276
150094302,150095048,chr5,RPL7P1,chr5:150094302-150095048,746
55488404,55519099,chr19,SSC5D,chr19:55488404-55519099,30695
150113839,150155872,chr5,PDGFRB,chr5:150113839-150155872,42033
120742637,120783069,chr3,GTF2E1,chr3:120742637-120783069,40432
33383179,33402682,chr9,AQP7,chr9:33383179-33402682,19503
18107798,18378483,chr1,IGSF21,chr1:18107798-18378483,270685
8339840,8346048,chr17,ODF4,chr17:8339840-8346048,6208
47972967,48004554,chr12,COL2A1,chr12:47972967-48004554,31587
122909082,123028605,chr3,SEMA5B,chr3:122909082-123028605,119523
52684449,52698347,chr1,COA7,chr1:52684449-52698347,13898
23565674,23630075,chr15,MKRN3,chr15:23565674-23630075,64401
55528611,55537133,chr19,SBK2,chr19:55528611-55537133,8522
8377516,8383213,chr17,RPL26,chr17:8377516-8383213,5697
55540656,55545543,chr19,SBK3,chr19:55540656-55545543,4887
21459756,21460082,chr1,PFN1P10,chr1:21459756-21460082,326
6621451,6622322,chr11,DCHS1-AS1,chr11:6621451-6622322,871
49423237,49488775,chr15,FGF7,chr15:49423237-49488775,65538
6680385,6683340,chr11,MRPL17,chr11:6680385-6683340,2955
55576774,55580848,chr19,ZNF579,chr19:55576774-55580848,4074
11674480,11691650,chr1,MAD2L2,chr1:11674480-11691650,17170
55591376,55601970,chr19,FIZ1,chr19:55591376-55601970,10594
6748131,6750324,chr11,GVINP2,chr11:6748131-6750324,2193
6621330,6655809,chr11,DCHS1,chr11:6621330-6655809,34479
55600022,55603138,chr19,ZNF524,chr19:55600022-55603138,3116
29612570,29614274,chr15,TUBBP8,chr15:29612570-29614274,1704
55620741,55624566,chr19,ZNF784,chr19:55620741-55624566,3825
29730713,29730985,chr15,HMGN2P5,chr15:29730713-29730985,272
30005205,30006430,chr15,NCAPGP2,chr15:30005205-30006430,1225
55635016,55643470,chr19,ZNF580,chr19:55635016-55643470,8454
30044455,30045296,chr15,SYNGR2P1,chr15:30044455-30045296,841
96760810,96808100,chr5,ERAP1,chr5:96760810-96808100,47290
43777087,43804427,chr15,SERF2,chr15:43777087-43804427,27340
55635459,55645623,chr19,ZNF581,chr19:55635459-55645623,10164
8511125,8511188,chr17,RNU7-43P,chr17:8511125-8511188,63
8560471,8560962,chr17,PPIAP52,chr17:8560471-8560962,491
78095244,78139660,chr11,ALG8,chr11:78095244-78139660,44416
55641062,55653161,chr19,CCDC106,chr19:55641062-55653161,12099
8729935,8745219,chr17,CCDC42,chr17:8729935-8745219,15284
8797110,8799365,chr17,MFSD6L,chr17:8797110-8799365,2255
33461353,33473930,chr9,NOL6,chr9:33461353-33473930,12577
8802722,8867677,chr17,PIK3R6,chr17:8802722-8867677,64955
183122215,183163839,chr3,LAMP3,chr3:183122215-183163839,41624
74174231,74197122,chr7,EIF4H,chr7:74174231-74197122,22891
42233674,42271266,chr8,IKBKB-DT,chr8:42233674-42271266,37592
113705011,113756693,chr2,SLC35F5,chr2:113705011-113756693,51682
166811009,166811567,chr3,CBX1P5,chr3:166811009-166811567,558
42341767,42342634,chr8,RPL5P23,chr8:42341767-42342634,867
55675226,55709858,chr19,EPN1,chr19:55675226-55709858,34632
108131100,108132114,chr8,AURKBP1,chr8:108131100-108132114,1014
108378831,108379545,chr8,RPS17P14,chr8:108378831-108379545,714
142449007,142578733,chr3,ATR,chr3:142449007-142578733,129726
8965896,8967070,chr17,PIK3R5-DT,chr17:8965896-8967070,1174
108443601,108489196,chr8,EMC2,chr8:108443601-108489196,45595
9021510,9244000,chr17,NTN1,chr17:9021510-9244000,222490
76607853,76630465,chr11,LINC02757,chr11:76607853-76630465,22612
76657524,76670747,chr11,LRRC32,chr11:76657524-76670747,13223
130693721,130707288,chr9,EXOSC2,chr9:130693721-130707288,13567
5274369,5306912,chr7,SLC29A4,chr7:5274369-5306912,32543
9250471,9576591,chr17,STX8,chr17:9250471-9576591,326120
40528683,40565057,chr15,CCDC32,chr15:40528683-40565057,36374
76694041,76719801,chr11,GUCY2EP,chr11:76694041-76719801,25760
55708438,55738402,chr19,NLRP9,chr19:55708438-55738402,29964
191495,196334,chr5,LRRC14B,chr5:191495-196334,4839
196868,218153,chr5,CCDC127,chr5:196868-218153,21285
139600838,139704109,chr8,KCNK9,chr8:139600838-139704109,103271
76782251,76798153,chr11,TSKU,chr11:76782251-76798153,15902
76782581,76783062,chr11,TSKU-AS1,chr11:76782581-76783062,481
36852906,37449223,chr7,ELMO1,chr7:36852906-37449223,596317
55737285,55737600,chr19,RN7SKP109,chr19:55737285-55737600,315
55769118,55773420,chr19,RFPL4AL1,chr19:55769118-55773420,4302
55777553,55778900,chr19,RFPL4AP1,chr19:55777553-55778900,1347
443175,471937,chr5,EXOC3,chr5:443175-471937,28762
55654146,55674716,chr19,U2AF2,chr19:55654146-55674716,20570
9576627,9643447,chr17,CFAP52,chr17:9576627-9643447,66820
76860859,77026797,chr11,ACER3,chr11:76860859-77026797,165938
139727725,140458579,chr8,TRAPPC9,chr8:139727725-140458579,730854
221418027,221574202,chr2,EPHA4,chr2:221418027-221574202,156175
89561434,89561517,chr16,SNORD68,chr16:89561434-89561517,83
89575758,89597246,chr16,CPNE7,chr16:89575758-89597246,21488
48042897,48106079,chr12,SENP1,chr12:48042897-48106079,63182
97394154,97420141,chr1,DPYD-IT1,chr1:97394154-97420141,25987
55222379,55223372,chr1,GYG1P3,chr1:55222379-55223372,993
113979391,114035572,chr1,OLFML3,chr1:113979391-114035572,56181
466124,473098,chr5,PP7080,chr5:466124-473098,6974
470456,524449,chr5,SLC9A3,chr5:470456-524449,53993
91099950,91302565,chr15,SV2B,chr15:91099950-91302565,202615
137094345,137094430,chr9,SNORD62,chr9:137094345-137094430,85
137169186,137169270,chr9,MIR3621,chr9:137169186-137169270,84
47760528,47997385,chr1,TRABD2B,chr1:47760528-47997385,236857
137220247,137222240,chr9,RNF208,chr9:137220247-137222240,1993
136519568,136519626,chr9,MIR4673,chr9:136519568-136519626,58
136546173,136546259,chr9,MIR4674,chr9:136546173-136546259,86
136375567,136400176,chr9,SNAPC4,chr9:136375567-136400176,24609
9589902,9590482,chr17,RPL19P18,chr17:9589902-9590482,580
93885199,93909456,chr1,GCLM,chr1:93885199-93909456,24257
1397026,1401570,chr19,GAMT,chr19:1397026-1401570,4544
9644698,9729687,chr17,USP43,chr17:9644698-9729687,84989
38694266,38720133,chr9,FAM240B,chr9:38694266-38720133,25867
128244721,128244830,chr9,MIR199B,chr9:128244721-128244830,109
128244947,128245030,chr9,MIR3154,chr9:128244947-128245030,83
91680343,91906335,chr1,TGFBR3,chr1:91680343-91906335,225992
89680737,89696354,chr16,CDK10,chr16:89680737-89696354,15617
128255829,128276026,chr9,GOLGA2,chr9:128255829-128276026,20197
42412823,42491141,chr15,ZNF106,chr15:42412823-42491141,78318
140094894,140100543,chr8,PEG13,chr8:140094894-140100543,5649
77034398,77041973,chr11,B3GNT6,chr11:77034398-77041973,7575
140511311,140517154,chr8,CHRAC1,chr8:140511311-140517154,5843
48081319,48081428,chr12,RNU6-1203P,chr12:48081319-48081428,109
77066961,77126155,chr11,CAPN5,chr11:77066961-77126155,59194
48132797,48132867,chr12,MIR6505,chr12:48132797-48132867,70
123536409,123536534,chr12,MIR3908,chr12:123536409-123536534,125
123575891,123585115,chr12,TMED2-DT,chr12:123575891-123585115,9224
123584533,123598582,chr12,TMED2,chr12:123584533-123598582,14049
1407569,1435687,chr19,DAZAP1,chr19:1407569-1435687,28118
180602858,180684942,chr3,CCDC39,chr3:180602858-180684942,82084
73799542,73832690,chr7,CLDN4,chr7:73799542-73832690,33148
473236,480884,chr5,SLC9A3-AS1,chr5:473236-480884,7648
141916399,141920625,chr7,OR9A4,chr7:141916399-141920625,4226
9822206,9892099,chr17,GLP2R,chr17:9822206-9892099,69893
143954844,143997312,chr7,OR2F1,chr7:143954844-143997312,42468
108162787,108443496,chr8,EIF3E,chr8:108162787-108443496,280709
150722253,150750033,chr7,GIMAP5,chr7:150722253-150750033,27780
94759259,94760279,chr2,CYP4F32P,chr2:94759259-94760279,1020
131637025,131649615,chr2,LINC01087,chr2:131637025-131649615,12590
123602077,123620943,chr12,DDX55,chr12:123602077-123620943,18866
221532668,221533008,chr2,TMEM256P2,chr2:221532668-221533008,340
535840,535882,chr5,MIR4456,chr5:535840-535882,42
602620,612210,chr5,CEP72-DT,chr5:602620-612210,9590
92141643,92179531,chr7,LRRD1,chr7:92141643-92179531,37888
62196115,62224731,chr2,B3GNT2,chr2:62196115-62224731,28616
612340,667168,chr5,CEP72,chr5:612340-667168,54828
187197486,187201462,chr3,RTP1,chr3:187197486-187201462,3976
181505075,181505879,chr3,RPL7AP25,chr3:181505075-181505879,804
129979666,129982738,chr2,RAB6C,chr2:129979666-129982738,3072
105604772,105876599,chr7,ATXN7L1,chr7:105604772-105876599,271827
2987987,3019755,chr6,NQO2,chr6:2987987-3019755,31768
178419201,178457309,chr3,LINC01014,chr3:178419201-178457309,38108
175977497,175978570,chr3,ACTG1P23,chr3:175977497-175978570,1073
128455186,128501292,chr9,ODF2,chr9:128455186-128501292,46106
659862,693352,chr5,TPPP,chr5:659862-693352,33490
102967408,102984429,chr2,LINC01935,chr2:102967408-102984429,17021
216385288,216412696,chr2,SMARCAL1-AS1,chr2:216385288-216412696,27408
155821024,155854456,chr3,SLC33A1,chr3:155821024-155854456,33432
115564601,115565432,chr1,CNOT7P2,chr1:115564601-115565432,831
107964443,107994607,chr1,VAV3-AS1,chr1:107964443-107994607,30164
767382,768930,chr5,BRD9P2,chr5:767382-768930,1548
56538452,56538911,chr1,RPL21P23,chr1:56538452-56538911,459
9852748,9853306,chr17,NPM1P45,chr17:9852748-9853306,558
816346,817001,chr5,SPCS2P3,chr5:816346-817001,655
9896320,9905271,chr17,RCVRN,chr17:9896320-9905271,8951
241149576,241183652,chr2,PPP1R7,chr2:241149576-241183652,34076
139221758,139221837,chr5,RNU6-572P,chr5:139221758-139221837,79
139273752,139331671,chr5,MATR3,chr5:139273752-139331671,57919
10258762,10259232,chr17,RPS27AP1,chr17:10258762-10259232,470
120833440,120836360,chr3,LINC02049,chr3:120833440-120836360,2920
10300865,10373130,chr17,MYH13,chr17:10300865-10373130,72265
95061596,95067545,chr1,ALG14-AS1,chr1:95061596-95067545,5949
93924386,93924716,chr1,MTND3P21,chr1:93924386-93924716,330
50174306,50175868,chr1,ELAVL4-AS1,chr1:50174306-50175868,1562
103099776,103149560,chr7,NAPEPLD,chr7:103099776-103149560,49784
56431950,56433213,chr6,RCC2P7,chr6:56431950-56433213,1263
56843928,56864078,chr6,DST-AS1,chr6:56843928-56864078,20150
141525133,141526121,chr3,RASA2-IT1,chr3:141525133-141526121,988
56871191,56871743,chr6,RPL17P26,chr6:56871191-56871743,552
56945730,56945836,chr6,RNU6-626P,chr6:56945730-56945836,106
56955107,57027346,chr6,BEND6,chr6:56955107-57027346,72239
43389882,43454247,chr1,SZT2,chr1:43389882-43454247,64365
1461143,1479219,chr19,C19orf25,chr19:1461143-1479219,18076
123616708,123616840,chr12,SNORA9B,chr12:123616708-123616840,132
173910498,173920796,chr3,NLGN1-AS1,chr3:173910498-173920796,10298
77102840,77103331,chr11,OMP,chr11:77102840-77103331,491
123620406,123633766,chr12,EIF2B1,chr12:123620406-123633766,13360
55538884,55588947,chr15,PYGO1,chr15:55538884-55588947,50063
149433044,149433274,chr3,RPL32P8,chr3:149433044-149433274,230
182498187,182536772,chr3,LINC01995,chr3:182498187-182536772,38585
182446970,182486364,chr3,LINC01994,chr3:182446970-182486364,39394
74012718,74171210,chr11,C2CD3,chr11:74012718-74171210,158492
56975606,56976062,chr6,OSTCP6,chr6:56975606-56976062,456
160342685,160343015,chr3,RPL35AP10,chr3:160342685-160343015,330
153067278,153067551,chr3,HMGN2P13,chr3:153067278-153067551,273
57004520,57004799,chr6,FTH1P15,chr6:57004520-57004799,279
139845078,139845411,chr3,TRMT112P5,chr3:139845078-139845411,333
132401253,132401796,chr3,NIP7P2,chr3:132401253-132401796,543
57029521,57029988,chr6,MRPL30P1,chr6:57029521-57029988,467
89682620,89686569,chr16,LINC02166,chr16:89682620-89686569,3949
183016255,183017808,chr3,MCCC1-AS1,chr3:183016255-183017808,1553
57046532,57055239,chr6,KIAA1586,chr6:57046532-57055239,8707
52115100,52191392,chr15,GNB5,chr15:52115100-52191392,76292
180680084,180700449,chr3,CCDC39-AS1,chr3:180680084-180700449,20365
89696357,89701705,chr16,SPATA2L,chr16:89696357-89701705,5348
24305187,24311430,chr14,CIDEB,chr14:24305187-24311430,6243
149761100,149968385,chr3,ANKUB1,chr3:149761100-149968385,207285
1481428,1490752,chr19,PCSK4,chr19:1481428-1490752,9324
89707134,89720898,chr16,VPS9D1,chr16:89707134-89720898,13764
10383144,10623886,chr17,MYHAS,chr17:10383144-10623886,240742
55365337,55433737,chr7,LANCL2,chr7:55365337-55433737,68400
41546381,41602384,chr6,FOXP4,chr6:41546381-41602384,56003
149648997,149650184,chr3,WWTR1-IT1,chr3:149648997-149650184,1187
10390322,10421950,chr17,MYH8,chr17:10390322-10421950,31628
177816865,177899224,chr3,LINC02015,chr3:177816865-177899224,82359
22598290,22612963,chr14,ABHD4,chr14:22598290-22612963,14673
120805866,120806745,chr3,NAP1L1P3,chr3:120805866-120806745,879
149474697,149503394,chr3,TM4SF4,chr3:149474697-149503394,28697
123633739,123662604,chr12,GTF2H3,chr12:123633739-123662604,28865
149984395,149984797,chr3,PPIAP73,chr3:149984395-149984797,402
99684957,99735102,chr7,CYP3A7-CYP3A51P,chr7:99684957-99735102,50145
172443291,172448456,chr3,GHSR,chr3:172443291-172448456,5165
150719997,150720836,chr3,SNRPCP3,chr3:150719997-150720836,839
89711856,89718165,chr16,VPS9D1-AS1,chr16:89711856-89718165,6309
129218093,129218350,chr3,RPS27P12,chr3:129218093-129218350,257
59429022,59465380,chr14,GPR135,chr14:59429022-59465380,36358
156809551,156810732,chr3,PA2G4P4,chr3:156809551-156810732,1181
67513940,67514320,chr3,NDUFB4P1,chr3:67513940-67514320,380
28267058,28278224,chr6,ZSCAN26,chr6:28267058-28278224,11166
154334943,154430190,chr3,GPR149,chr3:154334943-154430190,95247
89640816,89657738,chr16,CHMP1A,chr16:89640816-89657738,16922
51826195,51979342,chr14,GNG2,chr14:51826195-51979342,153147
181952343,182035644,chr3,LINC01206,chr3:181952343-182035644,83301
641689,641778,chr10,MIR5699,chr10:641689-641778,89
138795911,138904070,chr6,ECT2L,chr6:138795911-138904070,108159
649948,669581,chr10,DIP2C-AS1,chr10:649948-669581,19633
10443290,10469559,chr17,MYH4,chr17:10443290-10469559,26269
1505022,1513604,chr19,ADAMTSL5,chr19:1505022-1513604,8582
152134922,152436644,chr7,KMT2C,chr7:152134922-152436644,301722
65912457,67763637,chr10,CTNNA3,chr10:65912457-67763637,1851180
50275389,50355408,chr15,GABPB1,chr15:50275389-50355408,80019
88612431,88792953,chr14,EML5,chr14:88612431-88792953,180522
30896614,30903547,chr16,CTF1,chr16:30896614-30903547,6933
72080331,72110782,chr11,LRTOMT,chr11:72080331-72110782,30451
21983865,22001116,chr16,PDZD9,chr16:21983865-22001116,17251
10492307,10518542,chr17,MYH1,chr17:10492307-10518542,26235
158650014,158764876,chr6,SYTL3,chr6:158650014-158764876,114862
67334123,67334882,chr10,RPL7AP51,chr10:67334123-67334882,759
67403351,67403410,chr10,MIR7151,chr10:67403351-67403410,59
67750284,67751225,chr10,AKR1B10P1,chr10:67750284-67751225,941
84699986,84779922,chr16,USP10,chr16:84699986-84779922,79936
67793770,67794245,chr10,RPL21P92,chr10:67793770-67794245,475
96341438,96341526,chr11,MIR1260B,chr11:96341438-96341526,88
67796669,67838188,chr10,DNAJC12,chr10:67796669-67838188,41519
1570575,1570860,chr19,RN7SL477P,chr19:1570575-1570860,285
1573596,1592865,chr19,MBD3,chr19:1573596-1592865,19269
169215780,169254050,chr6,THBS2,chr6:169215780-169254050,38270
96349241,96389956,chr11,CCDC82,chr11:96349241-96389956,40715
100627049,100640613,chr1,LINC01349,chr1:100627049-100640613,13564
113696831,113759489,chr1,PHTF1,chr1:113696831-113759489,62658
139274102,139284899,chr5,SNHG4,chr5:139274102-139284899,10797
67808502,67808608,chr10,RNU6-1250P,chr10:67808502-67808608,106
67825310,67825600,chr10,RN7SL394P,chr10:67825310-67825600,290
67833763,67834081,chr10,DNAJC19P1,chr10:67833763-67834081,318
67858818,67858871,chr10,RNU6-523P,chr10:67858818-67858871,53
67874332,67874911,chr10,RPL12P8,chr10:67874332-67874911,579
67884656,67918390,chr10,SIRT1,chr10:67884656-67918390,33734
139276180,139276320,chr5,SNORA74D,chr5:139276180-139276320,140
139278781,139278978,chr5,SNORA74A,chr5:139278781-139278978,197
10521148,10549700,chr17,MYH2,chr17:10521148-10549700,28552
84368527,84464187,chr16,ATP2C2,chr16:84368527-84464187,95660
67960702,67961464,chr10,RPS3AP38,chr10:67960702-67961464,762
68007718,68008017,chr10,RN7SL220P,chr10:68007718-68008017,299
68010205,68010862,chr10,POU5F1P5,chr10:68010205-68010862,657
72332830,72355149,chr10,DNAJB12,chr10:72332830-72355149,22319
1446302,1473244,chr19,APC2,chr19:1446302-1473244,26942
189486480,189487992,chr2,KDM3AP1,chr2:189486480-189487992,1512
241015599,241064116,chr2,SNED1-AS1,chr2:241015599-241064116,48517
28894667,28948219,chr2,WDR43,chr2:28894667-28948219,53552
96389989,96507574,chr11,JRKL,chr11:96389989-96507574,117585
123712353,123761755,chr12,ATP6V0A2,chr12:123712353-123761755,49402
95866587,95925663,chr14,TUNAR,chr14:95866587-95925663,59076
25912754,25930691,chr6,SLC17A2,chr6:25912754-25930691,17937
96447132,96506826,chr11,JRKL-AS1,chr11:96447132-96506826,59694
96474572,96474692,chr11,RNA5SP346,chr11:96474572-96474692,120
96508425,96514748,chr11,LINC02737,chr11:96508425-96514748,6323
73931501,73950414,chr14,FAM161B,chr14:73931501-73950414,18913
129815848,129860003,chr11,TMEM45B,chr11:129815848-129860003,44155
75094432,75109221,chr10,DUSP13,chr10:75094432-75109221,14789
38285410,38286410,chr2,GAPDHP25,chr2:38285410-38286410,1000
129899706,130002835,chr11,PRDM10,chr11:129899706-130002835,103129
73949926,73963670,chr14,COQ6,chr14:73949926-73963670,13744
109711780,109775428,chr1,GSTM5,chr1:109711780-109775428,63648
77613027,77820900,chr15,LINGO1,chr15:77613027-77820900,207873
152800434,152800732,chr3,ATP5MGP5,chr3:152800434-152800732,298
55106460,55282617,chr6,HCRTR2,chr6:55106460-55282617,176157
156673235,156706770,chr3,TIPARP,chr3:156673235-156706770,33535
29108058,29114770,chr6,OR2J3,chr6:29108058-29114770,6712
127048027,127107288,chr2,BIN1,chr2:127048027-127107288,59261
123721246,123721639,chr12,RPL27P12,chr12:123721246-123721639,393
46860997,47005077,chr19,ARHGAP35,chr19:46860997-47005077,144080
29585121,29590500,chr6,OR2H2,chr6:29585121-29590500,5379
123762188,123935720,chr12,DNAH10,chr12:123762188-123935720,173532
36968141,36986298,chr6,MTCH1,chr6:36968141-36986298,18157
109668022,109709551,chr1,GSTM2,chr1:109668022-109709551,41529
39943239,39943680,chr19,PRR13P5,chr19:39943239-39943680,441
39971165,39981764,chr19,PSMC4,chr19:39971165-39981764,10599
57375967,57550717,chr15,CGNL1,chr15:57375967-57550717,174750
185417495,185418778,chr3,RPL4P4,chr3:185417495-185418778,1283
154023835,154024298,chr3,RPL21P42,chr3:154023835-154024298,463
88570403,88631964,chr16,ZC3H18,chr16:88570403-88631964,61561
129974688,129977935,chr3,TRH,chr3:129974688-129977935,3247
99821855,99866891,chr9,NR4A3,chr9:99821855-99866891,45036
142960650,143001559,chr3,PAQR9-AS1,chr3:142960650-143001559,40909
125734295,125735198,chr3,OR7E53P,chr3:125734295-125735198,903
10628526,10657309,chr17,MYH3,chr17:10628526-10657309,28783
170459548,170586075,chr3,SLC7A14,chr3:170459548-170586075,126527
106573663,107164706,chr10,SORCS1,chr10:106573663-107164706,591043
157081667,157128595,chr3,LINC00880,chr3:157081667-157128595,46928
99906654,99974534,chr9,STX17,chr9:99906654-99974534,67880
153431856,153502697,chr3,LINC02877,chr3:153431856-153502697,70841
45430579,45448761,chr15,C15orf48,chr15:45430579-45448761,18182
176068042,176068908,chr3,EI24P1,chr3:176068042-176068908,866
39984134,40021038,chr19,ZNF546,chr19:39984134-40021038,36904
178493327,178493810,chr3,PPIAP75,chr3:178493327-178493810,483
193553213,193555088,chr3,ATP13A4-AS1,chr3:193553213-193555088,1875
186851886,186856123,chr3,ADIPOQ-AS1,chr3:186851886-186856123,4237
183806457,183810783,chr3,YEATS2-AS1,chr3:183806457-183810783,4326
81053497,81077267,chr16,C16orf46,chr16:81053497-81077267,23770
155987304,155988176,chr3,SETP14,chr3:155987304-155988176,872
151637174,151657966,chr3,LINC02066,chr3:151637174-151657966,20792
193618609,193627337,chr3,OPA1-AS1,chr3:193618609-193627337,8728
187668912,187670394,chr3,SST,chr3:187668912-187670394,1482
56067254,56074510,chr8,RPS20,chr8:56067254-56074510,7256
3222325,3236221,chr16,ZNF200,chr16:3222325-3236221,13896
45789585,45789688,chr7,RNU6-241P,chr7:45789585-45789688,103
45816216,45819016,chr7,CICP20,chr7:45816216-45819016,2800
113828182,113947174,chr3,GRAMD1C,chr3:113828182-113947174,118992
45843634,45843740,chr7,RNU6-326P,chr7:45843634-45843740,106
88877294,88895597,chr15,HAPLN3,chr15:88877294-88895597,18303
45859994,45873082,chr7,CCDC201,chr7:45859994-45873082,13088
45888360,45893660,chr7,IGFBP1,chr7:45888360-45893660,5300
73368555,73395133,chr6,OOEP,chr6:73368555-73395133,26578
102419189,102423136,chr10,FBXL15,chr10:102419189-102423136,3947
130827406,130837135,chr6,SMLR1,chr6:130827406-130837135,9729
41053202,41064891,chr6,APOBEC2,chr6:41053202-41064891,11689
31399784,31415315,chr6,MICA,chr6:31399784-31415315,15531
40028260,40056231,chr19,ZNF780B,chr19:40028260-40056231,27971
52993201,52993702,chr1,RRAS2P1,chr1:52993201-52993702,501
88898683,88913381,chr15,MFGE8,chr15:88898683-88913381,14698
101786340,101787219,chr1,RPSAP19,chr1:101786340-101787219,879
100393033,100394026,chr1,BCAS2P2,chr1:100393033-100394026,993
80537902,80646560,chr10,SH2D4B,chr10:80537902-80646560,108658
10672474,10698375,chr17,SCO1,chr17:10672474-10698375,25901
94529173,94541759,chr1,F3,chr1:94529173-94541759,12586
45912245,45921874,chr7,IGFBP3,chr7:45912245-45921874,9629
123925461,123934984,chr12,DNAH10OS,chr12:123925461-123934984,9523
46286345,46330207,chr10,ANTXRL,chr10:46286345-46330207,43862
40121311,40122168,chr19,VN1R96P,chr19:40121311-40122168,857
119283825,119303380,chr12,LINC00934,chr12:119283825-119303380,19555
9235144,9236076,chr19,OR7D1P,chr19:9235144-9236076,932
9261015,9261716,chr19,OR7E18P,chr19:9261015-9261716,701
9265440,9268819,chr19,OR7E19P,chr19:9265440-9268819,3379
9278448,9279369,chr19,OR7H1P,chr19:9278448-9279369,921
99998301,99999069,chr9,UPF3AP3,chr9:99998301-99999069,768
119171555,119224855,chr12,HSPB8,chr12:119171555-119224855,53300
100102559,100102839,chr9,RN7SL75P,chr9:100102559-100102839,280
73958010,74019399,chr14,ENTPD5,chr14:73958010-74019399,61389
100116755,100117651,chr9,RPS2P35,chr9:100116755-100117651,896
9291140,9309838,chr19,ZNF699,chr19:9291140-9309838,18698
10697594,10711558,chr17,ADPRM,chr17:10697594-10711558,13964
100175178,100176054,chr9,NANOGP5,chr9:100175178-100176054,876
11842524,11869533,chr8,CTSB,chr8:11842524-11869533,27009
116775104,116775623,chr1,FTH1P22,chr1:116775104-116775623,519
119047405,119064785,chr1,WARS2-IT1,chr1:119047405-119064785,17380
62975751,63022504,chr1,LINC01739,chr1:62975751-63022504,46753
31441667,31446973,chr6,LINC01149,chr6:31441667-31446973,5306
9363020,9382617,chr19,ZNF177,chr19:9363020-9382617,19597
120388875,120580170,chr9,CDK5RAP2,chr9:120388875-120580170,191295
31479973,31494935,chr6,MICB-DT,chr6:31479973-31494935,14962
101893105,101894047,chr1,DNAJA1P5,chr1:101893105-101894047,942
31463170,31478936,chr6,HCP5,chr6:31463170-31478936,15766
139299852,139299968,chr5,RNA5SP195,chr5:139299852-139299968,116
139333038,139333365,chr5,RN7SKP64,chr5:139333038-139333365,327
10699015,10730023,chr17,TMEM220,chr17:10699015-10730023,31008
121142051,121142438,chr1,RPL22P6,chr1:121142051-121142438,387
139341587,139369720,chr5,PAIP2,chr5:139341587-139369720,28133
9466355,9498616,chr19,ZNF560,chr19:9466355-9498616,32261
27466810,27502185,chr12,SMCO2,chr12:27466810-27502185,35375
100719742,100739045,chr1,VCAM1,chr1:100719742-100739045,19303
3978062,3979099,chr6,GLRX3P2,chr6:3978062-3979099,1037
45997540,45998071,chr7,FTLP15,chr7:45997540-45998071,531
188969,229463,chr16,LUC7L,chr16:188969-229463,40494
45999621,46000778,chr7,TTC4P1,chr7:45999621-46000778,1157
73674287,73698109,chr10,AGAP5,chr10:73674287-73698109,23822
32812757,32838570,chr7,DPY19L1P2,chr7:32812757-32838570,25813
4021267,4064983,chr6,PRPF4B,chr6:4021267-4064983,43716
27496937,27498589,chr12,RARS1P1,chr12:27496937-27498589,1652
130002938,130004356,chr11,LINC00167,chr11:130002938-130004356,1418
56244043,56247482,chr19,ZSCAN5DP,chr19:56244043-56247482,3439
130032866,130033220,chr11,ELOBP2,chr11:130032866-130033220,354
56272748,56310454,chr19,EDDM13,chr19:56272748-56310454,37706
10716002,10716511,chr17,MAGOH2P,chr17:10716002-10716511,509
41246599,41962130,chr3,ULK4,chr3:41246599-41962130,715531
27523431,27695564,chr12,PPFIBP1,chr12:27523431-27695564,172133
32957404,33006930,chr7,FKBP9,chr7:32957404-33006930,49526
10729777,10815164,chr17,TMEM220-AS1,chr17:10729777-10815164,85387
130068147,130144811,chr11,APLP2,chr11:130068147-130144811,76664
56314703,56365316,chr19,ZSCAN5A-AS1,chr19:56314703-56365316,50613
56317177,56318008,chr19,VN2R17P,chr19:56317177-56318008,831
101226994,101229463,chr10,LBX1,chr10:101226994-101229463,2469
139367196,139384553,chr5,SLC23A1,chr5:139367196-139384553,17357
47487219,47491700,chr10,FAM25G,chr10:47487219-47491700,4481
91642516,91644082,chr1,HSP90B3P,chr1:91642516-91644082,1566
10794913,10804099,chr17,TMEM238L,chr17:10794913-10804099,9186
51518309,51561629,chr1,EPS15-AS1,chr1:51518309-51561629,43320
56368099,56379828,chr19,ZNF542P,chr19:56368099-56379828,11729
27258762,27288824,chr10,ODAD2P1,chr10:27258762-27288824,30062
10822470,10838087,chr17,PIRT,chr17:10822470-10838087,15617
27564430,27594588,chr10,LINC02680,chr10:27564430-27594588,30158
126424997,126798708,chr10,C10orf90,chr10:126424997-126798708,373711
10857899,10858004,chr17,RNU6-1065P,chr17:10857899-10858004,105
74019349,74082863,chr14,BBOF1,chr14:74019349-74082863,63514
10860535,10861462,chr17,RPL15P21,chr17:10860535-10861462,927
11157455,11157747,chr17,RN7SL601P,chr17:11157455-11157747,292
113929324,113977869,chr1,HIPK1,chr1:113929324-113977869,48545
11241213,11564063,chr17,SHISA6,chr17:11241213-11564063,322850
88960070,88961046,chr15,KRT18P47,chr15:88960070-88961046,976
88803436,88875353,chr15,ACAN,chr15:88803436-88875353,71917
38901235,38973912,chr8,PLEKHA2,chr8:38901235-38973912,72677
11598470,11969748,chr17,DNAH9,chr17:11598470-11969748,371278
4049434,4087344,chr6,FAM217A,chr6:4049434-4087344,37910
33001950,33002054,chr7,RNU6-388P,chr7:33001950-33002054,104
33014130,33062796,chr7,NT5C3A,chr7:33014130-33062796,48666
74056847,74084492,chr14,ALDH6A1,chr14:74056847-74084492,27645
73007217,73096974,chr10,P4HA1,chr10:73007217-73096974,89757
64445231,64456070,chr3,PRICKLE2-DT,chr3:64445231-64456070,10839
135965728,136147894,chr3,PPP2R3A,chr3:135965728-136147894,182166
139387467,139390081,chr5,MZB1,chr5:139387467-139390081,2614
56386226,56386690,chr19,SLC25A36P1,chr19:56386226-56386690,464
56393656,56399172,chr19,ZNF582-DT,chr19:56393656-56399172,5516
4079209,4130951,chr6,C6orf201,chr6:4079209-4130951,51742
38974228,38988663,chr8,HTRA4,chr8:38974228-38988663,14435
56397966,56436035,chr19,ZNF583,chr19:56397966-56436035,38069
139390592,139395104,chr5,PROB1,chr5:139390592-139395104,4512
139408588,139444491,chr5,DNAJC18,chr5:139408588-139444491,35903
38988808,38996824,chr8,TM2D2,chr8:38988808-38996824,8016
4115693,4135597,chr6,ECI2,chr6:4115693-4135597,19904
9959561,10010504,chr19,COL5A3,chr19:9959561-10010504,50943
33036212,33036382,chr7,RPS29P14,chr7:33036212-33036382,170
3305406,3318852,chr16,ZNF75A,chr16:3305406-3318852,13446
33045798,33046090,chr7,RN7SL505P,chr7:33045798-33046090,292
33177740,33177838,chr7,RNA5SP229,chr7:33177740-33177838,98
33094797,33109405,chr7,RP9,chr7:33094797-33109405,14608
39018615,39018683,chr8,SNORD38D,chr8:39018615-39018683,68
39106990,39284917,chr8,ADAM32,chr8:39106990-39284917,177927
64794388,64833681,chr7,ZNF138,chr7:64794388-64833681,39293
74174456,74174753,chr14,RN7SL530P,chr14:74174456-74174753,297
126012381,126388477,chr10,ADAM12,chr10:126012381-126388477,376096
74239449,74262738,chr14,VSX2,chr14:74239449-74262738,23289
3242027,3256633,chr16,MEFV,chr16:3242027-3256633,14606
139447907,139448017,chr5,RNU5B-4P,chr5:139447907-139448017,110
139935185,140577397,chr3,CLSTN2,chr3:139935185-140577397,642212
149057554,149057656,chr5,RNU6-732P,chr5:149057554-149057656,102
149062313,149062409,chr5,MIR584,chr5:149062313-149062409,96
149116178,149116480,chr5,RN7SKP145,chr5:149116178-149116480,302
74285269,74303055,chr14,ABCD4,chr14:74285269-74303055,17786
63957874,63962507,chr5,HTR1A,chr5:63957874-63962507,4633
64852397,64853354,chr7,SEPHS1P1,chr7:64852397-64853354,957
64862999,64864370,chr7,EEF1DP4,chr7:64862999-64864370,1371
99790156,99806927,chr15,DNM1P46,chr15:99790156-99806927,16771
148451032,148677235,chr5,HTR4,chr5:148451032-148677235,226203
128671693,128687877,chr7,FAM71F2,chr7:128671693-128687877,16184
190166764,190167651,chr3,NMNAT1P3,chr3:190166764-190167651,887
182460417,182461072,chr3,EIF4EP3,chr3:182460417-182461072,655
99791209,99791410,chr15,RN7SL484P,chr15:99791209-99791410,201
183635610,183684519,chr3,KLHL24,chr3:183635610-183684519,48909
130082495,130082781,chr11,RPL34P21,chr11:130082495-130082781,286
130159782,130210362,chr11,ST14,chr11:130159782-130210362,50580
104328603,104908561,chr7,LHFPL3,chr7:104328603-104908561,579958
104667749,104669576,chr7,EIF4BP6,chr7:104667749-104669576,1827
104738597,104804107,chr7,LHFPL3-AS1,chr7:104738597-104804107,65510
100074081,100074190,chr15,RNA5SP402,chr15:100074081-100074190,109
10013249,10022279,chr19,RDH8,chr19:10013249-10022279,9030
100344047,100350725,chr15,SPATA41,chr15:100344047-100350725,6678
100372936,100437914,chr15,CERS3-AS1,chr15:100372936-100437914,64978
104894628,104926645,chr7,LHFPL3-AS2,chr7:104894628-104926645,32017
104911928,104912193,chr7,RN7SL8P,chr7:104911928-104912193,265
10038354,10038413,chr19,MIR5589,chr19:10038354-10038413,59
100551820,100551922,chr15,RNU6-322P,chr15:100551820-100551922,102
100553529,100558954,chr15,PRKXP1,chr15:100553529-100558954,5425
10086122,10093252,chr19,SHFL,chr19:10086122-10093252,7130
100560686,100560792,chr15,RNU6-181P,chr15:100560686-100560792,106
66931537,66956518,chr15,LINC02206,chr15:66931537-66956518,24981
87833568,87876360,chr7,SLC25A40,chr7:87833568-87876360,42792
67000814,67001085,chr15,HMGN2P47,chr15:67000814-67001085,271
67063763,67195173,chr15,SMAD3,chr15:67063763-67195173,131410
187368385,187372076,chr3,RTP4,chr3:187368385-187372076,3691
195614947,195620233,chr3,MUC20P1,chr3:195614947-195620233,5286
149656999,149661364,chr3,WWTR1-AS1,chr3:149656999-149661364,4365
194202392,194250203,chr3,LINC02036,chr3:194202392-194250203,47811
57648188,57661865,chr11,CLP1,chr11:57648188-57661865,13677
10106223,10114780,chr19,PPAN-P2RY11,chr19:10106223-10114780,8557
57089982,57170306,chr3,IL17RD,chr3:57089982-57170306,80324
64764606,64778786,chr11,SF1,chr11:64764606-64778786,14180
87876216,87909553,chr7,DBF4,chr7:87876216-87909553,33337
4136072,4157385,chr6,ECI2-DT,chr6:4136072-4157385,21313
39157538,39158701,chr8,RPL3P10,chr8:39157538-39158701,1163
166903698,166904835,chr6,RPS6KA2-AS1,chr6:166903698-166904835,1137
166922113,166957191,chr6,RNASET2,chr6:166922113-166957191,35078
131949973,132012243,chr5,ACSL6,chr5:131949973-132012243,62270
10106362,10112012,chr19,PPAN,chr19:10106362-10112012,5650
73008856,73048123,chr8,TERF1,chr8:73008856-73048123,39267
27696388,27710803,chr12,MRPS35-DT,chr12:27696388-27710803,14415
119439001,119446086,chr1,HSD3BP2,chr1:119439001-119446086,7085
27696447,27697596,chr12,REP15,chr12:27696447-27697596,1149
109279556,109283186,chr1,PSRC1,chr1:109279556-109283186,3630
27702338,27702906,chr12,HMGB1P49,chr12:27702338-27702906,568
37125598,37232567,chr10,ANKRD30A,chr10:37125598-37232567,106969
27710822,27756295,chr12,MRPS35,chr12:27710822-27756295,45473
73018945,73019044,chr8,RNU6-285P,chr8:73018945-73019044,99
28097976,28211965,chr16,XPO6,chr16:28097976-28211965,113989
88205115,88226993,chr7,SRI,chr7:88205115-88226993,21878
63014881,63039407,chr8,GGH,chr8:63014881-63039407,24526
10107651,10107735,chr19,SNORD105,chr19:10107651-10107735,84
10109757,10109835,chr19,SNORD105B,chr19:10109757-10109835,78
10111693,10115372,chr19,P2RY11,chr19:10111693-10115372,3679
11977439,11997475,chr17,ZNF18,chr17:11977439-11997475,20036
10115014,10119918,chr19,EIF3G,chr19:10115014-10119918,4904
74303069,74360008,chr14,VRTN,chr14:74303069-74360008,56939
27780048,27803040,chr12,KLHL42,chr12:27780048-27803040,22992
88706249,88752776,chr10,LIPK,chr10:88706249-88752776,46527
74305425,74306527,chr14,SUB1P2,chr14:74305425-74306527,1102
74377818,74378418,chr14,RPS2P2,chr14:74377818-74378418,600
97737121,97760907,chr10,ZFYVE27,chr10:97737121-97760907,23786
74084956,74201493,chr14,LIN52,chr14:74084956-74201493,116537
27806082,27806390,chr12,RN7SKP15,chr12:27806082-27806390,308
67200667,67255195,chr15,AAGAB,chr15:67200667-67255195,54528
27958084,27972733,chr12,PTHLH,chr12:27958084-27972733,14649
67062417,67196778,chr8,CSPP1,chr8:67062417-67196778,134361
12020829,12143830,chr17,MAP2K4,chr17:12020829-12143830,123001
96254069,96374125,chr1,LINC01787,chr1:96254069-96374125,120056
97545701,97546958,chr1,SEC63P1,chr1:97545701-97546958,1257
47000898,47001087,chr1,CYP4A27P,chr1:47000898-47001087,189
49677369,49677893,chr14,STK16P1,chr14:49677369-49677893,524
132417502,132539032,chr3,DNAJC13,chr3:132417502-132539032,121530
99472332,99600995,chr1,LINC01708,chr1:99472332-99600995,128663
93925406,93926072,chr1,MTATP6P13,chr1:93925406-93926072,666
49684544,49684665,chr14,RNU6ATAC30P,chr14:49684544-49684665,121
90510910,90533472,chr1,LINC02787,chr1:90510910-90533472,22562
49693105,49753150,chr14,KLHDC1,chr14:49693105-49753150,60045
100538139,100542021,chr1,GPR88,chr1:100538139-100542021,3882
95234210,95247225,chr1,RWDD3,chr1:95234210-95247225,13015
88216660,88219226,chr7,SRI-AS1,chr7:88216660-88219226,2566
88049016,88142099,chr12,CEP290,chr12:88049016-88142099,93083
88270892,88306894,chr7,STEAP4,chr7:88270892-88306894,36002
117367449,117528872,chr1,MAN1A2,chr1:117367449-117528872,161423
12036496,12036637,chr17,RNU11-2P,chr17:12036496-12036637,141
12081899,12081996,chr17,MIR744,chr17:12081899-12081996,97
67232446,67232837,chr15,RPS24P16,chr15:67232446-67232837,391
151280515,151280612,chr6,RNU6-1247P,chr6:151280515-151280612,97
12549764,12642854,chr17,LINC00670,chr17:12549764-12642854,93090
151298841,151298933,chr6,RNY4P20,chr6:151298841-151298933,92
151319635,151319950,chr6,RN7SKP268,chr6:151319635-151319950,315
29699367,29968915,chr15,TJP1,chr15:29699367-29968915,269548
151364115,151391559,chr6,ZBTB2,chr6:151364115-151391559,27444
151398898,151452158,chr6,RMND1,chr6:151398898-151452158,53260
87934143,88202889,chr7,ADAM22,chr7:87934143-88202889,268746
12671862,12706135,chr17,MYOCD-AS1,chr17:12671862-12706135,34273
12760140,12790242,chr17,ARHGAP44-AS1,chr17:12760140-12790242,30102
12917268,12917342,chr17,MIR1269B,chr17:12917268-12917342,74
12991612,13018065,chr17,ELAC2,chr17:12991612-13018065,26453
10221433,10231331,chr19,S1PR2,chr19:10221433-10231331,9898
49768130,49786385,chr14,KLHDC2,chr14:49768130-49786385,18255
10230413,10230485,chr19,MIR4322,chr19:10230413-10230485,72
113011687,113073113,chr1,LRIG2-DT,chr1:113011687-113073113,61426
10251901,10260055,chr19,MRPL4,chr19:10251901-10260055,8154
84811602,84893206,chr1,LPAR3,chr1:84811602-84893206,81604
3112560,3120517,chr16,ZNF205,chr16:3112560-3120517,7957
28050993,28334486,chr10,MPP7,chr10:28050993-28334486,283493
116694112,116706603,chr1,LINC02868,chr1:116694112-116706603,12491
8845263,8845358,chr11,RNA5SP330,chr11:8845263-8845358,95
55915603,55944980,chr1,LINC01753,chr1:55915603-55944980,29377
8911139,8920084,chr11,AKIP1,chr11:8911139-8920084,8945
151411259,151413945,chr6,HSPA8P15,chr6:151411259-151413945,2686
151452258,151470101,chr6,ARMT1,chr6:151452258-151470101,17843
177294442,177323418,chr3,LINC00501,chr3:177294442-177323418,28976
97095923,97322955,chr1,DPYD-AS1,chr1:97095923-97322955,227032
64103470,64106056,chr3,PRICKLE2-AS2,chr3:64103470-64106056,2586
112396214,112463456,chr1,CTTNBP2NL,chr1:112396214-112463456,67242
151494017,151621193,chr6,CCDC170,chr6:151494017-151621193,127176
156044155,156044948,chr3,ALG1L15P,chr3:156044155-156044948,793
120628172,120682269,chr3,HGD,chr3:120628172-120682269,54097
145509047,145520594,chr1,PDE4DIPP5,chr1:145509047-145520594,11547
151615773,151615879,chr6,RNU6-813P,chr6:151615773-151615879,106
109309568,109397918,chr1,SORT1,chr1:109309568-109397918,88350
26103933,26104337,chr6,H4C3,chr6:26103933-26104337,404
116752197,116765719,chr6,FAM162B,chr6:116752197-116765719,13522
75111860,75116780,chr16,LDHD,chr16:75111860-75116780,4920
116792085,116829083,chr6,GPRC6A,chr6:116792085-116829083,36998
157961410,157962888,chr2,MTA3P1,chr2:157961410-157962888,1478
95311771,95561414,chr10,SORBS1,chr10:95311771-95561414,249643
207580631,207625928,chr2,METTL21A,chr2:207580631-207625928,45297
117048670,117048838,chr6,RPS29P13,chr6:117048670-117048838,168
117060682,117060799,chr6,RNA5SP214,chr6:117060682-117060799,117
116877212,116932161,chr6,RFX6,chr6:116877212-116932161,54949
41929479,42051994,chr8,KAT6A,chr8:41929479-42051994,122515
2911931,2951208,chr16,FLYWCH1,chr16:2911931-2951208,39277
189238686,189240594,chr3,TPRG1-AS2,chr3:189238686-189240594,1908
8920076,8933006,chr11,C11orf16,chr11:8920076-8933006,12930
10271093,10286615,chr19,ICAM1,chr19:10271093-10286615,15522
119468963,119494708,chr3,POGLUT1,chr3:119468963-119494708,25745
140158591,140158694,chr6,RNA5SP220,chr6:140158591-140158694,103
140205252,140205326,chr6,MIR3668,chr6:140205252-140205326,74
140683814,140683883,chr6,MIR4465,chr6:140683814-140683883,69
140761529,140762262,chr6,RPS3AP24,chr6:140761529-140762262,733
167666840,167679270,chr6,LINC02538,chr6:167666840-167679270,12430
207762598,207769906,chr2,FZD5,chr2:207762598-207769906,7308
167679626,167696290,chr6,LINC02487,chr6:167679626-167696290,16664
65758020,65826997,chr12,RPSAP52,chr12:65758020-65826997,68977
8947202,8965011,chr11,TMEM9B,chr11:8947202-8965011,17809
167992822,167997110,chr6,KIF25-AS1,chr6:167992822-167997110,4288
65851340,65882167,chr12,HMGA2-AS1,chr12:65851340-65882167,30827
119084998,119085954,chr1,RBMX2P3,chr1:119084998-119085954,956
117915478,118014133,chr2,CCDC93,chr2:117915478-118014133,98655
49782083,49852821,chr14,NEMF,chr14:49782083-49852821,70738
105587575,105618991,chr1,LINC01676,chr1:105587575-105618991,31416
131699644,131701401,chr6,OR2A4,chr6:131699644-131701401,1757
131708441,131711017,chr6,CTAGE9,chr6:131708441-131711017,2576
66023620,66023726,chr12,MIR6074,chr12:66023620-66023726,106
66027725,66031066,chr12,LINC02425,chr12:66027725-66031066,3341
66037235,66037714,chr12,RPL21P18,chr12:66037235-66037714,479
66066221,66066338,chr12,RNA5SP362,chr12:66066221-66066338,117
131792172,131792231,chr6,MIR548H5,chr6:131792172-131792231,59
131819803,131820091,chr6,SELENOKP2,chr6:131819803-131820091,288
6095699,6095970,chr12,RN7SL69P,chr12:6095699-6095970,271
10286955,10288522,chr19,ICAM4,chr19:10286955-10288522,1567
50313487,50368988,chr16,BRD7,chr16:50313487-50368988,55501
131820334,131820653,chr6,RN7SKP245,chr6:131820334-131820653,319
6270168,6270425,chr12,ATP5MFP5,chr12:6270168-6270425,257
125747084,125748098,chr3,OR7E97P,chr3:125747084-125748098,1014
6328757,6342114,chr12,TNFRSF1A,chr12:6328757-6342114,13357
131948176,131951372,chr6,CCN2,chr6:131948176-131951372,3196
140678064,140701150,chr3,TRIM42,chr3:140678064-140701150,23086
10289952,10296778,chr19,ICAM5,chr19:10289952-10296778,6826
84999147,85133138,chr1,DNAI3,chr1:84999147-85133138,133991
190514051,190659750,chr3,IL1RAP,chr3:190514051-190659750,145699
8980576,9004049,chr11,NRIP3,chr11:8980576-9004049,23473
167826911,167972023,chr6,AFDN,chr6:167826911-167972023,145112
10304803,10309880,chr19,ZGLP1,chr19:10304803-10309880,5077
9004093,9067776,chr11,NRIP3-DT,chr11:9004093-9067776,63683
9019476,9138114,chr11,SCUBE2,chr11:9019476-9138114,118638
10310045,10316015,chr19,FDX2,chr19:10310045-10316015,5970
22377594,22482004,chr2,LINC01830,chr2:22377594-22482004,104410
127247258,127250082,chr2,WBP11P2,chr2:127247258-127250082,2824
208057248,208057745,chr2,RPL12P17,chr2:208057248-208057745,497
187825341,187826449,chr2,ST13P2,chr2:187825341-187826449,1108
70173322,70187361,chr16,CLEC18C,chr16:70173322-70187361,14039
170813213,170861151,chr2,GAD1,chr2:170813213-170861151,47938
10316212,10333638,chr19,RAVER1,chr19:10316212-10333638,17426
49839725,49839827,chr14,RNU6-539P,chr14:49839725-49839827,102
49853616,49853914,chr14,RN7SL3,chr14:49853616-49853914,298
49862550,49862849,chr14,RN7SL2,chr14:49862550-49862849,299
49901850,49901950,chr14,RNU6-189P,chr14:49901850-49901950,100
49966399,49966511,chr14,MIR6076,chr14:49966399-49966511,112
50050368,50051336,chr14,PDLIM1P1,chr14:50050368-50051336,968
49893079,49897054,chr14,ARF6,chr14:49893079-49897054,3975
34694170,34694644,chr14,RPL23AP8,chr14:34694170-34694644,474
10333776,10339661,chr19,ICAM3,chr19:10333776-10339661,5885
34709113,34714823,chr14,CFL2,chr14:34709113-34714823,5710
99971437,100342005,chr15,ADAMTS17,chr15:99971437-100342005,370568
13299184,13306771,chr17,LINC02093,chr17:13299184-13306771,7587
13494032,13601929,chr17,HS3ST3A1,chr17:13494032-13601929,107897
13543529,13543646,chr17,MIR548H3,chr17:13543529-13543646,117
14024514,14025488,chr17,CDRT15P1,chr17:14024514-14025488,974
14069490,14231736,chr17,COX10,chr17:14069490-14231736,162246
113924000,113929495,chr1,HIPK1-AS1,chr1:113924000-113929495,5495
117272182,117321336,chr1,LINC01525,chr1:117272182-117321336,49154
9090312,9090379,chr11,MIR5691,chr11:9090312-9090379,67
9094377,9095890,chr11,KRT8P41,chr11:9094377-9095890,1513
6344554,6344837,chr12,RN7SL391P,chr12:6344554-6344837,283
5948877,6124770,chr12,VWF,chr12:5948877-6124770,175893
42152946,42171673,chr8,AP3M2,chr8:42152946-42171673,18727
110031577,110074641,chr1,STRIP1,chr1:110031577-110074641,43064
9138825,9265959,chr11,DENND5A,chr11:9138825-9265959,127134
52527652,52564464,chr19,ZNF808,chr19:52527652-52564464,36812
100559369,100603230,chr15,LINS1,chr15:100559369-100603230,43861
34740336,34740833,chr14,RPL12P6,chr14:34740336-34740833,497
34752731,34875647,chr14,BAZ1A,chr14:34752731-34875647,122916
186105668,186362234,chr3,DGKG,chr3:186105668-186362234,256566
14235673,14236862,chr17,CDRT15,chr17:14235673-14236862,1189
52564076,52564231,chr19,RPL39P34,chr19:52564076-52564231,155
14301081,14349404,chr17,HS3ST3B1,chr17:14301081-14349404,48323
52588505,52597345,chr19,ZNF137P,chr19:52588505-52597345,8840
14705076,14705534,chr17,RPS18P12,chr17:14705076-14705534,458
52702813,52735073,chr19,ZNF611,chr19:52702813-52735073,32260
14834557,14957216,chr17,LINC02096,chr17:14834557-14957216,122659
113876816,113887581,chr1,BCL2L15,chr1:113876816-113887581,10765
14947741,14948198,chr17,RPL23AP76,chr17:14947741-14948198,457
15030975,15031957,chr17,CDRT7,chr17:15030975-15031957,982
15105237,15106187,chr17,CDRT8,chr17:15105237-15106187,950
76309478,76384521,chr17,PRPSAP1,chr17:76309478-76384521,75043
100602589,100651701,chr15,ASB7,chr15:100602589-100651701,49112
127170011,127170231,chr2,NIFKP9,chr2:127170011-127170231,220
76699789,76700538,chr1,TPI1P1,chr1:76699789-76700538,749
108134043,108200849,chr1,SLC25A24,chr1:108134043-108200849,66806
188291669,188595931,chr2,GULP1,chr2:188291669-188595931,304262
42174718,42207709,chr8,PLAT,chr8:42174718-42207709,32991
108434130,108515023,chr12,LINC01498,chr12:108434130-108515023,80893
100400395,100544995,chr15,CERS3,chr15:100400395-100544995,144600
89560677,89564542,chr16,RPL13,chr16:89560677-89564542,3865
108515277,108525837,chr12,FICD,chr12:108515277-108525837,10560
52797408,52857600,chr19,ZNF28,chr19:52797408-52857600,60192
108522214,108561400,chr12,SART3,chr12:108522214-108561400,39186
98890245,99005032,chr1,PLPPR5,chr1:98890245-99005032,114787
52809824,52810708,chr19,PABPN1P2,chr19:52809824-52810708,884
57499915,57518404,chr19,ZNF773,chr19:57499915-57518404,18489
76337316,76337422,chr17,RNU6-24P,chr17:76337316-76337422,106
76376584,76387860,chr17,SPHK1,chr17:76376584-76387860,11276
183487551,183555706,chr3,KLHL6,chr3:183487551-183555706,68155
57527325,57557542,chr19,ZNF549,chr19:57527325-57557542,30217
109292365,109307011,chr1,MYBPHL,chr1:109292365-109307011,14646
57535257,57559863,chr19,ZNF550,chr19:57535257-57559863,24606
50548396,50649249,chr16,NKD1,chr16:50548396-50649249,100853
34845300,34845360,chr14,RNU7-41P,chr14:34845300-34845360,60
34874343,34876459,chr14,BAZ1A-AS1,chr14:34874343-34876459,2116
35085467,35122517,chr14,PPP2R3C,chr14:35085467-35122517,37050
111346600,111353013,chr1,PIFO,chr1:111346600-111353013,6413
176814155,176817001,chr3,LINC01209,chr3:176814155-176817001,2846
41859350,41859594,chr3,ATP6V0E1P2,chr3:41859350-41859594,244
184546714,184556918,chr3,LINC01840,chr3:184546714-184556918,10204
156747343,156817062,chr3,LINC00886,chr3:156747343-156817062,69719
57571566,57578911,chr19,ZNF416,chr19:57571566-57578911,7345
108272943,108337853,chr1,SLC25A24P1,chr1:108272943-108337853,64910
149999645,150000690,chr3,HNRNPA1P24,chr3:149999645-150000690,1045
57578456,57593890,chr19,ZIK1,chr19:57578456-57593890,15434
64174401,64175147,chr3,PRDX3P4,chr3:64174401-64175147,746
156713884,156714928,chr3,METTL15P1,chr3:156713884-156714928,1044
64515654,64688000,chr3,ADAMTS9,chr3:64515654-64688000,172346
76389456,76453152,chr17,UBE2O,chr17:76389456-76453152,63696
90660207,90664967,chr15,LINC01585,chr15:90660207-90664967,4760
95351251,95352676,chr1,LINC01650,chr1:95351251-95352676,1425
17654868,17655849,chr5,H3Y1,chr5:17654868-17655849,981
50742305,50742377,chr16,MIR3181,chr16:50742305-50742377,72
207654781,207654951,chr2,RPS29P9,chr2:207654781-207654951,170
90755243,90755312,chr15,SNORD18,chr15:90755243-90755312,69
79976716,79991262,chr5,MTX3,chr5:79976716-79991262,14546
50806668,50807629,chr16,LINC02168,chr16:50806668-50807629,961
158065545,158066059,chr2,PTP4A1P1,chr2:158065545-158066059,514
115048011,115089503,chr1,TSPAN2,chr1:115048011-115089503,41492
90855935,90856207,chr15,RN7SL363P,chr15:90855935-90856207,272
50869455,50869575,chr16,RNA5SP426,chr16:50869455-50869575,120
57603137,57603697,chr16,HMGB3P32,chr16:57603137-57603697,560
90883695,90895776,chr15,FES,chr15:90883695-90895776,12081
57614233,57624724,chr19,ZNF134,chr19:57614233-57624724,10491
186032884,186422432,chr2,LINC01473,chr2:186032884-186422432,389548
131135467,131283535,chr6,AKAP7,chr6:131135467-131283535,148068
57630395,57644041,chr19,ZNF211,chr19:57630395-57644041,13646
57610652,57665580,chr16,ADGRG1,chr16:57610652-57665580,54928
119462029,119463021,chr1,GAPDHP23,chr1:119462029-119463021,992
98210747,98272658,chr1,LINC01776,chr1:98210747-98272658,61911
97585862,97586294,chr1,RPL26P9,chr1:97585862-97586294,432
76430417,76431124,chr17,RPL7P49,chr17:76430417-76431124,707
160187367,160238735,chr5,FABP6,chr5:160187367-160238735,51368
77310751,77416349,chr7,GSAP,chr7:77310751-77416349,105598
113073198,113132260,chr1,LRIG2,chr1:113073198-113132260,59062
76527356,76551175,chr17,CYGB,chr17:76527356-76551175,23819
207681590,207682033,chr2,PPP1R14BP2,chr2:207681590-207682033,443
203706475,203738912,chr2,CD28,chr2:203706475-203738912,32437
76527586,76553578,chr17,PRCD,chr17:76527586-76553578,25992
57664280,57665039,chr19,TPRG1LP1,chr19:57664280-57665039,759
37371061,37393066,chr19,ZNF527,chr19:37371061-37393066,22005
27781379,27890681,chr2,RBKS,chr2:27781379-27890681,109302
9280654,9314636,chr11,TMEM41B,chr11:9280654-9314636,33982
127266726,127288567,chr6,RNF146,chr6:127266726-127288567,21841
88717117,88904257,chr5,MEF2C,chr5:88717117-88904257,187140
109399042,109426448,chr1,PSMA5,chr1:109399042-109426448,27406
37411155,37469275,chr19,ZNF569,chr19:37411155-37469275,58120
176269395,176338025,chr2,MTX2,chr2:176269395-176338025,68630
76558791,76558868,chr17,SNORD1C,chr17:76558791-76558868,77
76561109,76561192,chr17,SNORD1B,chr17:76561109-76561192,83
108562582,108569368,chr12,ISCU,chr12:108562582-108569368,6786
76561634,76561705,chr17,SNORD1A,chr17:76561634-76561705,71
127288712,127343609,chr6,ECHDC1,chr6:127288712-127343609,54897
76565377,76586956,chr17,ST6GALNAC2,chr17:76565377-76586956,21579
9311284,9311689,chr11,PRR13P2,chr11:9311284-9311689,405
9384652,9448127,chr11,IPO7,chr11:9384652-9448127,63475
37548914,37587348,chr19,ZNF571-AS1,chr19:37548914-37587348,38434
35121846,35277622,chr14,PRORP,chr14:35121846-35277622,155776
99969351,100035634,chr1,SLC35A3,chr1:99969351-100035634,66283
77461458,77462139,chr7,GCNT1P5,chr7:77461458-77462139,681
77537295,77640069,chr7,PTPN12,chr7:77537295-77640069,102774
76624761,76643786,chr17,ST6GALNAC1,chr17:76624761-76643786,19025
37551406,37614179,chr19,ZNF540,chr19:37551406-37614179,62773
189441446,189475552,chr2,WDR75,chr2:189441446-189475552,34106
183253253,183298504,chr3,B3GNT5,chr3:183253253-183298504,45251
9428773,9428954,chr11,SNORA23,chr11:9428773-9428954,181
61102489,61127852,chr11,CD5,chr11:61102489-61127852,25363
108589851,108598320,chr12,TMEM119,chr12:108589851-108598320,8469
61130257,61161615,chr11,VPS37C,chr11:61130257-61161615,31358
154352136,154354799,chr3,DDX50P2,chr3:154352136-154354799,2663
37554782,37594792,chr19,ZNF571,chr19:37554782-37594792,40010
108635810,108635870,chr12,MIR4496,chr12:108635810-108635870,60
108668448,108668508,chr12,RNU7-169P,chr12:108668448-108668508,60
42013802,42225890,chr3,TRAK1,chr3:42013802-42225890,212088
13196723,13219941,chr12,EMP1,chr12:13196723-13219941,23218
61203307,61213098,chr11,PGA3,chr11:61203307-61213098,9791
37667751,37692315,chr19,ZNF781,chr19:37667751-37692315,24564
42338454,42371808,chr8,POLB,chr8:42338454-42371808,33354
76656320,76656422,chr17,RNU6-227P,chr17:76656320-76656422,102
76703632,76703727,chr17,RNY4P36,chr17:76703632-76703727,95
35144021,35144480,chr14,RPL23AP70,chr14:35144021-35144480,459
37693280,37693564,chr19,SELENOKP1,chr19:37693280-37693564,284
35157904,35159099,chr14,SEPTIN7P1,chr14:35157904-35159099,1195
35219023,35219283,chr14,MRPL57P8,chr14:35219023-35219283,260
76734115,76737333,chr17,SRSF2,chr17:76734115-76737333,3218
35222174,35222746,chr14,DPRXP3,chr14:35222174-35222746,572
37696371,37719761,chr19,ZNF607,chr19:37696371-37719761,23390
35235180,35235651,chr14,RPL7AP3,chr14:35235180-35235651,471
13371089,13387167,chr12,LINC01559,chr12:13371089-13387167,16078
35262462,35263036,chr14,RPL9P3,chr14:35262462-35263036,574
101397359,101475112,chr2,RFX8,chr2:101397359-101475112,77753
13440884,13441001,chr12,RNA5SP353,chr12:13440884-13441001,117
13459670,13459776,chr12,RNU6-590P,chr12:13459670-13459776,106
35278633,35317493,chr14,PSMA6,chr14:35278633-35317493,38860
13683542,13683886,chr12,RN7SKP162,chr12:13683542-13683886,344
13083532,13103683,chr12,GSG1,chr12:13083532-13103683,20151
37823722,37855215,chr19,WDR87BP,chr19:37823722-37855215,31493
61241175,61251444,chr11,PGA5,chr11:61241175-61251444,10269
76736450,76736548,chr17,MIR636,chr17:76736450-76736548,98
94737337,94738249,chr2,CNN2P8,chr2:94737337-94738249,912
76752912,76753015,chr17,RNU6-97P,chr17:76752912-76753015,103
37884823,37906677,chr19,WDR87,chr19:37884823-37906677,21854
76470891,76501790,chr17,RHBDF2,chr17:76470891-76501790,30899
216412414,216483053,chr2,SMARCAL1,chr2:216412414-216483053,70639
122788933,122789895,chr9,OR5C1,chr9:122788933-122789895,962
90717346,90816166,chr15,BLM,chr15:90717346-90816166,98820
137251261,137253483,chr9,STPG3,chr9:137251261-137253483,2222
41190927,41191229,chr19,RN7SL718P,chr19:41190927-41191229,302
41193210,41207539,chr19,CYP2S1,chr19:41193210-41207539,14329
41219223,41261766,chr19,AXL,chr19:41219223-41261766,42543
61299451,61342596,chr11,DDB1,chr11:61299451-61342596,43145
127317883,127317973,chr6,RNA5SP217,chr6:127317883-127317973,90
127355756,127356789,chr6,YWHAZP4,chr6:127355756-127356789,1033
144000320,144008793,chr7,OR6B1,chr7:144000320-144008793,8473
127362513,127363403,chr6,RPL5P18,chr6:127362513-127363403,890
19144782,19145421,chr7,FERD3L,chr7:19144782-19145421,639
15422734,15465953,chr9,SNAPC3,chr9:15422734-15465953,43219
135092363,135170795,chr7,CYREN,chr7:135092363-135170795,78432
49834257,49877096,chr6,CRISP1,chr6:49834257-49877096,42839
30926428,30996602,chr12,TSPAN11,chr12:30926428-30996602,70174
189311263,189311967,chr2,KRT18P19,chr2:189311263-189311967,704
241356285,241494841,chr2,FARP2,chr2:241356285-241494841,138556
42374063,42377229,chr8,DKK4,chr8:42374063-42377229,3166
135128444,135129685,chr7,RNF14P4,chr7:135128444-135129685,1241
135148072,135166215,chr7,TMEM140,chr7:135148072-135166215,18143
77086716,77099902,chr17,SNHG20,chr17:77086716-77099902,13186
42391624,42405937,chr8,VDAC3,chr8:42391624-42405937,14313
53006282,53042215,chr12,EIF4B,chr12:53006282-53042215,35933
135183839,135211555,chr7,WDR91,chr7:135183839-135211555,27716
49946021,49950265,chr6,DEFB133,chr6:49946021-49950265,4244
49960249,49964164,chr6,DEFB114,chr6:49960249-49964164,3915
99850361,99924023,chr1,AGL,chr1:99850361-99924023,73662
49968677,49969625,chr6,DEFB113,chr6:49968677-49969625,948
61811974,62112550,chr14,SYT16,chr14:61811974-62112550,300576
50009138,50021994,chr6,DEFB110,chr6:50009138-50021994,12856
180887677,180888075,chr3,RPL32P10,chr3:180887677-180888075,398
50042099,50049929,chr6,DEFB112,chr6:50042099-50049929,7830
187958775,187976407,chr3,LINC01991,chr3:187958775-187976407,17632
32845209,32853816,chr6,TAP1,chr6:32845209-32853816,8607
168008689,168095924,chr3,GOLIM4,chr3:168008689-168095924,87235
62117346,62130962,chr14,LINC00643,chr14:62117346-62130962,13616
88534033,88584274,chr9,NXNL2,chr9:88534033-88584274,50241
35161992,35405338,chr9,UNC13B,chr9:35161992-35405338,243346
19975591,19976565,chr14,OR4K15,chr14:19975591-19976565,974
19999913,20004760,chr14,OR4Q2,chr14:19999913-20004760,4847
77426675,77457952,chr14,VIPAS39,chr14:77426675-77457952,31277
41286424,41286693,chr19,RN7SL34P,chr19:41286424-41286693,269
77088749,77217101,chr17,SEC14L1,chr17:77088749-77217101,128352
41310172,41324873,chr19,CCDC97,chr19:41310172-41324873,14701
41350911,41384083,chr19,TMEM91,chr19:41350911-41384083,33172
196318330,196325570,chr3,TM4SF19-AS1,chr3:196318330-196325570,7240
138215986,138218491,chr6,PBOV1,chr6:138215986-138218491,2505
47856673,48111197,chr6,PTCHD4,chr6:47856673-48111197,254524
28141883,28159460,chr6,ZKSCAN8,chr6:28141883-28159460,17577
124450820,124462150,chr8,TRMT12,chr8:124450820-124462150,11330
195746765,195811973,chr3,MUC4,chr3:195746765-195811973,65208
124474880,124488618,chr8,RNF139,chr8:124474880-124488618,13738
124488485,124539458,chr8,TATDN1,chr8:124488485-124539458,50973
135206994,135207078,chr7,MIR6509,chr7:135206994-135207078,84
135246113,135317752,chr7,SLC23A4P,chr7:135246113-135317752,71639
41354417,41364165,chr19,B9D2,chr19:41354417-41364165,9748
12211270,12243367,chr7,TMEM106B,chr7:12211270-12243367,32097
95145000,95165413,chr2,ZNF514,chr2:95145000-95165413,20413
43793723,43806328,chr12,TWF1,chr12:43793723-43806328,12605
41397808,41425002,chr19,BCKDHA,chr19:41397808-41425002,27194
70777310,70790643,chr2,FIGLA,chr2:70777310-70790643,13333
68635282,69390571,chr6,ADGRB3,chr6:68635282-69390571,755289
107823063,107826891,chr2,RGPD4-AS1,chr2:107823063-107826891,3828
12471352,12472545,chr7,SSBL5P,chr7:12471352-12472545,1193
12491095,12492004,chr7,TAS2R2P,chr7:12491095-12492004,909
17877847,18361616,chr2,KCNS3,chr2:17877847-18361616,483769
144153486,144158905,chr7,OR2A3P,chr7:144153486-144158905,5419
144176740,144177142,chr7,OR2AO1P,chr7:144176740-144177142,402
144228244,144239605,chr7,OR2A42,chr7:144228244-144239605,11361
144250045,144256244,chr7,OR2A20P,chr7:144250045-144256244,6199
144257663,144264792,chr7,OR2A7,chr7:144257663-144264792,7129
144194858,144280547,chr7,ARHGEF35-AS1,chr7:144194858-144280547,85689
152380546,152381564,chr6,SYNE1-AS1,chr6:152380546-152381564,1018
7158624,7411488,chr10,SFMBT2,chr10:7158624-7411488,252864
152410275,152410394,chr6,RNA5SP223,chr6:152410275-152410394,119
152545930,152546984,chr6,NANOGP11,chr6:152545930-152546984,1054
20695332,20753386,chr12,SLCO1C1,chr12:20695332-20753386,58054
152705735,152706128,chr6,HSPD1P16,chr6:152705735-152706128,393
29395631,29398008,chr6,OR12D2,chr6:29395631-29398008,2377
96875882,96986580,chr2,FAM178B,chr2:96875882-96986580,110698
29414928,29418905,chr6,OR12D1,chr6:29414928-29418905,3977
41443156,41444765,chr19,ERICH4,chr19:41443156-41444765,1609
29464596,29469806,chr6,UBDP1,chr6:29464596-29469806,5210
29475025,29476071,chr6,MAS1LP1,chr6:29475025-29476071,1046
29486697,29487956,chr6,MAS1L,chr6:29486697-29487956,1259
51450847,51458456,chr19,SIGLEC8,chr19:51450847-51458456,7609
29489271,29489676,chr6,RPS17P1,chr6:29489271-29489676,405
29329626,29331061,chr6,DDX6P1,chr6:29329626-29331061,1435
29353749,29431967,chr6,OR5V1,chr6:29353749-29431967,78218
144272445,144286966,chr7,ARHGEF34P,chr7:144272445-144286966,14521
29373423,29375291,chr6,OR12D3,chr6:29373423-29375291,1868
144294480,144300934,chr7,OR2A9P,chr7:144294480-144300934,6454
88139864,88166347,chr6,CNR1,chr6:88139864-88166347,26483
144300395,144356181,chr7,OR2A1-AS1,chr7:144300395-144356181,55786
33004182,33009591,chr6,HLA-DOA,chr6:33004182-33009591,5409
144312419,144322737,chr7,OR2A1,chr7:144312419-144322737,10318
144355288,144380632,chr7,ARHGEF5,chr7:144355288-144380632,25344
51478622,51490952,chr19,CEACAM18,chr19:51478622-51490952,12330
33075990,33089696,chr6,HLA-DPB1,chr6:33075990-33089696,13706
51491227,51501800,chr19,SIGLEC12,chr19:51491227-51501800,10573
77457870,77469472,chr14,AHSA1,chr14:77457870-77469472,11602
90868588,90883564,chr15,FURIN,chr15:90868588-90883564,14976
240998618,241095568,chr2,SNED1,chr2:240998618-241095568,96950
51508573,51509311,chr19,SIGLEC27P,chr19:51508573-51509311,738
48337180,48351414,chr12,ZNF641,chr12:48337180-48351414,14234
51517819,51531856,chr19,SIGLEC6,chr19:51517819-51531856,14037
75037472,75073642,chr10,DUSP29,chr10:75037472-75073642,36170
77474394,77498816,chr14,ISM2,chr14:77474394-77498816,24422
50182778,50279720,chr10,ASAH2,chr10:50182778-50279720,96942
39293228,39443390,chr12,KIF21A,chr12:39293228-39443390,150162
144397240,144410227,chr7,NOBOX,chr7:144397240-144410227,12987
33079451,33079860,chr6,RPL32P1,chr6:33079451-33079860,409
144434826,144435314,chr7,PPIAP83,chr7:144434826-144435314,488
33091753,33097295,chr6,HLA-DPA2,chr6:33091753-33097295,5542
144451681,144451817,chr7,RNU6ATAC40P,chr7:144451681-144451817,136
33103794,33107330,chr6,COL11A2P1,chr6:33103794-33107330,3536
77505997,77616637,chr14,SPTLC2,chr14:77505997-77616637,110640
144048948,144058845,chr7,OR2A5,chr7:144048948-144058845,9897
33131216,33143325,chr6,HLA-DPA3,chr6:33131216-33143325,12109
33144783,33147767,chr6,HCG24,chr6:33144783-33147767,2984
144069811,144075870,chr7,OR2A25,chr7:144069811-144075870,6059
33193588,33200665,chr6,RXRB,chr6:33193588-33200665,7077
124508515,124508576,chr8,MIR6844,chr8:124508515-124508576,61
144077721,144077825,chr7,OR2A41P,chr7:144077721-144077825,104
144086278,144098953,chr7,OR2A12,chr7:144086278-144098953,12675
77089307,77089493,chr17,SCARNA16,chr17:77089307-77089493,186
124539101,124580648,chr8,NDUFB9,chr8:124539101-124580648,41547
77089417,77089497,chr17,MIR6516,chr17:77089417-77089497,80
77152561,77152674,chr17,RNU4-47P,chr17:77152561-77152674,113
77198950,77199543,chr17,CYCSP40,chr17:77198950-77199543,593
144118461,144119360,chr7,OR2A15P,chr7:144118461-144119360,899
77257737,77281897,chr17,SEPTIN9-DT,chr17:77257737-77281897,24160
144123176,144131188,chr7,OR2A14,chr7:144123176-144131188,8012
144142009,144142938,chr7,OR2A13P,chr7:144142009-144142938,929
51563797,51564910,chr19,SIGLEC29P,chr19:51563797-51564910,1113
77396984,77397054,chr17,MIR4316,chr17:77396984-77397054,70
51571283,51592510,chr19,ZNF175,chr19:51571283-51592510,21227
155644451,155781485,chr7,RBM33,chr7:155644451-155781485,137034
51611927,51645545,chr19,SIGLEC5,chr19:51611927-51645545,33618
77547566,77547846,chr14,RN7SL587P,chr14:77547566-77547846,280
69183017,69214092,chr14,GALNT16-AS1,chr14:69183017-69214092,31075
51621136,51621701,chr19,RPL9P33,chr19:51621136-51621701,565
43371636,43376335,chr10,FXYD4,chr10:43371636-43376335,4699
69259277,69357033,chr14,GALNT16,chr14:69259277-69357033,97756
51648862,51649610,chr19,RPL7P51,chr19:51648862-51649610,748
51685363,51693456,chr19,SPACA6P-AS,chr19:51685363-51693456,8093
241734602,241768816,chr2,D2HGDH,chr2:241734602-241768816,34214
51692612,51692681,chr19,MIR99B,chr19:51692612-51692681,69
88635670,88656483,chr15,ISG20,chr15:88635670-88656483,20813
51692786,51692864,chr19,MIRLET7E,chr19:51692786-51692864,78
51693254,51693339,chr19,MIR125A,chr19:51693254-51693339,85
44645411,44645587,chr17,SMCO4P1,chr17:44645411-44645587,176
51713112,51723991,chr19,HAS1,chr19:51713112-51723991,10879
44646364,44650349,chr17,LINC01180,chr17:44646364-44650349,3985
44656404,44690308,chr17,MEIOC,chr17:44656404-44690308,33904
43385617,43409186,chr10,HNRNPF,chr10:43385617-43409186,23569
33199601,33199696,chr6,RNY4P10,chr6:33199601-33199696,95
124550784,124728473,chr8,MTSS1,chr8:124550784-124728473,177689
33200445,33204439,chr6,SLC39A7,chr6:33200445-33204439,3994
92493554,92536655,chr9,ECM2,chr9:92493554-92536655,43101
64155740,64163134,chr15,PPIB,chr15:64155740-64163134,7394
82647770,82692820,chr15,CPEB1-AS1,chr15:82647770-82692820,45050
51752026,51770531,chr19,FPR2,chr19:51752026-51770531,18505
155799980,155812463,chr7,SHH,chr7:155799980-155812463,12483
44673069,44689779,chr17,CCDC43,chr17:44673069-44689779,16710
43417249,43417438,chr10,SNORD3J,chr10:43417249-43417438,189
43420738,43422100,chr10,LINC02916,chr10:43420738-43422100,1362
82659281,82710112,chr15,AP3B2,chr15:82659281-82710112,50831
43458065,43458129,chr10,RNU7-193P,chr10:43458065-43458129,64
51795157,51826190,chr19,FPR3,chr19:51795157-51826190,31033
43556344,43574618,chr10,ZNF239,chr10:43556344-43574618,18274
122202577,122229626,chr9,LHX6,chr9:122202577-122229626,27049
156540491,156541103,chr7,LINC00244,chr7:156540491-156541103,612
33204655,33206831,chr6,HSD17B8,chr6:33204655-33206831,2176
45933734,45974044,chr19,NOVA2,chr19:45933734-45974044,40310
156640281,156677130,chr7,RNF32,chr7:156640281-156677130,36849
44708608,44752264,chr17,DBF4B,chr17:44708608-44752264,43656
43604843,43606251,chr10,CAP1P2,chr10:43604843-43606251,1408
43606419,43617904,chr10,ZNF485,chr10:43606419-43617904,11485
17972025,17972117,chr19,RNA5SP468,chr19:17972025-17972117,92
57668277,57689378,chr16,ADGRG3,chr16:57668277-57689378,21101
18048637,18049090,chr19,RPS18P13,chr19:18048637-18049090,453
33207835,33207944,chr6,MIR219A1,chr6:33207835-33207944,109
18058995,18098944,chr19,IL12RB1,chr19:18058995-18098944,39949
43628817,43674703,chr10,ZNF32-AS3,chr10:43628817-43674703,45886
33208500,33212722,chr6,RING1,chr6:33208500-33212722,4222
43630947,43631382,chr10,RPL21P88,chr10:43630947-43631382,435
43643860,43648881,chr10,ZNF32,chr10:43643860-43648881,5021
119429901,119438504,chr2,TMEM37,chr2:119429901-119438504,8603
43643872,43645047,chr10,ZNF32-AS1,chr10:43643872-43645047,1175
43645942,43648019,chr10,ZNF32-AS2,chr10:43645942-43648019,2077
43436841,43483181,chr10,ZNF487,chr10:43436841-43483181,46340
33215705,33216328,chr6,ZNF70P1,chr6:33215705-33216328,623
33237799,33239690,chr6,HTATSF1P1,chr6:33237799-33239690,1891
33250272,33272047,chr6,VPS52,chr6:33250272-33272047,21775
96043394,96060870,chr10,CCNJ,chr10:96043394-96060870,17476
44718861,44719130,chr17,RN7SL819P,chr17:44718861-44719130,269
168661733,169301139,chr5,SLIT3,chr5:168661733-169301139,639406
44758988,44781846,chr17,ADAM11,chr17:44758988-44781846,22858
57694793,57731805,chr16,DRC7,chr16:57694793-57731805,37012
110150494,110202202,chr1,SLC6A17,chr1:110150494-110202202,51708
69380128,69398299,chr14,ERH,chr14:69380128-69398299,18171
159712457,159771027,chr2,MARCHF7,chr2:159712457-159771027,58570
96064315,96064399,chr10,MIR3157,chr10:96064315-96064399,84
96112747,96112851,chr10,RNU6-271P,chr10:96112747-96112851,104
96189171,96271587,chr10,BLNK,chr10:96189171-96271587,82416
69398015,69462390,chr14,SLC39A9,chr14:69398015-69462390,64375
61333220,61353295,chr11,TKFC,chr11:61333220-61353295,20075
119414931,119423035,chr1,HSD3B2,chr1:119414931-119423035,8104
18144522,18151691,chr19,MAST3-AS1,chr19:18144522-18151691,7169
94555054,94603990,chr9,PCAT7,chr9:94555054-94603990,48936
156654185,156659582,chr7,RNF32-AS1,chr7:156654185-156659582,5397
156668946,156893216,chr7,LMBR1,chr7:156668946-156893216,224270
18153163,18170532,chr19,PIK3R2,chr19:18153163-18170532,17369
72656,90820,chr9,PGM5P3-AS1,chr9:72656-90820,18164
113813811,113871753,chr1,PTPN22,chr1:113813811-113871753,57942
94166258,94200902,chr9,MIRLET7A1HG,chr9:94166258-94200902,34644
64016950,64061612,chr9,FLJ43315,chr9:64016950-64061612,44662
21453802,21559900,chr9,MIR31HG,chr9:21453802-21559900,106098
124821978,124822058,chr8,MIR4662B,chr8:124821978-124822058,80
124821985,124822051,chr8,MIR4662A,chr8:124821985-124822051,66
124920428,124922076,chr8,MRS2P1,chr8:124920428-124922076,1648
41006999,41074957,chr9,PGM5P2,chr9:41006999-41074957,67958
44798448,44830816,chr17,GJC1,chr17:44798448-44830816,32368
30678066,30727846,chr8,GSR,chr8:30678066-30727846,49780
44508275,44921848,chr12,NELL2,chr12:44508275-44921848,413573
18173162,18178117,chr19,IFI30,chr19:18173162-18178117,4955
61348754,61362283,chr11,CYB561A3,chr11:61348754-61362283,13529
95085369,95149434,chr2,MRPS5,chr2:95085369-95149434,64065
44846353,44850476,chr17,HIGD1B,chr17:44846353-44850476,4123
86948629,87002033,chr9,GAS1RR,chr9:86948629-87002033,53404
136721366,136728184,chr9,SNHG7,chr9:136721366-136728184,6818
57735739,57757244,chr16,KATNB1,chr16:57735739-57757244,21505
44849948,44899445,chr17,EFTUD2,chr17:44849948-44899445,49497
18193218,18196948,chr19,MPV17L2,chr19:18193218-18196948,3730
83077498,83353787,chr5,XRCC4,chr5:83077498-83353787,276289
18196784,18204042,chr19,RAB3A,chr19:18196784-18204042,7258
96019724,96027993,chr9,LINC00092,chr9:96019724-96027993,8269
126557435,126558162,chr2,YWHAZP2,chr2:126557435-126558162,727
69191498,69244020,chr14,EXD2,chr14:69191498-69244020,52522
105144113,105145424,chr2,LINC01918,chr2:105144113-105145424,1311
33272075,33276511,chr6,RPS18,chr6:33272075-33276511,4436
241478316,241478993,chr2,KCTD5P1,chr2:241478316-241478993,677
77210449,77428256,chr5,PDE8B,chr5:77210449-77428256,217807
112399512,112487204,chr9,HSDL2-AS1,chr9:112399512-112487204,87692
156872078,156872218,chr7,RNU4-31P,chr7:156872078-156872218,140
156949712,156973176,chr7,NOM1,chr7:156949712-156973176,23464
18208652,18248200,chr19,PDE4C,chr19:18208652-18248200,39548
144666312,145262988,chr2,TEX41,chr2:144666312-145262988,596676
128663129,128684493,chr9,HMGA1P4,chr9:128663129-128684493,21364
37079645,37090928,chr9,EBLN3P,chr9:37079645-37090928,11283
61402641,61430031,chr11,CPSF7,chr11:61402641-61430031,27390
156994051,157010663,chr7,MNX1,chr7:156994051-157010663,16612
33277123,33284832,chr6,B3GALT4,chr6:33277123-33284832,7709
33279108,33289247,chr6,WDR46,chr6:33279108-33289247,10139
63597039,63641871,chr14,WDR89,chr14:63597039-63641871,44832
30729131,30767006,chr8,UBXN8,chr8:30729131-30767006,37875
57772289,57772352,chr16,MIR6772,chr16:57772289-57772352,63
72305367,72356721,chr9,LINC01504,chr9:72305367-72356721,51354
157006307,157007132,chr7,MNX1-AS2,chr7:157006307-157007132,825
157010805,157016426,chr7,MNX1-AS1,chr7:157010805-157016426,5621
67447084,67533739,chr14,TMEM229B,chr14:67447084-67533739,86655
157192368,157192832,chr7,RPS27AP12,chr7:157192368-157192832,464
57830536,57830642,chr16,RNU6-20P,chr16:57830536-57830642,106
50742050,50801935,chr16,CYLD,chr16:50742050-50801935,59885
96189366,96190219,chr10,NPM1P25,chr10:96189366-96190219,853
70597348,70602759,chr10,PRF1,chr10:70597348-70602759,5411
44143213,44198170,chr7,GCK,chr7:44143213-44198170,54957
22956950,22957029,chr14,MIR4707,chr14:22956950-22957029,79
23156309,23156414,chr14,RNU6-1138P,chr14:23156309-23156414,105
23185316,23273477,chr14,RNF212B,chr14:23185316-23273477,88161
70672506,70762441,chr10,ADAMTS14,chr10:70672506-70762441,89935
105993310,106740875,chr9,LINC01505,chr9:105993310-106740875,747565
33287227,33287289,chr6,MIR6873,chr6:33287227-33287289,62
33289302,33298401,chr6,PFDN6,chr6:33289302-33298401,9099
150761937,150873554,chr3,SIAH2-AS1,chr3:150761937-150873554,111617
156215560,156227883,chr3,KCNAB1-AS2,chr3:156215560-156227883,12323
30754236,30754539,chr8,HIKESHIP3,chr8:30754236-30754539,303
23259460,23259566,chr14,RNU6-1046P,chr14:23259460-23259566,106
23388596,23388666,chr14,MIR208A,chr14:23388596-23388666,70
23417987,23418063,chr14,MIR208B,chr14:23417987-23418063,76
81471547,81533853,chr14,SEL1L,chr14:81471547-81533853,62306
30774457,30814314,chr8,PPP2CB,chr8:30774457-30814314,39857
189969030,189969861,chr3,MTAPP2,chr3:189969030-189969861,831
112647874,112647941,chr4,MIR367,chr4:112647874-112647941,67
191329085,191398659,chr3,CCDC50,chr3:191329085-191398659,69574
112648004,112648071,chr4,MIR302D,chr4:112648004-112648071,67
70794230,70794523,chr10,RPS26P40,chr10:70794230-70794523,293
112648183,112648251,chr4,MIR302A,chr4:112648183-112648251,68
112648363,112648430,chr4,MIR302C,chr4:112648363-112648430,67
112648485,112648557,chr4,MIR302B,chr4:112648485-112648557,72
112685055,112685503,chr4,OSTCP4,chr4:112685055-112685503,448
70815948,70881184,chr10,SGPL1,chr10:70815948-70881184,65236
111353275,111367409,chr1,CHIAP3,chr1:111353275-111367409,14134
112693459,112693792,chr4,GET1P1,chr4:112693459-112693792,333
113418054,113761927,chr4,CAMK2D,chr4:113418054-113761927,343873
33290245,33290325,chr6,MIR6834,chr6:33290245-33290325,80
33291654,33298942,chr6,RGL2,chr6:33291654-33298942,7288
44899142,44905390,chr17,CCDC103,chr17:44899142-44905390,6248
4676600,4679502,chr9,CDC37L1-DT,chr9:4676600-4679502,2902
102876467,103108872,chr1,COL11A1,chr1:102876467-103108872,232405
70193997,70258866,chr9,SMC5-DT,chr9:70193997-70258866,64869
30831544,30913008,chr8,TEX15,chr8:30831544-30913008,81464
83707594,83713496,chr9,UBQLN1-AS1,chr9:83707594-83713496,5902
194136148,194138732,chr3,HES1,chr3:194136148-194138732,2584
70882280,70888565,chr10,PCBD1,chr10:70882280-70888565,6285
148580401,148580799,chr7,RPL32P17,chr7:148580401-148580799,398
148590766,148615860,chr7,C7orf33,chr7:148590766-148615860,25094
39709535,39810128,chr9,GLIDR,chr9:39709535-39810128,100593
142157527,142225592,chr3,GK5,chr3:142157527-142225592,68065
44924709,44947773,chr17,KIF18B,chr17:44924709-44947773,23064
70939036,70955947,chr10,LINC02622,chr10:70939036-70955947,16911
132685007,132760712,chr8,TMEM71,chr8:132685007-132760712,75705
21635342,21757857,chr12,LDHB,chr12:21635342-21757857,122515
70771238,70785401,chr10,TBATA,chr10:70771238-70785401,14163
148807257,148884321,chr7,EZH2,chr7:148807257-148884321,77064
81605338,81623086,chr14,LINC01467,chr14:81605338-81623086,17748
81260652,81436465,chr14,STON2,chr14:81260652-81436465,175813
18279694,18281622,chr19,JUND,chr19:18279694-18281622,1928
101031234,101041244,chr10,SFXN3,chr10:101031234-101041244,10010
18285343,18285495,chr19,RPL39P38,chr19:18285343-18285495,152
104077308,104093073,chr9,SMC2-DT,chr9:104077308-104093073,15765
18306236,18323112,chr19,LSM4,chr19:18306236-18323112,16876
93948226,93948302,chr14,MIR4506,chr14:93948226-93948302,76
94104836,94116695,chr14,IFI27,chr14:94104836-94116695,11859
38996754,39105445,chr8,ADAM9,chr8:38996754-39105445,108691
101089321,101131126,chr10,TLX1NB,chr10:101089321-101131126,41805
68543531,68546662,chr9,LINC01506,chr9:68543531-68546662,3131
44947912,44948939,chr17,KIF18B-DT,chr17:44947912-44948939,1027
44959693,44968303,chr17,C1QL1,chr17:44959693-44968303,8610
101131300,101137789,chr10,TLX1,chr10:101131300-101137789,6489
95759231,95876049,chr9,LINC00476,chr9:95759231-95876049,116818
82236668,82236728,chr17,MIR6787,chr17:82236668-82236728,60
82290046,82292814,chr17,LINC01970,chr17:82290046-82292814,2768
82314868,82317608,chr17,CD7,chr17:82314868-82317608,2740
103446786,103452402,chr10,CALHM2,chr10:103446786-103452402,5616
18340598,18369950,chr19,PGPEP1,chr19:18340598-18369950,29352
196291219,196318299,chr3,DYNLT2B,chr3:196291219-196318299,27080
3526466,3691814,chr9,RFX3-AS1,chr9:3526466-3691814,165348
189031898,189225312,chr2,COL5A2,chr2:189031898-189225312,193414
61430042,61446733,chr11,SDHAF2,chr11:61430042-61446733,16691
185190624,185281990,chr3,EHHADH,chr3:185190624-185281990,91366
103453240,103458900,chr10,CALHM1,chr10:103453240-103458900,5660
103094725,103110559,chr14,EXOC3L4,chr14:103094725-103110559,15834
91050491,91058024,chr12,KERA,chr12:91050491-91058024,7533
40992245,41218410,chr9,FRG1HP,chr9:40992245-41218410,226165
103472804,103479240,chr10,CALHM3,chr10:103472804-103479240,6436
103479603,103517393,chr10,NEURL1-AS1,chr10:103479603-103517393,37790
18391137,18397622,chr19,LRRC25,chr19:18391137-18397622,6485
69738860,69823204,chr12,RAB3IP,chr12:69738860-69823204,84344
103745966,103755423,chr10,SH3PXD2A-AS1,chr10:103745966-103755423,9457
82321024,82334074,chr17,SECTM1,chr17:82321024-82334074,13050
31291788,31420550,chr14,HEATR5A,chr14:31291788-31420550,128762
195280723,195282741,chr3,ACAP2-IT1,chr3:195280723-195282741,2018
103877569,103918184,chr10,STN1,chr10:103877569-103918184,40615
18418864,18434562,chr19,SSBP4,chr19:18418864-18434562,15698
143157914,143160711,chr8,LY6H,chr8:143157914-143160711,2797
61481120,61490931,chr11,PPP1R32,chr11:61481120-61490931,9811
41955445,41955763,chr3,RPL36P20,chr3:41955445-41955763,318
129332300,129359541,chr9,LINC01503,chr9:129332300-129359541,27241
149377778,149386583,chr3,TM4SF1-AS1,chr3:149377778-149386583,8805
148821012,148821073,chr7,RNU7-20P,chr7:148821012-148821073,61
148890226,148890513,chr7,RN7SL569P,chr7:148890226-148890513,287
148963315,148963410,chr7,RNY4,chr7:148963315-148963410,95
148983755,148983856,chr7,RNY3,chr7:148983755-148983856,101
148987136,148987248,chr7,RNY1,chr7:148987136-148987248,112
148987527,148989432,chr7,GHET1,chr7:148987527-148989432,1905
149003062,149028662,chr7,PDIA4,chr7:149003062-149028662,25600
195658062,195739964,chr3,MUC20-OT1,chr3:195658062-195739964,81902
33314406,33317942,chr6,ZBTB22,chr6:33314406-33317942,3536
124658412,124698631,chr9,MIR181A2HG,chr9:124658412-124698631,40219
103974515,103974814,chr10,RN7SL524P,chr10:103974515-103974814,299
88048135,88049823,chr10,MED6P1,chr10:88048135-88049823,1688
112957722,113012230,chr9,ZNF883,chr9:112957722-113012230,54508
33318558,33323016,chr6,DAXX,chr6:33318558-33323016,4458
87862638,87971930,chr10,PTEN,chr10:87862638-87971930,109292
62248591,63014000,chr8,NKAIN3,chr8:62248591-63014000,765409
149033057,149033167,chr7,RNU6-650P,chr7:149033057-149033167,110
149053961,149054173,chr7,COX6B1P1,chr7:149053961-149054173,212
10679230,10761234,chr5,DAP,chr5:10679230-10761234,82004
150944961,150978321,chr7,KCNH2,chr7:150944961-150978321,33360
137615326,137618906,chr9,ARRDC1-AS1,chr9:137615326-137618906,3580
82359247,82363775,chr17,TEX19,chr17:82359247-82363775,4528
69296678,69311111,chr9,BANCR,chr9:69296678-69311111,14433
141117278,141195808,chr8,DENND3,chr8:141117278-141195808,78530
31320224,31320634,chr14,ATP5MC1P2,chr14:31320224-31320634,410
73537143,73543796,chr14,ACOT1,chr14:73537143-73543796,6653
61508749,61511018,chr11,LRRC10B,chr11:61508749-61511018,2269
82389210,82418637,chr17,OGFOD3,chr17:82389210-82418637,29427
53443228,53443332,chr16,RNU6-1153P,chr16:53443228-53443332,104
70968166,71025339,chr5,NAIP,chr5:70968166-71025339,57173
62567011,62567071,chr11,MIR6747,chr11:62567011-62567071,60
120824828,120854385,chr9,CUTALP,chr9:120824828-120854385,29557
62575045,62591637,chr11,TUT1,chr11:62575045-62591637,16592
53491040,53504411,chr16,AKTIP,chr16:53491040-53504411,13371
73539221,73539781,chr14,NT5CP2,chr14:73539221-73539781,560
73567620,73575658,chr14,ACOT2,chr14:73567620-73575658,8038
62593214,62601865,chr11,MTA2,chr11:62593214-62601865,8651
73571159,73571667,chr14,NT5CP1,chr14:73571159-73571667,508
46753605,46759740,chr10,CTSLP3,chr10:46753605-46759740,6135
2421597,2622457,chr9,VLDLR-AS1,chr9:2421597-2622457,200860
73591873,73595766,chr14,ACOT4,chr14:73591873-73595766,3893
46759019,46786770,chr10,GLUD1P2,chr10:46759019-46786770,27751
73610945,73619888,chr14,ACOT6,chr14:73610945-73619888,8943
46807458,46807573,chr10,RNA5SP311,chr10:46807458-46807573,115
46816516,46832476,chr10,AGAP13P,chr10:46816516-46832476,15960
73631475,73632019,chr14,NDUFB8P1,chr14:73631475-73632019,544
73644875,73703732,chr14,DNAL1,chr14:73644875-73703732,58857
18434388,18438167,chr19,ISYNA1,chr19:18434388-18438167,3779
46911396,47002488,chr10,PTPN20,chr10:46911396-47002488,91092
33323628,33329279,chr6,SMIM40,chr6:33323628-33329279,5651
33338978,33339495,chr6,MYL12BP3,chr6:33338978-33339495,517
130521197,130528604,chr2,CFC1B,chr2:130521197-130528604,7407
29301701,29313017,chr6,OR14J1,chr6:29301701-29313017,11316
43295694,43305538,chr6,SLC22A7,chr6:43295694-43305538,9844
77122434,77329533,chr7,CCDC146,chr7:77122434-77329533,207099
82425498,82427310,chr17,HEXD-IT1,chr17:82425498-82427310,1812
150612381,150635818,chr2,LINC02612,chr2:150612381-150635818,23437
99979185,100099052,chr9,ERP44,chr9:99979185-100099052,119867
82442586,82450829,chr17,CYBC1,chr17:82442586-82450829,8243
73659564,73659660,chr14,RNU6-240P,chr14:73659564-73659660,96
73711783,73714384,chr14,PNMA1,chr14:73711783-73714384,2601
62602218,62612775,chr11,EML3,chr11:62602218-62612775,10557
73715122,73790285,chr14,MIDEAS,chr14:73715122-73790285,75163
89818179,89871319,chr16,SPIRE2,chr16:89818179-89871319,53140
72697903,72697978,chr7,MIR4650-2,chr7:72697903-72697978,75
143734139,143790645,chr8,IQANK1,chr8:143734139-143790645,56506
72822894,72823171,chr7,RN7SL377P,chr7:72822894-72823171,277
72841437,72841727,chr7,RN7SL625P,chr7:72841437-72841727,290
241492670,241509730,chr2,STK25,chr2:241492670-241509730,17060
72947581,72954790,chr7,NSUN5P2,chr7:72947581-72954790,7209
43299710,43308826,chr6,CRIP3,chr6:43299710-43308826,9116
118189455,118622112,chr8,SAMD12,chr8:118189455-118622112,432657
1801407,1816048,chr5,NDUFS6,chr5:1801407-1816048,14641
196211487,196243178,chr3,SLC51A,chr3:196211487-196243178,31691
157142933,157255185,chr5,ITK,chr5:157142933-157255185,112252
72959485,72969466,chr7,TRIM74,chr7:72959485-72969466,9981
49791866,49791934,chr19,MIR6799,chr19:49791866-49791934,68
49806866,49817376,chr19,FUZ,chr19:49806866-49817376,10510
43310231,43310357,chr6,RPL12P47,chr6:43310231-43310357,126
22367278,22434129,chr8,SLC39A14,chr8:22367278-22434129,66851
72969696,73005922,chr7,STAG3L3,chr7:72969696-73005922,36226
43363479,43364219,chr6,RPS2P28,chr6:43363479-43364219,740
131808016,131895155,chr6,ENPP1,chr6:131808016-131895155,87139
58872149,58920504,chr12,LRIG3,chr12:58872149-58920504,48355
73758747,73758819,chr14,MIR4505,chr14:73758747-73758819,72
180602163,180617828,chr3,TTC14,chr3:180602163-180617828,15665
89873570,89913627,chr16,TCF25,chr16:89873570-89913627,40057
73822559,73830135,chr14,LINC02274,chr14:73822559-73830135,7576
73851831,73885726,chr14,PTGR2,chr14:73851831-73885726,33895
95461755,95554977,chr5,TTC37,chr5:95461755-95554977,93222
73005541,73021103,chr7,PMS2P7,chr7:73005541-73021103,15562
73037371,73049246,chr7,PMS2P8,chr7:73037371-73049246,11875
73093657,73105389,chr7,PMS2P6,chr7:73093657-73105389,11732
73187969,73188736,chr7,PHBP5,chr7:73187969-73188736,767
74843754,74890610,chr7,STAG3L2,chr7:74843754-74890610,46856
74894116,74897835,chr7,PMS2P5,chr7:74894116-74897835,3719
22024125,22036897,chr8,NPM2,chr8:22024125-22036897,12772
75203926,75204711,chr7,PHBP6,chr7:75203926-75204711,785
75288120,75299795,chr7,PMS2P10,chr7:75288120-75299795,11675
54369133,54391298,chr12,ZNF385A,chr12:54369133-54391298,22165
49832018,49832099,chr19,MIR6800,chr19:49832018-49832099,81
49838639,49851676,chr19,PTOV1-AS1,chr19:49838639-49851676,13037
75344015,75359550,chr7,PMS2P2,chr7:75344015-75359550,15535
33365548,33366243,chr6,LYPLA2P1,chr6:33365548-33366243,695
33389374,33389475,chr6,RPL35AP4,chr6:33389374-33389475,101
33391823,33409896,chr6,KIFC1,chr6:33391823-33409896,18073
49850735,49860744,chr19,PTOV1,chr19:49850735-49860744,10009
113900284,113979727,chr4,ARSJ,chr4:113900284-113979727,79443
6615610,6624290,chr7,ZNF853,chr7:6615610-6624290,8680
6637318,6658279,chr7,ZNF316,chr7:6637318-6658279,20961
8182072,8241803,chr4,SH3TC1,chr4:8182072-8241803,59731
73886617,73932521,chr14,ZNF410,chr14:73886617-73932521,45904
184135038,184146127,chr3,EIF2B5,chr3:184135038-184146127,11089
6688433,6706947,chr7,ZNF12,chr7:6688433-6706947,18514
62611722,62615116,chr11,ROM1,chr11:62611722-62615116,3394
33400059,33400556,chr6,RPL12P1,chr6:33400059-33400556,497
33410399,33416453,chr6,PHF1,chr6:33410399-33416453,6054
62615296,62622154,chr11,B3GAT3,chr11:62615296-62622154,6858
82725873,82738904,chr15,ACTG1P17,chr15:82725873-82738904,13031
6710128,6753862,chr7,PMS2CL,chr7:6710128-6753862,43734
119126539,119127291,chr1,RPS3AP12,chr1:119126539-119127291,752
82750564,82757206,chr15,SNHG21,chr15:82750564-82757206,6642
116713833,116714835,chr1,GAPDHP64,chr1:116713833-116714835,1002
22042398,22048809,chr8,FGF17,chr8:22042398-22048809,6411
103525691,103555239,chr1,RNPC3,chr1:103525691-103555239,29548
6715630,6720982,chr7,SPDYE20P,chr7:6715630-6720982,5352
82755362,82806070,chr15,FSD2,chr15:82755362-82806070,50708
89912119,89920973,chr16,MC1R,chr16:89912119-89920973,8854
7346685,7479897,chr12,CD163L1,chr12:7346685-7479897,133212
73736094,73738852,chr7,ABHD11,chr7:73736094-73738852,2758
22089150,22104911,chr8,FHIP2B,chr8:22089150-22104911,15761
62624826,62646726,chr11,GANAB,chr11:62624826-62646726,21900
90019629,90044975,chr16,GAS8,chr16:90019629-90044975,25346
178149463,178153894,chr5,NHP2,chr5:178149463-178153894,4431
152391546,152433368,chr5,NMUR2,chr5:152391546-152433368,41822
98661701,98760500,chr1,SNX7,chr1:98661701-98760500,98799
23443586,23528093,chr5,PRDM9,chr5:23443586-23528093,84507
82755945,82756071,chr15,SCARNA15,chr15:82755945-82756071,126
82809628,82836108,chr15,WHAMM,chr15:82809628-82836108,26480
55019017,55211628,chr7,EGFR,chr7:55019017-55211628,192611
106583004,106762803,chr12,RFX4,chr12:106583004-106762803,179799
72114258,72143692,chr15,SENP8,chr15:72114258-72143692,29434
22106874,22109419,chr8,NUDT18,chr8:22106874-22109419,2545
136212745,136365545,chr5,TRPC7,chr5:136212745-136365545,152800
87650280,87664361,chr4,DMP1,chr4:87650280-87664361,14081
33416442,33418317,chr6,CUTA,chr6:33416442-33418317,1875
113894194,113905201,chr1,AP4B1,chr1:113894194-113905201,11007
22114419,22133384,chr8,HR,chr8:22114419-22133384,18965
49854591,49854651,chr19,MIR4749,chr19:49854591-49854651,60
49856970,49859289,chr19,PTOV1-AS2,chr19:49856970-49859289,2319
90028908,90029901,chr16,GAS8-AS1,chr16:90028908-90029901,993
90039761,90047773,chr16,URAHP,chr16:90039761-90047773,8012
72159806,72197787,chr15,GRAMD2A,chr15:72159806-72197787,37981
49859882,49878351,chr19,PNKP,chr19:49859882-49878351,18469
90093154,90096354,chr16,TUBB8P7,chr16:90093154-90096354,3200
87975667,87983532,chr4,SPP1,chr4:87975667-87983532,7865
90144592,90144695,chr16,RNU6-355P,chr16:90144592-90144695,103
90174062,90175865,chr16,CICP25,chr16:90174062-90175865,1803
90004871,90019890,chr16,DBNDD1,chr16:90004871-90019890,15019
138652698,138834928,chr3,PIK3CB,chr3:138652698-138834928,182230
241637213,241673857,chr2,ATG4B,chr2:241637213-241673857,36644
50046429,50066224,chr16,HEATR3-AS1,chr16:50046429-50066224,19795
50058150,50059231,chr16,ACTG1P16,chr16:50058150-50059231,1081
72241181,72272999,chr15,PARP6,chr15:72241181-72272999,31818
50098264,50098358,chr16,RNY4P3,chr16:50098264-50098358,94
50151280,50151577,chr16,RPL10P14,chr16:50151280-50151577,297
101639509,101787572,chr1,LINC01709,chr1:101639509-101787572,148063
56858518,56858601,chr16,MIR138-2,chr16:56858518-56858601,83
56865207,56915850,chr16,SLC12A3,chr16:56865207-56915850,50643
77376689,77392163,chr14,SAMD15,chr14:77376689-77392163,15474
77394021,77423523,chr14,NOXRED1,chr14:77394021-77423523,29502
109213918,109238182,chr1,SARS1,chr1:109213918-109238182,24264
46870762,46895113,chr10,FRMPD2B,chr10:46870762-46895113,24351
115578496,115602479,chr5,TICAM2,chr5:115578496-115602479,23983
79703227,79714681,chr10,NUTM2B,chr10:79703227-79714681,11454
93918894,93929608,chr14,FAM181A,chr14:93918894-93929608,10714
70025247,70043113,chr5,SERF1B,chr5:70025247-70043113,17866
86756601,86932825,chr10,BMPR1A,chr10:86756601-86932825,176224
22130604,22130708,chr8,HRURF,chr8:22130604-22130708,104
22138020,22141951,chr8,REEP4,chr8:22138020-22141951,3931
113221050,113298585,chr12,TPCN1,chr12:113221050-113298585,77535
24809454,25050147,chr14,STXBP6,chr14:24809454-25050147,240693
82454140,82458521,chr17,NARF-AS2,chr17:82454140-82458521,4381
82476597,82477924,chr17,NARF-AS1,chr17:82476597-82477924,1327
82482098,82483388,chr17,NARF-IT1,chr17:82482098-82483388,1290
33419661,33453689,chr6,SYNGAP1,chr6:33419661-33453689,34028
15251627,15251696,chr17,MIR4731,chr17:15251627-15251696,69
15303811,15341632,chr17,TEKT3,chr17:15303811-15341632,37821
175917873,176034680,chr5,THOC3,chr5:175917873-176034680,116807
6269849,6303265,chr4,WFS1,chr4:6269849-6303265,33416
86654518,86666460,chr10,OPN4,chr10:86654518-86666460,11942
131967684,131981967,chr10,BNIP3,chr10:131967684-131981967,14283
67819779,68730218,chr14,RAD51B,chr14:67819779-68730218,910439
194276682,194287368,chr3,LINC02048,chr3:194276682-194287368,10686
100896076,100981757,chr1,SLC30A7,chr1:100896076-100981757,85681
15311345,15311451,chr17,RNU6-799P,chr17:15311345-15311451,106
198223497,198226310,chr3,CICP6,chr3:198223497-198226310,2813
15408384,15408688,chr17,RN7SL792P,chr17:15408384-15408688,304
72749277,72861914,chr3,SHQ1,chr3:72749277-72861914,112637
44370165,44386493,chr10,CXCL12,chr10:44370165-44386493,16328
15229773,15272292,chr17,PMP22,chr17:15229773-15272292,42519
157395534,157575775,chr5,ADAM19,chr5:157395534-157575775,180241
193957372,194003760,chr3,LINC02026,chr3:193957372-194003760,46388
112956415,113047055,chr1,SLC16A1-AS1,chr1:112956415-113047055,90640
133430394,133431318,chr10,OR6L2P,chr10:133430394-133431318,924
177010719,177011067,chr3,MTND5P15,chr3:177010719-177011067,348
133453928,133523558,chr10,SCART1,chr10:133453928-133523558,69630
187698259,187702557,chr3,RTP2,chr3:187698259-187702557,4298
191213291,191234605,chr3,OSTN-AS1,chr3:191213291-191234605,21314
194765238,194768712,chr3,LINC01972,chr3:194765238-194768712,3474
22146830,22157084,chr8,LGI3,chr8:22146830-22157084,10254
150238519,150244232,chr3,LINC01213,chr3:150238519-150244232,5713
133481238,133481770,chr10,OR7M1P,chr10:133481238-133481770,532
109687814,109709039,chr1,GSTM1,chr1:109687814-109709039,21225
86935002,87141039,chr4,AFF1,chr4:86935002-87141039,206037
62646848,62653302,chr11,INTS5,chr11:62646848-62653302,6454
187448845,187449450,chr3,LINC02041,chr3:187448845-187449450,605
133520406,133561220,chr10,CYP2E1,chr10:133520406-133561220,40814
62662817,62665210,chr11,C11orf98,chr11:62662817-62665210,2393
196214222,196287957,chr3,PCYT1A,chr3:196214222-196287957,73735
56904264,56904353,chr16,MIR6863,chr16:56904264-56904353,89
56906534,56906956,chr16,RPS24P17,chr16:56906534-56906956,422
62665309,62668496,chr11,CSKMT,chr11:62665309-62668496,3187
56932142,56944864,chr16,HERPUD1,chr16:56932142-56944864,12722
62665422,62665570,chr11,SNORA57,chr11:62665422-62665570,148
62670273,62673686,chr11,UQCC3,chr11:62670273-62673686,3413
39397684,39432466,chr14,FBXO33,chr14:39397684-39432466,34782
62676498,62679117,chr11,UBXN1,chr11:62676498-62679117,2619
105880002,105932642,chr14,FAM30A,chr14:105880002-105932642,52640
22165140,22212326,chr8,BMP1,chr8:22165140-22212326,47186
61680723,61695892,chr14,HIF1A-AS1,chr14:61680723-61695892,15169
90820064,90828202,chr14,LINC02321,chr14:90820064-90828202,8138
80266639,80336680,chr4,FGF5,chr4:80266639-80336680,70041
97427071,97582146,chr14,LINC02325,chr14:97427071-97582146,155075
133553901,133569835,chr10,SYCE1,chr10:133553901-133569835,15934
49818282,49840383,chr19,MED25,chr19:49818282-49840383,22101
99412261,99435510,chr4,ADH7,chr4:99412261-99435510,23249
134148935,134176964,chr5,SKP1,chr5:134148935-134176964,28029
191245185,191425389,chr2,MYO1B,chr2:191245185-191425389,180204
100949534,100968347,chr7,MUC3A,chr7:100949534-100968347,18813
120150898,120176520,chr1,SEC22B,chr1:120150898-120176520,25622
38738155,38948273,chr14,LINC00639,chr14:38738155-38948273,210118
133575122,133576031,chr10,OR6L1P,chr10:133575122-133576031,909
133420666,133424625,chr10,SPRN,chr10:133420666-133424625,3959
58643440,58700077,chr1,MYSM1,chr1:58643440-58700077,56637
68158079,68158408,chr10,RN7SKP202,chr10:68158079-68158408,329
68230595,68232113,chr10,ATOH7,chr10:68230595-68232113,1518
101020072,101058859,chr7,MUC17,chr7:101020072-101058859,38787
68233251,68242379,chr10,LINC02640,chr10:68233251-68242379,9128
197791226,197888436,chr3,LRCH3,chr3:197791226-197888436,97210
68260557,68261499,chr10,KRT19P4,chr10:68260557-68261499,942
68282660,68333049,chr10,PBLD,chr10:68282660-68333049,50389
44622088,44678556,chr4,YIPF7,chr4:44622088-44678556,56468
82642605,82746664,chr14,LINC02301,chr14:82642605-82746664,104059
108621895,108633894,chr12,SELPLG,chr12:108621895-108633894,11999
26121991,26299290,chr12,SSPN,chr12:26121991-26299290,177299
101058299,101058567,chr7,RN7SKP54,chr7:101058299-101058567,268
62686406,62689530,chr11,LRRN4CL,chr11:62686406-62689530,3124
33437363,33454453,chr6,SYNGAP1-AS1,chr6:33437363-33454453,17090
72031902,72148305,chr4,NPFFR2,chr4:72031902-72148305,116403
101085481,101097967,chr7,TRIM56,chr7:101085481-101097967,12486
33438331,33438437,chr6,MIR5004,chr6:33438331-33438437,106
33453970,33457544,chr6,ZBTB9,chr6:33453970-33457544,3574
62690275,62727384,chr11,HNRNPUL2-BSCL2,chr11:62690275-62727384,37109
75423683,75427741,chr14,JDP2-AS1,chr14:75423683-75427741,4058
27048169,27048628,chr7,NHP2P2,chr7:27048169-27048628,459
68331174,68343193,chr10,HNRNPH3,chr10:68331174-68343193,12019
31053450,31059890,chr6,HCG22,chr6:31053450-31059890,6440
75294404,75298109,chr14,LINC01220,chr14:75294404-75298109,3705
62707676,62709201,chr11,GNG3,chr11:62707676-62709201,1525
27092993,27096000,chr7,HOXA1,chr7:27092993-27096000,3007
133150568,133150816,chr6,MTCYBP4,chr6:133150568-133150816,248
133510386,133510693,chr6,HSPE1P21,chr6:133510386-133510693,307
3041363,3243957,chr4,HTT,chr4:3041363-3243957,202594
98135986,98163151,chr14,LINC02295,chr14:98135986-98163151,27165
47002995,47003148,chr1,CYP4A44P,chr1:47002995-47003148,153
62712630,62727457,chr11,HNRNPUL2,chr11:62712630-62727457,14827
56961923,56983845,chr16,CETP,chr16:56961923-56983845,21922
27095647,27100265,chr7,HOTAIRM1,chr7:27095647-27100265,4618
108645109,108731526,chr12,CORO1C,chr12:108645109-108731526,86417
149724315,149749665,chr6,NUP43,chr6:149724315-149749665,25350
101552221,101560438,chr14,DIO3OS,chr14:101552221-101560438,8217
116909916,116990353,chr1,PTGFRN,chr1:116909916-116990353,80437
27100354,27102686,chr7,HOXA2,chr7:27100354-27102686,2332
148383935,148442836,chr5,FBXO38,chr5:148383935-148442836,58901
27107777,27134302,chr7,HOXA-AS2,chr7:27107777-27134302,26525
119467221,119473803,chr1,HSD3BP1,chr1:119467221-119473803,6582
114567557,114581629,chr1,BCAS2,chr1:114567557-114581629,14072
112025408,112064404,chr11,DLAT,chr11:112025408-112064404,38996
7306999,7312463,chr17,EIF5A,chr17:7306999-7312463,5464
27128507,27130780,chr7,HOXA4,chr7:27128507-27130780,2273
23938219,24052555,chr14,DHRS4-AS1,chr14:23938219-24052555,114336
38080056,38080877,chr10,EIF3LP3,chr10:38080056-38080877,821
38091764,38092051,chr10,FXYD6P2,chr10:38091764-38092051,287
38164648,38212417,chr10,CCNYL4,chr10:38164648-38212417,47769
27129977,27155928,chr7,HOXA-AS3,chr7:27129977-27155928,25951
38094334,38150293,chr10,ZNF37A,chr10:38094334-38150293,55959
27141052,27143681,chr7,HOXA5,chr7:27141052-27143681,2629
72284727,72320157,chr15,CELF6,chr15:72284727-72320157,35430
89995110,90035533,chr1,ZNF326,chr1:89995110-90035533,40423
105092739,105100131,chr14,LINC02298,chr14:105092739-105100131,7392
27145396,27150603,chr7,HOXA6,chr7:27145396-27150603,5207
149749443,149811420,chr6,PCMT1,chr6:149749443-149811420,61977
85911438,86161539,chr14,LINC02328,chr14:85911438-86161539,250101
27153716,27157936,chr7,HOXA7,chr7:27153716-27157936,4220
27162438,27175180,chr7,HOXA9,chr7:27162438-27175180,12742
69403903,69416918,chr10,TACR2,chr10:69403903-69416918,13015
88024519,88098025,chr14,LINC01146,chr14:88024519-88098025,73506
4324043,4342786,chr19,STAP2,chr19:4324043-4342786,18743
27168619,27171915,chr7,HOXA10-AS,chr7:27168619-27171915,3296
27169480,27169563,chr7,MIR196B,chr7:27169480-27169563,83
27181157,27185232,chr7,HOXA11,chr7:27181157-27185232,4075
147084616,147084756,chr1,RNVU1-8,chr1:147084616-147084756,140
79068966,79316519,chr10,ZMIZ1,chr10:79068966-79316519,247553
27184507,27189298,chr7,HOXA11-AS,chr7:27184507-27189298,4791
117111060,117122587,chr1,TRIM45,chr1:117111060-117122587,11527
149794763,149795746,chr6,BTBD10P2,chr6:149794763-149795746,983
156977558,156977825,chr3,KLF3P2,chr3:156977558-156977825,267
196568611,196589059,chr3,FBXO45,chr3:196568611-196589059,20448
149818757,149864359,chr6,LRP11,chr6:149818757-149864359,45602
27193503,27200091,chr7,HOXA13,chr7:27193503-27200091,6588
57091213,57092303,chr16,CPNE2-DT,chr16:57091213-57092303,1090
57092583,57148369,chr16,CPNE2,chr16:57092583-57148369,55786
185712528,185729787,chr3,IGF2BP2-AS1,chr3:185712528-185729787,17259
149863494,149919507,chr6,RAET1E-AS1,chr6:149863494-149919507,56013
27198575,27207259,chr7,HOTTIP,chr7:27198575-27207259,8684
149879962,149881572,chr6,CCT7P1,chr6:149879962-149881572,1610
72376113,72378788,chr15,HEXA-AS1,chr15:72376113-72378788,2675
72379215,72379710,chr15,RPL12P35,chr15:72379215-72379710,495
58056133,58056480,chr1,RPS26P15,chr1:58056133-58056480,347
74541206,74598131,chr15,ARID3B,chr15:74541206-74598131,56925
149916878,149923121,chr6,RAET1G,chr6:149916878-149923121,6243
143595216,143635641,chr1,NBPF17P,chr1:143595216-143635641,40425
27241429,27247229,chr7,EVX1-AS,chr7:27241429-27247229,5800
71816298,71851251,chr10,PSAP,chr10:71816298-71851251,34953
49950737,49958878,chr12,AQP2,chr12:49950737-49958878,8141
27242700,27250493,chr7,EVX1,chr7:27242700-27250493,7793
7311324,7315564,chr17,GPS2,chr17:7311324-7315564,4240
72558744,72828200,chr7,TYW1B,chr7:72558744-72828200,269456
149942014,149949235,chr6,ULBP2,chr6:149942014-149949235,7221
85821855,85821957,chr15,RNU6-231P,chr15:85821855-85821957,102
85825635,85825730,chr15,MIR548AP,chr15:85825635-85825730,95
118032687,118062430,chr12,WSB2,chr12:118032687-118062430,29743
45727200,45792964,chr10,WASHC2C,chr10:45727200-45792964,65764
86078809,86116747,chr15,LINC01584,chr15:86078809-86116747,37938
105698039,105698218,chr1,SEPTIN2P1,chr1:105698039-105698218,179
108375838,108410814,chr1,NBPF5P,chr1:108375838-108410814,34976
133240514,133532128,chr6,EYA4,chr6:133240514-133532128,291614
97796921,97798066,chr1,DPYD-AS2,chr1:97796921-97798066,1145
49869033,49878459,chr19,AKT1S1,chr19:49869033-49878459,9426
115641970,115698224,chr1,VANGL1,chr1:115641970-115698224,56254
62856004,62888880,chr11,SLC3A2,chr11:62856004-62888880,32876
73154938,73207283,chr7,GTF2IP4,chr7:73154938-73207283,52345
139560180,139678017,chr3,NMNAT3,chr3:139560180-139678017,117837
86138269,86138379,chr15,RNA5SP400,chr15:86138269-86138379,110
57152466,57186116,chr16,PSME3IP1,chr16:57152466-57186116,33650
86295649,86317173,chr15,AGBL1-AS1,chr15:86295649-86317173,21524
73220624,73235945,chr7,NCF1B,chr7:73220624-73235945,15321
73242751,73280119,chr7,GTF2IRD2P1,chr7:73242751-73280119,37368
86079871,87049169,chr15,AGBL1,chr15:86079871-87049169,969298
90835660,90849472,chr1,LINC02788,chr1:90835660-90849472,13812
20368537,20688583,chr12,PDE3A,chr12:20368537-20688583,320046
117549415,117549922,chr1,VPS25P1,chr1:117549415-117549922,507
119327399,119356182,chr1,LINC01780,chr1:119327399-119356182,28783
6448859,6496723,chr5,UBE2QL1,chr5:6448859-6496723,47864
117606048,117628389,chr1,TENT5C,chr1:117606048-117628389,22341
73293497,73301161,chr7,POM121B,chr7:73293497-73301161,7664
43951223,43967709,chr19,ZNF221,chr19:43951223-43967709,16486
20919290,20920303,chr14,RNASE2CP,chr14:20919290-20920303,1013
62908679,62921807,chr11,CHRM1,chr11:62908679-62921807,13128
73302516,73308826,chr7,NSUN5,chr7:73302516-73308826,6310
6599239,6633291,chr5,NSUN2,chr5:6599239-6633291,34052
145670852,145708148,chr1,PDZK1,chr1:145670852-145708148,37296
62935982,62936234,chr11,RN7SL259P,chr11:62935982-62936234,252
10922185,10928681,chr19,YIPF2,chr19:10922185-10928681,6496
86441108,86672636,chr11,ME3,chr11:86441108-86672636,231528
51751597,51816363,chr15,TMOD2,chr15:51751597-51816363,64766
39045039,39126857,chr4,KLHL5,chr4:39045039-39126857,81818
171894436,171895240,chr3,TMEM212-IT1,chr3:171894436-171895240,804
120722024,120722311,chr3,MTCO1P29,chr3:120722024-120722311,287
195658096,195685904,chr3,SDHAP2,chr3:195658096-195685904,27808
49927571,50105102,chr14,LINC01588,chr14:49927571-50105102,177531
188178543,188180812,chr3,FLJ42393,chr3:188178543-188180812,2269
196536532,196536702,chr3,RPS29P3,chr3:196536532-196536702,170
187721377,187745725,chr3,BCL6,chr3:187721377-187745725,24348
115957905,116277693,chr12,MED13L,chr12:115957905-116277693,319788
73312536,73328082,chr7,TRIM50,chr7:73312536-73328082,15546
147223554,147224348,chr1,RPL7AP15,chr1:147223554-147224348,794
145572345,145607858,chr1,NBPF25P,chr1:145572345-145607858,35513
22219703,22232101,chr8,PHYHIP,chr8:22219703-22232101,12398
7315628,7329393,chr17,NEURL4,chr17:7315628-7329393,13765
36594369,36675695,chr11,IFTAP,chr11:36594369-36675695,81326
99070978,99088801,chr4,ADH5,chr4:99070978-99088801,17823
148271884,148280749,chr1,LINC01731,chr1:148271884-148280749,8865
73328161,73358637,chr7,FKBP6,chr7:73328161-73358637,30476
241315100,241354027,chr2,SEPTIN2,chr2:241315100-241354027,38927
41431318,41440717,chr19,DMAC2,chr19:41431318-41440717,9399
120419850,120467739,chr1,NBPF8,chr1:120419850-120467739,47889
68206992,68257211,chr15,CLN6,chr15:68206992-68257211,50219
6633427,6674386,chr5,SRD5A1,chr5:6633427-6674386,40959
22245133,22254601,chr8,POLR3D,chr8:22245133-22254601,9468
119434166,119435080,chr1,GAPDHP74,chr1:119434166-119435080,914
12349547,12835545,chr10,CAMK1D,chr10:12349547-12835545,485998
57245259,57253635,chr16,ARL2BP,chr16:57245259-57253635,8376
150067279,150145329,chr1,VPS45,chr1:150067279-150145329,78050
183697797,183812624,chr3,YEATS2,chr3:183697797-183812624,114827
6686325,6707711,chr5,LINC02102,chr5:6686325-6707711,21386
57248547,57284672,chr16,PLLP,chr16:57248547-57284672,36125
6713432,6757044,chr5,TENT4A,chr5:6713432-6757044,43612
72367340,72626131,chr10,MICU1,chr10:72367340-72626131,258791
57321352,57322117,chr16,RPL23AP91,chr16:57321352-57322117,765
73339094,73339200,chr7,RNU6-1080P,chr7:73339094-73339200,106
84876554,84876956,chr7,HMGN2P11,chr7:84876554-84876956,402
70480568,70523560,chr16,COG4,chr16:70480568-70523560,42992
84983556,84984506,chr7,HNRNPA1P8,chr7:84983556-84984506,950
85027828,85029692,chr7,HSPA8P16,chr7:85027828-85029692,1864
84995553,85187056,chr7,SEMA3D,chr7:84995553-85187056,191503
64341673,64387986,chr14,TEX21P,chr14:64341673-64387986,46313
35138824,35143109,chr19,FXYD1,chr19:35138824-35143109,4285
112063218,112074274,chr11,PIH1D2,chr11:112063218-112074274,11056
75479033,75514764,chr4,RCHY1,chr4:75479033-75514764,35731
197737179,197787596,chr3,FYTTD1,chr3:197737179-197787596,50417
70216040,70303084,chr6,COL9A1,chr6:70216040-70303084,87044
22254576,22275162,chr8,PIWIL2-DT,chr8:22254576-22275162,20586
74688864,74729001,chr7,GTF2I-AS1,chr7:74688864-74729001,40137
22275316,22357568,chr8,PIWIL2,chr8:22275316-22357568,82252
72685069,72793599,chr11,ARAP1,chr11:72685069-72793599,108530
74741457,74742121,chr7,PHBP15,chr7:74741457-74742121,664
74964705,75031528,chr7,CASTOR2,chr7:74964705-75031528,66823
24036439,24051028,chr14,DHRS4L1,chr14:24036439-24051028,14589
68254549,68254939,chr15,HMGN2P40,chr15:68254549-68254939,390
75027122,75074228,chr7,RCC1L,chr7:75027122-75074228,47106
6827853,6827921,chr5,MIR4278,chr5:6827853-6827921,68
6848127,6848462,chr5,RN7SKP79,chr5:6848127-6848462,335
44927600,44927703,chr15,RNU6-1108P,chr15:44927600-44927703,103
44962830,44962933,chr15,RNU6-1332P,chr15:44962830-44962933,103
44973558,44973661,chr15,RNU6-966P,chr15:44973558-44973661,103
45002864,45003028,chr15,RNU1-78P,chr15:45002864-45003028,164
6582136,6600288,chr5,LINC01018,chr5:6582136-6600288,18152
76959636,76965802,chr14,LINC01629,chr14:76959636-76965802,6166
44956687,44979229,chr15,TERB2,chr15:44956687-44979229,22542
34911580,34982584,chr14,SRP54-AS1,chr14:34911580-34982584,71004
185582496,185633551,chr3,SENP2,chr3:185582496-185633551,51055
60778331,60794852,chr10,CDK1,chr10:60778331-60794852,16521
73735458,73753351,chr15,INSYN1,chr15:73735458-73753351,17893
70809841,70815994,chr14,MAP3K9-DT,chr14:70809841-70815994,6153
41182725,41230757,chr15,EXD1,chr15:41182725-41230757,48032
49767001,49807114,chr19,AP2A1,chr19:49767001-49807114,40113
95157645,95181475,chr14,DICER1-AS1,chr14:95157645-95181475,23830
10442264,10454685,chr12,KLRC1,chr12:10442264-10454685,12421
73433778,73436120,chr7,FZD9,chr7:73433778-73436120,2342
55496786,55580888,chr14,KTN1-AS1,chr14:55496786-55580888,84102
67109941,67148544,chr16,PHAF1,chr16:67109941-67148544,38603
5031608,5037831,chr7,SPDYE19P,chr7:5031608-5037831,6223
60891935,60893577,chr5,GNL3LP1,chr5:60891935-60893577,1642
5045821,5069487,chr7,RBAK,chr7:5045821-5069487,23666
60917490,60919573,chr5,ERCC8-AS1,chr5:60917490-60919573,2083
61157704,61162468,chr5,SMIM15,chr5:61157704-61162468,4764
22838644,22869362,chr15,NIPA2,chr15:22838644-22869362,30718
20615667,20777038,chr7,ABCB5,chr7:20615667-20777038,161371
95521943,95534889,chr14,SNHG10,chr14:95521943-95534889,12946
93591687,93601744,chr10,RBP4,chr10:93591687-93601744,10057
7336529,7351477,chr17,ACAP1,chr17:7336529-7351477,14948
131155383,131224468,chr5,HINT1,chr5:131155383-131224468,69085
197509783,197573323,chr3,BDH1,chr3:197509783-197573323,63540
28765640,28823817,chr14,LINC01551,chr14:28765640-28823817,58177
24583609,24723887,chr10,ARHGAP21,chr10:24583609-24723887,140278
110082688,110109719,chr1,LINC01397,chr1:110082688-110109719,27031
113576757,113576899,chr1,MTND5P20,chr1:113576757-113576899,142
145738868,145824095,chr1,RNF115,chr1:145738868-145824095,85227
131170944,131205428,chr5,LYRM7,chr5:131170944-131205428,34484
24993424,25006403,chr12,LINC02909,chr12:24993424-25006403,12979
97924637,97978124,chr14,LINC01550,chr14:97924637-97978124,53487
25092715,25093900,chr12,CENPUP2,chr12:25092715-25093900,1185
98906260,98906517,chr8,MRPL57P7,chr8:98906260-98906517,257
98921233,98921550,chr8,RN7SKP85,chr8:98921233-98921550,317
25108289,25195162,chr12,DNAI7,chr12:25108289-25195162,86873
148923639,149063163,chr5,SH3TC2,chr5:148923639-149063163,139524
44382298,44401608,chr19,ZNF285,chr19:44382298-44401608,19310
114854863,114995370,chr1,SYCP1,chr1:114854863-114995370,140507
99536636,99536730,chr8,MIR599,chr8:99536636-99536730,94
7459366,7484263,chr17,ZBTB4,chr17:7459366-7484263,24897
99536786,99536861,chr8,MIR875,chr8:99536786-99536861,75
99613783,99614081,chr8,RN7SL350P,chr8:99613783-99614081,298
99636529,99657828,chr4,C4orf54,chr4:99636529-99657828,21299
68509441,68517647,chr4,UGT2B29P,chr4:68509441-68517647,8206
68537173,68576413,chr4,UGT2B17,chr4:68537173-68576413,39240
58265365,58298134,chr14,PSMA3-AS1,chr14:58265365-58298134,32769
9827892,9830115,chr19,UBL5,chr19:9827892-9830115,2223
46243606,46245044,chr17,MAPK8IP1P1,chr17:46243606-46245044,1438
99873200,99893707,chr8,COX6C,chr8:99873200-99893707,20507
67148104,67150998,chr16,B3GNT9,chr16:67148104-67150998,2894
46274784,46361797,chr17,ARL17B,chr17:46274784-46361797,87013
67154185,67159909,chr16,TRADD,chr16:67154185-67159909,5724
68646597,68670652,chr4,UGT2B15,chr4:68646597-68670652,24055
41837775,41848147,chr15,PLA2G4B,chr15:41837775-41848147,10372
67159932,67164570,chr16,FBXL8,chr16:67159932-67164570,4638
193241128,193277738,chr3,PLAAT1,chr3:193241128-193277738,36610
1712858,1745171,chr4,TACC3,chr4:1712858-1745171,32313
812488,821955,chr19,PLPPR3,chr19:812488-821955,9467
31100117,31207804,chr14,HECTD1,chr14:31100117-31207804,107687
197298252,197303755,chr3,DLG1-AS1,chr3:197298252-197303755,5503
198119721,198120778,chr3,TUBB8P8,chr3:198119721-198120778,1057
46292733,46337794,chr17,LRRC37A,chr17:46292733-46337794,45061
191461163,191461456,chr3,PYDC2,chr3:191461163-191461456,293
55340032,55408510,chr15,CCPG1,chr15:55340032-55408510,68478
190680421,190699314,chr3,LINC02013,chr3:190680421-190699314,18893
86468257,86514357,chr8,RMDN1,chr8:86468257-86514357,46100
197889077,197960142,chr3,IQCG,chr3:197889077-197960142,71065
67170154,67175735,chr16,NOL3,chr16:67170154-67175735,5581
85504776,85594156,chr6,SNX14,chr6:85504776-85594156,89380
16197854,16245906,chr19,AP1M1,chr19:16197854-16245906,48052
50444128,50542535,chr7,FIGNL1,chr7:50444128-50542535,98407
151197949,151249536,chr1,PIP5K1A,chr1:151197949-151249536,51587
67175599,67184040,chr16,KIAA0895L,chr16:67175599-67184040,8441
149872968,149891204,chr7,ATP6V0E2,chr7:149872968-149891204,18236
46319679,46319959,chr17,RN7SL656P,chr17:46319679-46319959,280
46372855,46487141,chr17,NSFP1,chr17:46372855-46487141,114286
46503946,46509339,chr17,RDM1P2,chr17:46503946-46509339,5393
46516702,46579691,chr17,ARL17A,chr17:46516702-46579691,62989
160931778,160938626,chr5,LINC02159,chr5:160931778-160938626,6848
77975149,78029515,chr10,POLR3A,chr10:77975149-78029515,54366
198110112,198111878,chr3,FRG2FP,chr3:198110112-198111878,1766
161547063,161702593,chr5,GABRA6,chr5:161547063-161702593,155530
51993652,52020363,chr4,LRRC66,chr4:51993652-52020363,26711
27739331,27844564,chr7,TAX1BP1,chr7:27739331-27844564,105233
77511753,77611834,chr4,CXCL13,chr4:77511753-77611834,100081
195514428,195543386,chr3,PPP1R2,chr3:195514428-195543386,28958
67184379,67190185,chr16,EXOC3L1,chr16:67184379-67190185,5806
46537534,46537814,chr17,RN7SL199P,chr17:46537534-46537814,280
46558830,46562795,chr17,FAM215B,chr17:46558830-46562795,3965
188091272,188109603,chr4,TRIML2,chr4:188091272-188109603,18331
19188016,19188714,chr17,SNORD3A,chr17:19188016-19188714,698
56630176,56734086,chr15,ZNF280D,chr15:56630176-56734086,103910
19189665,19190245,chr17,SNORD3C,chr17:19189665-19190245,580
25195216,25209645,chr12,ETFRF1,chr12:25195216-25209645,14429
19208584,19211359,chr17,KYNUP3,chr17:19208584-19211359,2775
161751448,161751768,chr5,GLRXP3,chr5:161751448-161751768,320
19296596,19306261,chr17,EPN2-AS1,chr17:19296596-19306261,9665
19344506,19344574,chr17,MIR1180,chr17:19344506-19344574,68
122129546,122153569,chr5,ZNF474,chr5:122129546-122153569,24023
19377721,19383544,chr17,MAPK7,chr17:19377721-19383544,5823
122154496,122156015,chr5,ZNF474-AS1,chr5:122154496-122156015,1519
86481754,86483002,chr8,NTAN1P2,chr8:86481754-86483002,1248
86503591,86505061,chr8,SLC2A3P4,chr8:86503591-86505061,1470
194005259,194071025,chr3,LINC02028,chr3:194005259-194071025,65766
1438358,1440495,chr19,RPS15,chr19:1438358-1440495,2137
122436497,122479087,chr5,MGC32805,chr5:122436497-122479087,42590
86514435,86561498,chr8,CPNE3,chr8:86514435-86561498,47063
63167221,63521850,chr10,JMJD1C,chr10:63167221-63521850,354629
25404288,25404428,chr12,RNU4-67P,chr12:25404288-25404428,140
25435581,25436238,chr12,FAM133GP,chr12:25435581-25436238,657
25440875,25441052,chr12,TUBB4BP1,chr12:25440875-25441052,177
81087370,81215222,chr4,PRKG2,chr4:81087370-81215222,127852
27762427,27780236,chr12,MANSC4,chr12:27762427-27780236,17809
67192155,67198918,chr16,E2F4,chr16:67192155-67198918,6763
122311354,122464219,chr5,SNCAIP,chr5:122311354-122464219,152865
70671918,70672856,chr12,FAHD2P1,chr12:70671918-70672856,938
109097597,109110992,chr12,UNG,chr12:109097597-109110992,13395
117863485,117929621,chr1,GDAP2,chr1:117863485-117929621,66136
67199111,67204029,chr16,ELMO3,chr16:67199111-67204029,4918
45162928,45178237,chr19,TRAPPC6A,chr19:45162928-45178237,15309
196431385,196432530,chr3,UBXN7-AS1,chr3:196431385-196432530,1145
196468783,196503768,chr3,RNF168,chr3:196468783-196503768,34985
19383442,19387190,chr17,MFAP4,chr17:19383442-19387190,3748
196316082,196338373,chr3,TM4SF19-DYNLT2B,chr3:196316082-196338373,22291
61200326,62078335,chr4,ADGRL3,chr4:61200326-62078335,878009
197505262,197506986,chr3,LINC02012,chr3:197505262-197506986,1724
150321479,150353233,chr1,PRPF3,chr1:150321479-150353233,31754
198153287,198222513,chr3,FAM157A,chr3:198153287-198222513,69226
109277978,109309284,chr12,FOXN4,chr12:109277978-109309284,31306
196197452,196211437,chr3,ZDHHC19,chr3:196197452-196211437,13985
34926903,34945170,chr19,ZNF30,chr19:34926903-34945170,18267
86593755,86594589,chr8,MIOXP1,chr8:86593755-86594589,834
86660525,86661922,chr8,UBE2Q2P10,chr8:86660525-86661922,1397
4945277,4945383,chr2,RNU6-649P,chr2:4945277-4945383,106
9740643,9740783,chr2,RNU4-73P,chr2:9740643-9740783,140
6650373,6650439,chr2,MIR7515,chr2:6650373-6650439,66
10744186,10744249,chr2,RNU7-138P,chr2:10744186-10744249,63
10815485,10815546,chr2,RNU7-176P,chr2:10815485-10815546,61
11517397,11517503,chr2,RNA5SP84,chr2:11517397-11517503,106
11540605,11540677,chr2,MIR4429,chr2:11540605-11540677,72
11561194,11561306,chr2,RNU2-13P,chr2:11561194-11561306,112
11584773,11585047,chr2,RN7SL674P,chr2:11584773-11585047,274
7576841,7576971,chr2,RNU6ATAC37P,chr2:7576841-7576971,130
1049538,1132384,chr10,WDR37,chr10:1049538-1132384,82846
86657388,86660293,chr8,GOLGA2P1,chr8:86657388-86660293,2905
8011782,8017011,chr8,FAM90A11P,chr8:8011782-8017011,5229
15950689,15950981,chr2,RN7SL104P,chr2:15950689-15950981,292
17122841,17123140,chr2,RN7SKP168,chr2:17122841-17123140,299
15864935,15865051,chr2,RNU5E-7P,chr2:15864935-15865051,116
11767444,11767525,chr2,MIR548S,chr2:11767444-11767525,81
5974662,5974732,chr2,MIR7158,chr2:5974662-5974732,70
8019429,8024652,chr8,FAM90A24P,chr8:8019429-8024652,5223
20175346,20175639,chr2,RN7SL140P,chr2:20175346-20175639,293
143052341,143053282,chr7,OR6V1,chr7:143052341-143053282,941
14274622,14274725,chr2,RNU6-1288P,chr2:14274622-14274725,103
143935233,143936186,chr7,OR2F2,chr7:143935233-143936186,953
20175805,20175909,chr2,RNU6-961P,chr2:20175805-20175909,104
144109583,144110539,chr7,OR2A2,chr7:144109583-144110539,956
109347903,109455523,chr12,MYO1H,chr12:109347903-109455523,107620
7141227,7141544,chr2,RN7SKP112,chr2:7141227-7141544,317
22861552,22861884,chr2,RN7SKP27,chr2:22861552-22861884,332
86643909,86864879,chr7,GRM3,chr7:86643909-86864879,220970
18583367,18583468,chr2,RNU6-1215P,chr2:18583367-18583468,101
8027077,8032305,chr8,FAM90A12P,chr8:8027077-8032305,5228
11836933,11836986,chr2,MIR4262,chr2:11836933-11836986,53
12199130,12199201,chr2,MIR3681,chr2:12199130-12199201,71
19348429,19348505,chr2,MIR4757,chr2:19348429-19348505,76
12411398,12411501,chr2,RNU6-843P,chr2:12411398-12411501,103
8039978,8040953,chr8,OR7E96P,chr8:8039978-8040953,975
24564630,24564738,chr2,RNA5SP88,chr2:24564630-24564738,108
12737367,12737444,chr2,MIR3125,chr2:12737367-12737444,77
21922993,21923288,chr2,RN7SL117P,chr2:21922993-21923288,295
22338886,22339003,chr2,RNA5SP87,chr2:22338886-22339003,117
63573195,63616883,chr11,PLAAT3,chr11:63573195-63616883,43688
23996795,23997085,chr2,RN7SL610P,chr2:23996795-23997085,290
28683976,28684083,chr2,RNA5SP89,chr2:28683976-28684083,107
197668867,197749727,chr3,RUBCN,chr3:197668867-197749727,80860
27996367,27996449,chr2,MIR4263,chr2:27996367-27996449,82
30187434,30187566,chr2,SNORA10B,chr2:30187434-30187566,132
24045835,24045938,chr2,RNU6-370P,chr2:24045835-24045938,103
31228312,31228410,chr2,RNA5SP90,chr2:31228312-31228410,98
35471605,35471708,chr2,RNU6-1117P,chr2:35471605-35471708,103
34254552,34355566,chr19,GARRE1,chr19:34254552-34355566,101014
67202321,67202395,chr16,MIR328,chr16:67202321-67202395,74
35471405,35471486,chr2,MIR548AD,chr2:35471405-35471486,81
8088941,8089089,chr8,MIR548I3,chr8:8088941-8089089,148
34809233,34809556,chr2,RN7SL602P,chr2:34809233-34809556,323
8095946,8096726,chr8,RPS3AP31,chr8:8095946-8096726,780
36867398,36867495,chr2,RNU6-577P,chr2:36867398-36867495,97
41871271,41871388,chr2,RNU4-63P,chr2:41871271-41871388,117
8116745,8116949,chr8,SNRPCP17,chr8:8116745-8116949,204
45569199,45569492,chr2,RN7SL414P,chr2:45569199-45569492,293
33285769,33285887,chr2,RNA5SP91,chr2:33285769-33285887,118
8154308,8216916,chr8,ENPP7P1,chr8:8154308-8216916,62608
67227103,67229278,chr16,TMEM208,chr16:67227103-67229278,2175
126283065,126298845,chr11,TIRAP,chr11:126283065-126298845,15780
33332898,33333007,chr2,RNA5SP92,chr2:33332898-33333007,109
19411125,19417276,chr17,RNF112,chr17:19411125-19417276,6151
29681027,29681323,chr2,RN7SL516P,chr2:29681027-29681323,296
8167819,8226614,chr8,FAM85B,chr8:8167819-8226614,58795
42712740,42712847,chr2,RNU6-137P,chr2:42712740-42712847,107
109354083,109359488,chr12,LINC01486,chr12:109354083-109359488,5405
38147415,38147521,chr2,RNU6-951P,chr2:38147415-38147521,106
48340687,48340826,chr2,RNU4-49P,chr2:48340687-48340826,139
55951654,55952014,chr2,RN7SKP208,chr2:55951654-55952014,360
86553977,86743675,chr8,CNGB3,chr8:86553977-86743675,189698
76461676,76505995,chr7,DTX2,chr7:76461676-76505995,44319
60640705,60641002,chr2,RN7SL361P,chr2:60640705-60641002,297
55982967,55983076,chr2,MIR217,chr2:55982967-55983076,109
109448655,109477359,chr12,KCTD10,chr12:109448655-109477359,28704
55988950,55989059,chr2,MIR216A,chr2:55988950-55989059,109
56000714,56000795,chr2,MIR216B,chr2:56000714-56000795,81
60387362,60387445,chr2,MIR4432,chr2:60387362-60387445,83
56235217,56235330,chr2,RNA5SP93,chr2:56235217-56235330,113
60384605,60384763,chr2,RNU1-32P,chr2:60384605-60384763,158
59647621,59647723,chr2,RNU6-508P,chr2:59647621-59647723,102
60998752,60998888,chr2,RNA5SP95,chr2:60998752-60998888,136
55499950,55500055,chr2,RNU6-634P,chr2:55499950-55500055,105
55456106,55456204,chr2,RNU6-221P,chr2:55456106-55456204,98
55014418,55014521,chr2,RNU6-433P,chr2:55014418-55014521,103
59694762,59694869,chr2,RNA5SP94,chr2:59694762-59694869,107
62205826,62205917,chr2,MIR5192,chr2:62205826-62205917,91
62491178,62491468,chr2,RN7SL18P,chr2:62491178-62491468,290
116739981,116742609,chr1,NEFHP1,chr1:116739981-116742609,2628
28913664,28913748,chr2,SNORD92,chr2:28913664-28913748,84
48501922,48502024,chr2,RNU6-282P,chr2:48501922-48502024,102
28927067,28927144,chr2,SNORD53,chr2:28927067-28927144,77
113905213,113914086,chr1,DCLRE1B,chr1:113905213-113914086,8873
54166944,54167007,chr2,RNU7-172P,chr2:54166944-54167007,63
28927983,28928060,chr2,SNORD53B,chr2:28927983-28928060,77
64817378,64817675,chr2,RN7SL341P,chr2:64817378-64817675,297
47359505,47359777,chr2,RN7SKP119,chr2:47359505-47359777,272
47377675,47377770,chr2,MIR559,chr2:47377675-47377770,95
60719640,60719741,chr2,RNU6-612P,chr2:60719640-60719741,101
45374176,45446119,chr10,ALOX5,chr10:45374176-45446119,71943
62262387,62262671,chr2,RN7SL51P,chr2:62262387-62262671,284
60911303,60911442,chr2,RNU4-51P,chr2:60911303-60911442,139
17824780,17848071,chr19,JAK3,chr19:17824780-17848071,23291
52702522,52702615,chr2,MIR4431,chr2:52702522-52702615,93
128934731,128943399,chr11,TP53AIP1,chr11:128934731-128943399,8668
49059603,49059658,chr2,MIR548BA,chr2:49059603-49059658,55
43408307,43408412,chr2,RNU6-958P,chr2:43408307-43408412,105
67229387,67247481,chr16,FHOD1,chr16:67229387-67247481,18094
49233794,49233899,chr2,RNU6-439P,chr2:49233794-49233899,105
43492032,43492313,chr2,RN7SL531P,chr2:43492032-43492313,281
71379755,71379858,chr2,RNU6-105P,chr2:71379755-71379858,103
117640812,117641639,chr1,VDAC2P3,chr1:117640812-117641639,827
101803509,101806887,chr15,OR4F6,chr15:101803509-101806887,3378
64525513,64525565,chr2,MIR4434,chr2:64525513-64525565,52
64578892,64578997,chr2,RNU6-100P,chr2:64578892-64578997,105
101812202,101820197,chr15,OR4F15,chr15:101812202-101820197,7995
66358249,66358328,chr2,MIR4778,chr2:66358249-66358328,79
76772909,76773045,chr2,RNA5SP98,chr2:76772909-76773045,136
76445079,76445410,chr2,RN7SKP203,chr2:76445079-76445410,331
75090812,75090914,chr2,MIR5000,chr2:75090812-75090914,102
72721806,72722003,chr2,RNU2-39P,chr2:72721806-72722003,197
52109263,52112775,chr15,BCL2L10,chr15:52109263-52112775,3512
19419035,19424357,chr17,LINC02094,chr17:19419035-19424357,5322
78882447,78882552,chr2,RNU6-827P,chr2:78882447-78882552,105
185476496,185499057,chr3,TMEM41A,chr3:185476496-185499057,22561
81967079,81967374,chr2,RN7SL201P,chr2:81967079-81967374,295
19445970,19446852,chr17,RPS2P46,chr17:19445970-19446852,882
64906863,64907138,chr2,RN7SL211P,chr2:64906863-64907138,275
82268612,82268706,chr2,RNU6-685P,chr2:82268612-82268706,94
78882628,78882734,chr2,RNU6-812P,chr2:78882628-78882734,106
104153306,104153830,chr1,FTLP17,chr1:104153306-104153830,524
64994746,64994860,chr2,RNU6-548P,chr2:64994746-64994860,114
19496943,19497528,chr17,RPL17P43,chr17:19496943-19497528,585
60831664,60831929,chr2,RN7SL632P,chr2:60831664-60831929,265
146472566,146914294,chr1,HYDIN2,chr1:146472566-146914294,441728
62832342,62841809,chr11,WDR74,chr11:62832342-62841809,9467
48217575,48217899,chr2,RN7SKP224,chr2:48217575-48217899,324
85204926,85205032,chr2,RNU6-674P,chr2:85204926-85205032,106
8095900,8119047,chr17,ALOXE3,chr17:8095900-8119047,23147
76595413,76595678,chr2,RN7SKP164,chr2:76595413-76595678,265
55826922,55993660,chr15,NEDD4,chr15:55826922-55993660,166738
81496214,81496327,chr2,RNA5SP99,chr2:81496214-81496327,113
83657735,83657842,chr2,RNU6-1312P,chr2:83657735-83657842,107
87629755,87629834,chr2,MIR4435-1,chr2:87629755-87629834,79
103556545,103562657,chr14,BAG5,chr14:103556545-103562657,6112
70965584,70965867,chr2,RN7SL160P,chr2:70965584-70965867,283
88082519,88082599,chr2,MIR4780,chr2:88082519-88082599,80
86515204,86515308,chr2,RNU6-640P,chr2:86515204-86515308,104
87194786,87194859,chr2,MIR4771-1,chr2:87194786-87194859,73
22156913,22164479,chr8,SFTPC,chr8:22156913-22164479,7566
91674857,91674966,chr2,RNA5SP100,chr2:91674857-91674966,109
94846533,94846639,chr2,RNU6-1320P,chr2:94846533-94846639,106
55451004,55451099,chr2,RNU6-775P,chr2:55451004-55451099,95
95003545,95003843,chr2,RN7SL575P,chr2:95003545-95003843,298
97100587,97100874,chr2,RN7SL313P,chr2:97100587-97100874,287
101309450,101309534,chr2,MIR5696,chr2:101309450-101309534,84
190714811,190716399,chr3,CCT6P4,chr3:190714811-190716399,1588
98782410,98782548,chr2,RNU4-84P,chr2:98782410-98782548,138
88016354,88016547,chr2,RNU2-63P,chr2:88016354-88016547,193
96956708,96956815,chr2,RNA5SP101,chr2:96956708-96956815,107
97913054,97913117,chr2,RNU7-96P,chr2:97913054-97913117,63
195068284,195271159,chr3,XXYLT1,chr3:195068284-195271159,202875
101272936,101273049,chr2,SNORD89,chr2:101272936-101273049,113
103561896,103714249,chr14,KLC1,chr14:103561896-103714249,152353
43091388,43091494,chr2,RNU6-242P,chr2:43091388-43091494,106
114420125,114420302,chr2,RNU2-41P,chr2:114420125-114420302,177
109141490,109141588,chr2,MIR4265,chr2:109141490-109141588,98
109313571,109313625,chr2,MIR4266,chr2:109313571-109313625,54
113582959,113583096,chr2,MIR1302-3,chr2:113582959-113583096,137
119169822,119170115,chr2,RN7SL468P,chr2:119169822-119170115,293
98840675,98840736,chr2,RNU7-46P,chr2:98840675-98840736,61
111380291,111380571,chr1,HIGD1AP12,chr1:111380291-111380571,280
111771061,111771134,chr2,MIR4771-2,chr2:111771061-111771134,73
113681111,113681217,chr2,RNU6-744P,chr2:113681111-113681217,106
124989219,124989325,chr2,RNU6-259P,chr2:124989219-124989325,106
113086805,113086911,chr2,RNU6-1180P,chr2:113086805-113086911,106
65545401,65545696,chr2,RN7SL635P,chr2:65545401-65545696,295
117139715,117139775,chr2,RNU7-190P,chr2:117139715-117139775,60
115029826,115034302,chr1,TSHB,chr1:115029826-115034302,4476
126702839,126702942,chr2,RNU6-675P,chr2:126702839-126702942,103
113721290,113721368,chr2,MIR4782,chr2:113721290-113721368,78
118016385,118016669,chr2,RN7SL111P,chr2:118016385-118016669,284
111321013,111321086,chr2,MIR4435-2,chr2:111321013-111321086,73
65555432,65555534,chr2,VTRNA2-2P,chr2:65555432-65555534,102
127017421,127017482,chr2,RNU7-182P,chr2:127017421-127017482,61
123869256,123869570,chr2,RN7SKP102,chr2:123869256-123869570,314
109477402,109536705,chr12,UBE3B,chr12:109477402-109536705,59303
124932915,124933020,chr2,RNA5SP102,chr2:124932915-124933020,105
111930175,111930467,chr2,RN7SL297P,chr2:111930175-111930467,292
134127125,134127192,chr2,MIR3679,chr2:134127125-134127192,67
131602790,131602896,chr2,RNU6-617P,chr2:131602790-131602896,106
136390332,136390669,chr2,RN7SKP141,chr2:136390332-136390669,337
128445081,128445198,chr2,RNA5SP103,chr2:128445081-128445198,117
130497743,130497849,chr2,RNU6-473P,chr2:130497743-130497849,106
192796815,192917856,chr3,MB21D2,chr3:192796815-192917856,121041
134231195,134231312,chr2,RNA5SP104,chr2:134231195-134231312,117
138863597,138863895,chr2,RN7SKP286,chr2:138863597-138863895,298
132523617,132523936,chr2,RN7SKP103,chr2:132523617-132523936,319
81556887,81648465,chr17,NPLOC4,chr17:81556887-81648465,91578
140586626,140586685,chr2,MIR7157,chr2:140586626-140586685,59
151402724,151459494,chr1,POGZ,chr1:151402724-151459494,56770
141167257,141167357,chr2,RNU6-904P,chr2:141167257-141167357,100
147408342,147408448,chr2,RNU6-692P,chr2:147408342-147408448,106
140360194,140375141,chr5,SLC4A9,chr5:140360194-140375141,14947
127316873,127316979,chr2,RNU6-1147P,chr2:127316873-127316979,106
133333829,133333930,chr2,RNU6-579P,chr2:133333829-133333930,101
133391109,133391398,chr2,RN7SKP154,chr2:133391109-133391398,289
146145156,146145217,chr2,RNU7-2P,chr2:146145156-146145217,61
155330421,155330527,chr2,RNU6-546P,chr2:155330421-155330527,106
147713455,147713554,chr2,RNA5SP106,chr2:147713455-147713554,99
155089439,155089538,chr2,RNU6-1001P,chr2:155089439-155089538,99
157298807,157299158,chr2,RN7SKP281,chr2:157298807-157299158,351
154590407,154590528,chr2,RNA5SP107,chr2:154590407-154590528,121
160877547,160877850,chr2,RN7SL423P,chr2:160877547-160877850,303
133596091,133596399,chr2,RN7SKP93,chr2:133596091-133596399,308
159027036,159027142,chr2,RNU6-580P,chr2:159027036-159027142,106
161409554,161409670,chr2,RNA5SP108,chr2:161409554-161409670,116
163288995,163289096,chr2,RNU6-627P,chr2:163288995-163289096,101
139982684,139982986,chr2,RN7SL283P,chr2:139982684-139982986,302
158447166,158447461,chr2,RN7SL393P,chr2:158447166-158447461,295
157985789,157985894,chr2,RNU6-932P,chr2:157985789-157985894,105
159186835,159186901,chr2,MIR6888,chr2:159186835-159186901,66
147495438,147495540,chr2,RNU6-715P,chr2:147495438-147495540,102
93329971,93438487,chr11,DEUP1,chr11:93329971-93438487,108516
137512098,137512210,chr2,RNA5SP105,chr2:137512098-137512210,112
171856566,171856670,chr2,RNU6-182P,chr2:171856566-171856670,104
18140424,18543557,chr10,CACNB2,chr10:18140424-18543557,403133
57351271,57359898,chr19,ZNF304,chr19:57351271-57359898,8627
168451324,168451606,chr2,RN7SL813P,chr2:168451324-168451606,282
182048822,182048905,chr2,RNA5SP113,chr2:182048822-182048905,83
160407810,160407882,chr2,MIR4785,chr2:160407810-160407882,72
67237683,67272191,chr16,SLC9A5,chr16:67237683-67272191,34508
175167633,175167709,chr2,MIR933,chr2:175167633-175167709,76
181305593,181305652,chr2,MIR4437,chr2:181305593-181305652,59
184378975,184379044,chr2,MIR548AE1,chr2:184378975-184379044,69
189133036,189133111,chr2,MIR3129,chr2:189133036-189133111,75
195670372,195670474,chr2,RNU6-915P,chr2:195670372-195670474,102
188276732,188276844,chr2,RNA5SP114,chr2:188276732-188276844,112
188562238,188568666,chr3,LPP-AS1,chr3:188562238-188568666,6428
187122562,187122861,chr2,RN7SKP42,chr2:187122562-187122861,299
188297492,188297588,chr2,MIR561,chr2:188297492-188297588,96
187270698,187270804,chr2,RNU6-989P,chr2:187270698-187270804,106
176929985,176930090,chr2,RNU6-187P,chr2:176929985-176930090,105
196867856,196934714,chr3,SENP5,chr3:196867856-196934714,66858
191370938,191371044,chr2,RNU6-1045P,chr2:191370938-191371044,106
175022214,175022319,chr2,RNU6-763P,chr2:175022214-175022319,105
200373175,200373269,chr2,RNY4P34,chr2:200373175-200373269,94
24033405,24129968,chr19,ZNF254,chr19:24033405-24129968,96563
176600980,176601052,chr2,MIR1246,chr2:176600980-176601052,72
176664676,176664766,chr2,RNU6ATAC14P,chr2:176664676-176664766,90
196289409,196289707,chr2,RN7SL820P,chr2:196289409-196289707,298
182314284,182314544,chr2,RN7SL267P,chr2:182314284-182314544,260
207680533,207680639,chr2,RNU6-664P,chr2:207680533-207680639,106
168582943,168583018,chr2,MIR4774,chr2:168582943-168583018,75
205900630,205900958,chr2,RN7SKP178,chr2:205900630-205900958,328
168606390,168606496,chr2,RNU6-766P,chr2:168606390-168606496,106
208920547,208920664,chr2,RNA5SP117,chr2:208920547-208920664,117
199191059,199191120,chr2,RNU7-147P,chr2:199191059-199191120,61
209721913,209722021,chr2,RNA5SP118,chr2:209721913-209722021,108
212926257,212926336,chr2,MIR4776-1,chr2:212926257-212926336,79
213758067,213758159,chr2,MIR4438,chr2:213758067-213758159,92
207754807,207754881,chr2,MIR4775,chr2:207754807-207754881,74
179860836,179860908,chr2,MIR1258,chr2:179860836-179860908,72
212926257,212926336,chr2,MIR4776-2,chr2:212926257-212926336,79
175029769,175029877,chr2,RNU6-1290P,chr2:175029769-175029877,108
207109987,207110073,chr2,MIR2355,chr2:207109987-207110073,86
216793489,216793600,chr2,RNA5SP120,chr2:216793489-216793600,111
207166400,207166498,chr2,MIR7845,chr2:207166400-207166498,98
207269275,207269424,chr2,MIR1302-4,chr2:207269275-207269424,149
158935798,158935985,chr2,RNU2-21P,chr2:158935798-158935985,187
208054161,208054258,chr2,RNA5SP116,chr2:208054161-208054258,97
203782037,203782143,chr2,RNU6-474P,chr2:203782037-203782143,106
214846947,214847081,chr2,SNORA70I,chr2:214846947-214847081,134
223248498,223248794,chr2,RN7SL807P,chr2:223248498-223248794,296
228169743,228169849,chr2,RNU6-624P,chr2:228169743-228169849,106
219906502,219906565,chr2,MIR4268,chr2:219906502-219906565,63
226658710,226658793,chr2,MIR5702,chr2:226658710-226658793,83
230587121,230587227,chr2,RNU6-451P,chr2:230587121-230587227,106
206783234,206783308,chr2,MIR3130-1,chr2:206783234-206783308,74
106215763,106217218,chr8,SLC16A14P1,chr8:106215763-106217218,1455
206783234,206783308,chr2,MIR3130-2,chr2:206783234-206783308,74
211535653,211535769,chr2,RNA5SP119,chr2:211535653-211535769,116
212426263,212426360,chr2,MIR548F2,chr2:212426263-212426360,97
229236340,229236609,chr2,RN7SKP283,chr2:229236340-229236609,269
57921882,57935402,chr19,ZNF418,chr19:57921882-57935402,13520
208019638,208019741,chr2,RNU6-360P,chr2:208019638-208019741,103
230507101,230507386,chr2,RN7SL834P,chr2:230507101-230507386,285
106520474,106657548,chr8,OXR1-AS1,chr8:106520474-106657548,137074
236037250,236037311,chr2,RNU7-127P,chr2:236037250-236037311,61
236210373,236210548,chr2,RNU1-31P,chr2:236210373-236210548,175
143026200,143027132,chr7,OR9A2,chr7:143026200-143027132,932
236072295,236072556,chr2,RN7SL204P,chr2:236072295-236072556,261
106697427,106698013,chr8,TAGLN2P1,chr8:106697427-106698013,586
230752141,230752247,chr2,RNU6-268P,chr2:230752141-230752247,106
99876062,99877033,chr7,OR2AE1,chr7:99876062-99877033,971
240456001,240456089,chr2,MIR149,chr2:240456001-240456089,88
233205199,233205479,chr2,RN7SL32P,chr2:233205199-233205479,280
106729795,106729856,chr8,RNU7-84P,chr8:106729795-106729856,61
106759483,106770244,chr8,ABRA,chr8:106759483-106770244,10761
237015204,237015305,chr2,RNU6-1051P,chr2:237015204-237015305,101
63838928,63911020,chr11,MARK2,chr11:63838928-63911020,72092
128954180,129055173,chr7,TNPO3,chr7:128954180-129055173,100993
241477905,241477982,chr2,MIR3133,chr2:241477905-241477982,77
241584968,241585075,chr2,RNA5SP122,chr2:241584968-241585075,107
222498291,222498398,chr2,RNU6-619P,chr2:222498291-222498398,107
238412642,238412745,chr2,RNU6-234P,chr2:238412642-238412745,103
195514036,195514142,chr2,RNU6-169P,chr2:195514036-195514142,106
10911934,10914225,chr2,KCNF1,chr2:10911934-10914225,2291
81637171,81648749,chr17,TSPAN10,chr17:81637171-81648749,11578
28494205,28574267,chr8,FZD3,chr8:28494205-28574267,80062
189956728,190122437,chr3,P3H2,chr3:189956728-190122437,165709
11102142,11102997,chr2,RPL6P4,chr2:11102142-11102997,855
67289428,67326760,chr16,KCTD19,chr16:67289428-67326760,37332
51745172,51804110,chr19,FPR1,chr19:51745172-51804110,58938
81650459,81663112,chr17,PDE6G,chr17:81650459-81663112,12653
11133128,11151317,chr2,C2orf50,chr2:11133128-11151317,18189
56595300,56626481,chr19,ZNF71,chr19:56595300-56626481,31181
28505116,28505182,chr8,MIR4288,chr8:28505116-28505182,66
28530411,28530519,chr8,RNA5SP259,chr8:28530411-28530519,108
11155198,11178870,chr2,SLC66A3,chr2:11155198-11178870,23672
28600469,28755599,chr8,EXTL3,chr8:28600469-28755599,155130
81665036,81666635,chr17,OXLD1,chr17:81665036-81666635,1599
37467585,37488652,chr19,ZNF570,chr19:37467585-37488652,21067
81666737,81673904,chr17,CCDC137,chr17:81666737-81673904,7167
197950190,197956610,chr3,RPL35A,chr3:197950190-197956610,6420
35738801,35742453,chr19,IGFLR1,chr19:35738801-35742453,3652
67321658,67321987,chr16,RN7SKP118,chr16:67321658-67321987,329
81693757,81693869,chr17,MIR6786,chr17:81693757-81693869,112
81703367,81707517,chr17,MRPL12,chr17:81703367-81707517,4150
67326798,67385204,chr16,LRRC36,chr16:67326798-67385204,58406
28690215,28702030,chr8,EXTL3-AS1,chr8:28690215-28702030,11815
11233988,11234094,chr2,RNU6-1081P,chr2:11233988-11234094,106
11308025,11308941,chr2,AIDAP1,chr2:11308025-11308941,916
81712236,81721016,chr17,SLC25A10,chr17:81712236-81721016,8780
11351627,11352118,chr2,PPIAP60,chr2:11351627-11352118,491
140397323,140397444,chr5,RNU4-14P,chr5:140397323-140397444,121
35742464,35745445,chr19,U2AF1L4,chr19:35742464-35745445,2981
195568705,195584033,chr3,APOD,chr3:195568705-195584033,15328
28767661,28890242,chr8,INTS9,chr8:28767661-28890242,122581
140401814,140539856,chr5,ANKHD1,chr5:140401814-140539856,138042
11444375,11466177,chr2,E2F6,chr2:11444375-11466177,21802
100962701,102081622,chr6,GRIK2,chr6:100962701-102081622,1118921
196554177,196568674,chr3,WDR53,chr3:196554177-196568674,14497
151207837,151210488,chr7,H2BE1,chr7:151207837-151210488,2651
81528377,81537130,chr17,FSCN2,chr17:81528377-81537130,8753
103100143,103100704,chr1,SOD2P1,chr1:103100143-103100704,561
150268200,150280916,chr1,C1orf54,chr1:150268200-150280916,12716
5306790,5425414,chr7,TNRC18,chr7:5306790-5425414,118624
195701618,195711643,chr3,SMBD1P,chr3:195701618-195711643,10025
198228194,198228376,chr3,SEPTIN14P3,chr3:198228194-198228376,182
75626845,75667189,chr17,RECQL5,chr17:75626845-75667189,40344
35745600,35747519,chr19,PSENEN,chr19:35745600-35747519,1919
67389809,67393518,chr16,TPPP3,chr16:67389809-67393518,3709
197960200,198043720,chr3,LMLN,chr3:197960200-198043720,83520
117929720,117966543,chr1,WDR3,chr1:117929720-117966543,36823
35748361,35754519,chr19,LIN37,chr19:35748361-35754519,6158
85650491,85678932,chr6,SNHG5,chr6:85650491-85678932,28441
67390691,67390850,chr16,RNU1-123P,chr16:67390691-67390850,159
67394152,67416833,chr16,ZDHHC1,chr16:67394152-67416833,22681
100969565,101018939,chr7,MUC12,chr7:100969565-101018939,49374
35754566,35758079,chr19,HSPB6,chr19:35754566-35758079,3513
35758143,35771028,chr19,PROSER3,chr19:35758143-35771028,12885
156033247,156034080,chr2,HEBP2P1,chr2:156033247-156034080,833
150149183,150164720,chr1,PLEKHO1,chr1:150149183-150164720,15537
37683766,37833788,chr7,GPR141,chr7:37683766-37833788,150022
67430652,67437553,chr16,HSD11B2,chr16:67430652-67437553,6901
156324437,156342348,chr2,NR4A2,chr2:156324437-156342348,17911
100400826,100428992,chr7,ZCWPW1,chr7:100400826-100428992,28166
29264989,29269822,chr15,NSMCE3,chr15:29264989-29269822,4833
28884483,29118315,chr15,APBA2,chr15:28884483-29118315,233832
28798142,28802085,chr8,INTS9-AS1,chr8:28798142-28802085,3943
67482571,67483547,chr16,AGRP,chr16:67482571-67483547,976
16094192,16095209,chr16,RPL17P40,chr16:16094192-16095209,1017
42271302,42332460,chr8,IKBKB,chr8:42271302-42332460,61158
16300159,16300242,chr16,MIR3179-2,chr16:16300159-16300242,83
16306370,16306434,chr16,MIR3670-2,chr16:16306370-16306434,64
16309879,16309966,chr16,MIR3180-2,chr16:16309879-16309966,87
16310341,16334190,chr16,PKD1P1,chr16:16310341-16334190,23849
121396754,121463508,chr1,LINC02798,chr1:121396754-121463508,66754
188947214,189325304,chr3,TPRG1,chr3:188947214-189325304,378090
118614333,118615646,chr1,PSMC1P12,chr1:118614333-118615646,1313
115976513,116070054,chr1,SLC22A15,chr1:115976513-116070054,93541
35799988,35813299,chr19,PRODH2,chr19:35799988-35813299,13311
143620952,143730410,chr7,TCAF2,chr7:143620952-143730410,109458
151156664,151170296,chr1,SCNM1,chr1:151156664-151170296,13632
185426249,185449826,chr4,C4orf47,chr4:185426249-185449826,23577
194708093,194826008,chr3,LINC01968,chr3:194708093-194826008,117915
16324588,16324654,chr16,MIR6511A2,chr16:16324588-16324654,66
16329305,16329364,chr16,MIR6770-2,chr16:16329305-16329364,59
16356224,16377507,chr16,PKD1P2,chr16:16356224-16377507,21283
16368876,16368942,chr16,MIR6511A3,chr16:16368876-16368942,66
69311350,69326939,chr16,VPS4A,chr16:69311350-69326939,15589
140401908,140549569,chr5,ANKHD1-EIF4EBP3,chr5:140401908-140549569,147661
45023147,45077185,chr15,SORD,chr15:45023147-45077185,54038
13099033,13103161,chr19,LYL1,chr19:13099033-13103161,4128
76532222,76532327,chr4,RNU6-145P,chr4:76532222-76532327,105
85659892,85660606,chr6,PKMP3,chr6:85659892-85660606,714
76573568,76573632,chr4,MIR4450,chr4:76573568-76573632,64
76575551,76575626,chr4,MIR548AH,chr4:76575551-76575626,75
85677589,85677658,chr6,SNORD50B,chr6:85677589-85677658,69
85735744,85735921,chr6,SMIM11P1,chr6:85735744-85735921,177
75646243,75647975,chr17,SMIM6,chr17:75646243-75647975,1732
107824563,107915047,chr4,SGMS2,chr4:107824563-107915047,90484
85751581,85751753,chr6,RNU4-72P,chr6:85751581-85751753,172
57117676,57139864,chr7,ZNF479,chr7:57117676-57139864,22188
193307244,193314362,chr3,ATP13A5-AS1,chr3:193307244-193314362,7118
109553715,109573580,chr12,MMAB,chr12:109553715-109573580,19865
85993021,85993159,chr6,RNU4-12P,chr6:85993021-85993159,138
16299112,16761491,chr6,ATXN1,chr6:16299112-16761491,462379
7640711,7968020,chr7,UMAD1,chr7:7640711-7968020,327309
188941715,188947639,chr3,TPRG1-AS1,chr3:188941715-188947639,5924
8206736,8262421,chr19,CERS4,chr19:8206736-8262421,55685
75667251,75708062,chr17,SAP30BP,chr17:75667251-75708062,40811
152302165,152325239,chr1,FLG,chr1:152302165-152325239,23074
69320140,69339583,chr16,COG8,chr16:69320140-69339583,19443
156435290,156613735,chr2,GPD2,chr2:156435290-156613735,178445
196347662,196432430,chr3,UBXN7,chr3:196347662-196432430,84768
110059870,110070672,chr1,ALX3,chr1:110059870-110070672,10802
135681231,135729258,chr7,SLC13A4,chr7:135681231-135729258,48027
117138229,117138609,chr1,RPS15AP9,chr1:117138229-117138609,380
115836377,115843917,chr1,NHLH2,chr1:115836377-115843917,7540
69326913,69330588,chr16,PDF,chr16:69326913-69330588,3675
122152331,122364167,chr4,KIAA1109,chr4:122152331-122364167,211836
182610674,182611414,chr3,RPL7L1P8,chr3:182610674-182611414,740
114392790,114511203,chr1,TRIM33,chr1:114392790-114511203,118413
198038321,198039234,chr3,LMLN-AS1,chr3:198038321-198039234,913
65111845,65116384,chr11,TM7SF2,chr11:65111845-65116384,4539
69337996,69343106,chr16,NIP7,chr16:69337996-69343106,5110
186842704,186858463,chr3,ADIPOQ,chr3:186842704-186858463,15759
140547662,140549576,chr5,EIF4EBP3,chr5:140547662-140549576,1914
45092650,45114172,chr15,DUOX2,chr15:45092650-45114172,21522
95504182,95504496,chr6,CYCSP17,chr6:95504182-95504496,314
193398967,193593111,chr3,ATP13A4,chr3:193398967-193593111,194144
95575183,95577450,chr6,MANEA-DT,chr6:95575183-95577450,2267
140563671,140563751,chr5,MIR6831,chr5:140563671-140563751,80
140581504,140582335,chr5,HAUS1P1,chr5:140581504-140582335,831
7481094,7482594,chr6,HNRNPLP1,chr6:7481094-7482594,1500
140631728,140633701,chr5,CD14,chr5:140631728-140633701,1973
7541617,7586714,chr6,DSP,chr6:7541617-7586714,45097
43608456,43729717,chr7,COA1,chr7:43608456-43729717,121261
140638740,140647771,chr5,NDUFA2,chr5:140638740-140647771,9031
69343250,69351786,chr16,TMED6,chr16:69343250-69351786,8536
69355567,69408571,chr16,TERF2,chr16:69355567-69408571,53004
109567975,109568115,chr12,RNU4-32P,chr12:109567975-109568115,140
140647844,140647926,chr5,MIR3655,chr5:140647844-140647926,82
140670794,140673576,chr5,DND1,chr5:140670794-140673576,2782
109573255,109598125,chr12,MVK,chr12:109573255-109598125,24870
140691430,140699305,chr5,HARS2,chr5:140691430-140699305,7875
45114326,45118421,chr15,DUOXA2,chr15:45114326-45118421,4095
8302127,8308358,chr19,CD320,chr19:8302127-8308358,6231
123925237,123971414,chr7,SPAM1,chr7:123925237-123971414,46177
121118195,121118610,chr1,H3P4,chr1:121118195-121118610,415
8308768,8321375,chr19,NDUFA7,chr19:8308768-8321375,12607
152168125,152445456,chr1,FLG-AS1,chr1:152168125-152445456,277331
45129933,45165576,chr15,DUOX1,chr15:45129933-45165576,35643
69565808,69565868,chr16,MIR1538,chr16:69565808-69565868,60
155449184,155457753,chr3,PLCH1-AS1,chr3:155449184-155457753,8569
155485803,155487121,chr3,PLCH1-AS2,chr3:155485803-155487121,1318
172225428,172225872,chr3,RPS27AP8,chr3:172225428-172225872,444
193993331,193993985,chr3,DPPA2P3,chr3:193993331-193993985,654
155657760,155658612,chr3,RPL6P7,chr3:155657760-155658612,852
89088375,89164121,chr16,ACSF3,chr16:89088375-89164121,75746
190852737,190892429,chr3,GMNC,chr3:190852737-190892429,39692
27106184,27152583,chr7,HOXA3,chr7:27106184-27152583,46399
8321158,8323340,chr19,RPS28,chr19:8321158-8323340,2182
196506879,196515346,chr3,SMCO1,chr3:196506879-196515346,8467
7590198,7611967,chr6,SNRNP48,chr6:7590198-7611967,21769
156655224,156695659,chr2,LINC01958,chr2:156655224-156695659,40435
2679522,2775500,chr7,AMZ1,chr7:2679522-2775500,95978
156777706,156778372,chr2,RPLP0P7,chr2:156777706-156778372,666
154676588,154677119,chr3,RPL9P15,chr3:154676588-154677119,531
186046314,186110318,chr3,ETV5,chr3:186046314-186110318,64004
11372612,11403175,chr2,LINC00570,chr2:11372612-11403175,30563
41921499,41933046,chr6,BYSL,chr6:41921499-41933046,11547
190553264,190553480,chr2,RN7SKP179,chr2:190553264-190553480,216
8363289,8374370,chr19,ANGPTL4,chr19:8363289-8374370,11081
190646746,190692766,chr2,NAB1,chr2:190646746-190692766,46020
64228474,64266931,chr7,ZNF679,chr7:64228474-64266931,38457
148808181,149048286,chr1,PDE4DIP,chr1:148808181-149048286,240105
18120955,18138488,chr11,MRGPRX3,chr11:18120955-18138488,17533
59358895,59371714,chr11,OR5AN1,chr11:59358895-59371714,12819
64307459,64356634,chr7,ZNF736,chr7:64307459-64356634,49175
124183219,124188780,chr11,OR10D3,chr11:124183219-124188780,5561
41934934,42050357,chr6,CCND3,chr6:41934934-42050357,115423
4994851,5005536,chr11,OR51L1,chr11:4994851-5005536,10685
56354291,56361511,chr11,OR8J1,chr11:56354291-56361511,7220
64355078,64356199,chr7,TRIM60P18,chr7:64355078-64356199,1121
75721328,75757818,chr17,ITGB4,chr17:75721328-75757818,36490
123902167,123909229,chr11,OR8D4,chr11:123902167-123909229,7062
64433830,64434592,chr7,YWHAEP1,chr7:64433830-64434592,762
55648327,55652854,chr11,OR4S2,chr11:55648327-55652854,4527
55662201,55666195,chr11,OR4C6,chr11:55662201-55666195,3994
64443802,64444742,chr7,VN1R40P,chr7:64443802-64444742,940
105546089,106060524,chr8,ZFPM2-AS1,chr8:105546089-106060524,514435
64469185,64470653,chr7,ZNF680P1,chr7:64469185-64470653,1468
95066919,95071225,chr11,SRSF8,chr11:95066919-95071225,4306
8389290,8389380,chr19,MIR4999,chr19:8389290-8389380,90
64500825,64501729,chr7,HNRNPCP7,chr7:64500825-64501729,904
8389981,8404434,chr19,RAB11B,chr19:8389981-8404434,14453
56103687,56107658,chr11,OR8H2,chr11:56103687-56107658,3971
64519878,64563075,chr7,ZNF680,chr7:64519878-64563075,43197
59511368,59520703,chr11,OR4D9,chr11:59511368-59520703,9335
155762617,155806278,chr3,C3orf33,chr3:155762617-155806278,43661
47418769,47426473,chr11,PSMC3,chr11:47418769-47426473,7704
105737280,105737765,chr8,RPL12P24,chr8:105737280-105737765,485
89159146,89164245,chr16,LINC00304,chr16:89159146-89164245,5099
64551498,64552066,chr7,BNIP3P42,chr7:64551498-64552066,568
106270144,106752694,chr8,OXR1,chr8:106270144-106752694,482550
89166383,89169147,chr16,LINC02138,chr16:89166383-89169147,2764
89171748,89195492,chr16,CDH15,chr16:89171748-89195492,23744
64678954,64687393,chr7,BNIP3P11,chr7:64678954-64687393,8439
64679064,64679176,chr7,MIR6839,chr7:64679064-64679176,112
109662863,109663183,chr12,RN7SKP250,chr12:109662863-109663183,320
64933273,64933616,chr7,VN1R42P,chr7:64933273-64933616,343
153162226,153170627,chr3,RAP2B,chr3:153162226-153170627,8401
190880821,190965552,chr2,GLS,chr2:190880821-190965552,84731
122471599,122501073,chr12,ZCCHC8,chr12:122471599-122501073,29474
150368189,150374044,chr7,REPIN1,chr7:150368189-150374044,5855
150077494,150080117,chr3,LINC01998,chr3:150077494-150080117,2623
8444767,8489114,chr19,HNRNPM,chr19:8444767-8489114,44347
186079170,186080947,chr3,ETV5-AS1,chr3:186079170-186080947,1777
143503275,143504273,chr3,GAPDHP47,chr3:143503275-143504273,998
188151206,188154057,chr3,LPP-AS2,chr3:188151206-188154057,2851
184561785,184582408,chr3,EPHB3,chr3:184561785-184582408,20623
89217703,89237141,chr16,ZNF778,chr16:89217703-89237141,19438
150368790,150398630,chr7,ZNF775,chr7:150368790-150398630,29840
57597531,57600927,chr3,ARF4-AS1,chr3:57597531-57600927,3396
143517123,143518229,chr3,ST13P15,chr3:143517123-143518229,1106
57571363,57598220,chr3,ARF4,chr3:57571363-57598220,26857
150379854,150383885,chr7,ZNF775-AS1,chr7:150379854-150383885,4031
16232506,16300806,chr16,NOMO3,chr16:16232506-16300806,68300
122503454,122527000,chr12,RSRC2,chr12:122503454-122527000,23546
150450630,150479393,chr7,GIMAP8,chr7:150450630-150479393,28763
140698680,140706686,chr5,ZMAT2,chr5:140698680-140706686,8006
150243916,150323725,chr7,ACTR3C,chr7:150243916-150323725,79809
42018408,42018514,chr6,RNU6-761P,chr6:42018408-42018514,106
46746933,46759506,chr6,ANKRD66,chr6:46746933-46759506,12573
140711275,140711373,chr5,VTRNA1-1,chr5:140711275-140711373,98
114055596,114343023,chr6,HS3ST5,chr6:114055596-114343023,287427
140718925,140719013,chr5,VTRNA1-2,chr5:140718925-140719013,88
140726158,140726246,chr5,VTRNA1-3,chr5:140726158-140726246,88
41072974,41102403,chr6,NFYA,chr6:41072974-41102403,29429
195094588,195096057,chr3,XXYLT1-AS1,chr3:195094588-195096057,1469
69471452,69472532,chr3,RBM43P1,chr3:69471452-69472532,1080
140786136,141012347,chr5,PCDHA1,chr5:140786136-141012347,226211
31337465,31340726,chr7,NEUROD6,chr7:31337465-31340726,3261
185506262,185552588,chr3,LIPH,chr3:185506262-185552588,46326
31687215,31708455,chr7,PPP1R17,chr7:31687215-31708455,21240
83067666,83171350,chr6,DOP1A,chr6:83067666-83171350,103684
190992639,190993567,chr2,RAB1AP1,chr2:190992639-190993567,928
31514090,31658720,chr7,ITPRID1,chr7:31514090-31658720,144630
191029576,191151596,chr2,STAT4,chr2:191029576-191151596,122020
140794852,141012347,chr5,PCDHA2,chr5:140794852-141012347,217495
170888418,170908644,chr3,EIF5A2,chr3:170888418-170908644,20226
36571985,36572212,chr15,COX6CP4,chr15:36571985-36572212,227
4126659,4127569,chr4,OR7E103P,chr4:4126659-4127569,910
140801028,141012347,chr5,PCDHA3,chr5:140801028-141012347,211319
36617089,36619265,chr15,LARP4P,chr15:36617089-36619265,2176
4143458,4150421,chr4,UNC93B4,chr4:4143458-4150421,6963
36626674,36627775,chr15,TPST2P1,chr15:36626674-36627775,1101
4156522,4157443,chr4,OR7E99P,chr4:4156522-4157443,921
4174319,4175238,chr4,OR7E43P,chr4:4174319-4175238,919
140806929,141012347,chr5,PCDHA4,chr5:140806929-141012347,205418
36798596,36818459,chr15,CSNK1A1P1,chr15:36798596-36818459,19863
4188726,4226929,chr4,OTOP1,chr4:4188726-4226929,38203
36972821,36972901,chr15,MIR8063,chr15:36972821-36972901,80
4235542,4248223,chr4,TMEM128,chr4:4235542-4248223,12681
195147871,195152790,chr3,XXYLT1-AS2,chr3:195147871-195152790,4919
2268498,2270588,chr11,ASCL2,chr11:2268498-2270588,2090
36579626,36810248,chr15,CDIN1,chr15:36579626-36810248,230622
183548735,183552326,chr3,KLHL6-AS1,chr3:183548735-183552326,3591
140821604,141012347,chr5,PCDHA5,chr5:140821604-141012347,190743
65084979,65089375,chr11,TMEM262,chr11:65084979-65089375,4396
193155456,193157208,chr3,VEZF1P1,chr3:193155456-193157208,1752
122527246,122626396,chr12,KNTC1,chr12:122527246-122626396,99150
4290251,4321786,chr4,ZBTB49,chr4:4290251-4321786,31535
123201927,123274136,chr3,SEC22A,chr3:123201927-123274136,72209
64942143,64942926,chr7,MTDHP1,chr7:64942143-64942926,783
140827958,141012347,chr5,PCDHA6,chr5:140827958-141012347,184389
5776165,5783355,chr11,OR52N5,chr11:5776165-5783355,7190
64990356,65006743,chr7,ERV3-1,chr7:64990356-65006743,16387
5999445,6006946,chr11,OR56A4,chr11:5999445-6006946,7501
65023204,65023310,chr7,RNU6-1229P,chr7:65023204-65023310,106
65038354,65074713,chr7,CCT6P3,chr7:65038354-65074713,36359
5128776,5138356,chr11,OR52A5,chr11:5128776-5138356,9580
124302831,124315099,chr11,OR8D1,chr11:124302831-124315099,12268
99532942,99536524,chr10,NKX2-3,chr10:99532942-99536524,3582
58402464,58406874,chr11,OR5B3,chr11:58402464-58406874,4410
116620953,116645143,chr10,PNLIPRP2,chr10:116620953-116645143,24190
75586918,75669038,chr11,MAP6,chr11:75586918-75669038,82120
65065999,65066132,chr7,SNORA22C,chr7:65065999-65066132,133
65070538,65070672,chr7,SNORA15B-1,chr7:65070538-65070672,134
65084103,65100232,chr7,GTF2IP14,chr7:65084103-65100232,16129
5146824,5154757,chr11,OR52A1,chr11:5146824-5154757,7933
59416969,59426413,chr11,OR5A2,chr11:59416969-59426413,9444
35930158,35930264,chr7,RNU6-1085P,chr7:35930158-35930264,106
35946294,35972587,chr7,SEPTIN7P3,chr7:35946294-35972587,26293
102869470,102901899,chr10,AS3MT,chr10:102869470-102901899,32429
4415742,4542346,chr4,STX18,chr4:4415742-4542346,126604
124036013,124041325,chr11,OR10G7,chr11:124036013-124041325,5312
5786471,5791265,chr11,OR52N1,chr11:5786471-5791265,4794
140834248,141012347,chr5,PCDHA7,chr5:140834248-141012347,178099
35971147,35971567,chr7,PPP1R14BP4,chr7:35971147-35971567,420
58421238,58428121,chr11,OR5B2,chr11:58421238-58428121,6883
111292719,111665750,chr3,CD96,chr3:111292719-111665750,373031
56469274,56473352,chr11,OR5M3,chr11:56469274-56473352,4078
140841187,141012347,chr5,PCDHA8,chr5:140841187-141012347,171160
124437445,124445696,chr11,OR8B8,chr11:124437445-124445696,8251
191121950,191122056,chr2,RNU6-959P,chr2:191121950-191122056,106
191174233,191174835,chr2,HMGB1P27,chr2:191174233-191174835,602
140847772,141012347,chr5,PCDHA9,chr5:140847772-141012347,164575
47705468,47705979,chr2,NME2P2,chr2:47705468-47705979,511
72754729,72794047,chr11,STARD10,chr11:72754729-72794047,39318
64870172,64930981,chr7,ZNF273,chr7:64870172-64930981,60809
140855883,141012347,chr5,PCDHA10,chr5:140855883-141012347,156464
6427143,6580301,chr10,PRKCQ,chr10:6427143-6580301,153158
47797826,47798091,chr2,RPL36AP15,chr2:47797826-47798091,265
47883455,47883909,chr2,RPS27AP7,chr2:47883455-47883909,454
8490056,8502640,chr19,PRAM1,chr19:8490056-8502640,12584
47939738,47940218,chr2,PPIAP62,chr2:47939738-47940218,480
46392291,46394228,chr2,LINC01820,chr2:46392291-46394228,1937
23450658,23450722,chr7,RNU7-143P,chr7:23450658-23450722,64
46429190,46441833,chr2,LINC02583,chr2:46429190-46441833,12643
23490473,23491364,chr7,RPS2P32,chr7:23490473-23491364,891
23504780,23532041,chr7,TRA2A,chr7:23504780-23532041,27261
46448224,46448511,chr2,RN7SL817P,chr2:46448224-46448511,287
46479565,46484425,chr2,TMEM247,chr2:46479565-46484425,4860
8509678,8514167,chr19,ZNF414,chr19:8509678-8514167,4489
46490750,46542577,chr2,ATP6V1E2,chr2:46490750-46542577,51827
140861224,140863521,chr5,PCDHA14,chr5:140861224-140863521,2297
140868183,141012347,chr5,PCDHA11,chr5:140868183-141012347,144164
46541806,46584688,chr2,RHOQ,chr2:46541806-46584688,42882
26277609,26285638,chr6,H4C8,chr6:26277609-26285638,8029
30070266,30075849,chr6,RNF39,chr6:30070266-30075849,5583
107173200,107173809,chr8,HMGB1P46,chr8:107173200-107173809,609
48364367,48376377,chr19,SYNGR4,chr19:48364367-48376377,12010
4476121,4481700,chr4,STX18-IT1,chr4:4476121-4481700,5579
142964497,143060725,chr3,U2SURP,chr3:142964497-143060725,96228
72587217,72587313,chr15,MIR630,chr15:72587217-72587313,96
4507078,4507777,chr4,RPS7P15,chr4:4507078-4507777,699
29099490,29102701,chr6,OR2J1,chr6:29099490-29102701,3211
4348140,4419058,chr4,NSG1,chr4:4348140-4419058,70918
141391995,141432454,chr8,PTP4A3,chr8:141391995-141432454,40459
72608481,72636962,chr15,LINC02259,chr15:72608481-72636962,28481
29457155,29464328,chr6,OR2H1,chr6:29457155-29464328,7173
48382575,48391551,chr19,KDELR1,chr19:48382575-48391551,8976
23585062,23586355,chr7,CLK2P1,chr7:23585062-23586355,1293
72664577,72664799,chr15,RN7SL853P,chr15:72664577-72664799,222
23597382,23644708,chr7,CCDC126,chr7:23597382-23644708,47326
46568256,46580238,chr2,RHOQ-AS1,chr2:46568256-46580238,11982
72675798,72686182,chr15,HIGD2B,chr15:72675798-72686182,10384
140875302,141012347,chr5,PCDHA12,chr5:140875302-141012347,137045
46580937,46617055,chr2,PIGF,chr2:46580937-46617055,36118
72686179,72738475,chr15,BBS4,chr15:72686179-72738475,52296
29170907,29175811,chr6,OR2J2,chr6:29170907-29175811,4904
48445841,48457022,chr19,GRWD1,chr19:48445841-48457022,11181
291630,351355,chr6,DUSP22,chr6:291630-351355,59725
23619333,23622826,chr7,FCF1P1,chr7:23619333-23622826,3493
56300005,56320776,chr8,SDR16C5,chr8:56300005-56320776,20771
23680130,23703249,chr7,FAM221A,chr7:23680130-23703249,23119
94879770,94896678,chr8,CCNE2,chr8:94879770-94896678,16908
104942866,104969366,chr11,CASP4,chr11:104942866-104969366,26500
140882124,141012347,chr5,PCDHA13,chr5:140882124-141012347,130223
48455574,48466980,chr19,KCNJ14,chr19:48455574-48466980,11406
46616416,46630176,chr2,CRIPT,chr2:46616416-46630176,13760
27110111,27155266,chr10,YME1L1,chr10:27110111-27155266,45155
122701293,122703357,chr12,HCAR2,chr12:122701293-122703357,2064
122714756,122716811,chr12,HCAR3,chr12:122714756-122716811,2055
54603211,54607131,chr4,LINC02260,chr4:54603211-54607131,3920
122726076,122730844,chr12,HCAR1,chr12:122726076-122730844,4768
75776434,75785893,chr17,H3-3B,chr17:75776434-75785893,9459
54657267,54740783,chr4,KIT,chr4:54657267-54740783,83516
48552172,48599425,chr19,SULT2B1,chr19:48552172-48599425,47253
122774526,122827528,chr12,CCDC62,chr12:122774526-122827528,53002
233545482,233547032,chr2,PPFIA1P1,chr2:233545482-233547032,1550
233585439,233586291,chr2,UGT1A12P,chr2:233585439-233586291,852
233603553,233604401,chr2,UGT1A11P,chr2:233603553-233604401,848
233647926,233649026,chr2,UGT1A13P,chr2:233647926-233649026,1100
233671898,233773300,chr2,UGT1A9,chr2:233671898-233773300,101402
48606742,48607714,chr19,SPACA4,chr19:48606742-48607714,972
140966470,141012347,chr5,PCDHAC2,chr5:140966470-141012347,45877
48615328,48619184,chr19,RPL18,chr19:48615328-48619184,3856
104994235,105023168,chr11,CASP5,chr11:104994235-105023168,28933
102579646,102616756,chr7,RASA4,chr7:102579646-102616756,37110
75784521,75784607,chr17,MIR4738,chr17:75784521-75784607,86
75784806,75825799,chr17,UNK,chr17:75784806-75825799,40993
141051374,141059346,chr5,PCDHB1,chr5:141051374-141059346,7972
233691607,233773300,chr2,UGT1A6,chr2:233691607-233773300,81693
171309248,171312139,chr5,TLX3,chr5:171309248-171312139,2891
122834453,122862961,chr12,HIP1R,chr12:122834453-122862961,28508
171359117,171359412,chr5,RN7SL339P,chr5:171359117-171359412,295
171365595,171367693,chr5,RPSAP71,chr5:171365595-171367693,2098
124962437,125092633,chr6,RNF217,chr6:124962437-125092633,130196
166086,167024,chr8,OR4F21,chr8:166086-167024,938
23701740,23706756,chr8,NKX2-6,chr8:23701740-23706756,5016
171366118,171366252,chr5,SNORA70J,chr5:171366118-171366252,134
171366299,171366611,chr5,RPL10P8,chr5:171366299-171366611,312
71841560,71844412,chr8,MSC,chr8:71841560-71844412,2852
171386656,171386760,chr5,MIR3912,chr5:171386656-171386760,104
171419647,171457626,chr5,FGF18,chr5:171419647-171457626,37979
489803,545781,chr8,TDRP,chr8:489803-545781,55978
104489231,104589258,chr8,LRP12,chr8:104489231-104589258,100027
75827225,75844552,chr17,UNC13D,chr17:75827225-75844552,17327
170105897,170109734,chr5,FOXI1,chr5:170105897-170109734,3837
105025443,105035250,chr11,CASP1,chr11:105025443-105035250,9807
170140664,170141940,chr5,KRT18P41,chr5:170140664-170141940,1276
170191579,170199141,chr5,LINC01187,chr5:170191579-170199141,7562
170232447,170252575,chr5,C5orf58,chr5:170232447-170252575,20128
124306189,124372701,chr8,TMEM65,chr8:124306189-124372701,66512
6575189,6623362,chr4,MAN2B2,chr4:6575189-6623362,48173
72782835,72798199,chr15,ADPGK-AS1,chr15:72782835-72798199,15364
72899399,72900260,chr15,NPM1P42,chr15:72899399-72900260,861
170374671,170389634,chr5,KCNMB1,chr5:170374671-170389634,14963
93740121,93740773,chr8,RBM12B-AS1,chr8:93740121-93740773,652
93741193,93744534,chr8,RBM12B-DT,chr8:93741193-93744534,3341
72751294,72785846,chr15,ADPGK,chr15:72751294-72785846,34552
30876421,30900156,chr6,DDR1,chr6:30876421-30900156,23735
48619291,48630717,chr19,SPHK2,chr19:48619291-48630717,11426
143417679,143419150,chr8,MAFA-AS1,chr8:143417679-143419150,1471
143419182,143430732,chr8,MAFA,chr8:143419182-143430732,11550
143437659,143541447,chr8,ZC3H3,chr8:143437659-143541447,103788
170246233,170297815,chr5,LCP2,chr5:170246233-170297815,51582
282689,282792,chr3,RNU6-1194P,chr3:282689-282792,103
2088933,2089211,chr3,RN7SKP144,chr3:2088933-2089211,278
8364529,8364648,chr3,RNU4ATAC17P,chr3:8364529-8364648,119
15873771,15873849,chr3,MIR563,chr3:15873771-15873849,78
14530982,14531088,chr3,RNU6-905P,chr3:14530982-14531088,106
11952788,11953085,chr3,RN7SL147P,chr3:11952788-11953085,297
1065580,1065875,chr3,RN7SL120P,chr3:1065580-1065875,295
19314848,19314931,chr3,MIR4791,chr3:19314848-19314931,83
20137565,20137641,chr3,MIR3135A,chr3:20137565-20137641,76
23641489,23641592,chr3,RNU6-788P,chr3:23641489-23641592,103
19996803,19996925,chr3,RNU4-85P,chr3:19996803-19996925,122
20268965,20269070,chr3,RNU6-822P,chr3:20268965-20269070,105
16933196,16933260,chr3,MIR3714,chr3:16933196-16933260,64
31161704,31161787,chr3,MIR466,chr3:31161704-31161787,83
32506283,32506389,chr3,MIR548AY,chr3:32506283-32506389,106
83044368,83044771,chr15,FABP5P8,chr15:83044368-83044771,403
20507644,20507756,chr3,RNU6-815P,chr3:20507644-20507756,112
14394648,14394757,chr3,RNA5SP124,chr3:14394648-14394757,109
35256840,35256946,chr3,RNU6-243P,chr3:35256840-35256946,106
33103008,33103306,chr3,RN7SL296P,chr3:33103008-33103306,298
83067335,83067415,chr15,MIR4515,chr15:83067335-83067415,80
92084987,92134803,chr7,CYP51A1,chr7:92084987-92134803,49816
31228715,31228847,chr3,RNA5SP127,chr3:31228715-31228847,132
233721522,233722065,chr2,RPL17P11,chr2:233721522-233722065,543
33491983,33492098,chr3,RNA5SP128,chr3:33491983-33492098,115
36685040,36685369,chr3,RN7SKP227,chr3:36685040-36685369,329
143542110,143542398,chr8,RN7SKP175,chr8:143542110-143542398,288
33414150,33414211,chr3,RNU7-110P,chr3:33414150-33414211,61
233742750,233744015,chr2,DNAJB3,chr2:233742750-233744015,1265
35744476,35744559,chr3,MIR128-2,chr3:35744476-35744559,83
37341649,37341766,chr3,RNA5SP129,chr3:37341649-37341766,117
37140327,37140430,chr3,RNU6-1301P,chr3:37140327-37140430,103
38303773,38303879,chr3,RNU6-235P,chr3:38303773-38303879,106
83107572,83144854,chr15,TM6SF1,chr15:83107572-83144854,37282
233747214,233748079,chr2,UGT1A2P,chr2:233747214-233748079,865
40498891,40499003,chr3,RNU5B-2P,chr3:40498891-40499003,112
143553207,143563062,chr8,GSDMD,chr8:143553207-143563062,9855
23613661,23613759,chr3,RNU6-922P,chr3:23613661-23613759,98
45034474,45034588,chr3,RNU5B-3P,chr3:45034474-45034588,114
41766615,41766919,chr3,RN7SKP58,chr3:41766615-41766919,304
37573151,37573213,chr3,RNU7-73P,chr3:37573151-37573213,62
233760270,233773300,chr2,UGT1A1,chr2:233760270-233773300,13030
72059034,72089032,chr10,SPOCK2,chr10:72059034-72089032,29998
36968191,36968316,chr3,RNU6ATAC4P,chr3:36968191-36968316,125
42221840,42221965,chr3,RNU4-78P,chr3:42221840-42221965,125
17664963,17665025,chr3,RNU7-10P,chr3:17664963-17665025,62
44861888,44861981,chr3,MIR564,chr3:44861888-44861981,93
50675080,50675163,chr3,MIR4787,chr3:50675080-50675163,83
122865330,122896127,chr12,VPS37B,chr12:122865330-122896127,30797
44071087,44071186,chr3,RNU6-367P,chr3:44071087-44071186,99
39138206,39138266,chr3,MIR6822,chr3:39138206-39138266,60
51611438,51611562,chr3,RNU6ATAC29P,chr3:51611438-51611562,124
52551846,52551943,chr3,RNU6-856P,chr3:52551846-52551943,97
57512450,57512555,chr3,RNU6-1181P,chr3:57512450-57512555,105
52560570,52560707,chr3,RNU6ATAC16P,chr3:52560570-52560707,137
57536252,57536358,chr3,RNU6-108P,chr3:57536252-57536358,106
52689248,52689315,chr3,SNORD19,chr3:52689248-52689315,67
52691378,52691453,chr3,SNORD19C,chr3:52691378-52691453,75
52692736,52692812,chr3,SNORD69,chr3:52692736-52692812,76
233833416,233854566,chr2,HJURP,chr2:233833416-233854566,21150
57619447,57619572,chr3,RNU6ATAC26P,chr3:57619447-57619572,125
144186083,144195879,chr7,ARHGEF35,chr7:144186083-144195879,9796
67225464,67225527,chr3,MIR4272,chr3:67225464-67225527,63
57548838,57548945,chr3,RNU6-483P,chr3:57548838-57548945,107
68882967,68883091,chr3,RNA5SP135,chr3:68882967-68883091,124
62796124,62796419,chr3,RN7SL863P,chr3:62796124-62796419,295
62814382,62814491,chr3,RNU6-139P,chr3:62814382-62814491,109
63545440,63545535,chr3,RNA5SP134,chr3:63545440-63545535,95
78115158,78115457,chr3,RN7SL647P,chr3:78115158-78115457,299
73241789,73241896,chr3,RNU6-1270P,chr3:73241789-73241896,107
39970125,39970266,chr3,RNU4-56P,chr3:39970125-39970266,141
73593940,73594002,chr3,RNU7-119P,chr3:73593940-73594002,62
73110992,73111182,chr3,RNU2-64P,chr3:73110992-73111182,190
77811741,77811844,chr3,RNU6-217P,chr3:77811741-77811844,103
48630030,48637379,chr19,DBP,chr19:48630030-48637379,7349
73027808,73027873,chr3,RNU7-19P,chr3:73027808-73027873,65
60617805,60617870,chr3,MIR548BB,chr3:60617805-60617870,65
40209005,40209304,chr3,RN7SL411P,chr3:40209005-40209304,299
62118300,62118510,chr3,RNU2-10P,chr3:62118300-62118510,210
52846463,52846552,chr3,MIR8064,chr3:52846463-52846552,89
75630763,75630858,chr3,MIR1324,chr3:75630763-75630858,95
86362132,86362474,chr3,RN7SKP284,chr3:86362132-86362474,342
50419781,50419899,chr3,RNA5SP131,chr3:50419781-50419899,118
64511755,64511857,chr3,RNU6-739P,chr3:64511755-64511857,102
122974580,122980043,chr12,OGFOD2,chr12:122974580-122980043,5463
71827177,71827471,chr3,RN7SL271P,chr3:71827177-71827471,294
70808350,70808452,chr3,RNU6-281P,chr3:70808350-70808452,102
78938009,78938292,chr3,RN7SL751P,chr3:78938009-78938292,283
87742543,87742649,chr3,RNU6-873P,chr3:87742543-87742649,106
92197498,92246166,chr7,KRIT1,chr7:92197498-92246166,48668
79507887,79507969,chr3,MIR3923,chr3:79507887-79507969,82
69048958,69049035,chr3,MIR3136,chr3:69048958-69049035,77
81509476,81509664,chr3,RNU2-28P,chr3:81509476-81509664,188
75738280,75738363,chr3,MIR4273,chr3:75738280-75738363,83
78161698,78161992,chr3,RN7SKP61,chr3:78161698-78161992,294
6648695,6673965,chr4,LINC02482,chr4:6648695-6673965,25270
96359964,96360039,chr3,MIR8060,chr3:96359964-96360039,75
86235321,86235424,chr3,RNU6-1129P,chr3:86235321-86235424,103
103524033,103524116,chr3,MIR548AB,chr3:103524033-103524116,83
99964314,99964398,chr3,MIR3921,chr3:99964314-99964398,84
109225129,109225227,chr3,RNU6-1236P,chr3:109225129-109225227,98
44114212,44114310,chr3,MIR138-1,chr3:44114212-44114310,98
110551845,110551965,chr3,RNU6ATAC15P,chr3:110551845-110551965,120
90184634,90184733,chr3,RNU6-712P,chr3:90184634-90184733,99
109602828,109602897,chr3,MIR4445,chr3:109602828-109602897,69
102755064,102755170,chr3,RNU6-461P,chr3:102755064-102755170,106
110550115,110550854,chr10,RPL7P35,chr10:110550115-110550854,739
48637946,48646187,chr19,CA11,chr19:48637946-48646187,8241
50227436,50227490,chr3,MIR5787,chr3:50227436-50227490,54
119341834,119341940,chr3,RNU6-1127P,chr3:119341834-119341940,106
115837870,115838159,chr3,RN7SL815P,chr3:115837870-115838159,289
75845699,75856507,chr17,WBP2,chr17:75845699-75856507,10808
116582552,116582830,chr3,RN7SL582P,chr3:116582552-116582830,278
110567684,110606048,chr10,SMC3,chr10:110567684-110606048,38364
103159960,103160124,chr3,RNU1-43P,chr3:103159960-103160124,164
113432118,113432200,chr3,MIR8076,chr3:113432118-113432200,82
121049640,121049715,chr3,MIR5682,chr3:121049640-121049715,75
116850277,116850367,chr3,MIR4447,chr3:116850277-116850367,90
116965112,116965227,chr3,RNU5E-8P,chr3:116965112-116965227,115
73092148,73092257,chr3,RNU6-557P,chr3:73092148-73092257,109
125058304,125058438,chr3,RNA5SP137,chr3:125058304-125058438,134
113632704,113632998,chr3,RN7SL767P,chr3:113632704-113632998,294
112112801,112112898,chr3,MIR567,chr3:112112801-112112898,97
6693878,6697170,chr4,S100P,chr4:6693878-6697170,3292
113594876,113594942,chr3,MIR4446,chr3:113594876-113594942,66
77092057,77092163,chr3,RNU6-386P,chr3:77092057-77092163,106
128141875,128141977,chr3,RNU6-823P,chr3:128141875-128141977,102
127575266,127575331,chr3,MIR6825,chr3:127575266-127575331,65
127587111,127587176,chr3,MIR7976,chr3:127587111-127587176,65
96608814,96608917,chr3,RNU6-1094P,chr3:96608814-96608917,103
6707701,6709865,chr4,MRFAP1L1,chr4:6707701-6709865,2164
127240968,127241074,chr3,RNU6-1047P,chr3:127240968-127241074,106
117544205,117544311,chr3,RNU6-1200P,chr3:117544205-117544311,106
233865437,233868444,chr2,MSL3P1,chr2:233865437-233868444,3007
125388934,125388997,chr3,RNU6-232P,chr3:125388934-125388997,63
123161794,123161879,chr3,MIR7110,chr3:123161794-123161879,85
6716174,6717664,chr4,BLOC1S4,chr4:6716174-6717664,1490
125151465,125151552,chr3,MIR5092,chr3:125151465-125151552,87
125119097,125119200,chr3,RNU6-230P,chr3:125119097-125119200,103
52690744,52690827,chr3,SNORD19B,chr3:52690744-52690827,83
136430084,136430183,chr3,RNU6-1284P,chr3:136430084-136430183,99
6781375,6884170,chr4,KIAA0232,chr4:6781375-6884170,102795
137518134,137518255,chr3,RNA5SP142,chr3:137518134-137518255,121
136721394,136721495,chr3,RNU6-789P,chr3:136721394-136721495,101
139584105,139584445,chr3,RN7SKP124,chr3:139584105-139584445,340
139609669,139609939,chr3,RN7SL724P,chr3:139609669-139609939,270
233917373,234019522,chr2,TRPM8,chr2:233917373-234019522,102149
153199700,153200017,chr3,RN7SL300P,chr3:153199700-153200017,317
141902924,141903030,chr3,RNU6-509P,chr3:141902924-141903030,106
126160283,126160445,chr3,RNU1-30P,chr3:126160283-126160445,162
140673035,140691537,chr5,HARS1,chr5:140673035-140691537,18502
155437538,155437823,chr3,RN7SL715P,chr3:155437538-155437823,285
144186905,144187020,chr3,RNA5SP144,chr3:144186905-144187020,115
48638071,48682245,chr19,SEC1P,chr19:48638071-48682245,44174
142145454,142145555,chr3,RNU6-425P,chr3:142145454-142145555,101
157930492,157930725,chr3,RN7SKP46,chr3:157930492-157930725,233
142407657,142407737,chr3,RNU6-1294P,chr3:142407657-142407737,80
142420205,142420369,chr3,RNU1-100P,chr3:142420205-142420369,164
107007568,107007670,chr3,RNU6-1308P,chr3:107007568-107007670,102
166670029,166670122,chr3,RN7SKP298,chr3:166670029-166670122,93
153471466,153471571,chr3,RNU6-901P,chr3:153471466-153471571,105
168475198,168475388,chr3,RNU2-20P,chr3:168475198-168475388,190
157017342,157017696,chr3,RN7SKP177,chr3:157017342-157017696,354
48695971,48705951,chr19,FUT2,chr19:48695971-48705951,9980
83112738,83207823,chr15,HDGFL3,chr15:83112738-83207823,95085
149525631,149525726,chr3,RNU6-1098P,chr3:149525631-149525726,95
163470205,163470266,chr3,RNU7-82P,chr3:163470205-163470266,61
170423103,170423162,chr3,MIR6828,chr3:170423103-170423162,59
171106664,171106759,chr3,MIR569,chr3:171106664-171106759,95
168551854,168551949,chr3,MIR551B,chr3:168551854-168551949,95
177503303,177503552,chr3,RN7SKP52,chr3:177503303-177503552,249
170149845,170149951,chr3,RNU6-315P,chr3:170149845-170149951,106
178007672,178007779,chr3,RNU6-1120P,chr3:178007672-178007779,107
172703124,172703225,chr3,RNU6-547P,chr3:172703124-172703225,101
169720187,169720293,chr3,RNU6-637P,chr3:169720187-169720293,106
194145674,194145971,chr3,RN7SL215P,chr3:194145674-194145971,297
48712725,48719725,chr19,MAMSTR,chr19:48712725-48719725,7000
164171471,164171556,chr3,MIR1263,chr3:164171471-164171556,85
176515103,176515151,chr3,MIR7977,chr3:176515103-176515151,48
6687448,6690544,chr4,LINC02481,chr4:6687448-6690544,3096
183451857,183451988,chr3,SNORA63D,chr3:183451857-183451988,131
171504245,171504351,chr3,RNU6-348P,chr3:171504245-171504351,106
174631823,174632064,chr3,RN7SKP40,chr3:174631823-174632064,241
2041995,2043964,chr4,C4orf48,chr4:2041995-2043964,1969
174057641,174057864,chr3,RN7SKP234,chr3:174057641-174057864,223
181968459,181968681,chr3,RN7SKP265,chr3:181968459-181968681,222
183258300,183258416,chr3,RNA5SP151,chr3:183258300-183258416,116
180581057,180581163,chr3,RNU6-486P,chr3:180581057-180581163,106
196341609,196341715,chr3,RNU6-910P,chr3:196341609-196341715,106
146996607,146996713,chr3,RNU6-505P,chr3:146996607-146996713,106
170994870,170995033,chr3,RNU1-70P,chr3:170994870-170995033,163
169166272,169167117,chr4,RPL6P12,chr4:169166272-169167117,845
195134506,195134580,chr3,MIR3137,chr3:195134506-195134580,74
189829922,189830009,chr3,MIR944,chr3:189829922-189830009,87
143566192,143572772,chr8,MROH6,chr8:143566192-143572772,6580
149917342,149917449,chr3,RNU6-720P,chr3:149917342-149917449,107
176763233,176763341,chr3,RNA5SP147,chr3:176763233-176763341,108
195146728,195147003,chr3,RN7SL36P,chr3:195146728-195147003,275
83255884,83284664,chr15,BNC1,chr15:83255884-83284664,28780
172796429,172796558,chr3,RNU4-4P,chr3:172796429-172796558,129
175369540,175369621,chr3,MIR4789,chr3:175369540-175369621,81
181813401,181813702,chr3,RN7SL703P,chr3:181813401-181813702,301
177126017,177126120,chr3,RNU6-681P,chr3:177126017-177126120,103
149779009,149779108,chr3,RNU6-507P,chr3:149779009-149779108,99
169369704,169612632,chr4,NEK1,chr4:169369704-169612632,242928
105063345,105071541,chr11,CASP1P2,chr11:105063345-105071541,8196
175397247,175397348,chr3,RNU6-1233P,chr3:175397247-175397348,101
195214787,195214893,chr3,RNU6-25P,chr3:195214787-195214893,106
105092469,105101431,chr11,CARD17,chr11:105092469-105101431,8962
175609479,175609613,chr3,RNU4-91P,chr3:175609479-175609613,134
183453814,183453944,chr3,SNORA63E,chr3:183453814-183453944,130
175767558,175767661,chr3,RNU6-1317P,chr3:175767558-175767661,103
197293878,197293948,chr3,MIR4797,chr3:197293878-197293948,70
190642163,190642503,chr3,RN7SKP296,chr3:190642163-190642503,340
105122661,105123339,chr11,CASP1P1,chr11:105122661-105123339,678
181822872,181822990,chr3,RNA5SP150,chr3:181822872-181822990,118
105194440,105194946,chr11,OR2AL1P,chr11:105194440-105194946,506
41691585,41691678,chr15,MIR626,chr15:41691585-41691678,93
157173918,157174040,chr3,RNA5SP146,chr3:157173918-157174040,122
198196746,198196849,chr3,RNU6-860P,chr3:198196746-198196849,103
11342776,11346518,chr19,TMEM205,chr19:11342776-11346518,3742
195523087,195523221,chr3,RNU6ATAC24P,chr3:195523087-195523221,134
129818932,129819033,chr3,RNY3P13,chr3:129818932-129819033,101
178429197,178429290,chr3,RNA5SP148,chr3:178429197-178429290,93
118994824,118998004,chr11,CENATAC-DT,chr11:118994824-118998004,3180
196393710,196393812,chr3,RNU6-1279P,chr3:196393710-196393812,102
197994601,197994709,chr3,RNU6-621P,chr3:197994601-197994709,108
197894507,197894613,chr3,RNU6-858P,chr3:197894507-197894613,106
188688781,188688866,chr3,MIR28,chr3:188688781-188688866,85
196397508,196397778,chr3,RN7SL434P,chr3:196397508-196397778,270
118998138,119015793,chr11,CENATAC,chr11:118998138-119015793,17655
41774434,41827855,chr15,MAPKBP1,chr15:41774434-41827855,53421
196399911,196400207,chr3,RN7SL738P,chr3:196399911-196400207,296
193740471,193740715,chr3,RN7SL447P,chr3:193740471-193740715,244
195699401,195699497,chr3,MIR570,chr3:195699401-195699497,96
198071311,198071417,chr3,RNU6-821P,chr3:198071311-198071417,106
197674496,197674576,chr3,MIR922,chr3:197674496-197674576,80
195553792,195554043,chr3,RN7SL73P,chr3:195553792-195554043,251
190165417,190165523,chr3,RNU6-1109P,chr3:190165417-190165523,106
172237326,172237591,chr3,RN7SL141P,chr3:172237326-172237591,265
180736405,180736703,chr3,RN7SL229P,chr3:180736405-180736703,298
100609601,100695479,chr3,ADGRG7,chr3:100609601-100695479,85878
68087897,68212017,chr10,MYPN,chr10:68087897-68212017,124120
143574785,143578649,chr8,NAPRT,chr8:143574785-143578649,3864
1153106,1221771,chr16,CACNA1H,chr16:1153106-1221771,68665
100665050,100665476,chr3,GMFBP1,chr3:100665050-100665476,426
169729470,169757944,chr4,HPF1,chr4:169729470-169757944,28474
100952627,100952733,chr3,RNU6-865P,chr3:100952627-100952733,106
148865296,148897203,chr3,CPA3,chr3:148865296-148897203,31907
119003012,119003446,chr11,RPL23AP64,chr11:119003012-119003446,434
75874164,75878581,chr17,TRIM47,chr17:75874164-75878581,4417
119015712,119018691,chr11,RPS25,chr11:119015712-119018691,2979
11344684,11354944,chr19,CCDC159,chr19:11344684-11354944,10260
168356735,168537786,chr4,DDX60L,chr4:168356735-168537786,181051
86666785,86736072,chr10,LDB3,chr10:86666785-86736072,69287
148985868,148987668,chr3,UBQLN4P1,chr3:148985868-148987668,1800
75880335,75896951,chr17,TRIM65,chr17:75880335-75896951,16616
148991408,149031775,chr3,GYG1,chr3:148991408-149031775,40367
123010667,123010728,chr12,MIR4304,chr12:123010667-123010728,61
123081384,123084744,chr12,PITPNM2-AS1,chr12:123081384-123084744,3360
119018763,119025454,chr11,TRAPPC4,chr11:119018763-119025454,6691
51848223,51852729,chr12,FIGNL2-DT,chr12:51848223-51852729,4506
140071312,140109274,chr5,MALINC1,chr5:140071312-140109274,37962
51888009,51891727,chr12,ANKRD33,chr12:51888009-51891727,3718
75898644,75905093,chr17,MRPL38,chr17:75898644-75905093,6449
131035092,131035262,chr2,SMIM39,chr2:131035092-131035262,170
131047876,131093460,chr2,FAM168B,chr2:131047876-131093460,45584
132186948,132205759,chr10,DPYSL4,chr10:132186948-132205759,18811
11374666,11376951,chr19,SWSAP1,chr19:11374666-11376951,2285
140107777,140125619,chr5,PURA,chr5:140107777-140125619,17842
11377207,11384342,chr19,EPOR,chr19:11377207-11384342,7135
51906908,51923361,chr12,ACVRL1,chr12:51906908-51923361,16453
131177618,131178946,chr2,NEK2P4,chr2:131177618-131178946,1328
131189834,131198007,chr2,NF1P8,chr2:131189834-131198007,8173
140125937,140129392,chr5,IGIP,chr5:140125937-140129392,3455
140175156,140282052,chr5,CYSTM1,chr5:140175156-140282052,106896
131201142,131202941,chr2,MED15P8,chr2:131201142-131202941,1799
69517667,69518400,chr4,UGT2A3P7,chr4:69517667-69518400,733
75941507,75979177,chr17,ACOX1,chr17:75941507-75979177,37670
131229607,131229713,chr2,RNU6-127P,chr2:131229607-131229713,106
119067374,119067698,chr11,VPS11-DT,chr11:119067374-119067698,324
131279290,131309068,chr2,FAR2P4,chr2:131279290-131309068,29778
119102198,119118544,chr11,C2CD2L,chr11:119102198-119118544,16346
140245035,140303113,chr5,PFDN1,chr5:140245035-140303113,58078
69588417,69639642,chr4,UGT2A2,chr4:69588417-69639642,51225
143597831,143603224,chr8,TIGD5,chr8:143597831-143603224,5393
76312997,76421868,chr4,CCDC158,chr4:76312997-76421868,108871
143603210,143609773,chr8,PYCR3,chr8:143603210-143609773,6563
131299220,131300444,chr2,KLF2P4,chr2:131299220-131300444,1224
36968383,37084372,chr2,HEATR5B,chr2:36968383-37084372,115989
149030127,149086554,chr3,HLTF,chr3:149030127-149086554,56427
11384341,11419328,chr19,RGL3,chr19:11384341-11419328,34987
132036336,132184858,chr10,JAKMIP3,chr10:132036336-132184858,148522
51951699,51997078,chr12,ACVR1B,chr12:51951699-51997078,45379
140332843,140346603,chr5,HBEGF,chr5:140332843-140346603,13760
143612618,143618048,chr8,GFUS,chr8:143612618-143618048,5430
112861188,112898371,chr5,SRP19,chr5:112861188-112898371,37183
89111533,89114901,chr4,TIGD2,chr4:89111533-89114901,3368
89130852,89130953,chr4,RNU6-907P,chr4:89130852-89130953,101
75979231,76005999,chr17,TEN1-CDK3,chr17:75979231-76005999,26768
26163455,26435131,chr4,RBPJ,chr4:26163455-26435131,271676
75979240,76000586,chr17,TEN1,chr17:75979240-76000586,21346
37148530,37149304,chr2,ARL14EPP1,chr2:37148530-37149304,774
37194382,37194737,chr2,RPL31P16,chr2:37194382-37194737,355
37196488,37216193,chr2,CEBPZOS,chr2:37196488-37216193,19705
52755053,52791078,chr15,ONECUT1,chr15:52755053-52791078,36025
51987657,51987763,chr12,RNU6-574P,chr12:51987657-51987763,106
52006946,52015889,chr12,TAMALIN,chr12:52006946-52015889,8943
76004502,76027306,chr17,EVPL,chr17:76004502-76027306,22804
119121580,119136059,chr11,HINFP,chr11:119121580-119136059,14479
44554818,44663688,chr15,SPG11,chr15:44554818-44663688,108870
37201612,37231596,chr2,CEBPZ,chr2:37201612-37231596,29984
112876385,112922289,chr5,REEP5,chr5:112876385-112922289,45904
52022832,52059507,chr12,NR4A1,chr12:52022832-52059507,36675
143636019,143656418,chr8,ZNF623,chr8:143636019-143656418,20399
119149052,119162653,chr11,ABCG4,chr11:119149052-119162653,13601
11420604,11435782,chr19,ODAD3,chr19:11420604-11435782,15178
37231631,37253403,chr2,NDUFAF7,chr2:37231631-37253403,21772
93754844,93819234,chr8,TMEM67,chr8:93754844-93819234,64390
76038775,76072517,chr17,SRP68,chr17:76038775-76072517,33742
112885094,112885745,chr5,XBP1P1,chr5:112885094-112885745,651
112891610,112893079,chr5,ZRSR2P1,chr5:112891610-112893079,1469
75068275,75236911,chr5,ANKRD31,chr5:75068275-75236911,168636
100345001,100520277,chr1,CDC14A,chr1:100345001-100520277,175276
149086332,149102823,chr3,HLTF-AS1,chr3:149086332-149102823,16491
149099499,149099815,chr3,MED28P2,chr3:149099499-149099815,316
149129638,149173732,chr3,HPS3,chr3:149129638-149173732,44094
90458209,90474771,chr5,MBLAC2,chr5:90458209-90474771,16562
11451326,11481046,chr19,ELAVL3,chr19:11451326-11481046,29720
119166568,119184016,chr11,NLRX1,chr11:119166568-119184016,17448
90471748,90514557,chr5,POLR3G,chr5:90471748-90514557,42809
1227272,1230184,chr16,TPSB2,chr16:1227272-1230184,2912
52058459,52059503,chr12,NR4A1AS,chr12:52058459-52059503,1044
49982190,50011654,chr10,AGAP6,chr10:49982190-50011654,29464
2384073,2401104,chr17,MNT,chr17:2384073-2401104,17031
103547751,103578947,chr12,LINC02401,chr12:103547751-103578947,31196
37250502,37324833,chr2,PRKD3,chr2:37250502-37324833,74331
11483427,11505839,chr19,ZNF653,chr19:11483427-11505839,22412
128463594,128472317,chr3,DNAJB8-AS1,chr3:128463594-128472317,8723
2405562,2511891,chr17,METTL16,chr17:2405562-2511891,106329
128479427,128493201,chr3,GATA2,chr3:128479427-128493201,13774
1240379,1242554,chr16,TPSAB1,chr16:1240379-1242554,2175
90515611,90529584,chr5,LYSMD3,chr5:90515611-90529584,13973
103587273,103766719,chr12,STAB2,chr12:103587273-103766719,179446
161907111,162001536,chr5,LINC01202,chr5:161907111-162001536,94425
45825594,45853875,chr10,AGAP4,chr10:45825594-45853875,28281
11538767,11550323,chr19,CNN1,chr19:11538767-11550323,11556
162000057,162162977,chr5,GABRG2,chr5:162000057-162162977,162920
128489212,128502970,chr3,GATA2-AS1,chr3:128489212-128502970,13758
2557753,2558094,chr17,RN7SL33P,chr17:2557753-2558094,341
2586330,2587866,chr17,EIF4A1P9,chr17:2586330-2587866,1536
2613284,2613944,chr17,SAMD11P1,chr17:2613284-2613944,660
128538020,128538631,chr3,TMED10P2,chr3:128538020-128538631,611
119296419,119304445,chr4,C4orf3,chr4:119296419-119304445,8026
2680958,2681236,chr17,RN7SL608P,chr17:2680958-2681236,278
128619969,128681075,chr3,RPN1,chr3:128619969-128681075,61106
2692861,2692919,chr17,MIR6776,chr17:2692861-2692919,58
2748078,2748182,chr17,MIR1253,chr17:2748078-2748182,104
2748078,2748182,chr17,hsa-mir-1253,chr17:2748078-2748182,104
119317250,119322138,chr4,FABP2,chr4:119317250-119322138,4888
2593210,2685615,chr17,PAFAH1B1,chr17:2593210-2685615,92405
119334329,119378233,chr4,KLHL2P1,chr4:119334329-119378233,43904
119367562,119367646,chr4,RNU4-33P,chr4:119367562-119367646,84
72879349,72951440,chr7,POM121,chr7:72879349-72951440,72091
37331770,37331876,chr2,RNU6-939P,chr2:37331770-37331876,106
119212587,119295518,chr4,USP53,chr4:119212587-119295518,82931
102245371,102382899,chr10,GBF1,chr10:102245371-102382899,137528
37342827,37373322,chr2,QPCT,chr2:37342827-37373322,30495
1256059,1259008,chr16,TPSD1,chr16:1256059-1259008,2949
57546026,57586633,chr12,KIF5A,chr12:57546026-57586633,40607
11551147,11559236,chr19,ELOF1,chr19:11551147-11559236,8089
27023737,27024907,chr7,TPM3P4,chr7:27023737-27024907,1170
119185457,119190223,chr11,PDZD3,chr11:119185457-119190223,4766
72103181,72104209,chr7,ABCF2P2,chr7:72103181-72104209,1028
72862757,72871581,chr7,SPDYE7P,chr7:72862757-72871581,8824
128674735,128677005,chr3,POU5F1P6,chr3:128674735-128677005,2270
73440406,73522293,chr7,BAZ1B,chr7:73440406-73522293,81887
128748538,128749489,chr3,MARK2P8,chr3:128748538-128749489,951
128572000,128576086,chr3,LINC01565,chr3:128572000-128576086,4086
1260952,1263845,chr16,PRSS29P,chr16:1260952-1263845,2893
88095408,88095968,chr3,CBX5P1,chr3:88095408-88095968,560
88149959,88168729,chr3,C3orf38,chr3:88149959-88168729,18770
1286351,1288837,chr16,TPSP2,chr16:1286351-1288837,2486
37435510,37435608,chr2,RNU6-1116P,chr2:37435510-37435608,98
88317156,88319022,chr3,ABCF2P1,chr3:88317156-88319022,1866
101414228,101414633,chr3,FAM136CP,chr3:101414228-101414633,405
1329078,1329777,chr16,RPS20P2,chr16:1329078-1329777,699
37641882,37738468,chr2,CDC42EP3,chr2:37641882-37738468,96586
101521891,101522979,chr3,FAM172BP,chr3:101521891-101522979,1088
11574660,11579008,chr19,ACP5,chr19:11574660-11579008,4348
101574180,101594465,chr3,PCNP,chr3:101574180-101594465,20285
1308880,1327018,chr16,UBE2I,chr16:1308880-1327018,18138
203259604,203259897,chr2,RN7SL670P,chr2:203259604-203259897,293
203315390,203315871,chr2,MRPL50P2,chr2:203315390-203315871,481
39287456,39366375,chr4,RFC1,chr4:39287456-39366375,78919
101599243,101599644,chr3,RPL32P7,chr3:101599243-101599644,401
55608043,55615878,chr12,OR6U2P,chr12:55608043-55615878,7835
101615826,101615928,chr3,RNU6-1256P,chr3:101615826-101615928,102
101662060,101662164,chr3,RNY1P12,chr3:101662060-101662164,104
101676475,101679217,chr3,ZBTB11-AS1,chr3:101676475-101679217,2742
55646195,55646663,chr12,OR10AE3P,chr12:55646195-55646663,468
55654558,55655168,chr12,PSMB3P1,chr12:55654558-55655168,610
101681091,101686718,chr3,RPL24,chr3:101681091-101686718,5627
203394345,203535335,chr2,RAPH1,chr2:203394345-203535335,140990
73507208,73507274,chr7,RNU6-1198P,chr7:73507208-73507274,66
73536356,73557690,chr7,BCL7B,chr7:73536356-73557690,21334
55720367,55724705,chr12,RDH5,chr12:55720367-55724705,4338
119206298,119313926,chr11,CBL,chr11:119206298-119313926,107628
11585246,11587135,chr19,GAPDHP76,chr19:11585246-11587135,1889
101724593,101770562,chr3,CEP97,chr3:101724593-101770562,45969
102621509,102622331,chr8,POU5F1P2,chr8:102621509-102622331,822
102648784,102655725,chr8,KLF10,chr8:102648784-102655725,6941
49388219,49417990,chr19,KASH5,chr19:49388219-49417990,29771
55725323,55729707,chr12,CD63,chr12:55725323-55729707,4384
110871188,110899922,chr1,CD53,chr1:110871188-110899922,28734
134170487,134171085,chr3,HMGB3P14,chr3:134170487-134171085,598
134313576,134321171,chr3,LINC02004,chr3:134313576-134321171,7595
134351852,134356561,chr3,RPL39P5,chr3:134351852-134356561,4709
134385197,134385494,chr3,HMGN1P9,chr3:134385197-134385494,297
134437605,134438211,chr3,HMGB3P13,chr3:134437605-134438211,606
102688317,102688906,chr8,ADI1P2,chr8:102688317-102688906,589
134599923,134651636,chr3,KY,chr3:134599923-134651636,51713
102805517,102810039,chr8,GASAL1,chr8:102805517-102810039,4522
73593194,73624543,chr7,MLXIPL,chr7:73593194-73624543,31349
102826111,102893864,chr8,AZIN1,chr8:102826111-102893864,67753
119289562,119289677,chr11,RNU6-262P,chr11:119289562-119289677,115
119308529,119321521,chr11,MCAM,chr11:119308529-119321521,12992
113125321,113126883,chr1,RLIMP2,chr1:113125321-113126883,1562
113856635,113901237,chr1,AP4B1-AS1,chr1:113856635-113901237,44602
150265399,150269580,chr1,APH1A,chr1:150265399-150269580,4181
108808725,109302752,chr4,COL25A1,chr4:108808725-109302752,494027
49422419,49423441,chr19,PTH2,chr19:49422419-49423441,1022
56871170,56871276,chr17,RNU6-1158P,chr17:56871170-56871276,106
56891270,56891355,chr17,MIR3614,chr17:56891270-56891355,85
56938199,56961050,chr17,COIL,chr17:56938199-56961050,22851
49429401,49442360,chr19,SLC17A7,chr19:49429401-49442360,12959
134780527,134780627,chr3,RNU6-1174P,chr3:134780527-134780627,100
134783436,134783555,chr3,RNA5SP141,chr3:134783436-134783555,119
10000647,10000940,chr3,CYCSP10,chr3:10000647-10000940,293
56978129,57006768,chr17,SCPEP1,chr17:56978129-57006768,28639
10057973,10058287,chr3,CYCSP11,chr3:10057973-10058287,314
10081317,10108255,chr3,FANCD2OS,chr3:10081317-10108255,26938
10115675,10127190,chr3,BRK1,chr3:10115675-10127190,11515
10164919,10243745,chr3,IRAK2,chr3:10164919-10243745,78826
49446298,49453497,chr19,PIH1D1,chr19:49446298-49453497,7199
119312950,119313012,chr11,MIR6756,chr11:119312950-119313012,62
10284419,10285746,chr3,LINC00852,chr3:10284419-10285746,1327
121502344,121503891,chr1,MTIF2P1,chr1:121502344-121503891,1547
67266473,67286556,chr11,GRK2,chr11:67266473-67286556,20083
152348735,152360006,chr1,FLG2,chr1:152348735-152360006,11271
10285666,10292947,chr3,GHRL,chr3:10285666-10292947,7281
121184811,121392874,chr1,SRGAP2C,chr1:121184811-121392874,208063
81426393,82044244,chr4,RASGEF1B,chr4:81426393-82044244,617851
117953590,118185228,chr1,SPAG17,chr1:117953590-118185228,231638
37085056,37085852,chr5,RPS4XP6,chr5:37085056-37085852,796
1333638,1349441,chr16,BAIAP3,chr16:1333638-1349441,15803
37130430,37130700,chr5,RBISP2,chr5:37130430-37130700,270
37209364,37212381,chr5,OFD1P17,chr5:37209364-37212381,3017
37246173,37246479,chr5,RN7SL37P,chr5:37246173-37246479,306
57045478,57046797,chr17,RNF126P1,chr17:57045478-57046797,1319
37327135,37327196,chr5,RNU7-75P,chr5:37327135-37327196,61
123400922,123402344,chr5,KRT8P33,chr5:123400922-123402344,1422
123468781,123469429,chr5,HMGB3P17,chr5:123468781-123469429,648
74453790,74602605,chr7,GTF2IRD1,chr7:74453790-74602605,148815
57085092,57121346,chr17,AKAP1,chr17:57085092-57121346,36254
123344890,123423592,chr5,CEP120,chr5:123344890-123423592,78702
74350069,74351009,chr2,NECAP1P2,chr2:74350069-74351009,940
74351134,74351419,chr2,TAF13P2,chr2:74351134-74351419,285
74385474,74393882,chr2,DCTN1-AS1,chr2:74385474-74393882,8408
49453225,49471050,chr19,ALDH16A1,chr19:49453225-49471050,17825
67289300,67302485,chr11,ANKRD13D,chr11:67289300-67302485,13185
74418122,74418442,chr2,HMGA1P8,chr2:74418122-74418442,320
52872982,53366066,chr4,SCFD2,chr4:52872982-53366066,493084
10285754,10294903,chr3,GHRLOS,chr3:10285754-10294903,9149
74421678,74425755,chr2,WDR54,chr2:74421678-74425755,4077
35948221,36244514,chr4,ARAP2,chr4:35948221-36244514,296293
10293131,10321112,chr3,SEC13,chr3:10293131-10321112,27981
150282543,150287093,chr1,CIART,chr1:150282543-150287093,4550
67303478,67312607,chr11,SSH3,chr11:67303478-67312607,9129
49474207,49486231,chr19,FLT3LG,chr19:49474207-49486231,12024
74425835,74442422,chr2,RTKN,chr2:74425835-74442422,16587
57255851,57684689,chr17,MSI2,chr17:57255851-57684689,428838
121360156,121398806,chr1,SRGAP2-AS1,chr1:121360156-121398806,38650
116710171,116738070,chr12,SPRING1,chr12:116710171-116738070,27899
154559308,154560440,chr5,CIR1P1,chr5:154559308-154560440,1132
154596012,154596072,chr5,MIR3141,chr5:154596012-154596072,60
154685776,154685861,chr5,MIR1303,chr5:154685776-154685861,85
154718383,154718689,chr5,RN7SL803P,chr5:154718383-154718689,306
117060326,117107453,chr1,TTF2,chr1:117060326-117107453,47127
154818492,154859252,chr5,FAXDC2,chr5:154818492-154859252,40760
116782105,116782208,chr12,RNU6-558P,chr12:116782105-116782208,103
116856144,116881441,chr12,HRK,chr12:116856144-116881441,25297
55469200,55470138,chr12,OR6C70,chr12:55469200-55470138,938
55492378,55493316,chr12,OR6C68,chr12:55492378-55493316,938
55522593,55523417,chr12,OR6C64P,chr12:55522593-55523417,824
57619527,57626151,chr12,SLC26A10,chr12:57619527-57626151,6624
153457744,153460651,chr1,S100A7,chr1:153457744-153460651,2907
96418594,96418933,chr1,UBE2WP1,chr1:96418594-96418933,339
70592256,70607288,chr4,AMBN,chr4:70592256-70607288,15032
153330120,153348841,chr1,PGLYRP4,chr1:153330120-153348841,18721
74455087,74457944,chr2,INO80B,chr2:74455087-74457944,2857
119219314,119220096,chr1,RPL6P2,chr1:119219314-119220096,782
67317871,67398410,chr11,RAD9A,chr11:67317871-67398410,80539
154829458,154829540,chr5,MIR378H,chr5:154829458-154829540,82
154887411,154938211,chr5,GEMIN5,chr5:154887411-154938211,50800
102864271,103002424,chr8,MAILR,chr8:102864271-103002424,138153
153789030,153923360,chr1,GATAD2B,chr1:153789030-153923360,134330
6346843,6377730,chr12,SCNN1A,chr12:6346843-6377730,30887
10330229,10330285,chr3,MIR378B,chr3:10330229-10330285,56
48847572,48851981,chr3,PRKAR2A-AS1,chr3:48847572-48851981,4409
75156639,75172044,chr7,NCF1C,chr7:75156639-75172044,15405
75185385,75237696,chr7,GTF2IP1,chr7:75185385-75237696,52311
48856926,48898904,chr3,SLC25A20,chr3:48856926-48898904,41978
102923371,102924255,chr8,RPL5P24,chr8:102923371-102924255,884
36784324,36936125,chr8,KCNU1,chr8:36784324-36936125,151801
74455088,74460884,chr2,INO80B-WBP1,chr2:74455088-74460884,5796
74458400,74460891,chr2,WBP1,chr2:74458400-74460891,2491
57861243,57955412,chr17,CUEDC1,chr17:57861243-57955412,94169
67490245,67490315,chr11,MIR6752,chr11:67490245-67490315,70
49489965,49490048,chr19,SNORD32A,chr19:49489965-49490048,83
49490904,49490974,chr19,SNORD34,chr19:49490904-49490974,70
49491175,49491260,chr19,SNORD35A,chr19:49491175-49491260,85
67491768,67506263,chr11,PITPNM1,chr11:67491768-67506263,14495
70815783,70839897,chr4,GRSF1,chr4:70815783-70839897,24114
49496365,49499708,chr19,RPS11,chr19:49496365-49499708,3343
48917782,48918823,chr3,ARIH2OS,chr3:48917782-48918823,1041
48989889,49007153,chr3,P4HTM,chr3:48989889-49007153,17264
75416786,75486299,chr7,POM121C,chr7:75416786-75486299,69513
62443176,62443282,chr5,RNU6-661P,chr5:62443176-62443282,106
62512246,62512482,chr5,CKS1BP3,chr5:62512246-62512482,236
62575951,62576271,chr5,RPL35AP14,chr5:62575951-62576271,320
62578819,62581446,chr5,LRRC70,chr5:62578819-62581446,2627
49497720,49497806,chr19,SNORD35B,chr19:49497720-49497806,86
49500785,49500868,chr19,MIR150,chr19:49500785-49500868,83
49502432,49502639,chr19,COX6CP7,chr19:49502432-49502639,207
57971547,57988259,chr17,VEZF1,chr17:57971547-57988259,16712
161288429,161549044,chr5,GABRB2,chr5:161288429-161549044,260615
49506816,49526428,chr19,FCGRT,chr19:49506816-49526428,19612
110165948,110172489,chr1,SLC6A17-AS1,chr1:110165948-110172489,6541
153678688,153693992,chr1,NPR1,chr1:153678688-153693992,15304
37095150,37095390,chr8,SMARCE1P4,chr8:37095150-37095390,240
74471982,74472687,chr2,MRPL53,chr2:74471982-74472687,705
99013266,99877580,chr8,VPS13B,chr8:99013266-99877580,864314
6375045,6391571,chr12,LTBR,chr12:6375045-6391571,16526
74471986,74483408,chr2,CCDC142,chr2:74471986-74483408,11422
58000919,58007346,chr17,SRSF1,chr17:58000919-58007346,6427
49015488,49022293,chr3,DALRD3,chr3:49015488-49022293,6805
75533298,75738962,chr7,HIP1,chr7:75533298-75738962,205664
29439306,29440977,chr6,OR10C1,chr6:29439306-29440977,1671
29044213,29045175,chr6,OR2W1,chr6:29044213-29045175,962
28324693,28356271,chr6,ZSCAN31,chr6:28324693-28356271,31578
58076891,58083204,chr17,DYNLL2-DT,chr17:58076891-58083204,6313
74483073,74494559,chr2,TTC31,chr2:74483073-74494559,11486
58083419,58095542,chr17,DYNLL2,chr17:58083419-58095542,12123
115856910,115857819,chr1,HNRNPA1P43,chr1:115856910-115857819,909
58157028,58157800,chr17,MSX2P1,chr17:58157028-58157800,772
58192726,58205174,chr17,EPX,chr17:58192726-58205174,12448
113390515,113685923,chr1,MAGI3,chr1:113390515-113685923,295408
10486395,10684768,chr4,CLNK,chr4:10486395-10684768,198373
50761029,50767557,chr17,ANKRD40CL,chr17:50761029-50767557,6528
49528003,49546962,chr19,RCN3,chr19:49528003-49546962,18959
51165435,51171744,chr17,NME2,chr17:51165435-51171744,6309
6438498,6438852,chr12,SRP14P1,chr12:6438498-6438852,354
67506497,67508649,chr11,CDK2AP2,chr11:67506497-67508649,2152
6451690,6466517,chr12,TAPBPL,chr12:6451690-6466517,14827
62306162,62391025,chr5,KIF2A,chr5:62306162-62391025,84863
49555468,49590262,chr19,NOSIP,chr19:49555468-49590262,34794
110243940,110358349,chr6,METTL24,chr6:110243940-110358349,114409
67518912,67524517,chr11,CABP2,chr11:67518912-67524517,5605
136342281,136550819,chr6,MAP7,chr6:136342281-136550819,208538
74497517,74503316,chr2,LBX2,chr2:74497517-74503316,5799
99123657,99157792,chr4,ADH4,chr4:99123657-99157792,34135
49020148,49020234,chr3,MIR425,chr3:49020148-49020234,86
49020459,49023495,chr3,NDUFAF3,chr3:49020459-49023495,3036
74505043,74507695,chr2,PCGF1,chr2:74505043-74507695,2652
6199715,6238271,chr12,CD9,chr12:6199715-6238271,38556
67583742,67586656,chr11,GSTP1,chr11:67583742-67586656,2914
75769533,75789896,chr7,CCL26,chr7:75769533-75789896,20363
48103357,48123601,chr17,SNX11,chr17:48103357-48123601,20244
75810825,75823356,chr7,CCL24,chr7:75810825-75823356,12531
49020618,49020709,chr3,MIR191,chr3:49020618-49020709,91
67602880,67606706,chr11,NDUFV1-DT,chr11:67602880-67606706,3826
157436850,157443633,chr3,PTX3,chr3:157436850-157443633,6783
74513463,74517148,chr2,TLX2,chr2:74513463-74517148,3685
73073376,73258798,chr4,ANKRD17,chr4:73073376-73258798,185422
114468315,114469282,chr1,EIF2S2P5,chr1:114468315-114469282,967
63652675,63679020,chr3,SNTN,chr3:63652675-63679020,26345
75842602,75888926,chr7,RHBDD2,chr7:75842602-75888926,46324
67605653,67612554,chr11,NDUFV1,chr11:67605653-67612554,6901
111382860,111391819,chr1,PGBP,chr1:111382860-111391819,8959
110208834,110209987,chr1,LINC02586,chr1:110208834-110209987,1153
115904855,115931616,chr1,LINC01649,chr1:115904855-115931616,26761
74518131,74526281,chr2,DQX1,chr2:74518131-74526281,8150
153437058,153439949,chr1,S100A7L2,chr1:153437058-153439949,2891
63833870,63863868,chr3,THOC7,chr3:63833870-63863868,29998
110112443,110113947,chr1,UBL4B,chr1:110112443-110113947,1504
153774354,153780157,chr1,SLC27A3,chr1:153774354-153780157,5803
75899200,75986855,chr7,POR,chr7:75899200-75986855,87655
49580646,49591004,chr19,PRRG2,chr19:49580646-49591004,10358
40177010,40195656,chr17,RAPGEFL1,chr17:40177010-40195656,18646
74526645,74529760,chr2,AUP1,chr2:74526645-74529760,3115
63860645,63861819,chr3,THOC7-AS1,chr3:63860645-63861819,1174
63911518,63911772,chr3,SCAANT1,chr3:63911518-63911772,254
64004022,64012148,chr3,PSMD6-AS2,chr3:64004022-64012148,8126
64011964,64016246,chr3,PSMD6-AS1,chr3:64011964-64016246,4282
114103249,114103628,chr3,H2BP3,chr3:114103249-114103628,379
114127580,114199407,chr3,DRD3,chr3:114127580-114199407,71827
49635292,49640143,chr19,RRAS,chr19:49635292-49640143,4851
151070578,151125542,chr1,GABPB2,chr1:151070578-151125542,54964
49642209,49658642,chr19,SCAF1,chr19:49642209-49658642,16433
81309053,81324183,chr15,STARD5,chr15:81309053-81324183,15130
114231398,114233021,chr3,FAM214BP1,chr3:114231398-114233021,1623
215274992,215277947,chr2,LINC02862,chr2:215274992-215277947,2955
150257251,150265078,chr1,CA14,chr1:150257251-150265078,7827
114276913,114310288,chr3,TIGIT,chr3:114276913-114310288,33375
215311956,215349773,chr2,ATIC,chr2:215311956-215349773,37817
144772224,144787345,chr8,ZNF34,chr8:144772224-144787345,15121
114316475,114316569,chr3,MIR568,chr3:114316475-114316569,94
114351771,114388978,chr3,ZBTB20-AS1,chr3:114351771-114388978,37207
1349240,1351878,chr16,TSR3,chr16:1349240-1351878,2638
49659569,49665875,chr19,IRF3,chr19:49659569-49665875,6306
56588518,56588621,chr12,RNU6-343P,chr12:56588518-56588621,103
67627938,67629937,chr11,NUDT8,chr11:67627938-67629937,1999
81331088,81374213,chr15,TMC3,chr15:81331088-81374213,43125
56638175,56645984,chr12,ATP5F1B,chr12:56638175-56645984,7809
67642555,67650730,chr11,ACY3,chr11:67642555-67650730,8175
50426158,50474845,chr17,ACSF2,chr17:50426158-50474845,48687
114445521,114529452,chr3,ZBTB20-AS5,chr3:114445521-114529452,83931
15865719,15888625,chr16,CEP20,chr16:15865719-15888625,22906
114684580,114687609,chr3,ZBTB20-AS2,chr3:114684580-114687609,3029
154321090,154325325,chr1,AQP10,chr1:154321090-154325325,4235
114743445,114743525,chr3,MIR4796,chr3:114743445-114743525,80
114873114,114876514,chr3,ZBTB20-AS3,chr3:114873114-114876514,3400
114930541,114931449,chr3,YBX1P3,chr3:114930541-114931449,908
115100423,115103061,chr3,ZBTB20-AS4,chr3:115100423-115103061,2638
115279125,115279860,chr3,EIF4E2P2,chr3:115279125-115279860,735
132747426,132754403,chr5,CCNI2,chr5:132747426-132754403,6977
67662160,67681224,chr11,ALDH3B2,chr11:67662160-67681224,19064
144785298,144785588,chr8,RN7SL395P,chr8:144785298-144785588,290
114314500,115147288,chr3,ZBTB20,chr3:114314500-115147288,832788
136999971,137045180,chr6,IL20RA,chr6:136999971-137045180,45209
144789765,144792587,chr8,RPL8,chr8:144789765-144792587,2822
142310427,142326455,chr5,SPRY4,chr5:142310427-142326455,16028
157830911,157898256,chr1,CD5L,chr1:157830911-157898256,67345
180847611,180861285,chr5,ZFP62,chr5:180847611-180861285,13674
56645027,56645101,chr12,SNORD59A,chr12:56645027-56645101,74
153390032,153391073,chr1,S100A8,chr1:153390032-153391073,1041
56663341,56688408,chr12,PTGES3,chr12:56663341-56688408,25067
90166233,90166526,chr15,RN7SL346P,chr15:90166233-90166526,293
95474737,95479356,chr1,LINC01761,chr1:95474737-95479356,4619
90206572,90206967,chr15,RPS12P26,chr15:90206572-90206967,395
178941191,178966433,chr5,ZNF454,chr5:178941191-178966433,25242
105433994,105434821,chr1,CDK4P1,chr1:105433994-105434821,827
90229975,90234047,chr15,CIB1,chr15:90229975-90234047,4072
109828355,109871436,chr1,LINC01768,chr1:109828355-109871436,43081
67682772,67683058,chr11,RPL37P2,chr11:67682772-67683058,286
67711702,67716005,chr11,UNC93B5,chr11:67711702-67716005,4303
67722483,67723455,chr11,OR7E145P,chr11:67722483-67723455,972
15877163,15877266,chr16,RNU6-213P,chr16:15877163-15877266,103
62936385,62984967,chr11,SLC22A6,chr11:62936385-62984967,48582
15931697,15932294,chr16,RPL15P20,chr16:15931697-15932294,597
30378106,30400108,chr16,ZNF48,chr16:30378106-30400108,22002
151364304,151372707,chr1,SELENBP1,chr1:151364304-151372707,8403
134169248,134318112,chr6,SGK1,chr6:134169248-134318112,148864
103120149,103212799,chr5,PPIP5K2,chr5:103120149-103212799,92650
155158370,155183285,chr3,MME-AS1,chr3:155158370-155183285,24915
155240919,155258766,chr3,LINC01487,chr3:155240919-155258766,17847
90249530,90265482,chr15,TTLL13P,chr15:90249530-90265482,15952
155290227,155293683,chr3,STRIT1,chr3:155290227-155293683,3456
155309427,155309807,chr3,PABPC1P10,chr3:155309427-155309807,380
30407414,30431108,chr16,ZNF771,chr16:30407414-30431108,23694
30419625,30419759,chr16,SNORA80C,chr16:30419625-30419759,134
30443631,30445874,chr16,SEPHS2,chr16:30443631-30445874,2243
36993350,37050846,chr3,MLH1,chr3:36993350-37050846,57496
30483135,30483195,chr16,RNU7-61P,chr16:30483135-30483195,60
90265659,90275778,chr15,NGRN,chr15:90265659-90275778,10119
30503919,30504001,chr16,MIR4518,chr16:30503919-30504001,82
30524004,30526821,chr16,ZNF768,chr16:30524004-30526821,2817
75915197,75915269,chr7,MIR4651,chr7:75915197-75915269,72
75922755,75923443,chr7,RPL7L1P3,chr7:75922755-75923443,688
75943782,75943916,chr7,SNORA14A,chr7:75943782-75943916,134
75986831,75994656,chr7,TMEM120A,chr7:75986831-75994656,7825
168834132,168913371,chr2,SPC25,chr2:168834132-168913371,79239
90293939,90294207,chr15,RN7SL736P,chr15:90293939-90294207,268
30553764,30558374,chr16,ZNF764,chr16:30553764-30558374,4610
101926164,101933350,chr15,OR4G2P,chr15:101926164-101933350,7186
101937591,101938470,chr15,OR4G6P,chr15:101937591-101938470,879
101954885,101956412,chr15,FAM138E,chr15:101954885-101956412,1527
62989154,63015841,chr11,SLC22A8,chr11:62989154-63015841,26687
101960459,101960596,chr15,MIR1302-10,chr15:101960459-101960596,137
101961603,101976543,chr15,WASH3P,chr15:101961603-101976543,14940
30573740,30585769,chr16,ZNF785,chr16:30573740-30585769,12029
168901291,168910000,chr2,G6PC2,chr2:168901291-168910000,8709
30602558,30624012,chr16,ZNF689,chr16:30602558-30624012,21454
56670450,56670746,chr12,RN7SL809P,chr12:56670450-56670746,296
56731296,56752374,chr12,PRIM1,chr12:56731296-56752374,21078
168915498,169031324,chr2,ABCB11,chr2:168915498-169031324,115826
2843844,2930076,chr4,ADD1,chr4:2843844-2930076,86232
63046785,63048126,chr11,TUBAP7,chr11:63046785-63048126,1341
63115880,63116338,chr11,RPL29P22,chr11:63115880-63116338,458
101973524,101973591,chr15,MIR6859-3,chr15:101973524-101973591,67
63243085,63244004,chr11,CCND2P1,chr11:63243085-63244004,919
101976558,101979093,chr15,DDX11L9,chr15:101976558-101979093,2535
30650717,30656413,chr16,PRR14,chr16:30650717-30656413,5696
63268022,63311783,chr11,SLC22A10,chr11:63268022-63311783,43761
80152490,80186946,chr15,FAH,chr15:80152490-80186946,34456
75210154,75231448,chr10,VDAC2,chr10:75210154-75231448,21294
75996338,76048004,chr7,STYXL1,chr7:75996338-76048004,51666
63369785,63410294,chr11,SLC22A9,chr11:63369785-63410294,40509
8413131,8490411,chr17,NDEL1,chr17:8413131-8490411,77280
169115195,169115680,chr2,UBE2V1P6,chr2:169115195-169115680,485
5663195,5938619,chr11,TRIM5,chr11:5663195-5938619,275424
169127109,169362534,chr2,LRP2,chr2:169127109-169362534,235425
56752161,56787790,chr12,HSD17B6,chr12:56752161-56787790,35629
30658431,30670810,chr16,FBRS,chr16:30658431-30670810,12379
147175351,147243050,chr1,FMO5,chr1:147175351-147243050,67699
76048051,76067508,chr7,MDH2,chr7:76048051-76067508,19457
76453351,76470117,chr17,AANAT,chr17:76453351-76470117,16766
56712305,56731628,chr12,NACA,chr12:56712305-56731628,19323
30675300,30675402,chr16,RNU6-416P,chr16:30675300-30675402,102
30701337,30701435,chr16,RNU6-1043P,chr16:30701337-30701435,98
30472658,30523567,chr16,ITGAL,chr16:30472658-30523567,50909
144791931,144791991,chr8,MIR6850,chr8:144791931-144791991,60
144841042,144853736,chr8,COMMD5,chr8:144841042-144853736,12694
27878314,27894752,chr17,LYRM9,chr17:27878314-27894752,16438
144876497,144902168,chr8,ZNF250,chr8:144876497-144902168,25671
49289206,49362473,chr17,ZNF652,chr17:49289206-49362473,73267
6474683,6481479,chr11,ARFIP2,chr11:6474683-6481479,6796
43866558,43869893,chr7,MRPS24,chr7:43866558-43869893,3335
43866558,43906589,chr7,URGCP-MRPS24,chr7:43866558-43906589,40031
1716523,1738599,chr17,WDR81,chr17:1716523-1738599,22076
147099482,147124285,chr1,NBPF13P,chr1:147099482-147124285,24803
43875894,43926411,chr7,URGCP,chr7:43875894-43926411,50517
119368946,119370331,chr1,HAO2-IT1,chr1:119368946-119370331,1385
112363281,112363581,chr1,TXNP3,chr1:112363281-112363581,300
153717303,153718347,chr1,GEMIN2P1,chr1:153717303-153718347,1044
157273760,157283968,chr1,LINC02772,chr1:157273760-157283968,10208
30541381,30556489,chr6,GNL1,chr6:30541381-30556489,15108
151111912,151112728,chr1,RPS29P29,chr1:151111912-151112728,816
80195481,80252213,chr15,CTXND1,chr15:80195481-80252213,56732
148402516,148432545,chr1,PDE4DIPP6,chr1:148402516-148432545,30029
48312353,48331856,chr15,DUT-AS1,chr15:48312353-48331856,19503
49682117,49682195,chr19,MIR5088,chr19:49682117-49682195,78
48331011,48343373,chr15,DUT,chr15:48331011-48343373,12362
180784780,180815652,chr5,MGAT1,chr5:180784780-180815652,30872
153357854,153361023,chr1,S100A9,chr1:153357854-153361023,3169
6481501,6484681,chr11,TIMM10B,chr11:6481501-6484681,3180
49690898,49713731,chr19,CPT1C,chr19:49690898-49713731,22833
153396591,153396771,chr1,S100A15A,chr1:153396591-153396771,180
158175850,158177755,chr1,ELL2P1,chr1:158175850-158177755,1905
43918697,43920054,chr7,TUBG1P,chr7:43918697-43920054,1357
151159748,151165948,chr1,LYSMD1,chr1:151159748-151165948,6200
43926436,43956136,chr7,UBE2D4,chr7:43926436-43956136,29700
144930358,144950888,chr8,ZNF16,chr8:144930358-144950888,20530
154697455,154870281,chr1,KCNN3,chr1:154697455-154870281,172826
4987775,5018031,chr10,AKR1C2,chr10:4987775-5018031,30256
6497260,6593758,chr11,DNHD1,chr11:6497260-6593758,96498
184598529,184939492,chr2,ZNF804A,chr2:184598529-184939492,340963
90392257,90409766,chr5,CETN3,chr5:90392257-90409766,17509
152121687,152637801,chr6,SYNE1,chr6:152121687-152637801,516114
43800799,43833170,chr17,MPP3,chr17:43800799-43833170,32371
184902111,184902562,chr2,RPL23AP33,chr2:184902111-184902562,451
139716753,140154184,chr4,MAML3,chr4:139716753-140154184,437431
106697331,106698676,chr2,EEF1A1P12,chr2:106697331-106698676,1345
58157907,58198106,chr16,CSNK2A2,chr16:58157907-58198106,40199
106487364,106544297,chr2,CD8B2,chr2:106487364-106544297,56933
144994886,144995540,chr8,TMED10P1,chr8:144994886-144995540,654
145002811,145006046,chr8,ZNF252P-AS1,chr8:145002811-145006046,3235
25312774,25370383,chr4,ZCCHC4,chr4:25312774-25370383,57609
31131539,31131802,chr8,SUMO2P16,chr8:31131539-31131802,263
114431112,114768061,chr10,ABLIM1,chr10:114431112-114768061,336949
144148016,144261927,chr8,MROH1,chr8:144148016-144261927,113911
43940895,44019175,chr7,POLR2J4,chr7:43940895-44019175,78280
188974373,189012746,chr2,COL3A1,chr2:188974373-189012746,38373
77691166,77868780,chr5,TBCA,chr5:77691166-77868780,177614
120432204,120434052,chr1,PFN1P2,chr1:120432204-120434052,1848
88829102,88829419,chr1,ELOCP19,chr1:88829102-88829419,317
58199568,58199836,chr16,RN7SL645P,chr16:58199568-58199836,268
160400564,160428670,chr1,VANGL2,chr1:160400564-160428670,28106
58279997,58295047,chr16,PRSS54,chr16:58279997-58295047,15050
75308718,75316804,chr7,SPDYE14,chr7:75308718-75316804,8086
76510525,76516522,chr7,UPK3B,chr7:76510525-76516522,5997
42110853,42152878,chr4,BEND4,chr4:42110853-42152878,42025
117778087,117778506,chr1,PNRC2P1,chr1:117778087-117778506,419
6612768,6619448,chr11,TPP1,chr11:6612768-6619448,6680
153992685,154155116,chr1,NUP210L,chr1:153992685-154155116,162431
170353487,170736632,chr5,KCNIP1,chr5:170353487-170736632,383145
30423615,30430030,chr16,DCTPP1,chr16:30423615-30430030,6415
105682627,105895986,chr4,INTS12,chr4:105682627-105895986,213359
76609986,76627279,chr7,POMZP3,chr7:76609986-76627279,17293
16379055,16393954,chr16,NPIPA7,chr16:16379055-16393954,14899
53251251,53254406,chr12,MFSD5,chr12:53251251-53254406,3155
53268299,53293638,chr12,ESPL1,chr12:53268299-53293638,25339
15949138,16143257,chr16,ABCC1,chr16:15949138-16143257,194119
48831018,48866522,chr17,CALCOCO2,chr17:48831018-48866522,35504
48408313,48645721,chr15,FBN1,chr15:48408313-48645721,237408
75395063,75410996,chr7,TRIM73,chr7:75395063-75410996,15933
64666099,64711577,chr7,ZNF107,chr7:64666099-64711577,45478
49277917,49281838,chr16,CBLN1,chr16:49277917-49281838,3921
47761476,47766772,chr7,LINC00525,chr7:47761476-47766772,5296
88378739,88443097,chr4,HERC6,chr4:88378739-88443097,64358
47795291,47819847,chr7,PKD1L1-AS1,chr7:47795291-47819847,24556
157785743,157859145,chr5,CLINT1,chr5:157785743-157859145,73402
188978092,188978161,chr2,MIR1245A,chr2:188978092-188978161,69
188978093,188978161,chr2,MIR1245B,chr2:188978093-188978161,68
188995630,188995692,chr2,MIR3606,chr2:188995630-188995692,62
222298147,222305217,chr2,CCDC140,chr2:222298147-222305217,7070
47963288,47979615,chr7,HUS1,chr7:47963288-47979615,16327
117794490,118111826,chr8,EXT1,chr8:117794490-118111826,317336
86106223,86142157,chr2,PTCD3,chr2:86106223-86142157,35934
91923770,92031437,chr10,BTAF1,chr10:91923770-92031437,107667
114582848,114670422,chr1,DENND2C,chr1:114582848-114670422,87574
49739753,49763306,chr19,TSKS,chr19:49739753-49763306,23553
53295291,53299452,chr12,PFDN5,chr12:53295291-53299452,4161
49764524,49764630,chr19,RNU6-841P,chr19:49764524-49764630,106
11247626,11267865,chr8,LINC00529,chr8:11247626-11267865,20239
42220312,42228201,chr19,ZNF526,chr19:42220312-42228201,7889
11256020,11256602,chr8,RPL19P13,chr8:11256020-11256602,582
11284816,11328146,chr8,MTMR9,chr8:11284816-11328146,43330
42247569,42255128,chr19,ERF,chr19:42247569-42255128,7559
48035511,48061304,chr7,C7orf57,chr7:48035511-48061304,25793
154583128,154590745,chr4,FGA,chr4:154583128-154590745,7617
62403972,62628582,chr5,IPO11,chr5:62403972-62628582,224610
42313309,42325064,chr19,TMEM145,chr19:42313309-42325064,11755
49373804,49399431,chr16,C16orf78,chr16:49373804-49399431,25627
103493705,103592546,chr10,NEURL1,chr10:103493705-103592546,98841
153217584,153219310,chr1,PRR9,chr1:153217584-153219310,1726
49466106,49469875,chr16,LINC02179,chr16:49466106-49469875,3769
95577485,95609470,chr6,MANEA,chr6:95577485-95609470,31985
49487524,49857919,chr16,ZNF423,chr16:49487524-49857919,370395
82430590,82461177,chr4,ENOPH1,chr4:82430590-82461177,30587
85287789,85289007,chr6,KRT18P64,chr6:85287789-85289007,1218
11460510,11611666,chr10,USP6NL,chr10:11460510-11611666,151156
85387219,85390186,chr6,LINC02535,chr6:85387219-85390186,2967
85426657,85427125,chr6,DUTP5,chr6:85426657-85427125,468
85427453,85427966,chr6,TPT1P6,chr6:85427453-85427966,513
154155304,154194648,chr1,TPM3,chr1:154155304-154194648,39344
11331012,11332360,chr8,SLC35G5,chr8:11331012-11332360,1348
4343527,4360086,chr19,MPND,chr19:4343527-4360086,16559
47740202,47948466,chr7,PKD1L1,chr7:47740202-47948466,208264
11339637,11368452,chr8,TDH,chr8:11339637-11368452,28815
85449584,85495791,chr6,NT5E,chr6:85449584-85495791,46207
53299695,53307177,chr12,MYG1,chr12:53299695-53307177,7482
10141778,10153667,chr3,VHL,chr3:10141778-10153667,11889
186587794,186726722,chr4,FAT1,chr4:186587794-186726722,138928
39263495,39281735,chr3,CX3CR1,chr3:39263495-39281735,18240
86135870,86136006,chr2,SNORD94,chr2:86135870-86136006,136
86193026,86193108,chr2,MIR4779,chr2:86193026-86193108,82
86199355,86213790,chr2,MRPL35,chr2:86199355-86213790,14435
16586792,16670306,chr3,DAZL,chr3:16586792-16670306,83514
49517762,49518601,chr16,ADAM3B,chr16:49517762-49518601,839
49708006,49708243,chr16,MRPS21P7,chr16:49708006-49708243,237
11345748,11347502,chr8,TDH-AS1,chr8:11345748-11347502,1754
49764454,49764688,chr16,MRPS21P8,chr16:49764454-49764688,234
11368402,11438658,chr8,FAM167A-AS1,chr8:11368402-11438658,70256
29457338,29736959,chr10,SVIL,chr10:29457338-29736959,279621
49935028,49935352,chr16,RPL34P29,chr16:49935028-49935352,324
49954985,49968730,chr16,NCOA5LP,chr16:49954985-49968730,13745
11379395,11379675,chr8,RN7SL293P,chr8:11379395-11379675,280
11392411,11392517,chr8,RNU6-1084P,chr8:11392411-11392517,106
50246137,50318135,chr16,ADCY7,chr16:50246137-50318135,71998
11421476,11475908,chr8,FAM167A,chr8:11421476-11475908,54432
86440647,86492716,chr2,KDM3A,chr2:86440647-86492716,52069
76712832,76726799,chr17,JMJD6,chr17:76712832-76726799,13967
53307456,53324864,chr12,AAAS,chr12:53307456-53324864,17408
48645951,48652016,chr15,FBN1-DT,chr15:48645951-48652016,6065
142058330,142147122,chr6,NMBR,chr6:142058330-142147122,88792
24117153,24495756,chr3,THRB,chr3:24117153-24495756,378603
28281572,28302549,chr6,PGBD1,chr6:28281572-28302549,20977
56071421,56071639,chr15,CD24P2,chr15:56071421-56071639,218
56809860,56821742,chr4,SPINK2,chr4:56809860-56821742,11882
141943581,141969741,chr5,PCDH12,chr5:141943581-141969741,26160
56087280,56245082,chr15,RFX7,chr15:56087280-56245082,157802
11486894,11564599,chr8,BLK,chr8:11486894-11564599,77705
6876625,6877619,chr11,OR10A4,chr11:6876625-6877619,994
61792980,61867354,chr11,FADS2,chr11:61792980-61867354,74374
140639435,140645408,chr5,TMCO6,chr5:140639435-140645408,5973
30688047,30691420,chr6,NRM,chr6:30688047-30691420,3373
6640091,6642729,chr4,MRFAP1,chr4:6640091-6642729,2638
37891084,38139175,chr4,TBC1D1,chr4:37891084-38139175,248091
49223366,49230787,chr17,PHOSPHO1,chr17:49223366-49230787,7421
56274530,56274636,chr15,RNU6-1287P,chr15:56274530-56274636,106
56323193,56323719,chr15,HMGB1P33,chr15:56323193-56323719,526
74774011,74789315,chr7,NCF1,chr7:74774011-74789315,15304
39868202,39877896,chr17,ZPBP2,chr17:39868202-39877896,9694
30890559,30943108,chr15,FAN1,chr15:30890559-30943108,52549
4347780,4349061,chr19,EIF1P6,chr19:4347780-4349061,1281
4360370,4400547,chr19,SH3GL1,chr19:4360370-4400547,40177
11919900,11920809,chr8,OR7E158P,chr8:11919900-11920809,909
11928597,11933203,chr8,OR7E161P,chr8:11928597-11933203,4606
138139770,138178953,chr5,BRD8,chr5:138139770-138178953,39183
97142161,97283217,chr6,MMS22L,chr6:97142161-97283217,141056
11973937,11974599,chr8,DEFB136,chr8:11973937-11974599,662
11993174,11996312,chr8,DEFB134,chr8:11993174-11996312,3138
30477362,30527592,chr17,GOSR1,chr17:30477362-30527592,50230
12003400,12004082,chr8,DEFB131E,chr8:12003400-12004082,682
151207837,151227166,chr7,ABCF2-H2BE1,chr7:151207837-151227166,19329
64316460,64317559,chr11,TRMT112,chr11:64316460-64317559,1099
12043506,12043670,chr8,DEFB131C,chr8:12043506-12043670,164
12064389,12071747,chr8,DEFB130B,chr8:12064389-12071747,7358
12087396,12087445,chr8,RNA5SP253,chr8:12087396-12087445,49
12095176,12099536,chr8,DEFB108D,chr8:12095176-12099536,4360
12104389,12115516,chr8,ZNF705D,chr8:12104389-12115516,11127
85657742,85682908,chr11,CREBZF,chr11:85657742-85682908,25166
12132417,12134099,chr8,USP17L7,chr8:12132417-12134099,1682
12150895,12151134,chr8,DEFB109D,chr8:12150895-12151134,239
143316111,143352083,chr7,CLCN1,chr7:143316111-143352083,35972
56699095,56703884,chr11,OR9G1,chr11:56699095-56703884,4789
59473315,59479361,chr11,OR4D10,chr11:59473315-59479361,6046
17351800,17377341,chr11,NCR3LG1,chr11:17351800-17377341,25541
17435672,17436181,chr11,SDHCP4,chr11:17435672-17436181,509
38400215,38468834,chr8,FGFR1,chr8:38400215-38468834,68619
114059041,114256765,chr11,ZBTB16,chr11:114059041-114256765,197724
4402640,4445018,chr19,CHAF1A,chr19:4402640-4445018,42378
50292616,50292675,chr16,MIR6771,chr16:50292616-50292675,59
50152911,50235310,chr16,TENT4B,chr16:50152911-50235310,82399
26500303,26510425,chr6,BTN1A1,chr6:26500303-26510425,10122
17493895,17544416,chr11,USH1C,chr11:17493895-17544416,50521
4444999,4457794,chr19,UBXN6,chr19:4444999-4457794,12795
109492855,109691217,chr6,AK9,chr6:109492855-109691217,198362
66366622,66404784,chr16,CDH5,chr16:66366622-66404784,38162
237967014,238099412,chr2,UBE2F-SCLY,chr2:237967014-238099412,132398
22692914,22819575,chr4,GBA3,chr4:22692914-22819575,126661
2354086,2380745,chr7,EIF3B,chr7:2354086-2380745,26659
238028971,238029063,chr2,RNU6-1333P,chr2:238028971-238029063,92
53326575,53345315,chr12,SP7,chr12:53326575-53345315,18740
238060924,238099413,chr2,SCLY,chr2:238060924-238099413,38489
53380176,53416446,chr12,SP1,chr12:53380176-53416446,36270
18950345,19022595,chr17,SLC5A10,chr17:18950345-19022595,72250
30938941,30991628,chr15,MTMR10,chr15:30938941-30991628,52687
849276,932373,chr4,GAK,chr4:849276-932373,83097
115623510,115721490,chr3,GAP43,chr3:115623510-115721490,97980
26224199,26227473,chr6,H3C6,chr6:26224199-26227473,3274
132643312,132659182,chr6,TAAR1,chr6:132643312-132659182,15870
23916591,23924374,chr3,RPL15,chr3:23916591-23924374,7783
10671418,10694797,chr6,C6orf52,chr6:10671418-10694797,23379
53423855,53431672,chr12,AMHR2,chr12:53423855-53431672,7817
63521746,63583588,chr6,PTP4A1,chr6:63521746-63583588,61842
72692143,72887694,chr10,MCU,chr10:72692143-72887694,195551
4445978,4446048,chr19,MIR4746,chr19:4445978-4446048,70
4472297,4502208,chr19,HDGFL2,chr19:4472297-4502208,29911
154832697,155257723,chr6,TIAM2,chr6:154832697-155257723,425026
66427295,66493529,chr16,BEAN1,chr16:66427295-66493529,66234
30956248,30956350,chr15,RNU6-466P,chr15:30956248-30956350,102
31065032,31065141,chr15,MIR211,chr15:31065032-31065141,109
31001061,31161273,chr15,TRPM1,chr15:31001061-31161273,160212
2527074,2527145,chr7,MIR4648,chr7:2527074-2527145,71
2537810,2555694,chr7,BRAT1,chr7:2537810-2555694,17884
17547259,17647150,chr11,OTOG,chr11:17547259-17647150,99891
238100340,238133287,chr2,ESPNL,chr2:238100340-238133287,32947
13438484,13529014,chr10,BEND7,chr10:13438484-13529014,90530
53441678,53446645,chr12,PRR13,chr12:53441678-53446645,4967
17843511,17972422,chr17,TOM1L2,chr17:17843511-17972422,128911
66552563,66566251,chr16,CKLF,chr16:66552563-66566251,13688
129167827,129183922,chr3,CNBP,chr3:129167827-129183922,16095
101162509,101165569,chr7,VGF,chr7:101162509-101165569,3060
11370365,11832198,chr7,THSD7A,chr7:11370365-11832198,461833
238138668,238152947,chr2,KLHL30,chr2:238138668-238152947,14279
238158970,238168900,chr2,ERFE,chr2:238158970-238168900,9930
7485388,7511377,chr11,OLFML1,chr11:7485388-7511377,25989
66552587,66579135,chr16,CKLF-CMTM1,chr16:66552587-66579135,26548
79826739,79850878,chr10,NUTM2E,chr10:79826739-79850878,24139
4522531,4535224,chr19,PLIN5,chr19:4522531-4535224,12693
123567010,123639481,chr7,ASB15,chr7:123567010-123639481,72471
93993931,94332823,chr10,PLCE1,chr10:93993931-94332823,338892
238170402,238203708,chr2,ILKAP,chr2:238170402-238203708,33306
66579448,66588275,chr16,CMTM2,chr16:66579448-66588275,8827
7513298,7657127,chr11,PPFIBP2,chr11:7513298-7657127,143829
54230942,54280133,chr12,CBX5,chr12:54230942-54280133,49191
4536402,4540036,chr19,LRG1,chr19:4536402-4540036,3634
14145147,14178621,chr3,XPC,chr3:14145147-14178621,33474
20782279,20786886,chr7,SP8,chr7:20782279-20786886,4607
66603874,66613892,chr16,CMTM3,chr16:66603874-66613892,10018
4639516,4655568,chr19,TNFAIP8L1,chr19:4639516-4655568,16052
169612633,169723673,chr4,CLCN3,chr4:169612633-169723673,111040
127346790,127431924,chr7,ZNF800,chr7:127346790-127431924,85134
54231397,54231476,chr12,MIR3198-2,chr12:54231397-54231476,79
54255627,54255910,chr12,RN7SL390P,chr12:54255627-54255910,283
54262615,54279063,chr12,SCAT2,chr12:54262615-54279063,16448
52966896,53037898,chr19,ZNF702P,chr19:52966896-53037898,71002
54292111,54301015,chr12,NFE2,chr12:54292111-54301015,8904
116754430,116769229,chr1,CD2,chr1:116754430-116769229,14799
143499187,143500512,chr1,LINC02799,chr1:143499187-143500512,1325
106818224,106865316,chr1,LINC01661,chr1:106818224-106865316,47092
53044740,53051680,chr19,ERVV-2,chr19:53044740-53051680,6940
54301202,54351846,chr12,COPZ1,chr12:54301202-54351846,50644
48993562,49015970,chr19,RUVBL2,chr19:48993562-49015970,22408
63367575,63438553,chr1,ALG6,chr1:63367575-63438553,70978
170418868,170454733,chr3,CLDN11,chr3:170418868-170454733,35865
111726110,112206407,chr7,DOCK4,chr7:111726110-112206407,480297
185643130,185825042,chr3,IGF2BP2,chr3:185643130-185825042,181912
151276358,151303766,chr5,SLC36A3,chr5:151276358-151303766,27408
238238267,238240662,chr2,HES6,chr2:238238267-238240662,2395
49009906,49009972,chr19,MIR6798,chr19:49009906-49009972,66
178184505,178187371,chr5,GMCL2,chr5:178184505-178187371,2866
49015980,49017091,chr19,LHB,chr19:49015980-49017091,1111
66614750,66696743,chr16,CMTM4,chr16:66614750-66696743,81993
149492982,149551471,chr5,CSNK1A1,chr5:149492982-149551471,58489
49025461,49026020,chr19,NTF6A,chr19:49025461-49026020,559
49029726,49030341,chr19,NTF6G,chr19:49029726-49030341,615
49038479,49039038,chr19,NTF6B,chr19:49038479-49039038,559
68474152,68497221,chr1,DEPDC1,chr1:68474152-68497221,23069
49043848,49045311,chr19,CGB5,chr19:49043848-49045311,1463
103105349,103198445,chr4,CENPE,chr4:103105349-103198445,93096
7355123,7357219,chr17,TMEM95,chr17:7355123-7357219,2096
66926036,67101551,chr10,LRRTM3,chr10:66926036-67101551,175515
49061066,49065054,chr19,NTF4,chr19:49061066-49065054,3988
238244044,238290102,chr2,PER2,chr2:238244044-238290102,46058
7818497,8016631,chr10,TAF3,chr10:7818497-8016631,198134
49081332,49081630,chr19,RN7SL708P,chr19:49081332-49081630,298
49085419,49108605,chr19,SNRNP70,chr19:49085419-49108605,23186
28474111,28495575,chr16,CLN3,chr16:28474111-28495575,21464
82418318,82442645,chr17,HEXD,chr17:82418318-82442645,24327
8045378,8075198,chr10,GATA3,chr10:8045378-8075198,29820
28378955,28399747,chr6,ZSCAN12,chr6:28378955-28399747,20792
77650274,77927045,chr6,MEI4,chr6:77650274-77927045,276771
158536436,158635429,chr6,TMEM181,chr6:158536436-158635429,98993
114234631,114237578,chr3,ZNF80,chr3:114234631-114237578,2947
126103562,126197994,chr3,ALDH1L1,chr3:126103562-126197994,94432
54317781,54317887,chr12,RNU6-950P,chr12:54317781-54317887,106
54337216,54337314,chr12,MIR148B,chr12:54337216-54337314,98
54344610,54344876,chr12,RN7SL744P,chr12:54344610-54344876,266
54362445,54364487,chr12,GPR84,chr12:54362445-54364487,2042
238320441,238400897,chr2,TRAF3IP1,chr2:238320441-238400897,80456
109978256,109980720,chr6,GPR6,chr6:109978256-109980720,2464
96521595,96555276,chr6,UFL1,chr6:96521595-96555276,33681
6491886,6493841,chr12,MRPL51,chr12:6491886-6493841,1955
114535995,114537840,chr1,PKMP1,chr1:114535995-114537840,1845
8050450,8053484,chr10,GATA3-AS1,chr10:8050450-8053484,3034
101270875,101271363,chr1,PPIAP7,chr1:101270875-101271363,488
96562548,96618626,chr6,FHL5,chr6:96562548-96618626,56078
159581620,159582648,chr1,OR10AE1P,chr1:159581620-159582648,1028
148295180,148297556,chr1,LINC02806,chr1:148295180-148297556,2376
110756456,110756723,chr10,RN7SKP288,chr10:110756456-110756723,267
96648489,96649069,chr6,RPS7P8,chr6:96648489-96649069,580
110761142,110761242,chr10,RNA5SP327,chr10:110761142-110761242,100
96649453,96649591,chr6,RNU4-70P,chr6:96649453-96649591,138
121087345,121097161,chr1,FCGR1B,chr1:121087345-121097161,9816
96653274,96654142,chr6,TYMSP1,chr6:96653274-96654142,868
110871795,110900006,chr10,PDCD4,chr10:110871795-110900006,28211
49114324,49118460,chr19,LIN7B,chr19:49114324-49118460,4136
158109519,158168280,chr6,SERAC1,chr6:158109519-158168280,58761
72398302,72408367,chr15,TMEM202,chr15:72398302-72408367,10065
168291645,168472303,chr5,WWC1,chr5:168291645-168472303,180658
7665100,7677222,chr11,CYB5R2,chr11:7665100-7677222,12122
6493356,6531955,chr12,NCAPD2,chr12:6493356-6531955,38599
72450657,72451474,chr15,PHBP20,chr15:72450657-72451474,817
49118402,49119143,chr19,C19orf73,chr19:49118402-49119143,741
53315137,53316043,chr19,VN1R6P,chr19:53315137-53316043,906
157861197,157861460,chr1,MRPS21P2,chr1:157861197-157861460,263
53333749,53356906,chr19,ZNF845,chr19:53333749-53356906,23157
238152889,238155994,chr2,KLHL30-AS1,chr2:238152889-238155994,3105
231713314,231713398,chr2,MIR1244-1,chr2:231713314-231713398,84
72340924,72376420,chr15,HEXA,chr15:72340924-72376420,35496
231732433,231786272,chr2,PDE6D,chr2:231732433-231786272,53839
115556826,115557475,chr1,ELOCP20,chr1:115556826-115557475,649
4076711,4077491,chr4,RPS3AP16,chr4:4076711-4077491,780
109810642,109810998,chr1,NDUFA5P10,chr1:109810642-109810998,356
53365693,53392217,chr19,ZNF525,chr19:53365693-53392217,26524
4267701,4290154,chr4,LYAR,chr4:4267701-4290154,22453
28328325,28335489,chr17,IFT20,chr17:28328325-28335489,7164
158127287,158128301,chr1,SMIM42,chr1:158127287-158128301,1014
53389793,53430413,chr19,ZNF765,chr19:53389793-53430413,40620
231789481,231789887,chr2,RPL28P2,chr2:231789481-231789887,406
145607988,145670650,chr1,GPR89A,chr1:145607988-145670650,62662
90127394,91605295,chr4,CCSER1,chr4:90127394-91605295,1477901
231892242,231892298,chr2,MIR1471,chr2:231892242-231892298,56
231921809,231926396,chr2,NPPC,chr2:231921809-231926396,4587
110898090,110898155,chr10,MIR4680,chr10:110898090-110898155,65
231961245,232344350,chr2,DIS3L2,chr2:231961245-232344350,383105
110898730,110919201,chr10,BBIP1,chr10:110898730-110919201,20471
53413190,53413345,chr19,RPL39P36,chr19:53413190-53413345,155
53431984,53444670,chr19,TPM3P9,chr19:53431984-53444670,12686
53467733,53496255,chr19,ZNF813,chr19:53467733-53496255,28522
158237336,158242797,chr6,SRP72P2,chr6:158237336-158242797,5461
53479350,53480091,chr19,TPM3P6,chr19:53479350-53480091,741
7726436,7729684,chr11,OR10AB1P,chr11:7726436-7729684,3248
158437797,158438088,chr6,RN7SL173P,chr6:158437797-158438088,291
7745990,7746906,chr11,OR5P4P,chr11:7745990-7746906,916
158168350,158199344,chr6,GTF2H5,chr6:158168350-158199344,30994
7772890,7773814,chr11,OR5P1P,chr11:7772890-7773814,924
69588417,69653249,chr4,UGT2A1,chr4:69588417-69653249,64832
116748170,116772987,chr11,BUD13,chr11:116748170-116772987,24817
61574328,61574402,chr6,MTRNR2L9,chr6:61574328-61574402,74
53616802,53617254,chr19,OSTCP3,chr19:53616802-53617254,452
53629713,53630041,chr19,RN7SL317P,chr19:53629713-53630041,328
72621792,73198853,chr6,KCNQ5,chr6:72621792-73198853,577061
53632056,53637009,chr19,DPRX,chr19:53632056-53637009,4953
53653685,53653791,chr19,RNU6-698P,chr19:53653685-53653791,106
53666679,53666762,chr19,MIR512-1,chr19:53666679-53666762,83
53669157,53669254,chr19,MIR512-2,chr19:53669157-53669254,97
53671968,53672040,chr19,MIR1323,chr19:53671968-53672040,72
53674197,53674320,chr19,MIR498,chr19:53674197-53674320,123
53675711,53675797,chr19,MIR520E,chr19:53675711-53675797,86
53679003,53679085,chr19,MIR515-1,chr19:53679003-53679085,82
53679940,53680023,chr19,MIR519E,chr19:53679940-53680023,83
53682159,53682245,chr19,MIR520F,chr19:53682159-53682245,86
53685009,53685091,chr19,MIR515-2,chr19:53685009-53685091,82
51153559,51162428,chr17,NME1,chr17:51153559-51162428,8869
53686469,53686555,chr19,MIR519C,chr19:53686469-53686555,86
53688481,53688567,chr19,MIR1283-1,chr19:53688481-53688567,86
131423921,131635231,chr5,RAPGEF6,chr5:131423921-131635231,211310
53690881,53690965,chr19,MIR520A,chr19:53690881-53690965,84
53694393,53694475,chr19,MIR526B,chr19:53694393-53694475,82
53695213,53695293,chr19,MIR519B,chr19:53695213-53695293,80
53697533,53697617,chr19,MIR525,chr19:53697533-53697617,84
53698385,53698471,chr19,MIR523,chr19:53698385-53698471,86
53700015,53700101,chr19,MIR518F,chr19:53700015-53700101,86
53701227,53701287,chr19,MIR520B,chr19:53701227-53701287,60
53702737,53702819,chr19,MIR518B,chr19:53702737-53702819,82
53706252,53706336,chr19,MIR526A1,chr19:53706252-53706336,84
53707453,53707539,chr19,MIR520C,chr19:53707453-53707539,86
116773799,116788039,chr11,ZPR1,chr11:116773799-116788039,14240
53708735,53708835,chr19,MIR518C,chr19:53708735-53708835,100
53711002,53711088,chr19,MIR524,chr19:53711002-53711088,86
53712268,53712354,chr19,MIR517A,chr19:53712268-53712354,86
53713347,53713434,chr19,MIR519D,chr19:53713347-53713434,87
53716594,53716680,chr19,MIR521-2,chr19:53716594-53716680,86
53719064,53719165,chr19,RNU6-803P,chr19:53719064-53719165,101
53720096,53720182,chr19,MIR520D,chr19:53720096-53720182,86
53721076,53721142,chr19,MIR517B,chr19:53721076-53721142,66
53722166,53722255,chr19,MIR520G,chr19:53722166-53722255,89
53725442,53725526,chr19,MIR516B2,chr19:53725442-53725526,84
53726922,53726986,chr19,MIR526A2,chr19:53726922-53726986,64
53729838,53729925,chr19,MIR518E,chr19:53729838-53729925,87
53731006,53731090,chr19,MIR518A1,chr19:53731006-53731090,84
53732981,53733083,chr19,RNU6-980P,chr19:53732981-53733083,102
53734877,53734963,chr19,MIR518D,chr19:53734877-53734963,86
53736845,53736934,chr19,MIR516B1,chr19:53736845-53736934,89
53739333,53739419,chr19,MIR518A2,chr19:53739333-53739419,86
53741313,53741407,chr19,MIR517C,chr19:53741313-53741407,94
53742512,53742599,chr19,MIR520H,chr19:53742512-53742599,87
53745004,53745105,chr19,RNU6-982P,chr19:53745004-53745105,101
53748636,53748722,chr19,MIR521-1,chr19:53748636-53748722,86
185018490,185020953,chr4,HELT,chr4:185018490-185020953,2463
53749851,53749951,chr19,RNU6-751P,chr19:53749851-53749951,100
53751211,53751297,chr19,MIR522,chr19:53751211-53751297,86
53752397,53752481,chr19,MIR519A1,chr19:53752397-53752481,84
53754018,53754102,chr19,MIR527,chr19:53754018-53754102,84
53756741,53756830,chr19,MIR516A1,chr19:53756741-53756830,89
53758232,53758318,chr19,MIR1283-2,chr19:53758232-53758318,86
53760087,53760188,chr19,RNU6-1041P,chr19:53760087-53760188,101
53761133,53761222,chr19,MIR516A2,chr19:53761133-53761222,89
53762344,53762430,chr19,MIR519A2,chr19:53762344-53762430,86
1815248,1848483,chr19,REXO1,chr19:1815248-1848483,33235
6510222,6510551,chr12,SCARNA10,chr12:6510222-6510551,329
6532290,6533498,chr12,GAPDH-DT,chr12:6532290-6533498,1208
143336762,143474568,chr4,GAB1,chr4:143336762-143474568,137806
110919367,111017307,chr10,SHOC2,chr10:110919367-111017307,97940
6534512,6538374,chr12,GAPDH,chr12:6534512-6538374,3862
32105689,32168709,chr3,GPD1L,chr3:32105689-32168709,63020
232172653,232172747,chr2,MIR562,chr2:232172653-232172747,94
232343116,232343903,chr2,NRBF2P6,chr2:232343116-232343903,787
232349754,232351309,chr2,ECEL1P3,chr2:232349754-232351309,1555
232378724,232382889,chr2,ALPP,chr2:232378724-232382889,4165
12665890,12768949,chr17,MYOCD,chr17:12665890-12768949,103059
183829271,183884933,chr3,PARL,chr3:183829271-183884933,55662
31971091,31982821,chr6,STK19,chr6:31971091-31982821,11730
1816159,1816238,chr19,MIR1909,chr19:1816159-1816238,79
1852399,1863579,chr19,KLF16,chr19:1852399-1863579,11180
1876810,1885496,chr19,ABHD17A,chr19:1876810-1885496,8686
153259687,153262124,chr1,LORICRIN,chr1:153259687-153262124,2437
232385750,232387457,chr2,ECEL1P2,chr2:232385750-232387457,1707
87821398,87846814,chr4,MEPE,chr4:87821398-87846814,25416
232406844,232410714,chr2,ALPG,chr2:232406844-232410714,3870
154199085,154206333,chr1,C1orf189,chr1:154199085-154206333,7248
29246859,29254494,chr17,CRYBA1,chr17:29246859-29254494,7635
153728050,153774808,chr1,INTS3,chr1:153728050-153774808,46758
175632934,176002664,chr4,GPM6A,chr4:175632934-176002664,369730
232415818,232419816,chr2,ECEL1P1,chr2:232415818-232419816,3998
116789367,116792420,chr11,APOA5,chr11:116789367-116792420,3053
19020656,19047011,chr17,GRAP,chr17:19020656-19047011,26355
232442034,232447418,chr2,DIS3L2P1,chr2:232442034-232447418,5384
232456125,232460753,chr2,ALPI,chr2:232456125-232460753,4628
116820700,116823304,chr11,APOA4,chr11:116820700-116823304,2604
1905372,1926013,chr19,SCAMP4,chr19:1905372-1926013,20641
116829706,116833072,chr11,APOC3,chr11:116829706-116833072,3366
157146508,157160760,chr3,CCNL1,chr3:157146508-157160760,14252
110936622,110937233,chr10,RPL13AP6,chr10:110936622-110937233,611
110988926,110989013,chr10,MIR548E,chr10:110988926-110989013,87
111077029,111080907,chr10,ADRA2A,chr10:111077029-111080907,3878
100049774,100065040,chr7,ZSCAN21,chr7:100049774-100065040,15266
62811996,62819167,chr10,EGR2,chr10:62811996-62819167,7171
63872012,63873766,chr17,CSH2,chr17:63872012-63873766,1754
232479827,232487834,chr2,ECEL1,chr2:232479827-232487834,8007
116835751,116837622,chr11,APOA1,chr11:116835751-116837622,1871
102813230,103074839,chr7,FBXL13,chr7:102813230-103074839,261609
103367966,103389065,chr10,TAF5,chr10:103367966-103389065,21099
73497538,73626117,chr10,USP54,chr10:73497538-73626117,128579
116836117,116856018,chr11,APOA1-AS,chr11:116836117-116856018,19901
142286917,142287625,chr4,RPL5P13,chr4:142286917-142287625,708
142317238,142317546,chr4,LSM3P4,chr4:142317238-142317546,308
116843402,117098437,chr11,SIK3,chr11:116843402-117098437,255035
58353676,58417595,chr17,RNF43,chr17:58353676-58417595,63919
110617423,110642123,chr4,PITX2,chr4:110617423-110642123,24700
30234039,30326134,chr6,HCG17,chr6:30234039-30326134,92095
1905399,1913447,chr19,ADAT3,chr19:1905399-1913447,8048
30238301,30242279,chr6,TRIM26BP,chr6:30238301-30242279,3978
30328907,30346854,chr6,TRIM39-RPP21,chr6:30328907-30346854,17947
6556863,6568691,chr12,NOP2,chr12:6556863-6568691,11828
30345131,30346884,chr6,RPP21,chr6:30345131-30346884,1753
1941172,1981338,chr19,CSNK1G2,chr19:1941172-1981338,40166
232520388,232525716,chr2,PRSS56,chr2:232520388-232525716,5328
232525993,232536667,chr2,CHRND,chr2:232525993-232536667,10674
76726830,76733936,chr17,METTL23,chr17:76726830-76733936,7106
30351416,30351550,chr6,HLA-N,chr6:30351416-30351550,134
30363112,30364280,chr6,UBQLN1P1,chr6:30363112-30364280,1168
142023160,142847432,chr4,INPP4B,chr4:142023160-142847432,824272
172630249,172711218,chr3,NCEH1,chr3:172630249-172711218,80969
30326469,30343729,chr6,TRIM39,chr6:30326469-30343729,17260
114837227,114851453,chr1,NR1H5P,chr1:114837227-114851453,14226
153373711,153375621,chr1,S100A12,chr1:153373711-153375621,1910
151076624,151080866,chr7,FASTK,chr7:151076624-151080866,4242
48009873,48031640,chr10,AGAP12P,chr10:48009873-48031640,21767
88852633,88891944,chr1,GTF2B,chr1:88852633-88891944,39311
14125015,14143680,chr3,TMEM43,chr3:14125015-14143680,18665
1952531,1954586,chr19,CSNK1G2-AS1,chr19:1952531-1954586,2055
48050282,48060016,chr10,BMS1P7,chr10:48050282-48060016,9734
48064308,48140142,chr10,PTPN20CP,chr10:48064308-48140142,75834
232539692,232548115,chr2,CHRNG,chr2:232539692-232548115,8423
8697400,8698795,chr19,ACTL9,chr19:8697400-8698795,1395
48153088,48274696,chr10,FRMPD2,chr10:48153088-48274696,121608
8728735,8729204,chr19,RPL23AP78,chr19:8728735-8729204,469
27652602,27652825,chr6,RPL8P1,chr6:27652602-27652825,223
27737000,27738494,chr6,GPR89P,chr6:27737000-27738494,1494
2321520,2328611,chr19,LSM7,chr19:2321520-2328611,7091
27780619,27781111,chr6,RSL24D1P1,chr6:27780619-27781111,492
27807075,27807339,chr6,H4C10P,chr6:27807075-27807339,264
58205441,58219605,chr17,MKS1,chr17:58205441-58219605,14164
27814302,27814777,chr6,H2AC14,chr6:27814302-27814777,475
27815022,27815489,chr6,H2BC14,chr6:27815022-27815489,467
27824092,27824480,chr6,H4C11,chr6:27824092-27824480,388
27831174,27831560,chr6,H4C12,chr6:27831174-27831560,386
6534697,6535631,chr6,CNN3P1,chr6:6534697-6535631,934
6588108,6654983,chr6,LY86,chr6:6588108-6654983,66875
93926615,93927569,chr1,MTCO2P21,chr1:93926615-93927569,954
173183731,173207331,chr1,TNFSF4,chr1:173183731-173207331,23600
132152243,132152349,chr2,RNU6-1132P,chr2:132152243-132152349,106
132253154,132253305,chr2,RNA5-8SP5,chr2:132253154-132253305,151
132256966,132257080,chr2,MIR663B,chr2:132256966-132257080,114
132262328,132263042,chr2,CDC27P1,chr2:132262328-132263042,714
90001324,90082206,chr15,ZNF710,chr15:90001324-90082206,80882
2360238,2426239,chr19,TMPRSS9,chr19:2360238-2426239,66001
132352722,132353318,chr2,FAM201B,chr2:132352722-132353318,596
132406752,132406858,chr2,RNU6-175P,chr2:132406752-132406858,106
132488554,132489088,chr2,YBX1P7,chr2:132488554-132489088,534
162378841,162386812,chr1,C1orf226,chr1:162378841-162386812,7971
63892146,64019428,chr2,VPS54,chr2:63892146-64019428,127282
6794915,6795402,chr6,BTF3P7,chr6:6794915-6795402,487
177019340,177228000,chr3,TBL1XR1,chr3:177019340-177228000,208660
27810051,27811300,chr6,H3C10,chr6:27810051-27811300,1249
90006755,90006841,chr15,MIR3174,chr15:90006755-90006841,86
153416520,153423222,chr1,S100A7A,chr1:153416520-153423222,6702
31268749,31272130,chr6,HLA-C,chr6:31268749-31272130,3381
90074512,90082207,chr15,ZNF710-AS1,chr15:90074512-90082207,7695
90083045,90102477,chr15,IDH2,chr15:90083045-90102477,19432
50304068,50405101,chr7,IKZF1,chr7:50304068-50405101,101033
100941017,100941995,chr1,HNRNPA1P68,chr1:100941017-100941995,978
143619994,143620527,chr1,PFN1P12,chr1:143619994-143620527,533
160081538,160090563,chr1,KCNJ9,chr1:160081538-160090563,9025
2425625,2427586,chr19,TIMM13,chr19:2425625-2427586,1961
2427638,2456959,chr19,LMNB2,chr19:2427638-2456959,29321
109910242,109930992,chr1,CSF1,chr1:109910242-109930992,20750
117015897,117015992,chr11,RNY4P6,chr11:117015897-117015992,95
5938751,5951347,chr11,OR56A3,chr11:5938751-5951347,12596
5383812,5393263,chr11,OR51M1,chr11:5383812-5393263,9451
5449323,5456518,chr11,OR51I2,chr11:5449323-5456518,7195
2434914,2435000,chr19,MIR7108,chr19:2434914-2435000,86
2458935,2462185,chr19,LINC01775,chr19:2458935-2462185,3250
62689289,62709845,chr11,BSCL2,chr11:62689289-62709845,20556
2476122,2478259,chr19,GADD45B,chr19:2476122-2478259,2137
64092652,64144420,chr2,PELI1,chr2:64092652-64144420,51768
90102649,90138016,chr15,IDH2-DT,chr15:90102649-90138016,35367
90347587,90349437,chr15,GABARAPL3,chr15:90347587-90349437,1850
90352284,90369146,chr15,ZNF774,chr15:90352284-90369146,16862
56066684,56078801,chr19,LINC01864,chr19:56066684-56078801,12117
56087366,56121295,chr19,ZNF787,chr19:56087366-56121295,33929
64185078,64205485,chr2,LINC00309,chr2:64185078-64205485,20407
90385814,90386063,chr15,NDUFA3P4,chr15:90385814-90386063,249
64340747,64340848,chr2,MIR4433B,chr2:64340747-64340848,101
90388242,90502239,chr15,IQGAP1,chr15:90388242-90502239,113997
56132599,56160893,chr19,ZNF444,chr19:56132599-56160893,28294
64340759,64340839,chr2,MIR4433A,chr2:64340759-64340839,80
64347193,64347741,chr2,RPL23AP37,chr2:64347193-64347741,548
217251556,217251875,chr2,RN7SKP43,chr2:217251556-217251875,319
217261699,217336120,chr2,DIRC3-AS1,chr2:217261699-217336120,74421
48292699,48293417,chr10,RPS6P14,chr10:48292699-48293417,718
106802755,106803427,chr1,MTATP6P14,chr1:106802755-106803427,672
143487772,143488353,chr1,NKAIN1P1,chr1:143487772-143488353,581
54887563,54888850,chr1,DHCR24-DT,chr1:54887563-54888850,1287
28364356,28404049,chr17,SARM1,chr17:28364356-28404049,39693
29826967,29831125,chr6,HLA-G,chr6:29826967-29831125,4158
48306639,48439360,chr10,MAPK8,chr10:48306639-48439360,132721
217760547,217761291,chr2,RPL7L1P9,chr2:217760547-217761291,744
217900513,217900628,chr2,MIR6809,chr2:217900513-217900628,115
157724180,157725020,chr1,VDAC1P9,chr1:157724180-157725020,840
217284019,217756593,chr2,DIRC3,chr2:217284019-217756593,472574
116443555,116574823,chr5,SEMA6A,chr5:116443555-116574823,131268
151510510,151538692,chr1,CGN,chr1:151510510-151538692,28182
146175703,146200000,chr4,LSM6,chr4:146175703-146200000,24297
4449295,4450361,chr11,OR52K2,chr11:4449295-4450361,1066
130622838,130622944,chr2,RNU6-848P,chr2:130622838-130622944,106
130680050,130685863,chr2,CYP4F30P,chr2:130680050-130685863,5813
29827385,29828364,chr6,HCG4P8,chr6:29827385-29828364,979
4482646,4493497,chr11,OR52K1,chr11:4482646-4493497,10851
56176008,56185775,chr19,GALP,chr19:56176008-56185775,9767
4514966,4515924,chr11,OR52M2P,chr11:4514966-4515924,958
29871895,29873783,chr6,HCP5B,chr6:29871895-29873783,1888
58203202,58204142,chr11,OR1S2,chr11:58203202-58204142,940
29887752,29890482,chr6,HLA-H,chr6:29887752-29890482,2730
66590176,66593063,chr11,CCDC87,chr11:66590176-66593063,2887
29896654,29897786,chr6,HLA-T,chr6:29896654-29897786,1132
167996241,168045091,chr6,KIF25,chr6:167996241-168045091,48850
130690133,130718831,chr2,FAR2P3,chr2:130690133-130718831,28698
66593153,66606019,chr11,CCS,chr11:66593153-66606019,12866
146253975,146522372,chr4,SLC10A7,chr4:146253975-146522372,268397
56189570,56197920,chr19,ZSCAN5B,chr19:56189570-56197920,8350
130692243,130693770,chr2,KLF2P3,chr2:130692243-130693770,1527
130729070,130730336,chr2,GPR148,chr2:130729070-130730336,1266
14489388,14489609,chr19,SNRPGP15,chr19:14489388-14489609,221
28394642,28407197,chr17,SLC46A1,chr17:28394642-28407197,12555
130776646,130776957,chr2,CYCSP8,chr2:130776646-130776957,311
131328176,131330857,chr2,ARHGAP42P1,chr2:131328176-131330857,2681
14517085,14565980,chr19,TECR,chr19:14517085-14565980,48895
128928995,128929988,chr6,MESTP1,chr6:128928995-128929988,993
131352214,131353239,chr2,SSBP3P2,chr2:131352214-131353239,1025
127610292,127618142,chr7,PAX4,chr7:127610292-127618142,7850
129157523,129159120,chr6,BMPR1AP1,chr6:129157523-129159120,1597
148156139,148186980,chr1,LINC02805,chr1:148156139-148186980,30841
131369062,131369711,chr2,MTCYBP10,chr2:131369062-131369711,649
131369785,131370301,chr2,MTND6P10,chr2:131369785-131370301,516
129436875,129436980,chr6,RNU6-861P,chr6:129436875-129436980,105
131370306,131372075,chr2,MTND5P23,chr2:131370306-131372075,1769
183815922,183825594,chr3,MAP6D1,chr3:183815922-183825594,9672
131372294,131373650,chr2,MTND4P21,chr2:131372294-131373650,1356
131379743,131380083,chr2,MTND3P18,chr2:131379743-131380083,340
196319342,196338503,chr3,TM4SF19,chr3:196319342-196338503,19161
131380153,131380913,chr2,MTCO3P18,chr2:131380153-131380913,760
28416922,28417492,chr17,H3P41,chr17:28416922-28417492,570
66614964,66615090,chr11,RNU4-39P,chr11:66614964-66615090,126
151156649,151159749,chr1,TNFAIP8L2,chr1:151156649-151159749,3100
131380916,131381590,chr2,MTATP6P4,chr2:131380916-131381590,674
66616626,66629934,chr11,RBM14,chr11:66616626-66629934,13308
131381840,131382497,chr2,MTCO2P18,chr2:131381840-131382497,657
129576132,129710177,chr6,ARHGAP18,chr6:129576132-129710177,134045
163244505,163321894,chr1,RGS5,chr1:163244505-163321894,77389
131382643,131384061,chr2,MTCO1P18,chr2:131382643-131384061,1418
131384461,131385490,chr2,MTND2P18,chr2:131384461-131385490,1029
131385700,131386314,chr2,MTND1P26,chr2:131385700-131386314,614
28467822,28468406,chr17,RPS7P1,chr17:28467822-28468406,584
146408583,146408688,chr4,MIR7849,chr4:146408583-146408688,105
73853296,73854483,chr4,PF4V1,chr4:73853296-73854483,1187
66616626,66646469,chr11,RBM14-RBM4,chr11:66616626-66646469,29843
28546708,28552631,chr17,UNC119,chr17:28546708-28552631,5923
131395217,131395542,chr2,MED15P3,chr2:131395217-131395542,325
131402778,131410050,chr2,LINC01120,chr2:131402778-131410050,7272
73869393,73871308,chr4,CXCL1,chr4:73869393-73871308,1915
131381671,131388830,chr3,NUDT16,chr3:131381671-131388830,7159
66638667,66668374,chr11,RBM4,chr11:66638667-66668374,29707
143971823,144048719,chr3,DIPK2A,chr3:143971823-144048719,76896
73938604,73939558,chr4,HNRNPA1P55,chr4:73938604-73939558,954
73944011,73944324,chr4,CXCL1P1,chr4:73944011-73944324,313
36246913,36302114,chr5,RANBP3L,chr5:36246913-36302114,55201
73980811,73982027,chr4,PF4,chr4:73980811-73982027,1216
131423801,131424867,chr2,GNAQP1,chr2:131423801-131424867,1066
131442644,131444587,chr2,NOC2LP2,chr2:131442644-131444587,1943
131460999,131461577,chr2,RHOQP2,chr2:131460999-131461577,578
129756298,129757112,chr6,RPL5P21,chr6:129756298-129757112,814
100574011,100586129,chr7,LRCH4,chr7:100574011-100586129,12118
131464900,131492743,chr2,MZT2A,chr2:131464900-131492743,27843
73986439,73988190,chr4,PPBP,chr4:73986439-73988190,1751
154220179,154271510,chr1,UBAP2L,chr1:154220179-154271510,51331
120684938,120742993,chr3,RABL3,chr3:120684938-120742993,58055
73995642,73998677,chr4,CXCL5,chr4:73995642-73998677,3035
165327287,165988117,chr6,PDE10A,chr6:165327287-165988117,660830
28553383,28571794,chr17,PIGS,chr17:28553383-28571794,18411
74011578,74011876,chr4,RN7SL218P,chr4:74011578-74011876,298
74036589,74038807,chr4,CXCL3,chr4:74036589-74038807,2218
66664998,66677887,chr11,RBM4B,chr11:66664998-66677887,12889
131476119,131482934,chr2,TUBA3D,chr2:131476119-131482934,6815
74054038,74055399,chr4,PPBPP2,chr4:74054038-74055399,1361
146214515,146232267,chr4,REELD1,chr4:146214515-146232267,17752
69106065,69123032,chr3,LMOD3,chr3:69106065-69123032,16967
56049098,56330609,chr4,CRACD,chr4:56049098-56330609,281511
66712720,66713009,chr11,RN7SL12P,chr11:66712720-66713009,289
66761575,66762399,chr11,C1QBPP2,chr11:66761575-66762399,824
66771246,66771667,chr11,FTLP6,chr11:66771246-66771667,421
115124762,115180546,chr5,TRIM36,chr5:115124762-115180546,55784
129202966,129203070,chr11,RNU6-874P,chr11:129202966-129203070,104
129295286,129296481,chr11,ZNF123P,chr11:129295286-129296481,1195
128764466,128765018,chr3,FTH1P4,chr3:128764466-128765018,552
131491160,131491236,chr2,MIR4784,chr2:131491160-131491236,76
128785147,128785448,chr3,RN7SL698P,chr3:128785147-128785448,301
128798841,128799201,chr3,RPS15AP16,chr3:128798841-128799201,360
128965060,129279324,chr11,ARHGAP32,chr11:128965060-129279324,314264
128843564,128844404,chr3,MARK2P17,chr3:128843564-128844404,840
128848673,128849399,chr3,MARK3P3,chr3:128848673-128849399,726
128852112,128853008,chr3,MARK2P6,chr3:128852112-128853008,896
130836914,131047263,chr2,ARHGEF4,chr2:130836914-131047263,210349
66995173,67239514,chr7,TYW1,chr7:66995173-67239514,244341
63863155,64003462,chr3,ATXN7,chr3:63863155-64003462,140307
33064569,33080775,chr6,HLA-DPA1,chr6:33064569-33080775,16206
48446036,48656265,chr10,ARHGAP22,chr10:48446036-48656265,210229
32517353,32530287,chr6,HLA-DRB5,chr6:32517353-32530287,12934
28573115,28576948,chr17,ALDOC,chr17:28573115-28576948,3833
90634725,90635033,chr15,HSPE1P3,chr15:90634725-90635033,308
14529543,14529640,chr19,MIR639,chr19:14529543-14529640,97
77713387,77819615,chr4,CNOT6L,chr4:77713387-77819615,106228
14566078,14572066,chr19,NDUFB7,chr19:14566078-14572066,5988
149141483,149260542,chr5,ABLIM3,chr5:149141483-149260542,119059
40844018,40858207,chr15,SPINT1,chr15:40844018-40858207,14189
14584095,14584395,chr19,RN7SL337P,chr19:14584095-14584395,300
14588357,14588656,chr19,RN7SL842P,chr19:14588357-14588656,299
42325609,42378769,chr19,MEGF8,chr19:42325609-42378769,53160
5431335,5513809,chr7,FBXL18,chr7:5431335-5513809,82474
32549940,32550090,chr6,RNU1-61P,chr6:32549940-32550090,150
32552713,32560022,chr6,HLA-DRB6,chr6:32552713-32560022,7309
3441968,3449486,chr4,HGFAC,chr4:3441968-3449486,7518
32628179,32647062,chr6,HLA-DQA1,chr6:32628179-32647062,18883
29146569,29514328,chr7,CHN2,chr7:29146569-29514328,367759
167392796,167408519,chr3,LINC01327,chr3:167392796-167408519,15723
167239843,167407874,chr3,ZBBX,chr3:167239843-167407874,168031
3463306,3501473,chr4,DOK7,chr4:3463306-3501473,38167
48510525,48511589,chr10,ARHGAP22-IT1,chr10:48510525-48511589,1064
32659880,32660729,chr6,HLA-DQB1-AS1,chr6:32659880-32660729,849
32706124,32706955,chr6,MTCO3P1,chr6:32706124-32706955,831
48745545,48746128,chr10,RPL13AP19,chr10:48745545-48746128,583
32730758,32731695,chr6,HLA-DQB3,chr6:32730758-32731695,937
68956135,68985068,chr10,DDX21,chr10:68956135-68985068,28933
32659467,32668383,chr6,HLA-DQB1,chr6:32659467-32668383,8916
158795317,158862781,chr2,DAPL1,chr2:158795317-158862781,67464
3503612,3532446,chr4,LRPAP1,chr4:3503612-3532446,28834
21782659,22283567,chr11,ANO5,chr11:21782659-22283567,500908
98444854,98594392,chr2,INPP4A,chr2:98444854-98594392,149538
74598500,74645414,chr15,CLK3,chr15:74598500-74645414,46914
6570082,6614524,chr12,CHD4,chr12:6570082-6614524,44442
1755778,1801711,chr8,CLN8,chr8:1755778-1801711,45933
42351131,42351205,chr19,MIR8077,chr19:42351131-42351205,74
42387019,42390297,chr19,CNFN,chr19:42387019-42390297,3278
32459821,32473500,chr6,HLA-DRB9,chr6:32459821-32473500,13679
32578769,32589848,chr6,HLA-DRB1,chr6:32578769-32589848,11079
3293021,3439913,chr4,RGS12,chr4:3293021-3439913,146892
150708440,150759095,chr5,DCTN4,chr5:150708440-150759095,50655
42401514,42427388,chr19,LIPE,chr19:42401514-42427388,25874
100492619,100577444,chr3,TMEM45A,chr3:100492619-100577444,84825
1763888,1958627,chr8,KBTBD11-OT1,chr8:1763888-1958627,194739
1801125,1801192,chr8,MIR3674,chr8:1801125-1801192,67
1817231,1817307,chr8,MIR596,chr8:1817231-1817307,76
42428278,42442946,chr19,CXCL17,chr19:42428278-42442946,14668
1823926,1958641,chr8,ARHGEF10,chr8:1823926-1958641,134715
42472875,42473009,chr19,RNU4-60P,chr19:42472875-42473009,134
42507304,42561234,chr19,CEACAM1,chr19:42507304-42561234,53930
100749156,100993515,chr3,ABI3BP,chr3:100749156-100993515,244359
28577565,28599025,chr17,SPAG5,chr17:28577565-28599025,21460
148697914,148801110,chr7,CUL1,chr7:148697914-148801110,103196
4545191,4546144,chr11,OR52M1,chr11:4545191-4546144,953
4571423,4577820,chr11,C11orf40,chr11:4571423-4577820,6397
144285335,144853034,chr6,UTRN,chr6:144285335-144853034,567699
56597426,56598362,chr11,OR5M13P,chr11:56597426-56598362,936
56609236,56614874,chr11,OR5M1,chr11:56609236-56614874,5638
56619779,56620810,chr11,OR5AM1P,chr11:56619779-56620810,1031
56628932,56629860,chr11,OR5M12P,chr11:56628932-56629860,928
56633164,56634103,chr11,OR5AP1P,chr11:56633164-56634103,939
4821321,4822456,chr11,OR51F2,chr11:4821321-4822456,1135
58212720,58216084,chr11,OR1S1,chr11:58212720-58216084,3364
124395534,124399024,chr11,OR8B3,chr11:124395534-124399024,3490
124382394,124384499,chr11,OR8B2,chr11:124382394-124384499,2105
7937171,7941708,chr11,OR10A3,chr11:7937171-7941708,4537
6863057,6874717,chr11,OR10A2,chr11:6863057-6874717,11660
59436469,59451380,chr11,OR5A1,chr11:59436469-59451380,14911
159157409,159210053,chr5,RNF145,chr5:159157409-159210053,52644
4912588,4919350,chr11,OR51G2,chr11:4912588-4919350,6762
4903783,4909462,chr11,OR51A7,chr11:4903783-4909462,5679
166566178,166580705,chr1,FMO8P,chr1:166566178-166580705,14527
5880629,5887079,chr11,OR52E4,chr11:5880629-5887079,6450
56274154,56276819,chr11,OR5T1,chr11:56274154-56276819,2665
147082338,147083578,chr1,SSBL4P,chr1:147082338-147083578,1240
72478221,72479237,chr11,ART2BP,chr11:72478221-72479237,1016
116532936,116534092,chr1,NAP1L4P1,chr1:116532936-116534092,1156
72519986,72521733,chr11,ART2P,chr11:72519986-72521733,1747
146321214,146401647,chr1,SEC22B4P,chr1:146321214-146401647,80433
72570660,72573229,chr11,LINC01537,chr11:72570660-72573229,2569
165215951,165219104,chr1,LMX1A-AS1,chr1:165215951-165219104,3153
72584572,72587979,chr11,PDE2A-AS2,chr11:72584572-72587979,3407
101323337,101390303,chr1,LINC01307,chr1:101323337-101390303,66966
17365172,17389331,chr11,KCNJ11,chr11:17365172-17389331,24159
160091340,160098943,chr1,IGSF8,chr1:160091340-160098943,7603
6791736,6799689,chr11,OR6A2,chr11:6791736-6799689,7953
4637477,4643060,chr11,OR51D1,chr11:4637477-4643060,5583
4643420,4655488,chr11,OR51E1,chr11:4643420-4655488,12068
6765626,6771976,chr11,OR2AG2,chr11:6765626-6771976,6350
123976661,123977781,chr11,OR10S1,chr11:123976661-123977781,1120
124026798,124030634,chr11,OR10G8,chr11:124026798-124030634,3836
106391290,106468413,chr2,RGPD3,chr2:106391290-106468413,77123
68190705,68206079,chr15,CALML4,chr15:68190705-68206079,15374
89582988,89645242,chr10,PANK1,chr10:89582988-89645242,62254
67468174,67491154,chr11,AIP,chr11:67468174-67491154,22980
4942831,4947605,chr11,OR51A4,chr11:4942831-4947605,4774
167916675,167937072,chr1,MPC2,chr1:167916675-167937072,20397
128883138,129516566,chr6,LAMA2,chr6:128883138-129516566,633428
71453109,71524107,chr11,NADSYN1,chr11:71453109-71524107,70998
78077808,78104370,chr15,SH2D7,chr15:78077808-78104370,26562
28598790,28617377,chr17,SPAG5-AS1,chr17:28598790-28617377,18587
78264086,78282196,chr15,DNAJA4,chr15:78264086-78282196,18110
28601827,28614197,chr17,RSKR,chr17:28601827-28614197,12370
153379821,153380799,chr1,LAPTM4BP1,chr1:153379821-153380799,978
95117923,95247225,chr1,TLCD4-RWDD3,chr1:95117923-95247225,129302
34969881,34975578,chr10,LINC02635,chr10:34969881-34975578,5697
35079598,35079680,chr10,MIR3611,chr10:35079598-35079680,82
150660882,150679368,chr5,MYOZ3,chr5:150660882-150679368,18486
35135443,35135502,chr10,RNU7-77P,chr10:35135443-35135502,59
35158306,35158640,chr10,ATP6V1G1P4,chr10:35158306-35158640,334
160485030,160523262,chr1,SLAMF6,chr1:160485030-160523262,38232
42560433,42561750,chr19,CEACAMP2,chr19:42560433-42561750,1317
37923187,38067142,chr2,RMDN2,chr2:37923187-38067142,143955
88819896,88851844,chr10,ANKRD22,chr10:88819896-88851844,31948
42580243,42595055,chr19,CEACAM8,chr19:42580243-42595055,14812
88876450,88877544,chr10,PTCD2P2,chr10:88876450-88877544,1094
159128802,159128894,chr4,MIR3688-1,chr4:159128802-159128894,92
159128805,159128891,chr4,MIR3688-2,chr4:159128805-159128891,86
88879734,88975153,chr10,STAMBPL1,chr10:88879734-88975153,95419
159103013,159360174,chr4,RAPGEF2,chr4:159103013-159360174,257161
42620212,42633034,chr19,CEACAMP1,chr19:42620212-42633034,12822
1973677,2006936,chr8,KBTBD11,chr8:1973677-2006936,33259
108383736,108421295,chr1,SLC25A24P2,chr1:108383736-108421295,37559
14514769,14560391,chr19,DNAJB1,chr19:14514769-14560391,45622
166763334,166792767,chr1,FMO11P,chr1:166763334-166792767,29433
2045046,2165552,chr8,MYOM2,chr8:2045046-2165552,120506
88189633,88269476,chr5,TMEM161B,chr5:88189633-88269476,79843
147258885,147517875,chr1,LINC00624,chr1:147258885-147517875,258990
28614446,28645454,chr17,KIAA0100,chr17:28614446-28645454,31008
88932390,88940820,chr10,ACTA2-AS1,chr10:88932390-88940820,8430
145719471,145739288,chr1,CD160,chr1:145719471-145739288,19817
88935074,88991339,chr10,ACTA2,chr10:88935074-88991339,56265
169662007,169854080,chr1,C1orf112,chr1:169662007-169854080,192073
7595863,7618304,chr19,CAMSAP3,chr19:7595863-7618304,22441
35800932,35907110,chr7,SEPTIN7,chr7:35800932-35907110,106178
71473503,71473568,chr11,MIR6754,chr11:71473503-71473568,65
71527267,71528669,chr11,KRTAP5-7,chr11:71527267-71528669,1402
71538025,71539209,chr11,KRTAP5-8,chr11:71538025-71539209,1184
71548420,71549608,chr11,KRTAP5-9,chr11:71548420-71549608,1188
71565563,71566735,chr11,KRTAP5-10,chr11:71565563-71566735,1172
71579728,71579848,chr11,KRTAP5-14P,chr11:71579728-71579848,120
71593454,71594382,chr11,OR7E87P,chr11:71593454-71594382,928
71603260,71608040,chr11,UNC93B6,chr11:71603260-71608040,4780
88953813,89029605,chr10,FAS,chr10:88953813-89029605,75792
71620020,71621032,chr11,OR7E4P,chr11:71620020-71621032,1012
44316281,44361862,chr2,PREPL,chr2:44316281-44361862,45581
494512,507300,chr11,RNH1,chr11:494512-507300,12788
43794162,43800220,chr15,SERINC4,chr15:43794162-43800220,6058
7617439,7617505,chr19,MIR6792,chr19:7617439-7617505,66
7619525,7629545,chr19,XAB2,chr19:7619525-7629545,10020
139028112,139177218,chr4,ELF2,chr4:139028112-139177218,149106
2076589,2076640,chr8,MIR7160,chr8:2076589-2076640,51
80034745,80231232,chr8,TPD52,chr8:80034745-80231232,196487
56457987,56954830,chr6,DST,chr6:56457987-56954830,496843
123689644,123692407,chr3,MYLK-AS2,chr3:123689644-123692407,2763
77984036,78077724,chr15,TBC1D2B,chr15:77984036-78077724,93688
124132929,124133025,chr3,MIR5002,chr3:124132929-124133025,96
124151960,124153063,chr3,RPL7P15,chr3:124151960-124153063,1103
128693669,128825942,chr3,RAB7A,chr3:128693669-128825942,132273
166057426,166167001,chr1,FAM78B,chr1:166057426-166167001,109575
7629793,7631956,chr19,PET100,chr19:7629793-7631956,2163
25664873,25664939,chr3,MIR4442,chr3:25664873-25664939,66
25686896,25687123,chr3,CRIP1P2,chr3:25686896-25687123,227
158930796,158977059,chr1,PYHIN1,chr1:158930796-158977059,46263
177402141,177409564,chr5,F12,chr5:177402141-177409564,7423
25718944,25790039,chr3,NGLY1,chr3:25718944-25790039,71095
7631611,7633719,chr19,PCP2,chr19:7631611-7633719,2108
28648346,28662189,chr17,SDF2,chr17:28648346-28662189,13843
116811070,116922049,chr7,CAPZA2,chr7:116811070-116922049,110979
7665717,7666476,chr19,RPS27AP19,chr19:7665717-7666476,759
7669049,7670455,chr19,RETN,chr19:7669049-7670455,1406
537527,554912,chr11,LRRC56,chr11:537527-554912,17385
56919602,56971675,chr5,MIER3,chr5:56919602-56971675,52073
28655557,28655983,chr17,RPS12P28,chr17:28655557-28655983,426
69955256,69965728,chr4,CSN2,chr4:69955256-69965728,10472
28662198,28702679,chr17,SUPT6H,chr17:28662198-28702679,40481
7680833,7687703,chr19,TRAPPC5,chr19:7680833-7687703,6870
7688758,7702146,chr19,FCER2,chr19:7688758-7702146,13388
29120252,29570979,chr15,FAM189A1,chr15:29120252-29570979,450727
56134721,56140201,chr11,OR8J3,chr11:56134721-56140201,5480
70195725,70204576,chr4,ODAM,chr4:70195725-70204576,8851
40278372,40283064,chr15,ANKRD63,chr15:40278372-40283064,4692
74782080,74803197,chr15,CSK,chr15:74782080-74803197,21117
17392498,17476894,chr11,ABCC8,chr11:17392498-17476894,84396
183023420,183145592,chr1,LAMC1,chr1:183023420-183145592,122172
99828013,99866093,chr7,CYP3A43,chr7:99828013-99866093,38080
60881521,60931612,chr2,REL,chr2:60881521-60931612,50091
151029945,151093577,chr5,TNIP1,chr5:151029945-151093577,63632
7750684,7751161,chr19,RPL21P129,chr19:7750684-7751161,477
7787549,7790621,chr19,CLEC4GP1,chr19:7787549-7790621,3072
7813615,7814425,chr19,EXOSC3P2,chr19:7813615-7814425,810
158178030,158186427,chr1,CD1D,chr1:158178030-158186427,8397
7868719,7874390,chr19,PRR36,chr19:7868719-7874390,5671
70226124,70235252,chr4,FDCSP,chr4:70226124-70235252,9128
7879445,7880120,chr19,LYPLA2P2,chr19:7879445-7880120,675
7888505,7902021,chr19,LRRC8E,chr19:7888505-7902021,13516
21123968,21144368,chr2,TDRD15,chr2:21123968-21144368,20400
97083583,97094882,chr2,FAHD2B,chr2:97083583-97094882,11299
185159665,185209504,chr4,CFAP97,chr4:185159665-185209504,49839
66562175,66614247,chr8,MYBL1,chr8:66562175-66614247,52072
7903843,7914478,chr19,MAP2K7,chr19:7903843-7914478,10635
185204237,185370185,chr4,SNX25,chr4:185204237-185370185,165948
165631213,165661796,chr1,MGST3,chr1:165631213-165661796,30583
25749488,25749896,chr3,RPL32P11,chr3:25749488-25749896,408
25754925,25755670,chr3,TAF9BP1,chr3:25754925-25755670,745
25782917,25794534,chr3,OXSM,chr3:25782917-25794534,11617
174798809,175005381,chr2,CHN1,chr2:174798809-175005381,206572
25858525,25873748,chr3,LINC00692,chr3:25858525-25873748,15223
89063335,89063411,chr10,MIR4679-2,chr10:89063335-89063411,76
89063336,89063410,chr10,MIR4679-1,chr10:89063336-89063410,74
10784437,10795047,chr10,SFTA1P,chr10:10784437-10795047,10610
90233808,90245811,chr15,GDPGP1,chr15:90233808-90245811,12003
184241405,184241489,chr3,MIR1224,chr3:184241405-184241489,84
184242301,184249548,chr3,ALG3,chr3:184242301-184249548,7247
28714281,28718429,chr17,RAB34,chr17:28714281-28718429,4148
90291962,90295683,chr15,GOLGA2P8,chr15:90291962-90295683,3721
153427020,153428401,chr1,S100A7P1,chr1:153427020-153428401,1381
160190575,160201886,chr1,CASQ1,chr1:160190575-160201886,11311
53764204,53764310,chr15,RNU6-449P,chr15:53764204-53764310,106
10917866,10952234,chr10,LINC00710,chr10:10917866-10952234,34368
7920338,7923250,chr19,SNAPC2,chr19:7920338-7923250,2912
54320731,54321565,chr15,HNRNPA1P74,chr15:54320731-54321565,834
53978201,54628707,chr15,UNC13C,chr15:53978201-54628707,650506
22544986,22575788,chr8,SORBS3,chr8:22544986-22575788,30802
157513377,157552515,chr1,FCRL5,chr1:157513377-157552515,39138
7924491,7926135,chr19,CTXN1,chr19:7924491-7926135,1644
7926718,7943667,chr19,TIMM44,chr19:7926718-7943667,16949
70238382,70251474,chr4,CSN3,chr4:70238382-70251474,13092
184249672,184258759,chr3,EEF1AKMT4,chr3:184249672-184258759,9087
186026456,186026586,chr4,RNU4-64P,chr4:186026456-186026586,130
186069155,186088073,chr4,TLR3,chr4:186069155-186088073,18918
184249695,184293031,chr3,EEF1AKMT4-ECE2,chr3:184249695-184293031,43336
144451941,144836395,chr7,TPK1,chr7:144451941-144836395,384454
186104419,186175337,chr4,FAM149A,chr4:186104419-186175337,70918
81159575,81314058,chr15,IL16,chr15:81159575-81314058,154483
11071541,11105773,chr10,CELF2-AS2,chr10:11071541-11105773,34232
2328615,2355095,chr19,SPPL2B,chr19:2328615-2355095,26480
184259213,184261553,chr3,CAMK2N2,chr3:184259213-184261553,2340
160343316,160358952,chr1,NCSTN,chr1:160343316-160358952,15636
184299198,184309050,chr3,PSMD2,chr3:184299198-184309050,9852
11316833,11319884,chr10,CELF2-AS1,chr10:11316833-11319884,3051
73110375,73131828,chr10,NUDT13,chr10:73110375-73131828,21453
3301252,4269000,chr7,SDK1,chr7:3301252-4269000,967748
172555373,172608669,chr2,PDK1,chr2:172555373-172608669,53296
172659103,172666876,chr1,FASLG,chr1:172659103-172666876,7773
116950273,117176714,chr8,SLC30A8,chr8:116950273-117176714,226441
189775465,189814918,chr1,LINC01701,chr1:189775465-189814918,39453
162373203,162376854,chr1,SPATA46,chr1:162373203-162376854,3651
73126080,73126207,chr10,SNORA11F,chr10:73126080-73126207,127
21397119,21427577,chr19,ZNF493,chr19:21397119-21427577,30458
73130155,73169055,chr10,ECD,chr10:73130155-73169055,38900
153661788,153671028,chr1,ILF2,chr1:153661788-153671028,9240
21483374,21503238,chr19,LINC00664,chr19:21483374-21503238,19864
16646131,16706523,chr7,BZW2,chr7:16646131-16706523,60392
21521343,21521896,chr19,BNIP3P26,chr19:21521343-21521896,553
7739993,7747564,chr19,CD209,chr19:7739993-7747564,7571
28719985,28724359,chr17,RPL23A,chr17:28719985-28724359,4374
119439843,119525301,chr2,SCTR,chr2:119439843-119525301,85458
12136435,12138849,chr8,USP17L2,chr8:12136435-12138849,2414
143080630,143083486,chr8,LY6L,chr8:143080630-143083486,2856
11982256,11984590,chr8,DEFB135,chr8:11982256-11984590,2334
7482504,7486400,chr8,DEFB106B,chr8:7482504-7486400,3896
6977649,6980092,chr8,DEFA1,chr8:6977649-6980092,2443
168178962,168202109,chr1,TIPRL,chr1:168178962-168202109,23147
186157896,186158843,chr4,RPSAP70,chr4:186157896-186158843,947
186170863,186171257,chr4,LTO1P1,chr4:186170863-186171257,394
186189032,186191490,chr4,FLJ38576,chr4:186189032-186191490,2458
7442684,7463674,chr8,SPAG11B,chr8:7442684-7463674,20990
186191567,186213463,chr4,CYP4V2,chr4:186191567-186213463,21896
169132531,169367948,chr1,NME7,chr1:169132531-169367948,235417
10783391,10837977,chr2,PDIA6,chr2:10783391-10837977,54586
28720550,28720616,chr17,SNORD42B,chr17:28720550-28720616,66
28722582,28722653,chr17,SNORD4A,chr17:28722582-28722653,71
28723429,28723492,chr17,SNORD42A,chr17:28723429-28723492,63
28723682,28723753,chr17,SNORD4B,chr17:28723682-28723753,71
184314495,184335358,chr3,EIF4G1,chr3:184314495-184335358,20863
28724348,28727935,chr17,TLCD1,chr17:28724348-28727935,3587
186208979,186258471,chr4,KLKB1,chr4:186208979-186258471,49492
73168119,73244504,chr10,FAM149B1,chr10:73168119-73244504,76385
23181841,23201011,chr7,NUP42,chr7:23181841-23201011,19170
28725897,28743455,chr17,NEK8,chr17:28725897-28743455,17558
7821004,7823880,chr8,DEFB105A,chr8:7821004-7823880,2876
77100656,77420144,chr15,PEAK1,chr15:77100656-77420144,319488
7539627,7542450,chr8,PRR23D1,chr8:7539627-7542450,2823
6996766,6999198,chr8,DEFA1B,chr8:6996766-6999198,2432
15434475,15625028,chr16,BMERB1,chr16:15434475-15625028,190553
232137,264703,chr8,ZNF596,chr8:232137-264703,32566
52581317,52709817,chr15,FAM214A,chr15:52581317-52709817,128500
73183362,73247255,chr10,DNAJC9,chr10:73183362-73247255,63893
167630093,167708696,chr1,RCSD1,chr1:167630093-167708696,78603
15703135,15857028,chr16,MYH11,chr16:15703135-15857028,153893
186266189,186289681,chr4,F11,chr4:186266189-186289681,23492
73199826,73201225,chr10,EIF4A2P2,chr10:73199826-73201225,1399
32495426,32588726,chr7,AVL9,chr7:32495426-32588726,93300
73247360,73276984,chr10,DNAJC9-AS1,chr10:73247360-73276984,29624
28802444,28802822,chr17,RPL31P58,chr17:28802444-28802822,378
73248843,73252693,chr10,MRPS16,chr10:73248843-73252693,3850
28506243,28538900,chr17,FOXN1,chr17:28506243-28538900,32657
187563061,187564131,chr1,FDPSP1,chr1:187563061-187564131,1070
175315194,175743616,chr1,TNR,chr1:175315194-175743616,428422
73279062,73279168,chr10,RNU6-833P,chr10:73279062-73279168,106
46511511,46555650,chr17,LRRC37A2,chr17:46511511-46555650,44139
73375101,73414076,chr10,ANXA7,chr10:73375101-73414076,38975
7476875,7497449,chr19,PEX11G,chr19:7476875-7497449,20574
46590669,46757464,chr17,NSF,chr17:46590669-46757464,166795
6581474,6581609,chr12,SCARNA11,chr12:6581474-6581609,135
66987680,66995586,chr7,SBDS,chr7:66987680-66995586,7906
7492976,7508450,chr19,TEX45,chr19:7492976-7508450,15474
9444414,9450666,chr4,DEFB131A,chr4:9444414-9450666,6252
42157104,42238349,chr12,YAF2,chr12:42157104-42238349,81245
25861830,25929813,chr4,SMIM20,chr4:25861830-25929813,67983
1617915,1684313,chr4,FAM53A,chr4:1617915-1684313,66398
168225938,168253021,chr1,SFT2D2,chr1:168225938-168253021,27083
94394895,94431227,chr7,COL1A2,chr7:94394895-94431227,36332
7515292,7521025,chr19,ZNF358,chr19:7515292-7521025,5733
163524298,164384050,chr4,MARCHF1,chr4:163524298-164384050,859752
7522624,7534009,chr19,MCOLN1,chr19:7522624-7534009,11385
166081183,166087483,chr1,FAM78B-AS1,chr1:166081183-166087483,6300
165827614,165911618,chr1,UCK2,chr1:165827614-165911618,84004
375931,384079,chr8,FAM87A,chr8:375931-384079,8148
35008504,35127006,chr10,CUL2,chr10:35008504-35127006,118502
104330324,104467055,chr8,DPYS,chr8:104330324-104467055,136731
42238447,42459715,chr12,PPHLN1,chr12:42238447-42459715,221268
46721582,46722167,chr17,RPS7P11,chr17:46721582-46722167,585
70051277,70068095,chr17,LINC01028,chr17:70051277-70068095,16818
39639107,39666879,chr4,SMIM14-DT,chr4:39639107-39666879,27772
70166961,70169402,chr17,KCNJ2-AS1,chr17:70166961-70169402,2441
70168673,70180044,chr17,KCNJ2,chr17:70168673-70180044,11371
70241324,70241761,chr17,CALM2P1,chr17:70241324-70241761,437
160024953,160031990,chr1,PIGM,chr1:160024953-160031990,7037
76071961,76083666,chr17,ZACN,chr17:76071961-76083666,11705
233718736,233773300,chr2,UGT1A4,chr2:233718736-233773300,54564
104339087,104356689,chr8,DCSTAMP,chr8:104339087-104356689,17602
179025804,179076567,chr1,FAM20B,chr1:179025804-179076567,50763
7534004,7561764,chr19,PNPLA6,chr19:7534004-7561764,27760
57109762,57207459,chr4,IGFBP7-AS1,chr4:57109762-57207459,97697
34379068,34437808,chr15,GOLGA8A,chr15:34379068-34437808,58740
78638780,78683185,chr4,LINC01094,chr4:78638780-78683185,44405
190624890,190801658,chr1,LINC01720,chr1:190624890-190801658,176768
168540768,168543997,chr1,XCL2,chr1:168540768-168543997,3229
104484369,104484465,chr8,MIR548A3,chr8:104484369-104484465,96
76074781,76077537,chr17,GALR2,chr17:76074781-76077537,2756
123644442,123653801,chr8,KLHL38,chr8:123644442-123653801,9359
179968686,179969506,chr1,RPSAP16,chr1:179968686-179969506,820
76081016,76121576,chr17,EXOC7,chr17:76081016-76121576,40560
180154869,180204030,chr1,QSOX1,chr1:180154869-180204030,49161
6499632,6563409,chr8,ANGPT2,chr8:6499632-6563409,63777
117360596,117412712,chr4,LINC02263,chr4:117360596-117412712,52116
2512529,2529177,chr7,LFNG,chr7:2512529-2529177,16648
190908460,191020960,chr2,STAT1,chr2:190908460-191020960,112500
110595504,110615603,chr4,PANCR,chr4:110595504-110615603,20099
169917761,169975930,chr4,LINC02275,chr4:169917761-169975930,58169
89820174,89820868,chr1,LRRC8D-DT,chr1:89820174-89820868,694
170226535,170284881,chr4,LINC01612,chr4:170226535-170284881,58346
189764391,189940733,chr4,FRG1-DT,chr4:189764391-189940733,176342
45117366,45129938,chr15,DUOXA1,chr15:45117366-45129938,12572
167220876,167427345,chr1,POU2F1,chr1:167220876-167427345,206469
6622124,6622220,chr8,MIR8055,chr8:6622124-6622220,96
6708642,6761503,chr8,AGPAT5,chr8:6708642-6761503,52861
108538190,108620460,chr4,RPL34-DT,chr4:108538190-108620460,82270
44748581,44769881,chr7,ZMIZ2,chr7:44748581-44769881,21300
1115197,1153726,chr4,TMED11P,chr4:1115197-1153726,38529
2934882,2961738,chr4,NOP14-AS1,chr4:2934882-2961738,26856
6745164,6745244,chr8,MIR4659A,chr8:6745164-6745244,80
6745168,6745240,chr8,MIR4659B,chr8:6745168-6745240,72
11676959,11760002,chr8,GATA4,chr8:11676959-11760002,83043
72219403,72320646,chr5,MRPS27,chr5:72219403-72320646,101243
6406592,6648508,chr8,MCPH1,chr8:6406592-6648508,241916
76210956,76216025,chr11,LINC02761,chr11:76210956-76216025,5069
76349898,76381132,chr11,THAP12,chr11:76349898-76381132,31234
128292751,128519398,chr4,LINC02615,chr4:128292751-128519398,226647
76381303,76414619,chr11,GVQW3,chr11:76381303-76414619,33316
181874438,182145249,chr4,TENM3-AS1,chr4:181874438-182145249,270811
76444923,76553025,chr11,EMSY,chr11:76444923-76553025,108102
42312086,42326257,chr12,ZCRB1,chr12:42312086-42326257,14171
99756960,99784248,chr7,CYP3A4,chr7:99756960-99784248,27288
38509729,38518056,chr4,LINC01259,chr4:38509729-38518056,8327
120066944,120564789,chr4,MAD2L1-DT,chr4:120066944-120564789,497845
140926299,141012347,chr5,PCDHAC1,chr5:140926299-141012347,86048
141302910,141357096,chr4,LINC02432,chr4:141302910-141357096,54186
42323700,42323859,chr12,MIR7851,chr12:42323700-42323859,159
42398550,42398651,chr12,RNU6-249P,chr12:42398550-42398651,101
17490967,17492076,chr5,H3Y2,chr5:17490967-17492076,1109
123539026,123962704,chr4,LINC01091,chr4:123539026-123962704,423678
77628712,77638713,chr5,OTP,chr5:77628712-77638713,10001
82262810,82284930,chr15,SAXO2,chr15:82262810-82284930,22120
6538961,6556073,chr12,IFFO1,chr12:6538961-6556073,17112
98853985,98929007,chr5,CHD1,chr5:98853985-98929007,75022
7763210,7769605,chr19,CLEC4M,chr19:7763210-7769605,6395
101922042,101923113,chr15,OR4F4,chr15:101922042-101923113,1071
75639085,75648706,chr15,IMP3,chr15:75639085-75648706,9621
82543201,82648861,chr15,CPEB1,chr15:82543201-82648861,105660
57855500,57984126,chr8,LINC01602,chr8:57855500-57984126,128626
166796266,166797183,chr1,CNN2P10,chr1:166796266-166797183,917
10798397,11336675,chr10,CELF2,chr10:10798397-11336675,538278
58113189,58113622,chr8,RPL26P26,chr8:58113189-58113622,433
169921326,170085208,chr1,KIFAP3,chr1:169921326-170085208,163882
73567537,73578791,chr7,TBL2,chr7:73567537-73578791,11254
797075,812327,chr19,PTBP1,chr19:797075-812327,15252
88284507,88341661,chr4,PPM1K-DT,chr4:88284507-88341661,57154
103255822,103454667,chr4,LINC02428,chr4:103255822-103454667,198845
57994523,58204279,chr8,FAM110B,chr8:57994523-58204279,209756
12333644,12333693,chr8,RNA5SP254,chr8:12333644-12333693,49
38602438,38664926,chr4,KLF3-AS1,chr4:38602438-38664926,62488
12341426,12345776,chr8,DEFB108E,chr8:12341426-12345776,4350
12356136,12359391,chr8,ZNF705CP,chr8:12356136-12359391,3255
41142116,41261438,chr5,C6,chr5:41142116-41261438,119322
75749201,75919537,chr6,MYO6,chr6:75749201-75919537,170336
12362019,12388296,chr8,FAM66A,chr8:12362019-12388296,26277
28532708,28539008,chr16,NUPR1,chr16:28532708-28539008,6300
12393209,12400366,chr8,DEFB109A,chr8:12393209-12400366,7157
12415080,12418090,chr8,FAM90A25P,chr8:12415080-12418090,3010
119593774,119643075,chr12,TMEM233,chr12:119593774-119643075,49301
12421032,12425000,chr8,ALG1L12P,chr8:12421032-12425000,3968
28591943,28597050,chr16,SULT1A2,chr16:28591943-28597050,5107
12448013,12511278,chr8,ENPP7P6,chr8:12448013-12511278,63265
119631090,119631386,chr12,RN7SKP197,chr12:119631090-119631386,296
119667864,119681624,chr12,PRKAB1,chr12:119667864-119681624,13760
39902275,39928790,chr8,IDO1,chr8:39902275-39928790,26515
64971772,65006684,chr7,ZNF117,chr7:64971772-65006684,34912
142749468,142753072,chr7,PRSS1,chr7:142749468-142753072,3604
179365720,179554735,chr1,AXDND1,chr1:179365720-179554735,189015
188400736,188681051,chr4,LINC01060,chr4:188400736-188681051,280315
66469796,66481230,chr16,BEAN1-AS1,chr16:66469796-66481230,11434
57861948,57873588,chr11,OR5BA1P,chr11:57861948-57873588,11640
107891162,107931730,chr7,DLD,chr7:107891162-107931730,40568
57917297,57918239,chr11,OR5AZ1P,chr11:57917297-57918239,942
57945598,57946414,chr11,OR5BD1P,chr11:57945598-57946414,816
58005386,58005705,chr11,CYCSP26,chr11:58005386-58005705,319
58026706,58026812,chr11,RNU6-899P,chr11:58026706-58026812,106
119685791,119877320,chr12,CIT,chr12:119685791-119877320,191529
33440696,33468091,chr5,TARS1,chr5:33440696-33468091,27395
57753243,57819546,chr11,CTNND1,chr11:57753243-57819546,66303
44665732,44711323,chr15,PATL2,chr15:44665732-44711323,45591
39934614,40016397,chr8,IDO2,chr8:39934614-40016397,81783
119405523,119454653,chr4,GTF2IP12,chr4:119405523-119454653,49130
66508003,66552544,chr16,TK2,chr16:66508003-66552544,44541
131904093,132013642,chr8,EFR3A,chr8:131904093-132013642,109549
184334292,184353977,chr4,LINC02363,chr4:184334292-184353977,19685
79282722,79298239,chr15,ANKRD34C,chr15:79282722-79298239,15517
34489002,34490571,chr15,HNRNPLP2,chr15:34489002-34490571,1569
76098019,76098076,chr17,MIR6868,chr17:76098019-76098076,57
34494420,34495900,chr15,FSCN1P1,chr15:34494420-34495900,1480
76136333,76141245,chr17,FOXJ1,chr17:76136333-76141245,4912
34520608,34521791,chr15,DNM1P5,chr15:34520608-34521791,1183
174061732,174220398,chr4,LINC02268,chr4:174061732-174220398,158666
34525095,34588503,chr15,GOLGA8B,chr15:34525095-34588503,63408
76138432,76154650,chr17,RNF157-AS1,chr17:76138432-76154650,16218
3235703,3241614,chr17,OR1D4,chr17:3235703-3241614,5911
3265611,3266541,chr17,OR1D3P,chr17:3265611-3266541,930
59109857,59155260,chr17,SKA2,chr17:59109857-59155260,45403
59129276,59129458,chr17,RNU2-58P,chr17:59129276-59129458,182
59137758,59137872,chr17,MIR454,chr17:59137758-59137872,114
59151136,59151221,chr17,MIR301A,chr17:59151136-59151221,85
59155732,59206709,chr17,PRR11,chr17:59155732-59206709,50977
184892858,184899553,chr4,LINC01093,chr4:184892858-184899553,6695
183138402,183141282,chr1,LAMC1-AS1,chr1:183138402-183141282,2880
175538775,175556818,chr1,TNR-IT1,chr1:175538775-175556818,18043
106804474,106806032,chr1,MTCO1P14,chr1:106804474-106806032,1558
108167525,108258037,chr4,LEF1-AS1,chr4:108167525-108258037,90512
172748560,172749502,chr1,SLC25A38P1,chr1:172748560-172749502,942
118883046,118989556,chr1,TBX15,chr1:118883046-118989556,106510
70925030,70953942,chr5,SMN1,chr5:70925030-70953942,28912
47987148,48029119,chr7,SUN3,chr7:47987148-48029119,41971
1934677,2025334,chr17,RTN4RL1,chr17:1934677-2025334,90657
173527270,173659696,chr4,HAND2-AS1,chr4:173527270-173659696,132426
132024216,132059382,chr8,OC90,chr8:132024216-132059382,35166
168210616,168210969,chr1,RPL34P1,chr1:168210616-168210969,353
160317403,160317706,chr1,SUMO1P3,chr1:160317403-160317706,303
2030137,2043898,chr17,DPH1,chr17:2030137-2043898,13761
160678746,160711831,chr1,CD48,chr1:160678746-160711831,33085
116766505,116849463,chr8,UTP23,chr8:116766505-116849463,82958
34528290,34528371,chr15,MIR1233-2,chr15:34528290-34528371,81
34651135,34671095,chr15,LINC02252,chr15:34651135-34671095,19960
169990067,169990196,chr1,MRPS10P1,chr1:169990067-169990196,129
38068812,38072990,chr15,LINC01852,chr15:38068812-38072990,4178
116874424,116876868,chr8,RAD21-AS1,chr8:116874424-116876868,2444
37921939,37967724,chr15,TMCO5A,chr15:37921939-37967724,45785
116874728,116874800,chr8,MIR3610,chr8:116874728-116874800,72
116938207,116944487,chr8,AARD,chr8:116938207-116944487,6280
160288594,160343273,chr1,COPA,chr1:160288594-160343273,54679
22977877,22978127,chr8,RN7SL303P,chr8:22977877-22978127,250
22987417,23020509,chr8,RHOBTB2,chr8:22987417-23020509,33092
106654360,106661158,chr7,CCDC71L,chr7:106654360-106661158,6798
75092573,75149817,chr7,GTF2IRD2B,chr7:75092573-75149817,57244
49487510,49493057,chr19,RPL13A,chr19:49487510-49493057,5547
73253762,73358864,chr10,CFAP70,chr10:73253762-73358864,105102
2042022,2043425,chr17,OVCA2,chr17:2042022-2043425,1403
20073699,20074334,chr15,BCAR1P1,chr15:20073699-20074334,635
20095733,20096029,chr15,RN7SL584P,chr15:20095733-20096029,296
20153776,20160826,chr15,BMS1P15,chr15:20153776-20160826,7050
2049908,2050008,chr17,MIR132,chr17:2049908-2050008,100
2050271,2050380,chr17,MIR212,chr17:2050271-2050380,109
20228620,20277503,chr15,RHPN2P1,chr15:20228620-20277503,48883
2054154,2063241,chr17,HIC1,chr17:2054154-2063241,9087
32868172,32894131,chr7,KBTBD2,chr7:32868172-32894131,25959
23020133,23069031,chr8,TNFRSF10B,chr8:23020133-23069031,48898
42908208,42908667,chr5,PRELID3BP5,chr5:42908208-42908667,459
42917414,42917984,chr5,PRELID3BP6,chr5:42917414-42917984,570
20282744,20291586,chr15,CHEK2P2,chr15:20282744-20291586,8842
42972624,42973092,chr5,PRELID3BP7,chr5:42972624-42973092,468
2059839,2303785,chr17,SMG6,chr17:2059839-2303785,243946
12330885,12403941,chr7,VWDE,chr7:12330885-12403941,73056
84235773,84245358,chr15,GOLGA6L4,chr15:84235773-84245358,9585
43231812,43233173,chr5,TUBAP14,chr5:43231812-43233173,1361
66278498,66293357,chr15,DIS3L-AS1,chr15:66278498-66293357,14859
66293217,66333898,chr15,DIS3L,chr15:66293217-66333898,40681
96525267,96779595,chr5,CAST,chr5:96525267-96779595,254328
121709393,121928801,chr10,ATE1,chr10:121709393-121928801,219408
12525373,12551542,chr19,ZNF564,chr19:12525373-12551542,26169
12559571,12561105,chr19,PGK1P2,chr19:12559571-12561105,1534
12576100,12640098,chr19,ZNF490,chr19:12576100-12640098,63998
44606572,44709066,chr7,OGDH,chr7:44606572-44709066,102494
12610918,12633840,chr19,ZNF791,chr19:12610918-12633840,22922
30699807,30717447,chr6,MDC1,chr6:30699807-30717447,17640
184325696,184325771,chr3,SNORD66,chr3:184325696-184325771,75
23102921,23117445,chr8,TNFRSF10C,chr8:23102921-23117445,14524
184335926,184348421,chr3,FAM131A,chr3:184335926-184348421,12495
12643275,12643919,chr19,RPL10P16,chr19:12643275-12643919,644
12646511,12666742,chr19,MAN2B1,chr19:12646511-12666742,20231
23135588,23164027,chr8,TNFRSF10D,chr8:23135588-23164027,28439
84003332,84003479,chr10,RNU1-65P,chr10:84003332-84003479,147
84081429,84081995,chr10,HMGN2P8,chr10:84081429-84081995,566
2127430,2127904,chr17,MCUR1P1,chr17:2127430-2127904,474
2199762,2200039,chr17,RN7SL624P,chr17:2199762-2200039,277
84139482,84154841,chr10,GHITM,chr10:84139482-84154841,15359
2235713,2236086,chr17,SMG6-IT1,chr17:2235713-2236086,373
2303383,2325260,chr17,SRR,chr17:2303383-2325260,21877
170554302,170572870,chr6,TBP,chr6:170554302-170572870,18568
2682523,2709030,chr16,KCTD5,chr16:2682523-2709030,26507
23190452,23225102,chr8,TNFRSF10A,chr8:23190452-23225102,34650
66336191,66386746,chr15,TIPIN,chr15:66336191-66386746,50555
84167228,84172093,chr10,CERNA2,chr10:84167228-84172093,4865
84173801,84185294,chr10,C10orf99,chr10:84173801-84185294,11493
84194537,84219621,chr10,CDHR1,chr10:84194537-84219621,25084
109347475,109433817,chr4,SEC24B-AS1,chr4:109347475-109433817,86342
2712419,2720551,chr16,PRSS27,chr16:2712419-2720551,8132
184346185,184361650,chr3,CLCN2,chr3:184346185-184361650,15465
2306761,2307715,chr17,HNRNPA1P16,chr17:2306761-2307715,954
2322396,2336657,chr17,TSR1,chr17:2322396-2336657,14261
133075311,133149147,chr4,PCDH10-DT,chr4:133075311-133149147,73836
66347207,66347342,chr15,SCARNA14,chr15:66347207-66347342,135
66379337,66379915,chr15,RPL9P25,chr15:66379337-66379915,578
23189279,23190675,chr8,TNFRSF10A-AS1,chr8:23189279-23190675,1396
23206918,23207369,chr8,RPL23AP55,chr8:23206918-23207369,451
23224471,23230926,chr8,TNFRSF10A-DT,chr8:23224471-23230926,6455
66386837,66491656,chr15,MAP2K1,chr15:66386837-66491656,104819
2737076,2752600,chr16,SRRM2-AS1,chr16:2737076-2752600,15524
23243637,23262000,chr8,CHMP7,chr8:23243637-23262000,18363
41872741,41882955,chr4,LINC00682,chr4:41872741-41882955,10214
2752626,2772538,chr16,SRRM2,chr16:2752626-2772538,19912
119713634,119713724,chr12,MIR1178,chr12:119713634-119713724,90
119959424,119959754,chr12,RPL35AP30,chr12:119959424-119959754,330
7093776,7103394,chr4,LINC02447,chr4:7093776-7103394,9618
6747996,6767475,chr12,MLF2,chr12:6747996-6767475,19479
39527720,39594707,chr4,UGDH-AS1,chr4:39527720-39594707,66987
2329016,2329237,chr17,SNORD91B,chr17:2329016-2329237,221
32180968,32184322,chr6,AGER,chr6:32180968-32184322,3354
102827611,102844099,chr4,UBE2D3-AS1,chr4:102827611-102844099,16488
2330180,2330370,chr17,SNORD91A,chr17:2330180-2330370,190
82374142,82384027,chr4,HNRNPD-DT,chr4:82374142-82384027,9885
189560590,189583758,chr2,SLC40A1,chr2:189560590-189583758,23168
107863473,107989692,chr4,CYP2U1-AS1,chr4:107863473-107989692,126219
63432304,63446354,chr17,CYB561,chr17:63432304-63446354,14050
132061480,132111159,chr8,HHLA1,chr8:132061480-132111159,49679
108147623,108456717,chr7,NRCAM,chr7:108147623-108456717,309094
84220571,84225544,chr10,LRIT2,chr10:84220571-84225544,4973
31997376,32228543,chr4,LINC02506,chr4:31997376-32228543,231167
144435551,144435619,chr8,MIR6893,chr8:144435551-144435619,68
144437675,144439971,chr8,TONSL-AS1,chr8:144437675-144439971,2296
144449582,144465667,chr8,CYHR1,chr8:144449582-144465667,16085
8320105,8327165,chr4,LINC02517,chr4:8320105-8327165,7060
12666802,12675832,chr19,WDR83,chr19:12666802-12675832,9030
84230666,84259960,chr10,RGR,chr10:84230666-84259960,29294
119454762,119552025,chr4,SEPTIN7P14,chr4:119454762-119552025,97263
241106099,241150264,chr2,PASK,chr2:241106099-241150264,44165
165400922,165445355,chr1,RXRG,chr1:165400922-165445355,44433
144466043,144474202,chr8,KIFC2,chr8:144466043-144474202,8159
66414933,66415198,chr15,ATP5MFP6,chr15:66414933-66415198,265
66446455,66446777,chr15,RPL35AP32,chr15:66446455-66446777,322
84231520,84241546,chr10,LRIT1,chr10:84231520-84241546,10026
84267747,84294659,chr10,LINC00858,chr10:84267747-84294659,26912
66490135,66497780,chr15,SNAPC5,chr15:66490135-66497780,7645
12668073,12669415,chr19,WDR83OS,chr19:12668073-12669415,1342
84389170,84389626,chr10,RPL12P29,chr10:84389170-84389626,456
84390908,84392045,chr10,TNPO1P1,chr10:84390908-84392045,1137
84454679,84456056,chr10,CACYBPP1,chr10:84454679-84456056,1377
184380073,184390736,chr3,CHRD,chr3:184380073-184390736,10663
12687998,12688422,chr19,GNG14,chr19:12687998-12688422,424
17228241,17237593,chr10,VIM,chr10:17228241-17237593,9352
6965327,6970780,chr12,PHB2,chr12:6965327-6970780,5453
144473412,144475849,chr8,FOXH1,chr8:144473412-144475849,2437
12688053,12696631,chr19,FBXW9,chr19:12688053-12696631,8578
175877343,175880468,chr1,LINC01657,chr1:175877343-175880468,3125
63471604,63472093,chr17,PPIAP55,chr17:63471604-63472093,489
186311652,186375693,chr1,TPR,chr1:186311652-186375693,64041
66496958,66497034,chr15,MIR4512,chr15:66496958-66497034,76
66498015,66524532,chr15,RPL4,chr15:66498015-66524532,26517
144477969,144502121,chr8,PPP1R16A,chr8:144477969-144502121,24152
63477061,63498380,chr17,ACE,chr17:63477061-63498380,21319
139411927,139454034,chr4,RAB33B-AS1,chr4:139411927-139454034,42107
2796408,2796532,chr16,SNORA3C,chr16:2796408-2796532,124
2798470,2805304,chr16,PRSS41,chr16:2798470-2805304,6834
173699082,174001488,chr4,LINC02269,chr4:173699082-174001488,302406
2817180,2826304,chr16,PRSS21,chr16:2817180-2826304,9124
12706449,12706518,chr19,SNORD41,chr19:12706449-12706518,69
12730640,12734684,chr19,TRIR,chr19:12730640-12734684,4044
12737139,12748323,chr19,GET3,chr19:12737139-12748323,11184
144642919,144661357,chr4,HHIP-AS1,chr4:144642919-144661357,18438
12751702,12758458,chr19,BEST2,chr19:12751702-12758458,6756
140283724,140373406,chr4,SCOC-AS1,chr4:140283724-140373406,89682
152090459,152110157,chr4,LINC02273,chr4:152090459-152110157,19698
72175984,72826041,chr2,EXOC6B,chr2:72175984-72826041,650057
104117086,104138241,chr12,NFYB,chr12:104117086-104138241,21155
67701209,68080952,chr4,UBA6-DT,chr4:67701209-68080952,379743
2822659,2822993,chr16,EIF1P4,chr16:2822659-2822993,334
12787128,12787192,chr19,MIR5684,chr19:12787128-12787192,64
12791486,12793315,chr19,JUNB,chr19:12791486-12793315,1829
2852730,2858170,chr16,PRSS22,chr16:2852730-2858170,5440
12796820,12801800,chr19,PRDX2,chr19:12796820-12801800,4980
144502973,144507174,chr8,GPT,chr8:144502973-144507174,4201
104125236,104125356,chr12,RNA5SP370,chr12:104125236-104125356,120
104170395,104177659,chr12,LINC02385,chr12:104170395-104177659,7264
78939485,79309673,chr4,LINC01088,chr4:78939485-79309673,370188
104265309,104265836,chr12,RPL18AP3,chr12:104265309-104265836,527
44911316,44937010,chr10,TMEM72,chr10:44911316-44937010,25694
104303739,104305205,chr12,EID3,chr12:104303739-104305205,1466
116738178,116853631,chr12,RNFT2,chr12:116738178-116853631,115453
12806584,12813640,chr19,RNASEH2A,chr19:12806584-12813640,7056
70298970,70382650,chr10,LRRC20,chr10:70298970-70382650,83680
67660946,67662774,chr16,PARD6A,chr16:67660946-67662774,1828
79491802,79623479,chr4,LINC00989,chr4:79491802-79623479,131677
5044122,5066110,chr16,C16orf89,chr16:5044122-5066110,21988
148272304,148552044,chr6,SASH1,chr6:148272304-148552044,279740
12833951,12874952,chr19,MAST1,chr19:12833951-12874952,41001
96129715,96205288,chr10,ZNF518A,chr10:96129715-96205288,75573
101347752,101348887,chr4,FLJ20021,chr4:101347752-101348887,1135
96248514,96265997,chr2,TMEM127,chr2:96248514-96265997,17483
66501250,66501318,chr15,SNORD18C,chr15:66501250-66501318,68
66502020,66502091,chr15,SNORD18B,chr15:66502020-66502091,71
66502812,66502910,chr15,SNORD16,chr15:66502812-66502910,98
66503243,66503314,chr15,SNORD18A,chr15:66503243-66503314,71
160115759,160143591,chr1,ATP1A2,chr1:160115759-160143591,27832
65824460,65966291,chr12,HMGA2,chr12:65824460-65966291,141831
66504959,66550130,chr15,ZWILCH,chr15:66504959-66550130,45171
144509070,144511213,chr8,MFSD3,chr8:144509070-144511213,2143
114086327,114693772,chr7,FOXP2,chr7:114086327-114693772,607445
118278705,118285316,chr4,SNHG8,chr4:118278705-118285316,6611
184399790,184457891,chr3,LINC02054,chr3:184399790-184457891,58101
58159243,58241372,chr2,FANCL,chr2:58159243-58241372,82129
63507056,63519806,chr17,ACE3P,chr17:63507056-63519806,12750
22162992,22165794,chr10,ADIPOR1P1,chr10:22162992-22165794,2802
184505113,184508399,chr3,LINC01839,chr3:184505113-184508399,3286
63610772,63611184,chr17,FAM136DP,chr17:63610772-63611184,412
22208475,22218015,chr10,EBLN1,chr10:22208475-22218015,9540
38039205,38124025,chr3,DLEC1,chr3:38039205-38124025,84820
63622415,63696305,chr17,MAP3K3,chr17:63622415-63696305,73890
22225698,22226024,chr10,PSME2P6,chr10:22225698-22226024,326
89948697,89968060,chr16,DEF8,chr16:89948697-89968060,19363
22266991,22267346,chr10,RPL31P45,chr10:22266991-22267346,355
20401879,20493714,chr6,E2F3,chr6:20401879-20493714,91835
144511288,144517845,chr8,RECQL4,chr8:144511288-144517845,6557
22316386,22320306,chr10,COMMD3,chr10:22316386-22320306,3920
32821833,32838739,chr6,TAP2,chr6:32821833-32838739,16906
173349543,173370721,chr4,SAP30-DT,chr4:173349543-173370721,21178
12852260,12852327,chr19,MIR6794,chr19:12852260-12852327,67
12875209,12881466,chr19,DNASE2,chr19:12875209-12881466,6257
122728532,122732482,chr4,CETN4P,chr4:122728532-122732482,3950
112513516,112516180,chr4,NEUROG2,chr4:112513516-112516180,2664
112515385,112546881,chr4,NEUROG2-AS1,chr4:112515385-112546881,31496
12894133,12894880,chr19,RPS6P25,chr19:12894133-12894880,747
112530371,112530672,chr4,RPL23AP94,chr4:112530371-112530672,301
112539333,112636995,chr4,ZGRF1,chr4:112539333-112636995,97662
12763003,12872740,chr19,HOOK2,chr19:12763003-12872740,109737
70243002,70354993,chr12,CNOT2,chr12:70243002-70354993,111991
36390551,36442854,chr6,PXT1,chr6:36390551-36442854,52303
169792529,169794963,chr1,METTL18,chr1:169792529-169794963,2434
73241314,73310365,chr6,KHDC1,chr6:73241314-73310365,69051
160266340,160267225,chr1,RPSAP18,chr1:160266340-160267225,885
22316388,22329542,chr10,COMMD3-BMI1,chr10:22316388-22329542,13154
162395268,162412138,chr1,SH2D1B,chr1:162395268-162412138,16870
191221159,191228467,chr1,LINC01680,chr1:191221159-191228467,7308
15159038,15200995,chr19,NOTCH3,chr19:15159038-15200995,41957
38051759,38052395,chr3,PPP2R2DP1,chr3:38051759-38052395,636
33572547,33580293,chr6,BAK1,chr6:33572547-33580293,7746
111290851,111320566,chr1,CHIA,chr1:111290851-111320566,29715
231781671,231809254,chr2,COPS7B,chr2:231781671-231809254,27583
38103129,38137242,chr3,ACAA1,chr3:38103129-38137242,34113
144517992,144525172,chr8,LRRC14,chr8:144517992-144525172,7180
46220736,46491972,chr6,RCAN2,chr6:46220736-46491972,271236
112564988,112565398,chr4,H3P14,chr4:112564988-112565398,410
22321099,22331484,chr10,BMI1,chr10:22321099-22331484,10385
112637077,112657696,chr4,LARP7,chr4:112637077-112657696,20619
7107597,7251980,chr6,RREB1,chr6:7107597-7251980,144383
144522388,144527033,chr8,LRRC24,chr8:144522388-144527033,4645
15179283,15179350,chr19,MIR6795,chr19:15179283-15179350,67
15226919,15233435,chr19,EPHX3,chr19:15226919-15233435,6516
144525733,144529132,chr8,C8orf82,chr8:144525733-144529132,3399
63636601,63637113,chr17,EEF1DP7,chr17:63636601-63637113,512
63695888,63701172,chr17,LIMD2,chr17:63695888-63701172,5284
66547179,66565979,chr15,LCTL,chr15:66547179-66565979,18800
112646476,112650051,chr4,MIR302CHG,chr4:112646476-112650051,3575
40576853,40591399,chr19,SHKBP1,chr19:40576853-40591399,14546
144720907,144756417,chr8,ZNF251,chr8:144720907-144756417,35510
114043866,114046904,chr10,ADRB1,chr10:114043866-114046904,3038
144798876,144811169,chr8,ZNF517,chr8:144798876-144811169,12293
114111414,114111517,chr10,RNU6-709P,chr10:114111414-114111517,103
114117147,114117551,chr10,UBE2V1P5,chr10:114117147-114117551,404
114120862,114174232,chr10,CCDC186,chr10:114120862-114174232,53370
47649476,47685505,chr17,KPNB1,chr17:47649476-47685505,36029
66582190,66685794,chr15,LINC01169,chr15:66582190-66685794,103604
32536047,32587613,chr15,LINC02256,chr15:32536047-32587613,51566
39743735,39838227,chr8,ADAM2,chr8:39743735-39838227,94492
32593456,32607310,chr15,GOLGA8N,chr15:32593456-32607310,13854
114174105,114174179,chr10,MIR2110,chr10:114174105-114174179,74
114239254,114294489,chr10,VWA2,chr10:114239254-114294489,55235
241687085,241729478,chr2,ING5,chr2:241687085-241729478,42393
32602121,32602411,chr15,RN7SL286P,chr15:32602121-32602411,290
84177847,84187070,chr16,TAF1C,chr16:84177847-84187070,9223
32615144,32639941,chr15,ARHGAP11A,chr15:32615144-32639941,24797
165497724,165498348,chr1,PRELID1P7,chr1:165497724-165498348,624
114246074,114246714,chr10,AURKAP2,chr10:114246074-114246714,640
177928788,178038007,chr1,CRYZL2P-SEC16B,chr1:177928788-178038007,109219
114179270,114232304,chr10,TDRD1,chr10:114179270-114232304,53034
33299694,33314254,chr6,TAPBP,chr6:33299694-33314254,14560
100709295,100748964,chr3,TFG,chr3:100709295-100748964,39669
48040462,48040577,chr10,RNA5SP315,chr10:48040462-48040577,115
130592165,130599575,chr2,CFC1,chr2:130592165-130599575,7410
35219894,35230598,chr10,LINC02634,chr10:35219894-35230598,10704
35231331,35231394,chr10,RNU6-794P,chr10:35231331-35231394,63
35250959,35251052,chr10,RNU6-1167P,chr10:35250959-35251052,93
35314552,35336401,chr10,CCNY-AS1,chr10:35314552-35336401,21849
100872372,100895179,chr1,EXTL2,chr1:100872372-100895179,22807
46578217,46594173,chr10,SYT15,chr10:46578217-46594173,15956
68643579,68658251,chr2,PROKR1,chr2:68643579-68658251,14672
157876702,158136154,chr2,UPP2,chr2:157876702-158136154,259452
40592883,40629818,chr19,LTBP4,chr19:40592883-40629818,36935
160215715,160262549,chr1,DCAF8,chr1:160215715-160262549,46834
31711771,31714065,chr6,LY6G6E,chr6:31711771-31714065,2294
112054075,112069686,chr6,CCN6,chr6:112054075-112069686,15611
46610474,46652025,chr10,SHLD2P1,chr10:46610474-46652025,41551
6462237,6470677,chr12,VAMP1,chr12:6462237-6470677,8440
46632387,46635472,chr10,LINC02637,chr10:46632387-46635472,3085
222199887,222298998,chr2,PAX3,chr2:222199887-222298998,99111
22812628,22822849,chr7,TOMM7,chr7:22812628-22822849,10221
46634911,46635466,chr10,RHEBP1,chr10:46634911-46635466,555
46648948,46649276,chr10,RN7SL248P,chr10:46648948-46649276,328
47733236,47746122,chr17,TBX21,chr17:47733236-47746122,12886
46541736,46556658,chr10,GPRIN2,chr10:46541736-46556658,14922
122374696,122432354,chr10,PLEKHA1,chr10:122374696-122432354,57658
158730995,158830253,chr7,ESYT2,chr7:158730995-158830253,99258
47807372,47821834,chr17,OSBPL7,chr17:47807372-47821834,14462
32656084,32673065,chr15,SCG5-AS1,chr15:32656084-32673065,16981
32717270,32719007,chr15,GREM1-AS1,chr15:32717270-32719007,1737
116642130,116766925,chr8,EIF3H,chr8:116642130-116766925,124795
103594027,103855584,chr10,SH3PXD2A,chr10:103594027-103855584,261557
32718004,32745106,chr15,GREM1,chr15:32718004-32745106,27102
22287244,22302826,chr6,PRL,chr6:22287244-22302826,15582
30604028,30617752,chr15,GOLGA8H,chr15:30604028-30617752,13724
56080283,56092996,chr7,PHKG1,chr7:56080283-56092996,12713
48684873,48982956,chr10,WDFY4,chr10:48684873-48982956,298083
161347417,162727775,chr6,PRKN,chr6:161347417-162727775,1380358
54280193,54287088,chr12,HNRNPA1,chr12:54280193-54287088,6895
48120990,48142672,chr15,SLC24A5,chr15:48120990-48142672,21682
120059780,120373573,chr8,COL14A1,chr8:120059780-120373573,313793
69762328,69941741,chr16,WWP2,chr16:69762328-69941741,179413
31164337,31180731,chr6,POU5F1,chr6:31164337-31180731,16394
1082208,1093815,chr7,GPER1,chr7:1082208-1093815,11607
107826892,107892544,chr2,RGPD4,chr2:107826892-107892544,65652
27170605,27180261,chr7,HOXA10,chr7:27170605-27180261,9656
48178122,48203758,chr15,CTXN2,chr15:48178122-48203758,25636
230984368,230996032,chr2,SPATA3-AS1,chr2:230984368-230996032,11664
47823272,47831541,chr17,MRPL10,chr17:47823272-47831541,8269
168245565,168247343,chr1,ANKRD36BP1,chr1:168245565-168247343,1778
141074064,141480380,chr7,TMEM178B,chr7:141074064-141480380,406316
48178438,48304078,chr15,SLC12A1,chr15:48178438-48304078,125640
157993273,158100262,chr1,KIRREL1,chr1:157993273-158100262,106989
142760398,142774564,chr7,PRSS2,chr7:142760398-142774564,14166
100969458,100987515,chr10,MRPL43,chr10:100969458-100987515,18057
122318411,122886759,chr7,CADPS2,chr7:122318411-122886759,568348
231037523,231049719,chr2,C2orf72,chr2:231037523-231049719,12196
47831634,47837719,chr17,LRRC46,chr17:47831634-47837719,6085
231108230,231125042,chr2,HTR2B,chr2:231108230-231125042,16812
231133462,231133630,chr2,RNU1-93P,chr2:231133462-231133630,168
231256097,231256306,chr2,RPS28P4,chr2:231256097-231256306,209
231362708,231362793,chr2,MIR4777,chr2:231362708-231362793,85
231395710,231401164,chr2,B3GNT7,chr2:231395710-231401164,5454
231433923,231434426,chr2,ZBTB8OSP2,chr2:231433923-231434426,503
231437101,231437421,chr2,HIGD2AP1,chr2:231437101-231437421,320
47837692,47841289,chr17,SCRN2,chr17:47837692-47841289,3597
231456444,231456523,chr2,SNORD20,chr2:231456444-231456523,79
231460371,231460440,chr2,SNORD82,chr2:231460371-231460440,69
150218417,150236156,chr1,ANP32E,chr1:150218417-150236156,17739
231501990,231502201,chr2,RNU2-22P,chr2:231501990-231502201,211
231523187,231530445,chr2,NMUR1,chr2:231523187-231530445,7258
240565804,240581372,chr2,RNPEPL1,chr2:240565804-240581372,15568
40665905,40690972,chr19,NUMBL,chr19:40665905-40690972,25067
675671,678268,chr16,RHBDL1,chr16:675671-678268,2597
35126791,35212958,chr10,CREM,chr10:35126791-35212958,86167
39025987,39026093,chr3,RNU6-1227P,chr3:39025987-39026093,106
39052013,39096671,chr3,WDR48,chr3:39052013-39096671,44658
68035636,68047364,chr17,KPNA2,chr17:68035636-68047364,11728
240582700,240586699,chr2,CAPN10-DT,chr2:240582700-240586699,3999
67806765,67832148,chr16,TSNAXIP1,chr16:67806765-67832148,25383
240586734,240617705,chr2,CAPN10,chr2:240586734-240617705,30971
64308316,64308690,chr17,RPL31P57,chr17:64308316-64308690,374
64319415,64413776,chr17,PECAM1,chr17:64319415-64413776,94361
46557398,46559694,chr3,LRRC2-AS1,chr3:46557398-46559694,2296
200623896,200669907,chr1,DDX59,chr1:200623896-200669907,46011
46574534,46582457,chr3,TDGF1,chr3:46574534-46582457,7923
40708055,40708163,chr19,RNU6-195P,chr19:40708055-40708163,108
64449037,64468643,chr17,MILR1,chr17:64449037-64468643,19606
40691514,40725784,chr19,COQ8B,chr19:40691514-40725784,34270
46668995,46693704,chr3,ALS2CL,chr3:46668995-46693704,24709
21543039,21901839,chr7,DNAH11,chr7:21543039-21901839,358800
184790724,184974508,chr1,NIBAN1,chr1:184790724-184974508,183784
53966552,54022456,chr8,TCEA1,chr8:53966552-54022456,55904
64477785,64497054,chr17,POLG2,chr17:64477785-64497054,19269
223856579,223857387,chr1,PHBP11,chr1:223856579-223857387,808
211829636,211853703,chr1,LPGAT1-AS1,chr1:211829636-211853703,24067
167519536,167520586,chr1,AKR1D1P1,chr1:167519536-167520586,1050
178006136,178037950,chr1,CRYZL2P,chr1:178006136-178037950,31814
91534666,91535593,chr1,WDR82P2,chr1:91534666-91535593,927
64491523,64491789,chr17,ATP5MFP4,chr17:64491523-64491789,266
91023919,91024804,chr1,RPL5P6,chr1:91023919-91024804,885
64500774,64500839,chr17,MIR3064,chr17:64500774-64500839,65
64501214,64501313,chr17,MIR5047,chr17:64501214-64501313,99
180230264,180278984,chr1,LHX4,chr1:180230264-180278984,48720
64542282,64662307,chr17,SMURF2,chr17:64542282-64662307,120025
181099140,181100666,chr5,FOXO1B,chr5:181099140-181100666,1526
138558970,138559039,chr5,SNORD63B,chr5:138558970-138559039,69
10133342,10231286,chr19,DNMT1,chr19:10133342-10231286,97944
138553756,138575675,chr5,HSPA9,chr5:138553756-138575675,21919
35930718,36072500,chr1,AGO3,chr1:35930718-36072500,141782
240676418,240682906,chr2,AQP12B,chr2:240676418-240682906,6488
39950121,40099580,chr7,CDK13,chr7:39950121-40099580,149459
240868824,240880502,chr2,AGXT,chr2:240868824-240880502,11678
64747264,64747492,chr17,MICOS10P2,chr17:64747264-64747492,228
148772640,148784594,chr1,SEC22B3P,chr1:148772640-148784594,11954
64749918,64758603,chr17,KPNA2P3,chr17:64749918-64758603,8685
46694528,46710886,chr3,TMIE,chr3:46694528-46710886,16358
159535078,159536007,chr1,OR10J5,chr1:159535078-159536007,929
64186316,64222296,chr12,KICS2,chr12:64186316-64222296,35980
183186238,183245127,chr1,LAMC2,chr1:183186238-183245127,58889
132570416,132675592,chr8,DNAAF11,chr8:132570416-132675592,105176
64204793,64204899,chr12,RNU6-1009P,chr12:64204793-64204899,106
64228560,64228675,chr12,RNU5A-7P,chr12:64228560-64228675,115
64498254,64508199,chr17,DDX5,chr17:64498254-64508199,9945
48187121,48191691,chr15,CTXN2-AS1,chr15:48187121-48191691,4570
46712117,46717869,chr3,PRSS50,chr3:46712117-46717869,5752
64264762,64390758,chr12,C12orf56,chr12:64264762-64390758,125996
65092760,65115200,chr15,UBAP1L,chr15:65092760-65115200,22440
46719583,46736429,chr3,PRSS46P,chr3:46719583-46736429,16846
240886048,240896889,chr2,MAB21L4,chr2:240886048-240896889,10841
46742092,46750891,chr3,PRSS45P,chr3:46742092-46750891,8799
46753045,46756857,chr3,PRSS43P,chr3:46753045-46756857,3812
46809359,46812486,chr3,PRSS44P,chr3:46809359-46812486,3127
46829542,46834095,chr3,PRSS42P,chr3:46829542-46834095,4553
30360566,30393849,chr15,CHRFAM7A,chr15:30360566-30393849,33283
240954617,240967451,chr2,UICLM,chr2:240954617-240967451,12834
46835111,46882172,chr3,MYL3,chr3:46835111-46882172,47061
21158377,21180616,chr16,LDAF1,chr16:21158377-21180616,22239
64266413,64266766,chr12,OOEPP2,chr12:64266413-64266766,353
64338178,64338797,chr12,ATP6V1E1P3,chr12:64338178-64338797,619
165933857,165949891,chr2,TTC21B-AS1,chr2:165933857-165949891,16034
64404392,64451125,chr12,XPOT,chr12:64404392-64451125,46733
81799581,81842866,chr8,SNX16,chr8:81799581-81842866,43285
166180652,166180966,chr2,RN7SKP152,chr2:166180652-166180966,314
37084451,37099244,chr2,GPATCH11,chr2:37084451-37099244,14793
46877721,46903799,chr3,PTH1R,chr3:46877721-46903799,26078
1485886,1488981,chr16,PTX4,chr16:1485886-1488981,3095
28315651,28316059,chr15,RPL41P2,chr15:28315651-28316059,408
28332237,28336609,chr15,HERC2P1,chr15:28332237-28336609,4372
223863726,223864851,chr1,ACTBP11,chr1:223863726-223864851,1125
2520357,2531422,chr16,AMDHD2,chr16:2520357-2531422,11065
200669507,200694250,chr1,DDX59-AS1,chr1:200669507-200694250,24743
28378621,28392021,chr15,GOLGA8F,chr15:28378621-28392021,13400
137874979,138002086,chr7,CREB3L2,chr7:137874979-138002086,127107
116514534,116571039,chr1,CD58,chr1:116514534-116571039,56505
218880852,218899581,chr2,WNT10A,chr2:218880852-218899581,18729
22620418,22669148,chr8,BIN3,chr8:22620418-22669148,48730
218900811,218930636,chr2,LINC01494,chr2:218900811-218930636,29825
218916184,218916287,chr2,RNU6-642P,chr2:218916184-218916287,103
218953401,218954050,chr2,KRT8P30,chr2:218953401-218954050,649
218959666,218962155,chr2,CDK5R2,chr2:218959666-218962155,2489
28402868,28405033,chr15,ABCB10P3,chr15:28402868-28405033,2165
164921318,164921629,chr1,RPL35AP7,chr1:164921318-164921629,311
179447578,179448440,chr1,MEF2AP1,chr1:179447578-179448440,862
218975393,218989940,chr2,LINC00608,chr2:218975393-218989940,14547
203903723,203904013,chr1,HSPE1P6,chr1:203903723-203904013,290
194188967,194190342,chr1,EEF1A1P14,chr1:194188967-194190342,1375
192809039,192812275,chr1,RGS2,chr1:192809039-192812275,3236
28506625,28508808,chr15,ABCB10P4,chr15:28506625-28508808,2183
64575665,64575741,chr12,SNORD83,chr12:64575665-64575741,76
218981087,218985184,chr2,FEV,chr2:218981087-218985184,4097
64599078,64609459,chr12,RASSF3-DT,chr12:64599078-64609459,10381
64622509,64622605,chr12,MIR548Z,chr12:64622509-64622605,96
64622509,64622605,chr12,MIR548C,chr12:64622509-64622605,96
28575019,28579400,chr15,HERC2P11,chr15:28575019-28579400,4381
218990189,218993422,chr2,CRYBA2,chr2:218990189-218993422,3233
28111040,28322179,chr15,HERC2,chr15:28111040-28322179,211139
175297080,175297240,chr1,RPS29P4,chr1:175297080-175297240,160
57529633,57547224,chr12,DCTN2,chr12:57529633-57547224,17591
207088860,207099993,chr1,C4BPB,chr1:207088860-207099993,11133
155474206,155555450,chr7,CNPY1,chr7:155474206-155555450,81244
219001645,219001708,chr2,MIR375,chr2:219001645-219001708,63
6271169,6353827,chr10,LINC02649,chr10:6271169-6353827,82658
219002846,219041527,chr2,CFAP65,chr2:219002846-219041527,38681
29806486,29917061,chr7,WIPF3,chr7:29806486-29917061,110575
73337906,73338533,chr5,LINC02230,chr5:73337906-73338533,627
33073486,33116781,chr10,IATPR,chr10:33073486-33116781,43295
73444827,73448777,chr5,FOXD1,chr5:73444827-73448777,3950
91782835,91798309,chr10,TNKS2-AS1,chr10:91782835-91798309,15474
42909273,42912305,chr7,C7orf25,chr7:42909273-42912305,3032
73446357,73446984,chr5,FOXD1-AS1,chr5:73446357-73446984,627
73451498,73453395,chr5,LINC01385,chr5:73451498-73453395,1897
73454187,73472896,chr5,LINC01386,chr5:73454187-73472896,18709
7444298,7472040,chr10,LINC02642,chr10:7444298-7472040,27742
73497550,73498293,chr5,BTF3-DT,chr5:73497550-73498293,743
73508685,73509254,chr5,FUNDC2P1,chr5:73508685-73509254,569
73552190,73565667,chr5,ANKRA2,chr5:73552190-73565667,13477
87627548,87832296,chr7,RUNDC3B,chr7:87627548-87832296,204748
122879681,122898716,chr10,C10orf88B,chr10:122879681-122898716,19035
25651712,25732935,chr10,LINC00836,chr10:25651712-25732935,81223
22578279,22598025,chr8,PDLIM2,chr8:22578279-22598025,19746
50693588,50734041,chr16,NOD2,chr16:50693588-50734041,40453
167052836,167166479,chr1,GPA33,chr1:167052836-167166479,113643
89853595,90225443,chr10,LINC01374,chr10:89853595-90225443,371848
73565443,73583380,chr5,UTP15,chr5:73565443-73583380,17937
3432519,3502915,chr10,LINC02669,chr10:3432519-3502915,70396
46979666,47009704,chr3,NBEAL2,chr3:46979666-47009704,30038
168576605,168582069,chr1,XCL1,chr1:168576605-168582069,5464
135361795,135510127,chr7,CNOT4,chr7:135361795-135510127,148332
179829609,179836124,chr1,LINC02818,chr1:179829609-179836124,6515
30923055,30948783,chr16,FBXL19,chr16:30923055-30948783,25728
184999710,185008789,chr1,LINC01633,chr1:184999710-185008789,9079
223947605,223950416,chr1,CICP5,chr1:223947605-223950416,2811
81683326,81703138,chr17,HGS,chr17:81683326-81703138,19812
75243568,75373500,chr10,ZNF503-AS1,chr10:75243568-75373500,129932
160367071,160372846,chr1,NHLH1,chr1:160367071-160372846,5775
160670148,160670979,chr1,SETP9,chr1:160670148-160670979,831
191823432,192011260,chr1,LINC02770,chr1:191823432-192011260,187828
159998651,160070160,chr1,KCNJ10,chr1:159998651-160070160,71509
219054424,219060921,chr2,IHH,chr2:219054424-219060921,6497
219058688,219058750,chr2,MIR3131,chr2:219058688-219058750,62
207104233,207144972,chr1,C4BPA,chr1:207104233-207144972,40739
121928056,121952139,chr10,ATE1-AS1,chr10:121928056-121952139,24083
149714781,149734575,chr7,KRBA1,chr7:149714781-149734575,19794
28703554,28703790,chr15,RN7SL719P,chr15:28703554-28703790,236
219102434,219102719,chr2,RN7SL764P,chr2:219102434-219102719,285
28719377,28738431,chr15,GOLGA8M,chr15:28719377-28738431,19054
28737583,28759204,chr15,WHAMMP2,chr15:28737583-28759204,21621
30833626,30894302,chr16,BCL7C,chr16:30833626-30894302,60676
219161465,219170095,chr2,SLC23A3,chr2:219161465-219170095,8630
61001088,61194727,chr10,LINC00845,chr10:61001088-61194727,193639
122207663,122227456,chr12,DIABLO,chr12:122207663-122227456,19793
131772395,131790199,chr10,LINC01164,chr10:131772395-131790199,17804
171251866,171252982,chr5,USP12P1,chr5:171251866-171252982,1116
23354748,23367231,chr15,GOLGA8S,chr15:23354748-23367231,12483
32958437,33082409,chr10,ITGB1-DT,chr10:32958437-33082409,123972
134601149,134649271,chr5,SAR1B,chr5:134601149-134649271,48122
196652043,196747504,chr1,CFH,chr1:196652043-196747504,95461
44793119,44959724,chr10,TMEM72-AS1,chr10:44793119-44959724,166605
30761745,30776307,chr16,RNF40,chr16:30761745-30776307,14562
47010824,47013465,chr3,NRADDP,chr3:47010824-47013465,2641
23430839,23435212,chr15,HERC2P6,chr15:23430839-23435212,4373
47028855,47029030,chr3,MRPL57P3,chr3:47028855-47029030,175
38451027,38454820,chr3,ACVR2B-AS1,chr3:38451027-38454820,3793
168441151,168673445,chr6,SMOC2,chr6:168441151-168673445,232294
81000923,81005788,chr15,TLNRD1,chr15:81000923-81005788,4865
38453890,38493142,chr3,ACVR2B,chr3:38453890-38493142,39252
65895079,66253756,chr15,MEGF11,chr15:65895079-66253756,358677
219171897,219178106,chr2,CNPPD1,chr2:219171897-219178106,6209
3911889,3941506,chr10,LINC02660,chr10:3911889-3941506,29617
49605175,49636839,chr6,RHAG,chr6:49605175-49636839,31664
71217220,71218294,chr10,UNC5B-AS1,chr10:71217220-71218294,1074
73495525,73520070,chr10,PPP3CB-AS1,chr10:73495525-73520070,24545
45108959,45133354,chr17,PLCD3,chr17:45108959-45133354,24395
134634839,134634945,chr5,RNU6-1311P,chr5:134634839-134634945,106
134648785,134727909,chr5,SEC24A,chr5:134648785-134727909,79124
142111718,142222324,chr7,MGAM2,chr7:142111718-142222324,110606
65570338,65880289,chr10,LINC01515,chr10:65570338-65880289,309951
99960936,100131268,chr8,RGS22,chr8:99960936-100131268,170332
223992743,224010612,chr1,SEPTIN7P13,chr1:223992743-224010612,17869
38496127,38542161,chr3,EXOG,chr3:38496127-38542161,46034
45132600,45144181,chr17,ACBD4,chr17:45132600-45144181,11581
214051194,214187773,chr1,LINC02775,chr1:214051194-214187773,136579
219176225,219185475,chr2,RETREG2,chr2:219176225-219185475,9250
163266576,163355764,chr1,NUF2,chr1:163266576-163355764,89188
129225030,129430211,chr7,AHCYL2,chr7:129225030-129430211,205181
134701172,134701278,chr5,RNU6-1164P,chr5:134701172-134701278,106
134715483,134715582,chr5,RNU6-757P,chr5:134715483-134715582,99
134738495,134752157,chr5,CAMLG,chr5:134738495-134752157,13662
49568218,49644666,chr12,PRPF40B,chr12:49568218-49644666,76448
111087503,111231194,chr6,SLC16A10,chr6:111087503-111231194,143691
134758771,134855133,chr5,DDX46,chr5:134758771-134855133,96362
45854093,45972428,chr10,PARGP1,chr10:45854093-45972428,118335
66040233,66040332,chr15,MIR4311,chr15:66040233-66040332,99
42929480,42939294,chr6,CNPY3,chr6:42929480-42939294,9814
52450874,52755507,chr10,LNCAROD,chr10:52450874-52755507,304633
40323692,40326715,chr15,INAFM2,chr15:40323692-40326715,3023
137867214,137883312,chr6,TNFAIP3,chr6:137867214-137883312,16098
40331537,40331648,chr15,RNA5SP392,chr15:40331537-40331648,111
40351033,40356434,chr15,PHGR1,chr15:40351033-40356434,5401
11679083,11742857,chr16,TXNDC11,chr16:11679083-11742857,63774
17214239,17230018,chr10,VIM-AS1,chr10:17214239-17230018,15779
40358219,40378621,chr15,DISP2,chr15:40358219-40378621,20402
219195237,219209651,chr2,ZFAND2B,chr2:219195237-219209651,14414
42513510,42552825,chr10,ZNF37BP,chr10:42513510-42552825,39315
17511636,17521288,chr19,PGLS,chr19:17511636-17521288,9652
40439721,40468236,chr15,BAHD1,chr15:40439721-40468236,28515
38515448,38515830,chr3,DDTP1,chr3:38515448-38515830,382
38526802,38527325,chr3,RPL18AP7,chr3:38526802-38527325,523
45148475,45152099,chr17,HEXIM1,chr17:45148475-45152099,3624
4461691,4495763,chr16,NMRAL1,chr16:4461691-4495763,34072
179259028,179261273,chr3,LRRFIP1P1,chr3:179259028-179261273,2245
44957992,45109016,chr17,NMT1,chr17:44957992-45109016,151024
46786674,46811989,chr10,BMS1P1,chr10:46786674-46811989,25315
179323031,179338583,chr3,ZNF639,chr3:179323031-179338583,15552
10928811,10933535,chr19,TIMM29,chr19:10928811-10933535,4724
40470984,40473158,chr15,CHST14,chr15:40470984-40473158,2174
3052910,3063107,chr19,TLE5,chr19:3052910-3063107,10197
40405485,40435947,chr15,IVD,chr15:40405485-40435947,30462
78943328,79067895,chr10,ZMIZ1-AS1,chr10:78943328-79067895,124567
28503296,28528215,chr6,GPX6,chr6:28503296-28528215,24919
6104949,6161564,chr7,USP42,chr7:6104949-6161564,56615
104351301,104353624,chr10,CFAP58-DT,chr10:104351301-104353624,2323
120759898,120851457,chr10,WDR11-AS1,chr10:120759898-120851457,91559
134845680,134859735,chr5,C5orf24,chr5:134845680-134859735,14055
43014103,43021298,chr6,KLHDC3,chr6:43014103-43021298,7195
31693084,31707447,chr10,MACORIS,chr10:31693084-31707447,14363
134874371,134901635,chr5,TXNDC15,chr5:134874371-134901635,27264
110869741,110872253,chr10,PDCD4-AS1,chr10:110869741-110872253,2512
6852148,6866632,chr12,USP5,chr12:6852148-6866632,14484
87189773,87342612,chr10,NUTM2A-AS1,chr10:87189773-87342612,152839
227506182,227508292,chr1,TUBB8P9,chr1:227506182-227508292,2110
39026715,39027110,chr17,LINC02079,chr17:39026715-39027110,395
179347709,179394936,chr3,MFN1,chr3:179347709-179394936,47227
39057019,39113190,chr17,RDM1P5,chr17:39057019-39113190,56171
205568885,205602918,chr1,MFSD4A,chr1:205568885-205602918,34033
726936,735525,chr16,HAGHL,chr16:726936-735525,8589
151661096,151686975,chr5,SPARC,chr5:151661096-151686975,25879
39063313,39154394,chr17,PLXDC1,chr17:39063313-39154394,91081
129839593,130017129,chr8,CYRIB,chr8:129839593-130017129,177536
100352176,100367831,chr7,PILRB,chr7:100352176-100367831,15655
219209772,219218994,chr2,ABCB6,chr2:219209772-219218994,9222
135181308,135219173,chr6,MYB,chr6:135181308-135219173,37865
52307281,52529132,chr15,MYO5A,chr15:52307281-52529132,221851
35855861,35867136,chr19,KIRREL2,chr19:35855861-35867136,11275
168280877,168314426,chr1,TBX19,chr1:168280877-168314426,33549
151676945,151725473,chr5,CLMAT3,chr5:151676945-151725473,48528
151704289,151704578,chr5,RN7SKP232,chr5:151704289-151704578,289
151742316,151772532,chr5,ATOX1,chr5:151742316-151772532,30216
168055901,168056422,chr1,GCSHP5,chr1:168055901-168056422,521
66566393,66579137,chr16,CMTM1,chr16:66566393-66579137,12744
200027614,200177420,chr1,NR5A2,chr1:200027614-200177420,149806
151753992,151767247,chr5,ATOX1-AS1,chr5:151753992-151767247,13255
74027789,74069907,chr7,ELN,chr7:74027789-74069907,42118
151765859,151766378,chr5,RPLP1P6,chr5:151765859-151766378,519
70515870,70637440,chr12,PTPRB,chr12:70515870-70637440,121570
10369809,10462361,chr10,CELF2-DT,chr10:10369809-10462361,92552
151822513,151924851,chr5,GLRA1,chr5:151822513-151924851,102338
49296112,49299018,chr10,C10orf71-AS1,chr10:49296112-49299018,2906
39156894,39167484,chr17,ARL5C,chr17:39156894-39167484,10590
29409402,29512266,chr10,SVIL-AS1,chr10:29409402-29512266,102864
167219831,167220512,chr1,POU2F1-DT,chr1:167219831-167220512,681
175904762,175921057,chr1,LINC02803,chr1:175904762-175921057,16295
39173453,39197703,chr17,CACNB1,chr17:39173453-39197703,24250
182641816,182684576,chr1,RGS8,chr1:182641816-182684576,42760
179396088,179451476,chr3,GNB4,chr3:179396088-179451476,55388
219219380,219229717,chr2,ATG9A,chr2:219219380-219229717,10337
151875566,151875692,chr5,RNA5SP198,chr5:151875566-151875692,126
33888056,33888162,chr5,RNU6-923P,chr5:33888056-33888162,106
33936386,33938918,chr5,RXFP3,chr5:33936386-33938918,2532
33944623,33984693,chr5,SLC45A2,chr5:33944623-33984693,40070
1526637,1556988,chr10,ADARB2-AS1,chr10:1526637-1556988,30351
38488103,38565575,chr15,RASGRP1,chr15:38488103-38565575,77472
68636189,68727468,chr16,CDH3,chr16:68636189-68727468,91279
33986165,34008104,chr5,AMACR,chr5:33986165-34008104,21939
35867899,35879792,chr19,APLP1,chr19:35867899-35879792,11893
169849631,169894267,chr1,SCYL3,chr1:169849631-169894267,44636
58999482,59066396,chr10,LINC00844,chr10:58999482-59066396,66914
6772271,6779180,chr10,LINC00706,chr10:6772271-6779180,6909
89829483,89840863,chr10,LINC00865,chr10:89829483-89840863,11380
73730562,73737790,chr10,GLUD1P3,chr10:73730562-73737790,7228
38383069,38402916,chr10,SEPTIN7P9,chr10:38383069-38402916,19847
68686399,68686670,chr16,HSPE1P5,chr16:68686399-68686670,271
221701424,221742089,chr1,DUSP10,chr1:221701424-221742089,40665
68737292,68835537,chr16,CDH1,chr16:68737292-68835537,98245
179464346,179465328,chr3,MTHFD2P7,chr3:179464346-179465328,982
179562886,179588407,chr3,ACTL6A,chr3:179562886-179588407,25521
33987174,34124528,chr5,C1QTNF3-AMACR,chr5:33987174-34124528,137354
4581743,4593340,chr11,OR52I2,chr11:4581743-4593340,11597
4660853,4661763,chr11,OR51A9P,chr11:4660853-4661763,910
4680171,4697854,chr11,OR51E2,chr11:4680171-4697854,17683
34017858,34043213,chr5,C1QTNF3,chr5:34017858-34043213,25355
158025550,158031166,chr1,KIRREL1-IT1,chr1:158025550-158031166,5616
4690423,4697831,chr11,OR51C1P,chr11:4690423-4697831,7408
144227029,144250326,chr1,LINC02802,chr1:144227029-144250326,23297
95732976,96090250,chr10,ENTPD1-AS1,chr10:95732976-96090250,357274
124012997,124018732,chr11,OR10G4,chr11:124012997-124018732,5735
39210541,39225945,chr17,STAC2,chr17:39210541-39225945,15404
168449672,168451211,chr1,QRSL1P1,chr1:168449672-168451211,1539
18468336,18526951,chr11,TSG101,chr11:18468336-18526951,58615
235957879,235971825,chr1,LINC02768,chr1:235957879-235971825,13946
176547433,176547726,chr5,RN7SL684P,chr5:176547433-176547726,293
176595802,176610156,chr5,GPRIN1,chr5:176595802-176610156,14354
153203430,153205120,chr1,LELP1,chr1:153203430-153205120,1690
2935353,4994972,chr8,CSMD1,chr8:2935353-4994972,2059619
176620082,176630556,chr5,SNCB,chr5:176620082-176630556,10474
183248237,183418380,chr1,NMNAT2,chr1:183248237-183418380,170143
75074306,75079549,chr17,TRIM80P,chr17:75074306-75079549,5243
75087727,75106162,chr17,SLC16A5,chr17:75087727-75106162,18435
6580419,6616921,chr10,PRKCQ-AS1,chr10:6580419-6616921,36502
18490243,18490955,chr11,YWHABP2,chr11:18490243-18490955,712
35881890,35882153,chr19,RN7SL402P,chr19:35881890-35882153,263
147203276,147204932,chr1,CCT8P1,chr1:147203276-147204932,1656
18529609,18588747,chr11,UEVLD,chr11:18529609-18588747,59138
35887653,35902303,chr19,NFKBID,chr19:35887653-35902303,14650
238476542,238486060,chr1,LINC01139,chr1:238476542-238486060,9518
176629439,176629500,chr5,MIR4281,chr5:176629439-176629500,61
176630618,176646644,chr5,EIF4E1B,chr5:176630618-176646644,16026
234391313,234479179,chr1,TARBP1,chr1:234391313-234479179,87866
31206278,31320447,chr10,ZEB1-AS1,chr10:31206278-31320447,114169
75109952,75130272,chr17,ARMC7,chr17:75109952-75130272,20320
100373099,100454043,chr10,OLMALINC,chr10:100373099-100454043,80944
176647387,176659054,chr5,TSPAN17,chr5:176647387-176659054,11667
75130225,75131757,chr17,NT5C,chr17:75130225-75131757,1532
179588285,179604649,chr3,MRPL47,chr3:179588285-179604649,16364
35902529,35904377,chr19,HCST,chr19:35902529-35904377,1848
219229783,219236679,chr2,ANKZF1,chr2:219229783-219236679,6896
68742480,68742588,chr16,RNA5SP429,chr16:68742480-68742588,108
68822587,68823070,chr16,FTLP14,chr16:68822587-68823070,483
243029512,243052252,chr1,SEPTIN14P21,chr1:243029512-243052252,22740
20238972,20239247,chr16,SNRPEP3,chr16:20238972-20239247,275
20309574,20327808,chr16,GP2,chr16:20309574-20327808,18234
167529117,167553805,chr1,CREG1,chr1:167529117-167553805,24688
35904401,35908295,chr19,TYROBP,chr19:35904401-35908295,3894
806933,931821,chr10,LARP4B,chr10:806933-931821,124888
203954640,203955780,chr1,CBX1P3,chr1:203954640-203955780,1140
120489860,120701289,chr1,PDE4DIPP2,chr1:120489860-120701289,211429
38138478,38143022,chr3,MYD88,chr3:38138478-38143022,4544
75135248,75168281,chr17,JPT1,chr17:75135248-75168281,33033
121961975,122075570,chr5,SRFBP1,chr5:121961975-122075570,113595
160796074,160828261,chr1,LY9,chr1:160796074-160828261,32187
13815062,13815319,chr19,RN7SL619P,chr19:13815062-13815319,257
13823880,13842928,chr19,MIR23AHG,chr19:13823880-13842928,19048
122063195,122078413,chr5,LOX,chr5:122063195-122078413,15218
13836287,13836359,chr19,MIR24-2,chr19:13836287-13836359,72
13836440,13836517,chr19,MIR27A,chr19:13836440-13836517,77
13836587,13836659,chr19,MIR23A,chr19:13836587-13836659,72
13874699,13874808,chr19,MIR181C,chr19:13874699-13874808,109
13874875,13875011,chr19,MIR181D,chr19:13874875-13875011,136
13961530,14007039,chr19,RFX1,chr19:13961530-14007039,45509
18606403,18634791,chr11,SPTY2D1,chr11:18606403-18634791,28388
194339768,194351328,chr3,CPN2,chr3:194339768-194351328,11560
18665050,18665548,chr11,SRSF3P1,chr11:18665050-18665548,498
2883213,2885775,chr11,CDKN1C,chr11:2883213-2885775,2562
194355249,194369743,chr3,LRRC15,chr3:194355249-194369743,14494
194533503,194533583,chr3,RNU6-1101P,chr3:194533503-194533583,80
194562978,194564001,chr3,RPL23AP93,chr3:194562978-194564001,1023
48134632,48178353,chr15,MYEF2,chr15:48134632-48178353,43721
194640791,194672463,chr3,LSG1,chr3:194640791-194672463,31672
219236598,219245478,chr2,GLB1L,chr2:219236598-219245478,8880
14028148,14031551,chr19,RLN3,chr19:14028148-14031551,3403
43880811,43920274,chr11,ALKBH3,chr11:43880811-43920274,39463
14031762,14053218,chr19,IL27RA,chr19:14031762-14053218,21456
75165586,75182959,chr17,SUMO2,chr17:75165586-75182959,17373
171387116,171411810,chr5,NPM1,chr5:171387116-171411810,24694
179591613,179691272,chr1,TDRD5,chr1:179591613-179691272,99659
144428775,144444440,chr8,TONSL,chr8:144428775-144444440,15665
14053363,14062076,chr19,PALM3,chr19:14053363-14062076,8713
194685883,194689037,chr3,FAM43A,chr3:194685883-194689037,3154
4979437,4985323,chr3,BHLHE40,chr3:4979437-4985323,5886
20333051,20356301,chr16,UMOD,chr16:20333051-20356301,23250
75205659,75235758,chr17,NUP85,chr17:75205659-75235758,30099
14070342,14071237,chr19,EEF1DP1,chr19:14070342-14071237,895
14073361,14073479,chr19,MIR1199,chr19:14073361-14073479,118
14081624,14085875,chr19,C19orf67,chr19:14081624-14085875,4251
5068676,5069044,chr3,RNF10P1,chr3:5068676-5069044,368
5080212,5084429,chr3,UBTFL8,chr3:5080212-5084429,4217
14087851,14091036,chr19,SAMD1,chr19:14087851-14091036,3185
43897456,43899636,chr11,SEC14L1P1,chr11:43897456-43899636,2180
43909289,43920944,chr11,ALKBH3-AS1,chr11:43909289-43920944,11655
96142333,96160806,chr8,GDF6,chr8:96142333-96160806,18473
5122249,5180911,chr3,ARL8B,chr3:5122249-5180911,58662
43925342,43943878,chr11,C11orf96,chr11:43925342-43943878,18536
22599599,22604150,chr8,C8orf58,chr8:22599599-22604150,4551
44047981,44059977,chr11,ACCSL,chr11:44047981-44059977,11996
170211010,170211457,chr1,ISCUP1,chr1:170211010-170211457,447
14091688,14118084,chr19,PRKACA,chr19:14091688-14118084,26396
246724409,246768137,chr1,SCCPDH,chr1:246724409-246768137,43728
44065925,44084237,chr11,ACCS,chr11:44065925-44084237,18312
20359175,20404737,chr16,PDILT,chr16:20359175-20404737,45562
5187646,5219958,chr3,EDEM1,chr3:5187646-5219958,32312
219245455,219250337,chr2,STK16,chr2:219245455-219250337,4882
179954773,180114875,chr1,CEP350,chr1:179954773-180114875,160102
14119512,14136613,chr19,ASF1B,chr19:14119512-14136613,17101
20409534,20441336,chr16,ACSM5,chr16:20409534-20441336,31802
14137146,14171267,chr19,ADGRL1-AS1,chr19:14137146-14171267,34121
18527303,19084730,chr8,PSD3,chr8:18527303-19084730,557427
5250177,5250255,chr3,MIR4790,chr3:5250177-5250255,78
14213052,14213323,chr19,RN7SL231P,chr19:14213052-14213323,271
5252926,5253223,chr3,RN7SL553P,chr3:5252926-5253223,297
18831959,18868230,chr19,UPF1,chr19:18831959-18868230,36271
72576691,72576854,chr3,RNU1-62P,chr3:72576691-72576854,163
55487699,55488308,chr3,WNT5A-AS1,chr3:55487699-55488308,609
44260440,44310139,chr11,ALX4,chr11:44260440-44310139,49699
55508311,56468467,chr3,ERC2,chr3:55508311-56468467,960156
20451461,20487669,chr16,ACSM2A,chr16:20451461-20487669,36208
42738730,42920809,chr15,TTBK2,chr15:42738730-42920809,182079
44095648,44251962,chr11,EXT2,chr11:44095648-44251962,156314
75236599,75262363,chr17,GGA3,chr17:75236599-75262363,25764
219253243,219272197,chr2,TUBA4B,chr2:219253243-219272197,18954
219289623,219309648,chr2,PTPRN,chr2:219289623-219309648,20025
209785617,209806175,chr1,IRF6,chr1:209785617-209806175,20558
44711487,44718851,chr15,B2M,chr15:44711487-44718851,7364
55657206,55659382,chr3,ERC2-IT1,chr3:55657206-55659382,2176
6444955,6451718,chr12,CD27,chr12:6444955-6451718,6763
55852492,55852594,chr3,MIR3938,chr3:55852492-55852594,102
56072104,56072407,chr3,RN7SKP45,chr3:56072104-56072407,303
56185104,56185222,chr3,RNA5SP133,chr3:56185104-56185222,118
205597556,205632011,chr1,ELK4,chr1:205597556-205632011,34455
56557161,56621837,chr3,CCDC66,chr3:56557161-56621837,64676
6693791,6700815,chr12,PIANP,chr12:6693791-6700815,7024
3046062,3060726,chr16,MMP25,chr16:3046062-3060726,14664
18868545,18896158,chr19,GDF1,chr19:18868545-18896158,27613
191146025,191146961,chr1,HNRNPA1P46,chr1:191146025-191146961,936
40594020,40664342,chr15,KNL1,chr15:40594020-40664342,70322
228687415,228687826,chr1,FTH1P2,chr1:228687415-228687826,411
246540561,246566261,chr1,TFB2M,chr1:246540561-246566261,25700
18899514,18919387,chr19,COPE,chr19:18899514-18919387,19873
30023198,30027736,chr16,C16orf92,chr16:30023198-30027736,4538
69470349,69579793,chr12,FRS2,chr12:69470349-69579793,109444
58378052,58378148,chr16,RNU6-269P,chr16:58378052-58378148,96
58384442,58384542,chr16,RNU6-1110P,chr16:58384442-58384542,100
58421326,58462470,chr16,LINC02137,chr16:58421326-58462470,41144
58496908,58497014,chr16,RNU6-103P,chr16:58496908-58497014,106
219173869,219212865,chr1,LYPLAL1,chr1:219173869-219212865,38996
58515479,58523842,chr16,SETD6,chr16:58515479-58523842,8363
93698561,93731527,chr8,CIBAR1,chr8:93698561-93731527,32966
69769487,69769773,chr3,RN7SL418P,chr3:69769487-69769773,286
38845764,39052157,chr3,SCN11A,chr3:38845764-39052157,206393
75463251,75579315,chr15,PTPN9,chr15:75463251-75579315,116064
167721192,167791919,chr1,MPZL1,chr1:167721192-167791919,70727
58519951,58629885,chr16,CNOT1,chr16:58519951-58629885,109934
59142748,59155039,chr11,FAM111A,chr11:59142748-59155039,12291
70047790,70098176,chr15,TLE3,chr15:70047790-70098176,50386
75261674,75266376,chr17,MRPS7,chr17:75261674-75266376,4702
66682497,66744670,chr11,SPTBN2,chr11:66682497-66744670,62173
211940399,212035557,chr1,INTS7,chr1:211940399-212035557,95158
219294111,219294200,chr2,MIR153-1,chr2:219294111-219294200,89
75271369,75273895,chr17,MIF4GD-DT,chr17:75271369-75273895,2526
219327407,219333177,chr2,RESP18,chr2:219327407-219333177,5770
55696424,55773407,chr8,TMEM68,chr8:55696424-55773407,76983
75272981,75289510,chr17,SLC25A19,chr17:75272981-75289510,16529
18080869,18320107,chr12,RERGL,chr12:18080869-18320107,239238
18919705,18929189,chr19,DDX49,chr19:18919705-18929189,9484
219069357,219160865,chr2,NHEJ1,chr2:219069357-219160865,91508
7812512,7891148,chr12,SLC2A14,chr12:7812512-7891148,78636
184710364,184712064,chr3,MAGEF1,chr3:184710364-184712064,1700
184725013,184773178,chr3,LINC02069,chr3:184725013-184773178,48165
185076838,185153060,chr3,C3orf70,chr3:185076838-185153060,76222
185162871,185191955,chr3,EHHADH-AS1,chr3:185162871-185191955,29084
185245460,185246441,chr3,EIF2S2P2,chr3:185245460-185246441,981
8682788,8714759,chr11,RPL27A,chr11:8682788-8714759,31971
185253210,185253272,chr3,MIR5588,chr3:185253210-185253272,62
106063246,106078155,chr2,ECRG4,chr2:106063246-106078155,14909
184812143,185052614,chr3,VPS8,chr3:184812143-185052614,240471
60945177,61154531,chr5,NDUFAF2,chr5:60945177-61154531,209354
141433829,141507230,chr8,MROH5,chr8:141433829-141507230,73401
106093308,106194301,chr2,UXS1,chr2:106093308-106194301,100993
36035021,36071358,chr5,UGT3A2,chr5:36035021-36071358,36337
8684227,8684356,chr11,SNORA3A,chr11:8684227-8684356,129
8685439,8685569,chr11,SNORA3B,chr11:8685439-8685569,130
102835801,102843609,chr11,MMP3,chr11:102835801-102843609,7808
18929201,18941261,chr19,HOMER3,chr19:18929201-18941261,12060
102204502,102238961,chr8,RRM2B,chr8:102204502-102238961,34459
75318076,75405709,chr17,GRB2,chr17:75318076-75405709,87633
36098407,36151887,chr5,LMBRD2,chr5:36098407-36151887,53480
175921975,175922145,chr1,RPS29P5,chr1:175921975-175922145,170
102862736,102874982,chr11,MMP12,chr11:102862736-102874982,12246
244454377,244641177,chr1,CATSPERE,chr1:244454377-244641177,186800
102880492,102880846,chr11,BOLA3P1,chr11:102880492-102880846,354
102903892,102903953,chr11,RNU7-159P,chr11:102903892-102903953,61
103050686,103092194,chr11,DCUN1D5,chr11:103050686-103092194,41508
36147892,36147988,chr5,MIR580,chr5:36147892-36147988,96
36155119,36155222,chr5,RNU6-1305P,chr5:36155119-36155222,103
36192589,36242279,chr5,NADK2,chr5:36192589-36242279,49690
75406069,75406162,chr17,MIR3678,chr17:75406069-75406162,93
75409086,75409188,chr17,RNU6-938P,chr17:75409086-75409188,102
106247369,106247741,chr2,RPL22P10,chr2:106247369-106247741,372
32324565,32350023,chr17,C17orf75,chr17:32324565-32350023,25458
103402013,103402586,chr11,MTCO3P15,chr11:103402013-103402586,573
106253231,106253717,chr2,SRSF3P4,chr2:106253231-106253717,486
103402588,103403422,chr11,MTATP6P15,chr11:103402588-103403422,834
130129621,130139417,chr2,MED15P9,chr2:130129621-130139417,9796
103403512,103404167,chr11,MTCO2P15,chr11:103403512-103404167,655
103404309,103405834,chr11,MTCO1P15,chr11:103404309-103405834,1525
103406213,103407241,chr11,MTND2P26,chr11:103406213-103407241,1028
103407441,103408376,chr11,MTND1P36,chr11:103407441-103408376,935
130139287,130145134,chr2,CCDC74B,chr2:130139287-130145134,5847
103109410,103479863,chr11,DYNC2H1,chr11:103109410-103479863,370453
41301587,41353922,chr19,TGFB1,chr19:41301587-41353922,52335
130678934,130746829,chr3,PIK3R4,chr3:130678934-130746829,67895
209232196,209233419,chr1,TFDP1P1,chr1:209232196-209233419,1223
173477330,173488815,chr1,PRDX6,chr1:173477330-173488815,11485
11435284,11450968,chr19,PRKCSH,chr19:11435284-11450968,15684
235327350,235344532,chr1,GGPS1,chr1:235327350-235344532,17182
36221055,36221902,chr5,NADK2-AS1,chr5:36221055-36221902,847
116845934,116874776,chr8,RAD21,chr8:116845934-116874776,28842
36151989,36196849,chr5,SKP2,chr5:36151989-36196849,44860
32343528,32344124,chr17,OOSP1P2,chr17:32343528-32344124,596
32350109,32350202,chr17,MIR632,chr17:32350109-32350202,93
130181737,130190729,chr2,MZT2B,chr2:130181737-130190729,8992
39200283,39204840,chr17,RPL19,chr17:39200283-39204840,4557
56595596,56636816,chr12,BAZ2A,chr12:56595596-56636816,41220
130811768,130812095,chr3,RN7SKP212,chr3:130811768-130812095,327
130827659,130828376,chr3,GSTO3P,chr3:130827659-130828376,717
130191745,130198439,chr2,TUBA3E,chr2:130191745-130198439,6694
236348257,236502915,chr1,EDARADD,chr1:236348257-236502915,154658
12182096,12194133,chr8,FAM86B1,chr8:12182096-12194133,12037
131092821,131092927,chr3,RNU6-726P,chr3:131092821-131092927,106
190305707,190322446,chr3,CLDN1,chr3:190305707-190322446,16739
130212870,130213490,chr2,RHOQP3,chr2:130212870-130213490,620
130229379,130232106,chr2,NOC2LP1,chr2:130229379-130232106,2727
240560054,240565256,chr2,DUSP28,chr2:240560054-240565256,5202
31822591,31823436,chr2,KRT18P52,chr2:31822591-31823436,845
190624595,190625169,chr3,GCNT1P3,chr3:190624595-190625169,574
31823413,31823817,chr2,AK2P2,chr2:31823413-31823817,404
190322541,190412138,chr3,CLDN16,chr3:190322541-190412138,89597
31867809,32039805,chr2,DPY30,chr2:31867809-32039805,171996
166474745,166481565,chr1,FMO7P,chr1:166474745-166481565,6820
246755511,246755832,chr1,RPL35AP6,chr1:246755511-246755832,321
221819842,221840717,chr1,LINC01655,chr1:221819842-221840717,20875
130850595,131016712,chr3,ATP2C1,chr3:130850595-131016712,166117
49361150,49369998,chr17,ZNF652-AS1,chr17:49361150-49369998,8848
190097658,190478404,chr1,BRINP3,chr1:190097658-190478404,380746
32165046,32165757,chr2,SLC30A6-DT,chr2:32165046-32165757,711
49424269,49424922,chr17,EIF4EP2,chr17:49424269-49424922,653
32165841,32224379,chr2,SLC30A6,chr2:32165841-32224379,58538
49457861,49461749,chr17,LINC02075,chr17:49457861-49461749,3888
7484366,7514616,chr17,POLR2A,chr17:7484366-7514616,30250
209267798,209268223,chr1,ATP5MC2P1,chr1:209267798-209268223,425
165201867,165356715,chr1,LMX1A,chr1:165201867-165356715,154848
49404052,49414901,chr17,PHB,chr17:49404052-49414901,10849
490046,507833,chr19,MADCAM1-AS1,chr19:490046-507833,17787
507497,519654,chr19,TPGS1,chr19:507497-519654,12157
531760,542092,chr19,CDC34,chr19:531760-542092,10332
58548499,58548633,chr16,SNORA46,chr16:58548499-58548633,134
58559796,58559929,chr16,SNORA50A,chr16:58559796-58559929,133
7414855,7416863,chr8,DEFB4B,chr8:7414855-7416863,2008
58665109,58684770,chr16,SLC38A7,chr16:58665109-58684770,19661
89588049,89709300,chr12,ATP2B1,chr12:89588049-89709300,121251
73241331,73259530,chr8,C8orf89,chr8:73241331-73259530,18199
167809386,167914215,chr1,ADCY10,chr1:167809386-167914215,104829
142449430,142545009,chr8,ADGRB1,chr8:142449430-142545009,95579
544034,549924,chr19,GZMM,chr19:544034-549924,5890
32201600,32203999,chr2,DDX50P1,chr2:32201600-32203999,2399
32214456,32214562,chr2,RNU6-647P,chr2:32214456-32214562,106
32224453,32265732,chr2,NLRC4,chr2:32224453-32265732,41279
2714567,2721372,chr19,DIRAS1,chr19:2714567-2721372,6805
49878623,49879363,chr2,RPL7P13,chr2:49878623-49879363,740
2732204,2740028,chr19,SLC39A3,chr19:2732204-2740028,7824
50588690,50589415,chr2,MTCO1P42,chr2:50588690-50589415,725
50696172,50696262,chr2,MIR8485,chr2:50696172-50696262,90
164895677,164895777,chr2,RNA5SP111,chr2:164895677-164895777,100
4498881,4539035,chr17,SPNS2,chr17:4498881-4539035,40154
165087526,165204050,chr2,SCN3A,chr2:165087526-165204050,116524
2754715,2783362,chr19,SGTA,chr19:2754715-2783362,28647
151771045,151812911,chr5,G3BP1,chr5:151771045-151812911,41866
24384285,24406013,chr8,ADAMDEC1,chr8:24384285-24406013,21728
58707131,58734342,chr16,GOT2,chr16:58707131-58734342,27211
182054570,182061712,chr1,ZNF648,chr1:182054570-182061712,7142
169722640,169764705,chr1,SELE,chr1:169722640-169764705,42065
4538897,4555386,chr17,MYBBP1A,chr17:4538897-4555386,16489
448268,491399,chr11,PTDSS2,chr11:448268-491399,43131
47075707,47079959,chr12,AMIGO2,chr12:47075707-47079959,4252
58744251,58744357,chr16,RNU6-1155P,chr16:58744251-58744357,106
58770524,58770820,chr16,RN7SL143P,chr16:58770524-58770820,296
58776540,58777563,chr16,GEMIN8P2,chr16:58776540-58777563,1023
7729383,7751605,chr12,CLEC4C,chr12:7729383-7751605,22222
58825891,58826368,chr16,RPL12P36,chr16:58825891-58826368,477
53433977,53491648,chr16,RBL2,chr16:53433977-53491648,57671
143915153,143976734,chr8,PLEC,chr8:143915153-143976734,61581
532242,537321,chr11,HRAS,chr11:532242-537321,5079
217426992,217631090,chr1,GPATCH2,chr1:217426992-217631090,204098
53598153,53703938,chr16,RPGRIP1L,chr16:53598153-53703938,105785
214281102,214337131,chr1,SMYD2,chr1:214281102-214337131,56029
34853094,34916379,chr11,APIP,chr11:34853094-34916379,63285
81257975,81759553,chr12,PPFIA2,chr12:81257975-81759553,501578
4556927,4560818,chr17,GGT6,chr17:4556927-4560818,3891
100307702,100322196,chr7,SPDYE3,chr7:100307702-100322196,14494
2785503,2815807,chr19,THOP1,chr19:2785503-2815807,30304
105110704,105399308,chr7,SRPK2,chr7:105110704-105399308,288604
4572206,4572515,chr17,TXNP4,chr17:4572206-4572515,309
4583999,4608319,chr17,SMTNL2,chr17:4583999-4608319,24320
34915829,35020591,chr11,PDHX,chr11:34915829-35020591,104762
4610449,4617650,chr17,LINC01996,chr17:4610449-4617650,7201
4619749,4619852,chr17,RNU6-955P,chr17:4619749-4619852,103
4630919,4642294,chr17,ALOX15,chr17:4630919-4642294,11375
2745845,2751677,chr5,IRX2,chr5:2745845-2751677,5832
4669774,4704337,chr17,PELP1,chr17:4669774-4704337,34563
44973770,44978028,chr11,LINC02685,chr11:44973770-44978028,4258
2712591,2715237,chr5,LSINCT5,chr5:2712591-2715237,2646
148826611,148828623,chr5,ADRB2,chr5:148826611-148828623,2012
55112971,55173177,chr5,CDC20B,chr5:55112971-55173177,60206
45240302,45286341,chr11,SYT13,chr11:45240302-45286341,46039
157573747,157598085,chr1,FCRL4,chr1:157573747-157598085,24338
799179,809753,chr11,PIDD1,chr11:799179-809753,10574
2819868,2836735,chr19,ZNF554,chr19:2819868-2836735,16867
105301522,105302086,chr7,RWDD4P1,chr7:105301522-105302086,564
169690665,169711702,chr1,SELL,chr1:169690665-169711702,21037
105332790,105332896,chr7,RNU6-1322P,chr7:105332790-105332896,106
2841437,2860471,chr19,ZNF555,chr19:2841437-2860471,19034
104940943,105115019,chr7,KMT2E,chr7:104940943-105115019,174076
132822141,132830659,chr5,SHROOM1,chr5:132822141-132830659,8518
165285253,165286048,chr2,MAPRE1P3,chr2:165285253-165286048,795
229606238,229606299,chr2,RNU7-9P,chr2:229606238-229606299,61
229894346,229894453,chr2,RNU6-613P,chr2:229894346-229894453,107
4710596,4721499,chr17,ARRB2,chr17:4710596-4721499,10903
229922302,230013119,chr2,FBXO36,chr2:229922302-230013119,90817
164769116,164774641,chr1,PBX1-AS1,chr1:164769116-164774641,5525
244598391,244598687,chr1,CYCSP5,chr1:244598391-244598687,296
2867335,2883445,chr19,ZNF556,chr19:2867335-2883445,16110
168695468,168729206,chr1,DPT,chr1:168695468-168729206,33738
229937814,229937882,chr2,RNU6-964P,chr2:229937814-229937882,68
229942728,229945137,chr2,FBXO36-IT1,chr2:229942728-229945137,2409
229973315,229973421,chr2,RNU6-1027P,chr2:229973315-229973421,106
237940762,237941061,chr1,MTCO1P38,chr1:237940762-237941061,299
230034982,230068993,chr2,SLC16A14,chr2:230034982-230068993,34011
65926556,66082546,chr5,ERBIN,chr5:65926556-66082546,155990
95310928,95318263,chr1,LINC01760,chr1:95310928-95318263,7335
10486125,10503558,chr19,KEAP1,chr19:10486125-10503558,17433
207165496,207183910,chr1,C4BPAP1,chr1:207165496-207183910,18414
132414977,133532501,chr11,OPCML,chr11:132414977-133532501,1117524
223538007,223665723,chr1,CAPN8,chr1:223538007-223665723,127716
230058229,230058324,chr2,RNY4P19,chr2:230058229-230058324,95
227587237,227587515,chr2,SCYGR9,chr2:227587237-227587515,278
227598893,227599255,chr2,SCYGR2,chr2:227598893-227599255,362
227608784,227609101,chr2,SCYGR10,chr2:227608784-227609101,317
227614538,227614840,chr2,SCYGR3,chr2:227614538-227614840,302
227616998,227618655,chr2,SCYGR4,chr2:227616998-227618655,1657
227666804,227667061,chr2,SCYGR5,chr2:227666804-227667061,257
227683763,227718028,chr2,SLC19A3,chr2:227683763-227718028,34265
89921392,89938761,chr16,TUBB3,chr16:89921392-89938761,17369
10543895,10553418,chr19,ATG4D,chr19:10543895-10553418,9523
228735479,228746664,chr1,RHOU,chr1:228735479-228746664,11185
8612037,8682694,chr11,TRIM66,chr11:8612037-8682694,70657
227724440,227724757,chr2,SCYGR6,chr2:227724440-227724757,317
227728335,227728625,chr2,SCYGR7,chr2:227728335-227728625,290
227745845,227746681,chr2,SCYGR8,chr2:227745845-227746681,836
227763052,227763152,chr2,RNA5SP121,chr2:227763052-227763152,100
227778510,227778735,chr2,SNRPGP8,chr2:227778510-227778735,225
179082070,179098023,chr1,TOR3A,chr1:179082070-179098023,15953
227805739,227817564,chr2,CCL20,chr2:227805739-227817564,11825
117285232,117316259,chr11,BACE1,chr11:117285232-117316259,31027
102551221,102563538,chr7,SPDYE2,chr7:102551221-102563538,12317
227870083,227870644,chr2,TDGF1P2,chr2:227870083-227870644,561
102650319,102662625,chr7,SPDYE2B,chr7:102650319-102662625,12306
227871054,227924344,chr2,DAW1,chr2:227871054-227924344,53290
157674321,157700769,chr1,FCRL3,chr1:157674321-157700769,26448
75596868,75623300,chr16,ADAT1,chr16:75596868-75623300,26432
75492320,75504316,chr7,SPDYE5,chr7:75492320-75504316,11996
10551033,10551092,chr19,RNU7-140P,chr19:10551033-10551092,59
10552122,10552204,chr19,MIR1238,chr19:10552122-10552204,82
10553085,10566031,chr19,KRI1,chr19:10553085-10566031,12946
73075972,73086038,chr7,SPDYE9,chr7:73075972-73086038,10066
73047862,73057911,chr7,SPDYE11,chr7:73047862-73057911,10049
74904289,74915078,chr7,SPDYE12P,chr7:74904289-74915078,10789
75280790,75289501,chr7,SPDYE13,chr7:75280790-75289501,8711
75335343,75345396,chr7,SPDYE15,chr7:75335343-75345396,10053
76531313,76543297,chr7,SPDYE16,chr7:76531313-76543297,11984
120735623,120992653,chr2,GLI2,chr2:120735623-120992653,257030
77022306,77032361,chr7,SPDYE17,chr7:77022306-77032361,10055
77050391,77062558,chr7,SPDYE18,chr7:77050391-77062558,12167
67276941,67289005,chr7,SPDYE21,chr7:67276941-67289005,12064
57882340,57971128,chr16,CNGB1,chr16:57882340-57971128,88788
43997897,44010124,chr7,SPDYE1,chr7:43997897-44010124,12227
4731428,4733608,chr17,MED11,chr17:4731428-4733608,2180
100106876,100119841,chr7,TAF6,chr7:100106876-100119841,12965
230203110,230313215,chr2,SP140,chr2:230203110-230313215,110105
4733533,4739928,chr17,CXCL16,chr17:4733533-4739928,6395
170115636,170116576,chr1,SIGLEC30P,chr1:170115636-170116576,940
166022215,166023027,chr1,RPS3AP10,chr1:166022215-166023027,812
4739833,4746119,chr17,ZMYND15,chr17:4739833-4746119,6286
185045526,185102603,chr1,RNF2,chr1:185045526-185102603,57077
10566460,10569059,chr19,CDKN2D,chr19:10566460-10569059,2599
10572671,10587315,chr19,AP1M2,chr19:10572671-10587315,14644
209325392,209328535,chr1,LINC01696,chr1:209325392-209328535,3143
182712862,182714544,chr1,LINC01688,chr1:182712862-182714544,1682
4771884,4783213,chr17,TM4SF5,chr17:4771884-4783213,11329
4785285,4786433,chr17,VMO1,chr17:4785285-4786433,1148
202724495,202808487,chr1,KDM5B,chr1:202724495-202808487,83992
4788964,4790589,chr17,GLTPD2,chr17:4788964-4790589,1625
11027024,11027763,chr16,RPL7P46,chr16:11027024-11027763,739
4796144,4798502,chr17,PSMB6,chr17:4796144-4798502,2358
10866222,10943021,chr16,CIITA,chr16:10866222-10943021,76799
10602457,10644557,chr19,SLC44A2,chr19:10602457-10644557,42100
4801159,4807013,chr17,C17orf114,chr17:4801159-4807013,5854
4807152,4823434,chr17,PLD2,chr17:4807152-4823434,16282
34358633,34367196,chr15,LPCAT4,chr15:34358633-34367196,8563
77660009,77820869,chr11,RSF1,chr11:77660009-77820869,160860
60172015,60184666,chr11,MS4A6A,chr11:60172015-60184666,12651
80404350,80597933,chr15,ARNT2,chr15:80404350-80597933,193583
10651862,10653844,chr19,ILF3-DT,chr19:10651862-10653844,1982
10654261,10692417,chr19,ILF3,chr19:10654261-10692417,38156
130448645,130476645,chr11,ADAMTS15,chr11:130448645-130476645,28000
144517978,144521477,chr2,ZEB2-AS1,chr2:144517978-144521477,3499
4833340,4898061,chr17,MINK1,chr17:4833340-4898061,64721
7689437,7706477,chr11,OVCH2,chr11:7689437-7706477,17040
144523912,144579434,chr2,LINC01412,chr2:144523912-144579434,55522
206651621,206721570,chr2,DYTN,chr2:206651621-206721570,69949
695591,705028,chr11,TMEM80,chr11:695591-705028,9437
132692628,132737638,chr5,KIF3A,chr5:132692628-132737638,45010
6845683,6846636,chr11,OR10A5,chr11:6845683-6846636,953
123939617,123940573,chr11,OR4D5,chr11:123939617-123940573,956
55819630,55820571,chr11,OR5D18,chr11:55819630-55820571,941
56346039,56346998,chr11,OR8K1,chr11:56346039-56346998,959
56093308,56094240,chr11,OR8I2,chr11:56093308-56094240,932
6921002,6921994,chr11,OR2D3,chr11:6921002-6921994,992
11677595,11827409,chr2,LPIN1,chr2:11677595-11827409,149814
48245104,48246015,chr11,OR4X2,chr11:48245104-48246015,911
497258,520296,chr7,PDGFA,chr7:497258-520296,23038
56663686,56664618,chr11,OR5AR1,chr11:56663686-56664618,932
6199224,6200186,chr11,OR52W1,chr11:6199224-6200186,962
55343201,55344187,chr11,OR4A16,chr11:55343201-55344187,986
56988914,56989843,chr11,OR5AK2,chr11:56988914-56989843,929
58030953,58031906,chr11,OR6Q1,chr11:58030953-58031906,953
48488793,48489722,chr11,OR4A47,chr11:48488793-48489722,929
113975075,113990313,chr11,HTR3A,chr11:113975075-113990313,15238
101281510,101295282,chr15,SNRPA1,chr15:101281510-101295282,13772
561958,565619,chr7,PRKAR1B-AS2,chr7:561958-565619,3661
603185,608482,chr7,PRKAR1B-AS1,chr7:603185-608482,5297
29551521,29552151,chr7,GTF3C6P3,chr7:29551521-29552151,630
29563835,29567293,chr7,PRR15,chr7:29563835-29567293,3458
29598795,29685255,chr7,ZNRF2P2,chr7:29598795-29685255,86460
141944428,142149544,chr3,TFDP2,chr3:141944428-142149544,205116
57186137,57240469,chr16,RSPRY1,chr16:57186137-57240469,54332
29625870,29625983,chr7,TMSB4XP3,chr7:29625870-29625983,113
29650227,29742594,chr7,DPY19L2P3,chr7:29650227-29742594,92367
29680734,29680828,chr7,MIR550A3,chr7:29680734-29680828,94
35169224,35169535,chr7,S100A11P2,chr7:35169224-35169535,311
35202430,35254100,chr7,TBX20,chr7:35202430-35254100,51670
74650231,74760692,chr7,GTF2I,chr7:74650231-74760692,110461
11547722,11636381,chr16,LITAF,chr16:11547722-11636381,88659
124256376,124266224,chr11,OR8G5,chr11:124256376-124266224,9848
61222347,61231694,chr11,PGA4,chr11:61222347-61231694,9347
43358172,43371043,chr15,ZSCAN29,chr15:43358172-43371043,12871
154857553,154876792,chr5,CNOT8,chr5:154857553-154876792,19239
4538798,4560047,chr12,RAD51AP1,chr12:4538798-4560047,21249
62319015,62336213,chr3,C3orf14,chr3:62319015-62336213,17198
9753404,10182928,chr16,GRIN2A,chr16:9753404-10182928,429524
74100311,74138540,chr15,ISLR2,chr15:74100311-74138540,38229
36826819,36945057,chr3,TRANK1,chr3:36826819-36945057,118238
58189070,58194053,chr11,OR9Q2,chr11:58189070-58194053,4983
56027654,56038191,chr11,OR5AS1,chr11:56027654-56038191,10537
6783020,6791558,chr11,OR2AG1,chr11:6783020-6791558,8538
5754243,5755958,chr11,OR52N4,chr11:5754243-5755958,1715
125625163,125676255,chr11,CHEK1,chr11:125625163-125676255,51092
138261437,138329886,chr3,NME9,chr3:138261437-138329886,68449
51208057,51338601,chr15,CYP19A1,chr15:51208057-51338601,130544
152651593,152717997,chr2,PRPF40A,chr2:152651593-152717997,66404
4856757,4857374,chr17,ATP6V0CP1,chr17:4856757-4857374,617
10514842,10528202,chr16,LINC01290,chr16:10514842-10528202,13360
4882975,4883316,chr17,RN7SL784P,chr17:4882975-4883316,341
4897771,4934438,chr17,CHRNE,chr17:4897771-4934438,36667
10528422,10580632,chr16,EMP2,chr16:10528422-10580632,52210
4899418,4902934,chr17,C17orf107,chr17:4899418-4902934,3516
27066927,27069166,chr16,C16orf82,chr16:27066927-27069166,2239
67360460,67654612,chr3,SUCLG2,chr3:67360460-67654612,294152
57994676,58000672,chr16,ZNF319,chr16:57994676-58000672,5996
42514188,42514307,chr17,MIR5010,chr17:42514188-42514307,119
42533532,42534009,chr17,PTP4A2P1,chr17:42533532-42534009,477
30569672,30572734,chr16,ZNF688,chr16:30569672-30572734,3062
42536241,42544449,chr17,NAGLU,chr17:42536241-42544449,8208
81006552,81033114,chr16,CENPN,chr16:81006552-81033114,26562
38007496,38029642,chr3,PLCD1,chr3:38007496-38029642,22146
42546764,42548706,chr17,HSD17B1P1,chr17:42546764-42548706,1942
42552436,42554748,chr17,HSD17B1-AS1,chr17:42552436-42554748,2312
42552922,42555214,chr17,HSD17B1,chr17:42552922-42555214,2292
93467514,93516214,chr12,MRPL42,chr12:93467514-93516214,48700
152876820,152877767,chr2,UBQLN4P2,chr2:152876820-152877767,947
124241095,124254364,chr11,OR8G1,chr11:124241095-124254364,13269
42561467,42566277,chr17,COASY,chr17:42561467-42566277,4810
94543921,94549895,chr11,FUT4,chr11:94543921-94549895,5974
55554307,55555419,chr11,OR4C15,chr11:55554307-55555419,1112
55172547,55232563,chr2,CLHC1,chr2:55172547-55232563,60016
4881819,4882883,chr11,OR51T1,chr11:4881819-4882883,1064
131245493,131398447,chr5,CDC42SE2,chr5:131245493-131398447,152954
6891574,6892500,chr11,OR2D2,chr11:6891574-6892500,926
124319262,124320197,chr11,OR8D2,chr11:124319262-124320197,935
6169355,6170326,chr11,OR52B2,chr11:6169355-6170326,971
56576774,56577721,chr11,OR5M10,chr11:56576774-56577721,947
123942867,123943838,chr11,OR6T1,chr11:123942867-123943838,971
123753580,123754518,chr11,OR6X1,chr11:123753580-123754518,938
124539635,124545333,chr11,OR8B12,chr11:124539635-124545333,5698
124423942,124424871,chr11,OR8B4,chr11:124423942-124424871,929
56542340,56543257,chr11,OR5M11,chr11:56542340-56543257,917
56490435,56491370,chr11,OR5M8,chr11:56490435-56491370,935
123805408,123806349,chr11,OR6M1,chr11:123805408-123806349,941
10573091,10693988,chr11,IRAG1,chr11:10573091-10693988,120897
243049782,243051619,chr1,CICP21,chr1:243049782-243051619,1837
157745733,157777132,chr1,FCRL2,chr1:157745733-157777132,31399
147824572,147831671,chr5,SPINK1,chr5:147824572-147831671,7099
55224280,55225908,chr2,CDPF1P1,chr2:55224280-55225908,1628
180233143,180292099,chr5,MAPK9,chr5:180233143-180292099,58956
10701430,10713437,chr19,QTRT1,chr19:10701430-10713437,12007
50024410,50037088,chr16,CNEP1R1,chr16:50024410-50037088,12678
55236595,55269347,chr2,MTIF2,chr2:55236595-55269347,32752
42572310,42577831,chr17,PSMC3IP,chr17:42572310-42577831,5521
102120183,102197520,chr12,PARPBP,chr12:102120183-102197520,77337
156539553,156555149,chr3,SSR3,chr3:156539553-156555149,15596
217631324,217871696,chr1,SPATA17,chr1:217631324-217871696,240372
82339993,82349475,chr15,GOLGA6L10,chr15:82339993-82349475,9482
74719542,74725536,chr15,CYP1A1,chr15:74719542-74725536,5994
10718404,10718503,chr19,MIR638,chr19:10718404-10718503,99
10780254,10780335,chr19,MIR4748,chr19:10780254-10780335,81
10817426,10817496,chr19,MIR199A1,chr19:10817426-10817496,70
10828973,10829035,chr19,MIR6793,chr19:10828973-10829035,62
234527887,234531803,chr1,LINC01354,chr1:234527887-234531803,3916
10832067,10836318,chr19,TMED1,chr19:10832067-10836318,4251
131013875,131027649,chr3,ASTE1,chr3:131013875-131027649,13774
10806051,10807286,chr12,TAS2R8,chr12:10806051-10807286,1235
19113932,19121629,chr16,ITPRIPL2,chr16:19113932-19121629,7697
123918660,123972831,chr12,CCDC92,chr12:123918660-123972831,54171
170662728,170739421,chr1,PRRX1,chr1:170662728-170739421,76693
90056566,90092072,chr16,PRDM7,chr16:90056566-90092072,35506
10836575,10869790,chr19,C19orf38,chr19:10836575-10869790,33215
89969791,89972534,chr16,CENPBD1,chr16:89969791-89972534,2743
55282319,55284522,chr2,PRORSD1P,chr2:55282319-55284522,2203
64010550,64024010,chr3,PSMD6,chr3:64010550-64024010,13460
1833986,1884294,chr16,MEIOB,chr16:1833986-1884294,50308
10841839,10842250,chr19,HIKESHIP2,chr19:10841839-10842250,411
221880981,221978523,chr1,LINC02257,chr1:221880981-221978523,97542
53519527,53580269,chr19,ZNF331,chr19:53519527-53580269,60742
75355207,75368612,chr15,MAN2C1,chr15:75355207-75368612,13405
42579513,42610623,chr17,RETREG3,chr17:42579513-42610623,31110
43718992,43758793,chr12,PUS7L,chr12:43718992-43758793,39801
185296388,185317273,chr1,IVNS1ABP,chr1:185296388-185317273,20885
67277510,67289499,chr16,PLEKHG4,chr16:67277510-67289499,11989
155375580,155745071,chr3,PLCH1,chr3:155375580-155745071,369491
229763837,229923239,chr2,TRIP12,chr2:229763837-229923239,159402
55602360,55607645,chr11,OR4C11,chr11:55602360-55607645,5285
58116742,58125530,chr11,OR9I1,chr11:58116742-58125530,8788
67631303,67639763,chr11,TBX10,chr11:67631303-67639763,8460
6019336,6034338,chr11,OR56A1,chr11:6019336-6034338,15002
58506807,58508105,chr11,OR5B21,chr11:58506807-58508105,1298
55965755,55969945,chr11,OR10AG1,chr11:55965755-55969945,4190
5440570,5441514,chr11,OR51I1,chr11:5440570-5441514,944
42647834,42648143,chr17,ATP5MGP7,chr17:42647834-42648143,309
42648178,42648738,chr17,HMGB3P27,chr17:42648178-42648738,560
5323359,5324297,chr11,OR51B2,chr11:5323359-5324297,938
42659284,42667006,chr17,TUBG2,chr17:42659284-42667006,7722
48365485,48366465,chr11,OR4C5,chr11:48365485-48366465,980
5544489,5548540,chr11,OR52H1,chr11:5544489-5548540,4051
56231282,56234255,chr11,OR5T2,chr11:56231282-56234255,2973
42667914,42676994,chr17,PLEKHH3,chr17:42667914-42676994,9080
219409039,219459369,chr1,LYPLAL1-AS1,chr1:219409039-219459369,50330
6844793,6851292,chr12,CDCA3,chr12:6844793-6851292,6499
204141404,204143327,chr1,ERLNC1,chr1:204141404-204143327,1923
223644110,223644383,chr1,SNRPEP10,chr1:223644110-223644383,273
32602721,32794662,chr11,CCDC73,chr11:32602721-32794662,191941
56929207,56966140,chr1,C8B,chr1:56929207-56966140,36933
56641489,56642439,chr11,OR5AP2,chr11:56641489-56642439,950
59456961,59457905,chr11,OR4D6,chr11:59456961-59457905,944
177992235,177996242,chr5,PROP1,chr5:177992235-177996242,4007
207708,215113,chr11,RIC8A,chr11:207708-215113,7405
6870935,6889358,chr12,SPSB2,chr12:6870935-6889358,18423
176392501,176416539,chr5,CLTB,chr5:176392501-176416539,24038
47522942,47624665,chr17,NPEPPS,chr17:47522942-47624665,101723
7470811,7503893,chr12,CD163,chr12:7470811-7503893,33082
176857302,177164973,chr1,ASTN1,chr1:176857302-177164973,307671
149517235,149736714,chr3,WWTR1,chr3:149517235-149736714,219479
179862066,179907897,chr5,TBC1D9B,chr5:179862066-179907897,45831
119711830,119712145,chr8,RN7SKP153,chr8:119711830-119712145,315
144529179,144685846,chr8,ARHGAP39,chr8:144529179-144685846,156667
1351931,1365737,chr16,GNPTG,chr16:1351931-1365737,13806
119096025,119108331,chr11,DPAGT1,chr11:119096025-119108331,12306
66378797,66501263,chr3,LRIG1,chr3:66378797-66501263,122466
119730774,119832863,chr8,TAF2,chr8:119730774-119832863,102089
74796151,74851605,chr7,GTF2IRD2,chr7:74796151-74851605,55454
20536226,20576427,chr16,ACSM2B,chr16:20536226-20576427,40201
51590266,51812864,chr12,SCN8A,chr12:51590266-51812864,222598
166665885,166682196,chr1,FMO10P,chr1:166665885-166682196,16311
209367662,209380518,chr1,LINC01698,chr1:209367662-209380518,12856
151012209,151024499,chr7,ATG9B,chr7:151012209-151024499,12290
43444252,43483893,chr5,TMEM267,chr5:43444252-43483893,39641
147386046,147406809,chr3,ZIC4,chr3:147386046-147406809,20763
238491358,238492644,chr1,KRT18P32,chr1:238491358-238492644,1286
219199914,219200567,chr1,RIMKLBP2,chr1:219199914-219200567,653
212035553,212107400,chr1,DTL,chr1:212035553-212107400,71847
72285495,72434680,chr11,CLPB,chr11:72285495-72434680,149185
70900669,70918530,chr5,SERF1A,chr5:70900669-70918530,17861
151148009,151174745,chr7,GBX1,chr7:151148009-151174745,26736
290170,294422,chr7,FOXL3,chr7:290170-294422,4252
96481626,96709880,chr7,SEM1,chr7:96481626-96709880,228254
141853090,141879246,chr5,PCDH1,chr5:141853090-141879246,26156
42226225,42242625,chr19,GSK3A,chr19:42226225-42242625,16400
52836219,52897548,chr3,STIMATE,chr3:52836219-52897548,61329
185118101,185157072,chr1,TRMT1L,chr1:185118101-185157072,38971
39105252,39274528,chr5,FYB1,chr5:39105252-39274528,169276
184371935,184381968,chr3,THPO,chr3:184371935-184381968,10033
96858182,96859618,chr7,MARK2P10,chr7:96858182-96859618,1436
102285091,102321711,chr7,SH2B2,chr7:102285091-102321711,36620
20586550,20607107,chr16,ACSM5P1,chr16:20586550-20607107,20557
34927292,35038271,chr7,DPY19L1,chr7:34927292-35038271,110979
72199029,72231819,chr15,PKM,chr15:72199029-72231819,32790
20610243,20797581,chr16,ACSM3,chr16:20610243-20797581,187338
221966341,221984964,chr1,LINC02474,chr1:221966341-221984964,18623
209686178,209734949,chr1,HSD11B1,chr1:209686178-209734949,48771
161104696,161253532,chr3,NMD3,chr3:161104696-161253532,148836
243056307,243101744,chr1,LINC01347,chr1:243056307-243101744,45437
179293714,179358680,chr1,SOAT1,chr1:179293714-179358680,64966
34940760,34940834,chr7,MIR548N,chr7:34940760-34940834,74
117275451,117323152,chr7,WNT2,chr7:117275451-117323152,47701
42068477,42081552,chr19,ZNF574,chr19:42068477-42081552,13075
63622178,63622831,chr2,PRELID1P6,chr2:63622178-63622831,653
63642455,63644038,chr2,RPS4XP5,chr2:63642455-63644038,1583
42132555,42137099,chr19,POU2F2-AS1,chr19:42132555-42137099,4544
63684305,63684710,chr2,RPL27P6,chr2:63684305-63684710,405
63717122,63717899,chr2,CSP1,chr2:63717122-63717899,777
42133445,42133513,chr19,MIR4323,chr19:42133445-42133513,68
63751697,63752630,chr2,HNRNPA1P66,chr2:63751697-63752630,933
42198598,42220140,chr19,DEDD2,chr19:42198598-42220140,21542
63588609,63607197,chr2,MDH1,chr2:63588609-63607197,18588
117287120,117715971,chr7,CFTR,chr7:117287120-117715971,428851
77877330,77884119,chr17,LINC01973,chr17:77877330-77884119,6789
77920098,77920258,chr17,RNU1-80P,chr17:77920098-77920258,160
73780097,73878910,chr8,UBE2W,chr8:73780097-73878910,98813
77959240,78108835,chr17,TNRC6C,chr17:77959240-78108835,149595
53095679,53110063,chr5,MOCS2,chr5:53095679-53110063,14384
126940746,126945090,chr11,KIRREL3-AS2,chr11:126940746-126945090,4344
217781198,217785120,chr1,SPATA17-AS1,chr1:217781198-217785120,3922
20702816,20742084,chr16,THUMPD1,chr16:20702816-20742084,39268
126988458,126988542,chr11,MIR3167,chr11:126988458-126988542,84
216072465,216086917,chr1,USH2A-AS2,chr1:216072465-216086917,14452
127002910,127006058,chr11,KIRREL3-AS3,chr11:127002910-127006058,3148
108822333,108822650,chr11,CYCSP29,chr11:108822333-108822650,317
45651510,45651805,chr19,RN7SL836P,chr19:45651510-45651805,295
212686417,212699840,chr1,BATF3,chr1:212686417-212699840,13423
109005517,109005623,chr11,RNU6-654P,chr11:109005517-109005623,106
46383789,46391776,chr11,CHRM4,chr11:46383789-46391776,7987
45668221,45683722,chr19,GIPR,chr19:45668221-45683722,15501
110577042,110713189,chr11,ARHGAP20,chr11:110577042-110713189,136147
238777049,238779200,chr1,MIPEPP2,chr1:238777049-238779200,2151
246566444,246668595,chr1,CNST,chr1:246566444-246668595,102151
20784509,20784615,chr16,RNU6-944P,chr16:20784509-20784615,106
73298683,73298787,chr2,RNU6-111P,chr2:73298683-73298787,104
56727418,57079329,chr3,ARHGEF3,chr3:56727418-57079329,351911
73370019,73370892,chr2,RPSAP28,chr2:73370019-73370892,873
20806429,20849665,chr16,REXO5,chr16:20806429-20849665,43236
73456764,73459482,chr2,ALMS1-IT1,chr2:73456764-73459482,2718
73640723,73642422,chr2,NAT8,chr2:73640723-73642422,1699
73641083,73697509,chr2,ALMS1P1,chr2:73641083-73697509,56426
73700576,73701340,chr2,NAT8B,chr2:73700576-73701340,764
73729104,73737400,chr2,TPRKB,chr2:73729104-73737400,8296
185071567,185072035,chr1,FTH1P25,chr1:185071567-185072035,468
207225798,207229202,chr1,C4BPAP2,chr1:207225798-207229202,3404
78066258,78066761,chr17,UBE2V2P2,chr17:78066258-78066761,503
78066947,78067053,chr17,RNU6-625P,chr17:78066947-78067053,106
204073115,204127743,chr1,SOX13,chr1:204073115-204127743,54628
78107397,78132407,chr17,TMC6,chr17:78107397-78132407,25010
64452090,64502114,chr12,TBK1,chr12:64452090-64502114,50024
132184876,132192808,chr5,P4HA2-AS1,chr5:132184876-132192808,7932
171345105,171345307,chr1,SRP14P4,chr1:171345105-171345307,202
132217849,132217918,chr5,MIR6830,chr5:132217849-132217918,69
73833773,73834042,chr8,RN7SL760P,chr8:73833773-73834042,269
132257696,132273454,chr5,PDLIM4,chr5:132257696-132273454,15758
73905357,73915010,chr8,GYG1P1,chr8:73905357-73915010,9653
235975830,236065109,chr1,NID1,chr1:235975830-236065109,89279
73762184,73780157,chr2,DUSP11,chr2:73762184-73780157,17973
73939169,73972307,chr8,ELOC,chr8:73939169-73972307,33138
45674928,45675024,chr19,MIR642A,chr19:45674928-45675024,96
45674932,45675008,chr19,MIR642B,chr19:45674932-45675008,76
30830369,31369810,chr11,DCDC1,chr11:30830369-31369810,539441
45692403,45703989,chr19,QPCTL,chr19:45692403-45703989,11586
43232590,43266928,chr15,TGM5,chr15:43232590-43266928,34338
73784189,73817147,chr2,C2orf78,chr2:73784189-73817147,32958
117363222,117428123,chr7,ASZ1,chr7:117363222-117428123,64901
132294394,132344190,chr5,SLC22A4,chr5:132294394-132344190,49796
45710629,45730896,chr19,FBXO46,chr19:45710629-45730896,20267
203328280,203447728,chr2,ABI2,chr2:203328280-203447728,119448
73972437,73982783,chr8,TMEM70,chr8:73972437-73982783,10346
4542593,4581776,chr19,SEMA6B,chr19:4542593-4581776,39183
222010825,222064773,chr1,LINC01705,chr1:222010825-222064773,53948
203305491,203309602,chr1,BTG2,chr1:203305491-203309602,4111
132365490,132365599,chr5,MIR3936,chr5:132365490-132365599,109
20623235,20698890,chr16,ACSM1,chr16:20623235-20698890,75655
22459123,22469226,chr15,GOLGA6L22,chr15:22459123-22469226,10103
31532287,31555053,chr5,C5orf22,chr5:31532287-31555053,22766
212051524,212052006,chr1,RPL21P28,chr1:212051524-212052006,482
40978880,41116280,chr15,INO80,chr15:40978880-41116280,137400
209744373,209745214,chr1,ADORA2BP1,chr1:209744373-209745214,841
227563543,227677443,chr1,ZNF678,chr1:227563543-227677443,113900
131370478,132336822,chr11,NTM,chr11:131370478-132336822,966344
246771837,246839611,chr1,KIF28P,chr1:246771837-246839611,67774
73982125,73982467,chr8,RPS20P21,chr8:73982125-73982467,342
78130770,78142968,chr17,TMC8,chr17:78130770-78142968,12198
73984493,73984883,chr8,DSTNP3,chr8:73984493-73984883,390
73991392,74029079,chr8,LY96,chr8:73991392-74029079,37687
117439982,117440780,chr7,ANKRD49P4,chr7:117439982-117440780,798
175010789,175023425,chr1,MRPS14,chr1:175010789-175023425,12636
117560733,117564676,chr7,CFTR-AS1,chr7:117560733-117564676,3943
117710651,117874139,chr7,CTTNBP2,chr7:117710651-117874139,163488
173500460,173603072,chr1,SLC9C2,chr1:173500460-173603072,102612
74048677,74048784,chr8,RNU6-1300P,chr8:74048677-74048784,107
8674596,8784575,chr16,ABAT,chr16:8674596-8784575,109979
74055882,74056647,chr8,RPS3AP32,chr8:74055882-74056647,765
31595565,31595669,chr5,RNU6-363P,chr5:31595565-31595669,104
9560329,9584504,chr19,ZNF121,chr19:9560329-9584504,24175
74079537,74079643,chr8,RNU6-1197P,chr8:74079537-74079643,106
66964099,67056604,chr8,PPP1R42,chr8:66964099-67056604,92505
132190147,132295315,chr5,P4HA2,chr5:132190147-132295315,105168
50606489,50611774,chr3,CISH,chr3:50606489-50611774,5285
36888124,36916291,chr19,ZNF829,chr19:36888124-36916291,28167
149812770,149962139,chr3,RNF13,chr3:149812770-149962139,149369
11164270,11197791,chr19,KANK2,chr19:11164270-11197791,33521
78157403,78159135,chr17,EIF5AP2,chr17:78157403-78159135,1732
217850403,217850633,chr1,UBBP2,chr1:217850403-217850633,230
78174091,78187233,chr17,TK1,chr17:78174091-78187233,13142
107249482,107498055,chr8,ANGPT1,chr8:107249482-107498055,248573
129863636,129895590,chr11,NFRKB,chr11:129863636-129895590,31954
197911902,197935478,chr1,LHX9,chr1:197911902-197935478,23576
151232483,151240979,chr7,CHPF2,chr7:151232483-151240979,8496
42866464,42879822,chr19,PSG1,chr19:42866464-42879822,13358
209827972,209857565,chr1,UTP25,chr1:209827972-209857565,29593
78214186,78225636,chr17,BIRC5,chr17:78214186-78225636,11450
151238421,151238538,chr7,MIR671,chr7:151238421-151238538,117
102433106,102456825,chr7,ORAI2,chr7:102433106-102456825,23719
93921268,93921667,chr1,CHCHD2P5,chr1:93921268-93921667,399
244653103,244709033,chr1,DESI2,chr1:244653103-244709033,55930
146338839,146341728,chr5,POU4F3,chr5:146338839-146341728,2889
55605647,55617269,chr19,ZNF865,chr19:55605647-55617269,11622
27335520,27342599,chr2,GTF3C2-AS1,chr2:27335520-27342599,7079
685546,695498,chr19,PRSS57,chr19:685546-695498,9952
23889951,23946591,chr3,NKIRAS1,chr3:23889951-23946591,56640
205913048,205943460,chr1,SLC26A9,chr1:205913048-205943460,30412
93728155,93741017,chr8,RBM12B,chr8:93728155-93741017,12862
146586099,146586200,chr5,RNA5SP196,chr5:146586099-146586200,101
146656401,146656695,chr5,RN7SL791P,chr5:146656401-146656695,294
22070241,22083221,chr15,OR4M2,chr15:22070241-22083221,12980
75282835,75295807,chr15,GOLGA6D,chr15:75282835-75295807,12972
18086949,19002416,chr7,HDAC9,chr7:18086949-19002416,915467
31400494,31532196,chr5,DROSHA,chr5:31400494-31532196,131702
51689128,51712387,chr19,SPACA6,chr19:51689128-51712387,23259
144827518,144847509,chr8,ZNF7,chr8:144827518-144847509,19991
64507001,64697564,chr12,RASSF3,chr12:64507001-64697564,190563
41621134,41773081,chr15,MGA,chr15:41621134-41773081,151947
27370496,27377535,chr2,SNX17,chr2:27370496-27377535,7039
78248493,78254416,chr17,THA1P,chr17:78248493-78254416,5923
8683254,8683551,chr16,RN7SL743P,chr16:8683254-8683551,297
8705456,8705517,chr16,RNU7-63P,chr16:8705456-8705517,61
78261349,78278492,chr17,LINC01993,chr17:78261349-78278492,17143
120908072,121424761,chr3,STXBP5L,chr3:120908072-121424761,516689
8780384,8797642,chr16,TMEM186,chr16:8780384-8797642,17258
17523301,17553839,chr19,NIBAN3,chr19:17523301-17553839,30538
8356902,8376704,chr17,KRBA2,chr17:8356902-8376704,19802
64713445,64759431,chr12,GNS,chr12:64713445-64759431,45986
42402449,42423256,chr17,CAVIN1,chr17:42402449-42423256,20807
42440198,42440259,chr17,RNU7-97P,chr17:42440198-42440259,61
42494773,42494830,chr17,MIR548AT,chr17:42494773-42494830,57
77216558,77301687,chr11,GDPD4,chr11:77216558-77301687,85129
8852942,8869012,chr16,CARHSP1,chr16:8852942-8869012,16070
75258334,75273455,chr15,GOLGA6C,chr15:75258334-75273455,15121
42313324,42388540,chr17,STAT3,chr17:42313324-42388540,75216
30082955,30096690,chr15,GOLGA8J,chr15:30082955-30096690,13735
46396414,46594125,chr11,AMBRA1,chr11:46396414-46594125,197711
170271395,170284277,chr1,LINC01142,chr1:170271395-170284277,12882
32389599,32403292,chr15,GOLGA8K,chr15:32389599-32403292,13693
205657851,205680509,chr1,SLC45A3,chr1:205657851-205680509,22658
27377235,27380790,chr2,ZNF513,chr2:27377235-27380790,3555
166895711,166975540,chr1,ILDR2,chr1:166895711-166975540,79829
27381195,27409591,chr2,PPM1G,chr2:27381195-27409591,28396
30135051,30148748,chr15,GOLGA8T,chr15:30135051-30148748,13697
30995802,31033715,chr8,PURG,chr8:30995802-31033715,37913
22244962,22245043,chr8,MIR320A,chr8:22244962-22245043,81
52313154,52313500,chr8,RPL34P17,chr8:52313154-52313500,346
52534037,52565430,chr8,ALKAL1,chr8:52534037-52565430,31393
72654697,72669599,chr15,GOLGA6B,chr15:72654697-72669599,14902
27392784,27393367,chr2,FTH1P3,chr2:27392784-27393367,583
52110838,52460959,chr8,ST18,chr8:52110838-52460959,350121
27427790,27442259,chr2,NRBP1,chr2:27427790-27442259,14469
8869251,8870032,chr16,CARHSP1-DT,chr16:8869251-8870032,781
8881634,8885351,chr16,LITAFD,chr16:8881634-8885351,3717
134065303,134250859,chr3,RYK,chr3:134065303-134250859,185556
93035271,93089211,chr15,RGMA,chr15:93035271-93089211,53940
8892097,8975328,chr16,USP7,chr16:8892097-8975328,83231
245154985,245709432,chr1,KIF26B,chr1:245154985-245709432,554447
134500178,134500284,chr5,RNU6-456P,chr5:134500178-134500284,106
134506552,134509229,chr5,LINC01843,chr5:134506552-134509229,2677
134517810,134518092,chr5,RN7SL541P,chr5:134517810-134518092,282
121024072,121090776,chr11,TBCEL,chr11:121024072-121090776,66704
64867956,64868699,chr12,RPL7P39,chr12:64867956-64868699,743
64883394,64990646,chr12,LINC02389,chr12:64883394-64990646,107252
146580742,147084784,chr5,PPP2R2B,chr5:146580742-147084784,504042
50569152,50596168,chr3,HEMK1,chr3:50569152-50596168,27016
216194051,216204366,chr1,USH2A-AS1,chr1:216194051-216204366,10315
162541332,162541628,chr1,UQCRBP2,chr1:162541332-162541628,296
198197779,198198186,chr1,PRR13P1,chr1:198197779-198198186,407
64920845,64982524,chr12,LINC02231,chr12:64920845-64982524,61679
64939023,64939117,chr12,RNU6ATAC42P,chr12:64939023-64939117,94
166474879,166490307,chr1,LINC01675,chr1:166474879-166490307,15428
65050626,65121305,chr12,WIF1,chr12:65050626-65121305,70679
229022773,229038274,chr1,LINC02815,chr1:229022773-229038274,15501
199006040,199021037,chr1,LINC01222,chr1:199006040-199021037,14997
218285293,218337983,chr1,RRP15,chr1:218285293-218337983,52690
57411161,57421934,chr19,ZNF17,chr19:57411161-57421934,10773
25677273,25865184,chr15,ATP10A,chr15:25677273-25865184,187911
7018969,7021432,chr19,MBD3L2B,chr19:7018969-7021432,2463
248095184,248101103,chr1,OR2L13,chr1:248095184-248101103,5919
35443907,35451767,chr19,FFAR2,chr19:35443907-35451767,7860
113532555,113629575,chr3,SIDT1,chr3:113532555-113629575,97020
16134028,16158575,chr19,HSH2D,chr19:16134028-16158575,24547
54026681,54053504,chr1,TMEM59,chr1:54026681-54053504,26823
65095749,65095855,chr12,RNU6-166P,chr12:65095749-65095855,106
65134688,65135273,chr12,APOOP3,chr12:65134688-65135273,585
65169583,65248355,chr12,LEMD3,chr12:65169583-65248355,78772
11956207,12009769,chr11,DKK3,chr11:11956207-12009769,53562
27442366,27446481,chr2,KRTCAP3,chr2:27442366-27446481,4115
123897305,123961408,chr3,CCDC14,chr3:123897305-123961408,64103
45212370,45245407,chr19,EXOC3L2,chr19:45212370-45245407,33037
27475494,27475595,chr2,RNU6-986P,chr2:27475494-27475595,101
49675786,49689029,chr19,PRMT1,chr19:49675786-49689029,13243
27491883,27495200,chr2,FNDC4,chr2:27491883-27495200,3317
124776856,124882668,chr12,SCARB1,chr12:124776856-124882668,105812
21908873,21913690,chr8,DOK2,chr8:21908873-21913690,4817
27496839,27523684,chr2,GCKR,chr2:27496839-27523684,26845
40382721,40394288,chr15,KNSTRN,chr15:40382721-40394288,11567
146706381,146707600,chr5,KRT8P48,chr5:146706381-146707600,1219
146914207,146919506,chr5,PPP2R2B-IT1,chr5:146914207-146919506,5299
147180204,147234859,chr5,STK32A-AS1,chr5:147180204-147234859,54655
157341598,157345677,chr5,FNDC9,chr5:157341598-157345677,4079
157363382,157365501,chr5,NIPAL4-DT,chr5:157363382-157365501,2119
21919662,22006585,chr8,XPO7,chr8:21919662-22006585,86923
165210627,165213090,chr1,LMX1A-AS2,chr1:165210627-165213090,2463
73104008,73155431,chr7,SPDYE10P,chr7:73104008-73155431,51423
199016133,199076735,chr1,LINC01221,chr1:199016133-199076735,60602
74807739,74949200,chr11,XRRA1,chr11:74807739-74949200,141461
157460213,157474722,chr5,NIPAL4,chr5:157460213-157474722,14509
90154456,90164829,chr7,STEAP1,chr7:90154456-90164829,10373
8962706,8966990,chr16,USP7-AS1,chr16:8962706-8966990,4284
230906243,230978875,chr1,TTC13,chr1:230906243-230978875,72632
89443318,89443424,chr16,RNU6-430P,chr16:89443318-89443424,106
366969,371289,chr16,MRPL28,chr16:366969-371289,4320
90167590,90238137,chr7,STEAP2,chr7:90167590-90238137,70547
27444377,27489805,chr2,IFT172,chr2:27444377-27489805,45428
75336329,75364001,chr5,HMGCR,chr5:75336329-75364001,27672
112086335,112131004,chr3,C3orf52,chr3:112086335-112131004,44669
127283783,127288046,chr3,PRR20G,chr3:127283783-127288046,4263
112596797,112649530,chr3,CCDC80,chr3:112596797-112649530,52733
370788,387113,chr16,PGAP6,chr16:370788-387113,16325
90316503,90321304,chr7,FAM237B,chr7:90316503-90321304,4801
216201635,216201826,chr1,MRPS18BP1,chr1:216201635-216201826,191
149334024,149334857,chr7,NPM1P12,chr7:149334024-149334857,833
203400266,203400581,chr1,LARP7P1,chr1:203400266-203400581,315
229042171,229042591,chr1,ISCA1P2,chr1:229042171-229042591,420
149431363,149461062,chr7,ZNF777,chr7:149431363-149461062,29699
174999163,175012027,chr1,CACYBP,chr1:174999163-175012027,12864
82429816,82439153,chr15,GOLGA6L9,chr15:82429816-82439153,9337
149472696,149497817,chr7,ZNF746,chr7:149472696-149497817,25121
99551382,99552117,chr15,RPL7P5,chr15:99551382-99552117,735
42297033,42303546,chr19,PAFAH1B3,chr19:42297033-42303546,6513
34792083,34877514,chr6,UHRF1BP1,chr6:34792083-34877514,85431
99715697,99733561,chr15,LYSMD4,chr15:99715697-99733561,17864
123282296,123449090,chr3,ADCY5,chr3:123282296-123449090,166794
128709061,128731743,chr7,FAM71F1,chr7:128709061-128731743,22682
396725,410367,chr16,NME4,chr16:396725-410367,13642
35825372,35869287,chr19,NPHS1,chr19:35825372-35869287,43915
124901512,124901611,chr12,RNU6-927P,chr12:124901512-124901611,99
124915547,124915659,chr12,MIR5188,chr12:124915547-124915659,112
124935455,124935895,chr12,RPL22P19,chr12:124935455-124935895,440
188905688,189037564,chr1,LINC01035,chr1:188905688-189037564,131876
158765741,158819368,chr6,EZR,chr6:158765741-158819368,53627
22048995,22082527,chr8,DMTN,chr8:22048995-22082527,33532
50923472,50932510,chr12,METTL7A,chr12:50923472-50932510,9038
217892900,217920804,chr1,LINC00210,chr1:217892900-217920804,27904
99565417,99716488,chr15,MEF2A,chr15:99565417-99716488,151071
10492223,10629368,chr6,GCNT2,chr6:10492223-10629368,137145
205233821,205236867,chr1,TMCC2-AS1,chr1:205233821-205236867,3046
50953922,50970506,chr12,HIGD1C,chr12:50953922-50970506,16584
51014134,51014241,chr12,RNU6-87P,chr12:51014134-51014241,107
51037499,51037602,chr12,RNU6-1273P,chr12:51037499-51037602,103
18017555,18046269,chr11,TPH1,chr11:18017555-18046269,28714
95583499,95596516,chr7,PDK4,chr7:95583499-95596516,13017
202348699,202592706,chr1,PPP1R12B,chr1:202348699-202592706,244007
51047962,51060424,chr12,LETMD1,chr12:51047962-51060424,12462
125225669,125375325,chr3,ZNF148,chr3:125225669-125375325,149656
95772506,96110322,chr7,DYNC1I1,chr7:95772506-96110322,337816
65375192,65383701,chr11,SLC25A45,chr11:65375192-65383701,8509
151656691,152129619,chr6,ESR1,chr6:151656691-152129619,472928
401858,412487,chr16,DECR2,chr16:401858-412487,10629
36214602,36238771,chr19,ZNF146,chr19:36214602-36238771,24169
178237476,178590393,chr5,COL23A1,chr5:178237476-178590393,352917
44326555,44367217,chr19,ZNF112,chr19:44326555-44367217,40662
9757347,9769992,chr3,CAMK1,chr3:9757347-9769992,12645
88504576,89065982,chr11,GRM5,chr11:88504576-89065982,561406
46674275,46717127,chr19,PRKD2,chr19:46674275-46717127,42852
178377924,178378220,chr5,RN7SL646P,chr5:178377924-178378220,296
178619728,178619998,chr5,RN7SKP70,chr5:178619728-178619998,270
179550554,179610012,chr5,RUFY1,chr5:179550554-179610012,59458
94168349,94168751,chr15,H3P40,chr15:94168349-94168751,402
9793082,9835401,chr3,ARPC4-TTLL3,chr3:9793082-9835401,42319
94231538,94483952,chr15,MCTP2,chr15:94231538-94483952,252414
51061205,51083664,chr12,CSRNP2,chr12:51061205-51083664,22459
56666730,56668065,chr16,MT1G,chr16:56666730-56668065,1335
46617527,46674818,chr11,ATG13,chr11:46617527-46674818,57291
143940300,144064599,chr6,PLAGL1,chr6:143940300-144064599,124299
51106817,51107144,chr12,RPL35AP29,chr12:51106817-51107144,327
51162901,51163007,chr12,RNU6-199P,chr12:51162901-51163007,106
71429980,71442054,chr16,TLE7,chr16:71429980-71442054,12074
9837849,9844602,chr3,RPUSD3,chr3:9837849-9844602,6753
131639396,131661823,chr12,LINC02414,chr12:131639396-131661823,22427
131661063,131661174,chr12,RNA5SP377,chr12:131661063-131661174,111
131667492,131668246,chr12,RPS6P21,chr12:131667492-131668246,754
131711081,131799738,chr12,SFSWAP,chr12:131711081-131799738,88657
71464555,71565089,chr16,ZNF19,chr16:71464555-71565089,100534
214348700,214552449,chr1,PTPN14,chr1:214348700-214552449,203749
94583506,94589259,chr15,LINC02852,chr15:94583506-94589259,5753
9890574,9894349,chr3,JAGN1,chr3:9890574-9894349,3775
51952106,52067375,chr15,MAPK6,chr15:51952106-52067375,115269
9902612,9916402,chr3,IL17RE,chr3:9902612-9916402,13790
179572156,179572741,chr5,PRDX2P3,chr5:179572156-179572741,585
179595904,179603741,chr5,RUFY1-AS1,chr5:179595904-179603741,7837
41905354,41921139,chr6,MED20,chr6:41905354-41921139,15785
71525233,71538748,chr16,CHST4,chr16:71525233-71538748,13515
179614178,179634784,chr5,HNRNPH1,chr5:179614178-179634784,20606
28431930,28443502,chr6,ZSCAN23,chr6:28431930-28443502,11572
71563430,71563528,chr16,RNU6-1061P,chr16:71563430-71563528,98
71564952,71578187,chr16,TAT-AS1,chr16:71564952-71578187,13235
71565660,71577092,chr16,TAT,chr16:71565660-71577092,11432
162727132,163315500,chr6,PACRG,chr6:162727132-163315500,588368
32613860,32697095,chr15,ARHGAP11A-SCG5,chr15:32613860-32697095,83235
14826241,14835185,chr19,OR7A5,chr19:14826241-14835185,8944
229087114,229205428,chr1,LINC02814,chr1:229087114-229205428,118314
131801315,131801434,chr12,RNA5SP378,chr12:131801315-131801434,119
17292609,17306843,chr19,MRPL34,chr19:17292609-17306843,14234
131815263,131815368,chr12,RNU6-1017P,chr12:131815263-131815368,105
131894622,131923150,chr12,ULK1,chr12:131894622-131923150,28528
166603916,166631400,chr1,FMO9P,chr1:166603916-166631400,27484
121309995,121310412,chr2,RPS17P7,chr2:121309995-121310412,417
138422043,138692571,chr6,NHSL1,chr6:138422043-138692571,270528
121530422,121532705,chr2,CLASP1-AS1,chr2:121530422-121532705,2283
121530881,121531007,chr2,RNU4ATAC,chr2:121530881-121531007,126
121658475,121658973,chr2,RPL12P15,chr2:121658475-121658973,498
71626161,71642114,chr16,MARVELD3,chr16:71626161-71642114,15953
102345746,102356444,chr7,SPDYE6,chr7:102345746-102356444,10698
38930944,38933168,chr19,MRPS12,chr19:38930944-38933168,2224
223701593,223776018,chr1,CAPN2,chr1:223701593-223776018,74425
121708512,121709115,chr2,NPM1P32,chr2:121708512-121709115,603
121726945,121736911,chr2,NIFK,chr2:121726945-121736911,9966
30400562,30414260,chr15,GOLGA8R,chr15:30400562-30414260,13698
71637835,71724701,chr16,PHLPP2,chr16:71637835-71724701,86866
49035569,49036895,chr19,CGB1,chr19:49035569-49036895,1326
49031890,49033238,chr19,CGB2,chr19:49031890-49033238,1348
100148912,100155944,chr7,LAMTOR4,chr7:100148912-100155944,7032
48661407,48673081,chr19,NTN5,chr19:48661407-48673081,11674
121737103,121767853,chr2,TSN,chr2:121737103-121767853,30750
49550666,49561907,chr6,C6orf141,chr6:49550666-49561907,11241
45167214,45201175,chr15,SHF,chr15:45167214-45201175,33961
75237675,75250323,chr6,COX7A2,chr6:75237675-75250323,12648
46297042,46343433,chr19,HIF3A,chr19:46297042-46343433,46391
6496778,6551461,chr7,GRID2IP,chr7:6496778-6551461,54683
131929200,131945896,chr12,PUS1,chr12:131929200-131945896,16696
42154600,42155972,chr17,RAB5C-AS1,chr17:42154600-42155972,1372
42156891,42181142,chr17,KCNH4,chr17:42156891-42181142,24251
42746958,42868558,chr6,BICRAL,chr6:42746958-42868558,121600
121779133,121809962,chr2,LINC01823,chr2:121779133-121809962,30829
49416778,49422685,chr3,AMT,chr3:49416778-49422685,5907
211658657,211675630,chr1,NEK2,chr1:211658657-211675630,16973
43770184,43786487,chr6,VEGFA,chr6:43770184-43786487,16303
42184060,42185452,chr17,HCRT,chr17:42184060-42185452,1392
28841832,28848675,chr15,GOLGA6L7,chr15:28841832-28848675,6843
19404161,19758029,chr8,CSGALNACT1,chr8:19404161-19758029,353868
42188799,42194532,chr17,GHDC,chr17:42188799-42194532,5733
147844517,147930826,chr2,ACVR2A,chr2:147844517-147930826,86309
71110244,71115494,chr15,CT62,chr15:71110244-71115494,5250
114922094,115019917,chr7,MDFIC,chr7:114922094-115019917,97823
12094008,12359144,chr11,MICAL2,chr11:12094008-12359144,265136
71666091,71666197,chr16,RNU6-208P,chr16:71666091-71666197,106
71698567,71698701,chr16,SNORA70D,chr16:71698567-71698701,134
131828393,131851783,chr12,MMP17,chr12:131828393-131851783,23390
71792638,71818259,chr15,NR2E3,chr15:71792638-71818259,25621
144266674,144269288,chr7,CTAGE8,chr7:144266674-144269288,2614
71729000,71809201,chr16,AP1G1,chr16:71729000-71809201,80201
128862042,128910719,chr7,KCP,chr7:128862042-128910719,48677
197902630,197907367,chr1,C1orf53,chr1:197902630-197907367,4737
132581997,132582061,chr12,MIR6763,chr12:132581997-132582061,64
160945025,160954809,chr1,ITLN2,chr1:160945025-160954809,9784
132603150,132610582,chr12,LRCOL1,chr12:132603150-132610582,7432
42199177,42276707,chr17,STAT5B,chr17:42199177-42276707,77530
123123106,123123682,chr8,HMGB1P19,chr8:123123106-123123682,576
132618776,132622388,chr12,P2RX2,chr12:132618776-132622388,3612
123215788,123215863,chr8,MIR4663,chr8:123215788-123215863,75
123219967,123241377,chr8,C8orf76,chr8:123219967-123241377,21410
71858570,71858686,chr15,RNA5SP399,chr15:71858570-71858686,116
90620007,90717141,chr15,CRTC3-AS1,chr15:90620007-90717141,97134
203475806,203491352,chr1,PRELP,chr1:203475806-203491352,15546
73019719,73029766,chr7,SPDYE8,chr7:73019719-73029766,10047
147877422,147877528,chr2,RNU6-1275P,chr2:147877422-147877528,106
90529923,90645345,chr15,CRTC3,chr15:90529923-90645345,115422
135231979,135258663,chr7,STRA8,chr7:135231979-135258663,26684
147930396,148021604,chr2,ORC4,chr2:147930396-148021604,91208
229271062,229305894,chr1,RAB4A,chr1:229271062-229305894,34832
38587641,38618882,chr19,MAP4K1,chr19:38587641-38618882,31241
2474728,2476894,chr7,GRIFIN,chr7:2474728-2476894,2166
102473128,102478922,chr7,POLR2J,chr7:102473128-102478922,5794
123226189,123274284,chr8,ZHX1-C8orf76,chr8:123226189-123274284,48095
132123340,132648688,chr7,PLXNA4,chr7:132123340-132648688,525348
20008051,20009234,chr17,SPECC1-DT,chr17:20008051-20009234,1183
123236852,123237062,chr8,UBA52P5,chr8:123236852-123237062,210
20111824,20112990,chr17,KCTD9P1,chr17:20111824-20112990,1166
20126388,20126488,chr17,RNU6-258P,chr17:20126388-20126488,100
20290257,20290358,chr17,RNU6-1057P,chr17:20290257-20290358,101
20323001,20323110,chr17,RNU6-467P,chr17:20323001-20323110,109
123248451,123275541,chr8,ZHX1,chr8:123248451-123275541,27090
20375369,20376840,chr17,UPF3AP2,chr17:20375369-20376840,1471
175044626,175045648,chr1,ENTR1P2,chr1:175044626-175045648,1022
32350132,32381885,chr17,ZNF207,chr17:32350132-32381885,31753
235109341,235128837,chr1,TOMM20,chr1:235109341-235128837,19496
210265636,210267241,chr1,ST13P19,chr1:210265636-210267241,1605
123262843,123262949,chr8,RNU6-628P,chr8:123262843-123262949,106
178090677,178093984,chr1,RASAL2-AS1,chr1:178090677-178093984,3307
123178960,123210079,chr8,FAM83A,chr8:123178960-123210079,31119
237943724,237945275,chr1,MTRNR2L11,chr1:237943724-237945275,1551
166856510,166876264,chr1,TADA1,chr1:166856510-166876264,19754
144183466,144186080,chr7,CTAGE4,chr7:144183466-144186080,2614
100200653,100272218,chr7,CASTOR3,chr7:100200653-100272218,71565
204154819,204190324,chr1,REN,chr1:204154819-204190324,35505
17681578,17681657,chr8,MIR548V,chr8:17681578-17681657,79
17748118,17748230,chr8,RNA5SP256,chr8:17748118-17748230,112
43746394,43773279,chr15,PDIA3,chr15:43746394-43773279,26885
60327255,60396596,chr11,MS4A6E,chr11:60327255-60396596,69341
148021011,148516971,chr2,MBD5,chr2:148021011-148516971,495960
17643795,17801094,chr8,MTUS1,chr8:17643795-17801094,157299
162445549,162446566,chr1,SLAMF6P1,chr1:162445549-162446566,1017
218043505,218059140,chr1,LINC01653,chr1:218043505-218059140,15635
185321157,185335039,chr1,GS1-279B7.1,chr1:185321157-185335039,13882
49027501,49038451,chr11,TRIM49B,chr11:49027501-49038451,10950
247965233,247966386,chr1,OR2AK2,chr1:247965233-247966386,1153
171270954,171271590,chr1,HMGB1P11,chr1:171270954-171271590,636
64035931,64119173,chr11,FLRT1,chr11:64035931-64119173,83242
230978981,231000733,chr1,ARV1,chr1:230978981-231000733,21752
179641544,179645046,chr5,C5orf60,chr5:179641544-179645046,3502
125094389,125111763,chr11,TMEM218,chr11:125094389-125111763,17374
53655508,53811952,chr7,LINC01446,chr7:53655508-53811952,156444
248691760,248716755,chr1,LYPD9P,chr1:248691760-248716755,24995
204032447,204041265,chr1,LINC00303,chr1:204032447-204041265,8818
179678560,179681034,chr5,CBY3,chr5:179678560-179681034,2474
246775880,246792385,chr1,LINC01341,chr1:246775880-246792385,16505
179679032,179694768,chr5,HMGB3P22,chr5:179679032-179694768,15736
223779893,223845954,chr1,TP53BP2,chr1:223779893-223845954,66061
38596346,38601694,chr19,MAP4K1-AS1,chr19:38596346-38601694,5348
179678628,179731641,chr5,CANX,chr5:179678628-179731641,53013
38619082,38636955,chr19,EIF3K,chr19:38619082-38636955,17873
148295656,148296679,chr2,USP12P2,chr2:148295656-148296679,1023
148595158,148595328,chr2,RPS29P8,chr2:148595158-148595328,170
71758402,71758487,chr16,SNORD71,chr16:71758402-71758487,85
109792758,109857705,chr2,RGPD5,chr2:109792758-109857705,64947
52934813,52935635,chr16,PHBP21,chr16:52934813-52935635,822
19678288,19718979,chr17,SLC47A2,chr17:19678288-19718979,40691
49422333,49429326,chr3,NICN1,chr3:49422333-49429326,6993
15966449,16739591,chr11,SOX6,chr11:15966449-16739591,773142
103175133,103280410,chr7,DPY19L2P2,chr7:103175133-103280410,105277
53337453,53337571,chr16,RNA5SP427,chr16:53337453-53337571,118
55655988,55707645,chr16,SLC6A2,chr16:55655988-55707645,51657
49467115,49467228,chr3,RNA5SP130,chr3:49467115-49467228,113
49468703,49535618,chr3,DAG1,chr3:49468703-49535618,66915
132623753,132687376,chr12,POLE,chr12:132623753-132687376,63623
248003129,248004068,chr1,OR2L6P,chr1:248003129-248004068,939
209900923,210171389,chr1,SYT14,chr1:209900923-210171389,270466
99980752,99987838,chr7,AZGP1P1,chr7:99980752-99987838,7086
49549306,49554366,chr3,BSN-DT,chr3:49549306-49554366,5060
49554477,49671549,chr3,BSN,chr3:49554477-49671549,117072
9771434,9791592,chr17,DHRS7C,chr17:9771434-9791592,20158
49640483,49641769,chr3,BSN-AS1,chr3:49640483-49641769,1286
49674014,49683971,chr3,APEH,chr3:49674014-49683971,9957
30624494,30649529,chr15,ARHGAP11B,chr15:30624494-30649529,25035
38730187,38769904,chr19,CAPN12,chr19:38730187-38769904,39717
15688378,15696891,chr7,LINC02587,chr7:15688378-15696891,8513
143579697,143599541,chr8,EEF1D,chr8:143579697-143599541,19844
15502264,15563595,chr17,TVP23C,chr17:15502264-15563595,61331
109984058,109984988,chr2,GPAA1P1,chr2:109984058-109984988,930
109986939,109988394,chr2,ZBTB45P1,chr2:109986939-109988394,1455
109987063,109996140,chr2,LINC01123,chr2:109987063-109996140,9077
23439038,23447243,chr15,GOLGA6L2,chr15:23439038-23447243,8205
54759316,54812727,chr7,SEC61G-DT,chr7:54759316-54812727,53411
89924064,89933063,chr11,TRIM49D2,chr11:89924064-89933063,8999
149547154,149624752,chr7,ZNF767P,chr7:149547154-149624752,77598
110069961,110070042,chr2,MIR4267,chr2:110069961-110070042,81
28519611,28533014,chr15,GOLGA8G,chr15:28519611-28533014,13403
110083870,110116022,chr2,MALL,chr2:110083870-110116022,32152
182839347,182887982,chr1,DHX9,chr1:182839347-182887982,48635
66975277,66977009,chr11,C11orf86,chr11:66975277-66977009,1732
89911111,89922245,chr11,TRIM49D1,chr11:89911111-89922245,11134
110086433,110086523,chr2,MIR4436B1,chr2:110086433-110086523,90
38789200,38791754,chr19,LGALS7B,chr19:38789200-38791754,2554
110184054,110185179,chr2,ACTR1AP1,chr2:110184054-110185179,1125
38797002,38797109,chr19,RNU6-140P,chr19:38797002-38797109,107
5808924,5821483,chr11,OR52N2,chr11:5808924-5821483,12559
92836367,92917188,chr7,CDK6-AS1,chr7:92836367-92917188,80821
38801671,38812945,chr19,LGALS4,chr19:38801671-38812945,11274
104885718,104898670,chr11,CASP12,chr11:104885718-104898670,12952
110279606,110285681,chr2,MALLP1,chr2:110279606-110285681,6075
55728115,55750111,chr16,CES1P2,chr16:55728115-55750111,21996
110284853,110284943,chr2,MIR4436B2,chr2:110284853-110284943,90
77083681,77122332,chr7,FAM185BP,chr7:77083681-77122332,38651
75100563,75206549,chr11,SLCO2B1,chr11:75100563-75206549,105986
110375138,110384442,chr2,LINC01106,chr2:110375138-110384442,9304
2689386,2712663,chr17,CLUH,chr17:2689386-2712663,23277
77892422,77892915,chr16,PPIAP50,chr16:77892422-77892915,493
110383112,110384642,chr2,ZBTB45P2,chr2:110383112-110384642,1530
110386377,110388163,chr2,GPAA1P2,chr2:110386377-110388163,1786
78022515,78066761,chr16,CLEC3A,chr16:78022515-78066761,44246
28387196,28387485,chr15,RN7SL238P,chr15:28387196-28387485,289
28426491,28426584,chr15,MIR4509-2,chr15:28426491-28426584,93
28490752,28490845,chr15,MIR4509-3,chr15:28490752-28490845,93
23363272,23363561,chr15,RN7SL536P,chr15:23363272-23363561,289
52056199,52090716,chr1,BTF3L4,chr1:52056199-52090716,34517
38647649,38731589,chr19,ACTN4,chr19:38647649-38731589,83940
78048483,78049897,chr16,KRT8P22,chr16:78048483-78049897,1414
76059958,76229121,chr15,TMEM266,chr15:76059958-76229121,169163
78099400,79212667,chr16,WWOX,chr16:78099400-79212667,1113267
63900313,63925202,chr7,LINC02848,chr7:63900313-63925202,24889
110122311,110205066,chr2,NPHP1,chr2:110122311-110205066,82755
20328296,20331781,chr7,ITGB8-AS1,chr7:20328296-20331781,3485
49689538,49721529,chr3,RNF123,chr3:49689538-49721529,31991
66809993,66844888,chr7,GTF2IRD1P1,chr7:66809993-66844888,34895
182441577,182442362,chr1,TEDDM2P,chr1:182441577-182442362,785
185157080,185291781,chr1,SWT1,chr1:185157080-185291781,134701
96955141,97014088,chr7,DLX6-AS1,chr7:96955141-97014088,58947
78234652,78241989,chr16,WWOX-AS1,chr16:78234652-78241989,7337
76258986,76261690,chr15,TYRO3P,chr15:76258986-76261690,2704
76336773,76342475,chr15,ISL2,chr15:76336773-76342475,5702
78355529,78355834,chr16,LSM3P5,chr16:78355529-78355834,305
78825281,78826006,chr16,RPS3P7,chr16:78825281-78826006,725
124929873,125482966,chr7,POT1-AS1,chr7:124929873-125482966,553093
36485343,36485440,chr5,RNA5SP181,chr5:36485343-36485440,97
31475398,31870789,chr15,OTUD7A,chr15:31475398-31870789,395391
36864425,36876700,chr5,NIPBL-DT,chr5:36864425-36876700,12275
79264454,79264573,chr16,RNA5SP431,chr16:79264454-79264573,119
132687587,132704985,chr12,PXMP2,chr12:132687587-132704985,17398
13920138,13952348,chr16,ERCC4,chr16:13920138-13952348,32210
36885206,36886497,chr5,KRT18P31,chr5:36885206-36886497,1291
13553654,13553966,chr5,NENFP3,chr5:13553654-13553966,312
150296343,150339307,chr5,ARSI,chr5:150296343-150339307,42964
224114111,224162047,chr1,FBXO28,chr1:224114111-224162047,47936
43533462,43590208,chr15,PPIP5K1,chr15:43533462-43590208,56746
18667629,18682314,chr17,FOXO3B,chr17:18667629-18682314,14685
150357629,150400308,chr5,TCOF1,chr5:150357629-150400308,42679
75266228,75271231,chr17,MIF4GD,chr17:75266228-75271231,5003
132710819,132722734,chr12,PGAM5,chr12:132710819-132722734,11915
90119358,90128866,chr7,DPY19L2P4,chr7:90119358-90128866,9508
13922332,13922679,chr16,RPS26P52,chr16:13922332-13922679,347
75131138,75131880,chr11,OR2AT1P,chr11:75131138-75131880,742
14018880,14021077,chr16,LINC02186,chr16:14018880-14021077,2197
75206048,75241173,chr11,TPBGL-AS1,chr11:75206048-75241173,35125
14200357,14200979,chr16,TVP23CP2,chr16:14200357-14200979,622
75228322,75228657,chr11,ZDHHC20P3,chr11:75228322-75228657,335
243124428,243255348,chr1,CEP170,chr1:243124428-243255348,130920
1609290,1652615,chr19,TCF3,chr19:1609290-1652615,43325
75240774,75243704,chr11,TPBGL,chr11:75240774-75243704,2930
16149565,16223522,chr16,ABCC6,chr16:16149565-16223522,73957
75260122,75351705,chr11,ARRB1,chr11:75260122-75351705,91583
66376044,66493566,chr7,LINC00174,chr7:66376044-66493566,117522
132723945,132724057,chr12,RNA5SP379,chr12:132723945-132724057,112
132489551,132585188,chr12,FBRSL1,chr12:132489551-132585188,95637
27808173,27808667,chr6,H2AC13,chr6:27808173-27808667,494
26216200,26216688,chr6,H2BC8,chr6:26216200-26216688,488
27807479,27807929,chr6,H2BC13,chr6:27807479-27807929,450
81395457,81466332,chr17,BAHCC1,chr17:81395457-81466332,70875
27838545,27855709,chr6,H2BC15,chr6:27838545-27855709,17164
150433654,150448141,chr7,LINC00996,chr7:150433654-150448141,14487
26199516,26199988,chr6,H2BC7,chr6:26199516-26199988,472
26251614,26252075,chr6,H2BC9,chr6:26251614-26252075,461
26114873,26123926,chr6,H2BC4,chr6:26114873-26123926,9053
26270918,26271413,chr6,H3C8,chr6:26270918-26271413,495
26026896,26027283,chr6,H4C2,chr6:26026896-26027283,387
26204610,26205021,chr6,H4C5,chr6:26204610-26205021,411
132588592,132589741,chr6,TAAR5,chr6:132588592-132589741,1149
26158122,26171349,chr6,H2BC5,chr6:26158122-26171349,13227
152697897,152724569,chr6,MYCT1,chr6:152697897-152724569,26672
64460578,64686068,chr15,ZNF609,chr15:64460578-64686068,225490
655939,657100,chr6,HUS1B,chr6:655939-657100,1161
41149337,41154347,chr6,TREML1,chr6:41149337-41154347,5010
40068243,40068590,chr12,RPL30P13,chr12:40068243-40068590,347
45769060,45815263,chr7,GTF2IP13,chr7:45769060-45815263,46203
40140926,40142876,chr12,LINC02555,chr12:40140926-40142876,1950
40186009,40224915,chr12,LRRK2-DT,chr12:40186009-40224915,38906
67991099,67996469,chr17,C17orf58,chr17:67991099-67996469,5370
85014311,85036277,chr12,TSPAN19,chr12:85014311-85036277,21966
67139961,67302485,chr7,PMS2P4,chr7:67139961-67302485,162524
78356778,78360077,chr17,SOCS3,chr17:78356778-78360077,3299
64671263,64671369,chr15,RNU6-549P,chr15:64671263-64671369,106
64687573,64703281,chr15,OAZ2,chr15:64687573-64703281,15708
39687914,39730426,chr17,ERBB2,chr17:39687914-39730426,42512
49716829,49719684,chr3,AMIGO3,chr3:49716829-49719684,2855
41789896,41895375,chr6,USP49,chr6:41789896-41895375,105479
49716844,49723973,chr3,GMPPB,chr3:49716844-49723973,7129
28080568,28089563,chr6,ZNF165,chr6:28080568-28089563,8995
103930107,103953931,chr12,HSP90B1,chr12:103930107-103953931,23824
31620715,31637771,chr6,PRRC2A,chr6:31620715-31637771,17056
75422394,75433203,chr11,KLHL35,chr11:75422394-75433203,10809
151409161,151413354,chr7,WDR86-AS1,chr7:151409161-151413354,4193
125955796,126063335,chr11,CDON,chr11:125955796-126063335,107539
65751037,65764225,chr7,CCT6P1,chr7:65751037-65764225,13188
4882507,4960741,chr16,PPL,chr16:4882507-4960741,78234
30254402,30254508,chr15,RNU6-17P,chr15:30254402-30254508,106
30405307,30405597,chr15,RN7SL196P,chr15:30405307-30405597,290
71096952,71783383,chr15,THSD4,chr15:71096952-71783383,686431
49758483,49758656,chr3,COX6CP14,chr3:49758483-49758656,173
9945542,9952408,chr3,PRRT3,chr3:9945542-9952408,6866
9947404,9954787,chr3,PRRT3-AS1,chr3:9947404-9954787,7383
9866711,9880255,chr3,CIDEC,chr3:9866711-9880255,13544
238919302,238926269,chr2,LINC01940,chr2:238919302-238926269,6967
239068817,239068914,chr2,MIR4440,chr2:239068817-239068914,97
239085827,239085926,chr2,MIR4441,chr2:239085827-239085926,99
239305462,239305545,chr2,MIR4269,chr2:239305462-239305545,83
239351724,239351804,chr2,MIR2467,chr2:239351724-239351804,80
30447226,30644225,chr2,LCLAT1,chr2:30447226-30644225,196999
148695994,148696204,chr3,RPL38P1,chr3:148695994-148696204,210
148824782,148825387,chr3,HMGB1P30,chr3:148824782-148825387,605
47250523,47250626,chr3,SNORD13P3,chr3:47250523-47250626,103
47282917,47346816,chr3,KLHL18,chr3:47282917-47346816,63899
4958330,5019157,chr16,SEC14L5,chr16:4958330-5019157,60827
35079989,35186248,chr7,DPY19L2P1,chr7:35079989-35186248,106259
62343029,62343138,chr15,MIR6085,chr15:62343029-62343138,109
62362029,62362331,chr15,HMGN1P26,chr15:62362029-62362331,302
62637172,62645291,chr15,MGC15885,chr15:62637172-62645291,8119
31715348,31717919,chr6,LY6G6D,chr6:31715348-31717919,2571
62823957,62824041,chr15,MIR190A,chr15:62823957-62824041,84
186760693,186762050,chr3,PSMD10P2,chr3:186760693-186762050,1357
75507747,75528148,chr7,PMS2P3,chr7:75507747-75528148,20401
186771841,186771947,chr3,RNU6-1105P,chr3:186771841-186771947,106
43037617,43053943,chr6,CUL7,chr6:43037617-43053943,16326
186772589,186773476,chr3,GPS2P2,chr3:186772589-186773476,887
166747379,166748660,chr1,RPL4P2,chr1:166747379-166748660,1281
78168581,78173527,chr17,SYNGR2,chr17:78168581-78173527,4946
62390526,62844631,chr15,TLN2,chr15:62390526-62844631,454105
186783205,186789897,chr3,EIF4A2,chr3:186783205-186789897,6692
5033702,5087379,chr16,ALG1,chr16:5033702-5087379,53677
168786539,168865514,chr2,NOSTRIN,chr2:168786539-168865514,78975
175944831,176207286,chr1,COP1,chr1:175944831-176207286,262455
22854126,22872952,chr7,SNHG26,chr7:22854126-22872952,18826
17074388,17077715,chr11,RPS13,chr11:17074388-17077715,3327
60677453,61392838,chr17,BCAS3,chr17:60677453-61392838,715385
47685864,47722021,chr6,ADGRF4,chr6:47685864-47722021,36157
45606994,45645602,chr19,EML2,chr19:45606994-45645602,38608
66493607,66495758,chr7,GS1-124K5.4,chr7:66493607-66495758,2151
150442635,150449739,chr5,RPS14,chr5:150442635-150449739,7104
722582,726954,chr16,CCDC78,chr16:722582-726954,4372
17074654,17074744,chr11,SNORD14A,chr11:17074654-17074744,90
17075779,17075868,chr11,SNORD14B,chr11:17075779-17075868,89
17115652,17115763,chr11,RNU6-593P,chr11:17115652-17115763,111
28107689,28130082,chr6,ZSCAN16,chr6:28107689-28130082,22393
17077730,17207986,chr11,PIK3C2A,chr11:17077730-17207986,130256
103930425,103930555,chr12,MIR3652,chr12:103930425-103930555,130
28107748,28117139,chr6,ZNF602P,chr6:28107748-28117139,9391
28161769,28169594,chr6,ZKSCAN8P1,chr6:28161769-28169594,7825
39404590,39406579,chr7,POU6F2-AS1,chr7:39404590-39406579,1989
103940763,103965708,chr12,C12orf73,chr12:103940763-103965708,24945
67302621,67362950,chr7,STAG3L4,chr7:67302621-67362950,60329
28176188,28176674,chr6,ZNF603P,chr6:28176188-28176674,486
28188050,28189432,chr6,ZKSCAN8P2,chr6:28188050-28189432,1382
28217643,28218634,chr6,TOB2P1,chr6:28217643-28218634,991
28224886,28233487,chr6,ZSCAN9,chr6:28224886-28233487,8601
35751856,35800949,chr7,SEPTIN7-DT,chr7:35751856-35800949,49093
103965822,103988874,chr12,TDG,chr12:103965822-103988874,23052
36596588,36688334,chr5,SLC1A3,chr5:36596588-36688334,91746
102973483,102988856,chr7,NFE4,chr7:102973483-102988856,15373
143407784,143523449,chr7,EPHA1-AS1,chr7:143407784-143523449,115665
28241697,28252269,chr6,ZKSCAN4,chr6:28241697-28252269,10572
151877042,151879229,chr7,PRKAG2-AS1,chr7:151877042-151879229,2187
28259297,28260958,chr6,NKAPL,chr6:28259297-28260958,1661
32916815,32943176,chr7,RP9P,chr7:32916815-32943176,26361
27083280,27084147,chr6,VN1R11P,chr6:27083280-27084147,867
27109790,27109980,chr6,RNU2-62P,chr6:27109790-27109980,190
64230278,64234286,chr11,DNAJC4,chr11:64230278-64234286,4008
27125897,27132795,chr6,H2BC11,chr6:27125897-27132795,6898
203340628,203351758,chr1,FMOD,chr1:203340628-203351758,11130
27133043,27133535,chr6,H2AC11,chr6:27133043-27133535,492
90954881,90963125,chr15,RCCD1,chr15:90954881-90963125,8244
27139282,27139678,chr6,H4C9,chr6:27139282-27139678,396
27146361,27146855,chr6,H2BC12,chr6:27146361-27146855,494
27147106,27147562,chr6,H2AC12,chr6:27147106-27147562,456
27147626,27147688,chr6,MIR3143,chr6:27147626-27147688,62
101299558,101301346,chr7,LNCPRESS1,chr7:101299558-101301346,1788
27211244,27211913,chr6,RPL10P2,chr6:27211244-27211913,669
202369526,202370145,chr1,CYCSP4,chr1:202369526-202370145,619
27247701,27256624,chr6,PRSS16,chr6:27247701-27256624,8923
247974741,247975653,chr1,OR2L9P,chr1:247974741-247975653,912
100300024,100336307,chr7,PMS2P1,chr7:100300024-100336307,36283
178513109,178548602,chr1,TEX35,chr1:178513109-178548602,35493
159235798,159286703,chr2,WDSUB1,chr2:159235798-159286703,50905
57703710,57712221,chr11,MED19,chr11:57703710-57712221,8511
40196744,40369285,chr12,LRRK2,chr12:40196744-40369285,172541
23690310,23713226,chr16,ERN2,chr16:23690310-23713226,22916
186784796,186784864,chr3,SNORD2,chr3:186784796-186784864,68
186786323,186786445,chr3,SNORA63B,chr3:186786323-186786445,122
186786672,186786777,chr3,MIR1248,chr3:186786672-186786777,105
186786675,186786852,chr3,SNORA81,chr3:186786675-186786852,177
118510273,118531094,chr11,TTC36-AS1,chr11:118510273-118531094,20821
186787612,186787749,chr3,SNORA4,chr3:186787612-186787749,137
32641676,32697098,chr15,SCG5,chr15:32641676-32697098,55422
186810880,186825521,chr3,LINC02043,chr3:186810880-186825521,14641
138889255,138889957,chr3,ATP5MC1P3,chr3:138889255-138889957,702
118527472,118531197,chr11,TTC36,chr11:118527472-118531197,3725
138935189,138944020,chr3,LINC01391,chr3:138935189-138944020,8831
138944224,138947137,chr3,FOXL2,chr3:138944224-138947137,2913
138947217,138953990,chr3,FOXL2NB,chr3:138947217-138953990,6773
12424411,12436406,chr8,FAM86B2,chr8:12424411-12436406,11995
139003962,139006268,chr3,PRR23A,chr3:139003962-139006268,2306
118531041,118547280,chr11,TMEM25,chr11:118531041-118547280,16239
139019031,139020926,chr3,PRR23B,chr3:139019031-139020926,1895
139042102,139044892,chr3,PRR23C,chr3:139042102-139044892,2790
160739057,160754821,chr1,SLAMF7,chr1:160739057-160754821,15764
139081654,139082377,chr3,RPL7L1P7,chr3:139081654-139082377,723
139104185,139125171,chr3,BPESC1,chr3:139104185-139125171,20986
139232992,139233522,chr3,PISRT1,chr3:139232992-139233522,530
98944403,98952104,chr8,OSR2,chr8:98944403-98952104,7701
139452884,139480747,chr3,RBP2,chr3:139452884-139480747,27863
62673851,63046487,chr2,EHBP1,chr2:62673851-63046487,372636
139493809,139494937,chr3,ACTG1P1,chr3:139493809-139494937,1128
122303658,122310119,chr7,FEZF1-AS1,chr7:122303658-122310119,6461
120324509,120349354,chr3,LRRC58,chr3:120324509-120349354,24845
5823128,5854439,chr7,ZNF815P,chr7:5823128-5854439,31311
120395668,120395729,chr3,MIR198,chr3:120395668-120395729,61
32635222,32635554,chr3,RPL30P4,chr3:32635222-32635554,332
32730635,32737454,chr3,CNOT10-AS1,chr3:32730635-32737454,6819
32752910,32753901,chr3,SUGT1P2,chr3:32752910-32753901,991
32785646,32786116,chr3,RPL23AP43,chr3:32785646-32786116,470
32817997,32897824,chr3,TRIM71,chr3:32817997-32897824,79827
30552050,30565684,chr15,GOLGA8Q,chr15:30552050-30565684,13634
22604757,22620964,chr8,CCAR2,chr8:22604757-22620964,16207
12070195,12071360,chr3,ACTG1P12,chr3:12070195-12071360,1165
12153068,12158912,chr3,TIMP4,chr3:12153068-12158912,5844
27285903,27312273,chr6,POM121L2,chr6:27285903-27312273,26370
45723780,45769042,chr7,SEPTIN7P2,chr7:45723780-45769042,45262
23755026,23758935,chr16,CHP2,chr16:23755026-23758935,3909
27324894,27325768,chr6,VN1R10P,chr6:27324894-27325768,874
27356451,27375277,chr6,ZNF204P,chr6:27356451-27375277,18826
27374615,27403908,chr6,ZNF391,chr6:27374615-27403908,29293
12165299,12165642,chr3,MTCO1P5,chr3:12165299-12165642,343
12257801,12258460,chr3,GSTM5P1,chr3:12257801-12258460,659
65578753,65611289,chr15,INTS14,chr15:65578753-65611289,32536
15419978,15449956,chr19,WIZ,chr19:15419978-15449956,29978
23835983,24220611,chr16,PRKCB,chr16:23835983-24220611,384628
27407697,27407996,chr6,MCFD2P1,chr6:27407697-27407996,299
12511095,12511213,chr3,RNA5SP123,chr3:12511095-12511213,118
12514706,12514807,chr3,RNU6-377P,chr3:12514706-12514807,101
27450743,27473118,chr6,ZNF184,chr6:27450743-27473118,22375
167441789,167479004,chr3,SERPINI2,chr3:167441789-167479004,37215
84859491,84913629,chr12,SLC6A15,chr12:84859491-84913629,54138
29390363,29551903,chr17,TAOK1,chr17:29390363-29551903,161540
27523076,27524339,chr6,HNRNPA1P1,chr6:27523076-27524339,1263
27560822,27561744,chr6,CD83P1,chr6:27560822-27561744,922
27596412,27596517,chr6,RNU6-471P,chr6:27596412-27596517,105
42050513,42087461,chr6,TAF8,chr6:42050513-42087461,36948
138187650,138213343,chr5,CDC23,chr5:138187650-138213343,25693
192158462,192185815,chr1,RGS18,chr1:192158462-192185815,27353
167683298,167734939,chr3,PDCD10,chr3:167683298-167734939,51641
231241207,231277973,chr1,GNPAT,chr1:231241207-231277973,36766
58556678,58692055,chr17,TEX14,chr17:58556678-58692055,135377
207711540,207761839,chr2,CCNYL1,chr2:207711540-207761839,50299
1307401,1307719,chr19,RPS15P9,chr19:1307401-1307719,318
138252380,138274621,chr5,GFRA3,chr5:138252380-138274621,22241
24203116,24203231,chr16,MIR1273H,chr16:24203116-24203231,115
72829425,72837396,chr7,SBDSP1,chr7:72829425-72837396,7971
1508023,1536046,chr19,PLK5,chr19:1508023-1536046,28023
24236104,24252863,chr16,LINC02194,chr16:24236104-24252863,16759
24256335,24362412,chr16,CACNG3,chr16:24256335-24362412,106077
107739999,107744581,chr7,CBLL1-AS1,chr7:107739999-107744581,4582
24400056,24400117,chr16,RNU7-24P,chr16:24400056-24400117,61
24537693,24572863,chr16,RBBP6,chr16:24537693-24572863,35170
100837314,100852637,chr7,SLC12A9-AS1,chr7:100837314-100852637,15323
41408408,41483563,chr15,RTF1,chr15:41408408-41483563,75155
138266996,138267757,chr5,RPS27AP18,chr5:138266996-138267757,761
30516309,30595286,chr7,GARS1-DT,chr7:30516309-30595286,78977
138285269,138338355,chr5,CDC25C,chr5:138285269-138338355,53086
57907629,58159920,chr2,VRK2,chr2:57907629-58159920,252291
118544528,118572970,chr11,IFT46,chr11:118544528-118572970,28442
218345336,218444619,chr1,TGFB2,chr1:218345336-218444619,99283
34873831,34873927,chr6,RNY3P15,chr6:34873831-34873927,96
1354711,1378431,chr19,PWWP3A,chr19:1354711-1378431,23720
34877462,34889192,chr6,TAF11,chr6:34877462-34889192,11730
89749875,89751249,chr15,MESP1,chr15:89749875-89751249,1374
42273201,42353666,chr15,GANC,chr15:42273201-42353666,80465
101014319,101017665,chr7,MUC12-AS1,chr7:101014319-101017665,3346
87322583,87399749,chr6,SMIM8,chr6:87322583-87399749,77166
105013281,105014321,chr7,KMT2E-AS1,chr7:105013281-105014321,1040
17922968,18029948,chr8,PCM1,chr8:17922968-18029948,106980
205302063,205321745,chr1,NUAK2,chr1:205302063-205321745,19682
156388922,156640654,chr7,LINC01006,chr7:156388922-156640654,251732
87344813,87365463,chr6,C6orf163,chr6:87344813-87365463,20650
186375838,186421378,chr1,ODR4,chr1:186375838-186421378,45540
87407972,87464465,chr6,CFAP206,chr6:87407972-87464465,56493
75410322,75416794,chr7,NSUN5P1,chr7:75410322-75416794,6472
1491166,1497927,chr19,REEP6,chr19:1491166-1497927,6761
33013087,34174964,chr17,ASIC2,chr17:33013087-34174964,1161877
15235519,15332545,chr19,BRD4,chr19:15235519-15332545,97026
177700524,177712275,chr1,LINC01741,chr1:177700524-177712275,11751
80028893,80029631,chr12,RPL7P38,chr12:80028893-80029631,738
80068691,80068757,chr12,RNU7-106P,chr12:80068691-80068757,66
80343515,80343792,chr12,RN7SKP261,chr12:80343515-80343792,277
196044883,196065235,chr1,LINC01724,chr1:196044883-196065235,20352
80402178,80680273,chr12,PTPRQ,chr12:80402178-80680273,278095
118560690,118561580,chr11,RPL5P30,chr11:118560690-118561580,890
87444395,87445175,chr6,ST13P16,chr6:87444395-87445175,780
118593988,118594093,chr11,RNU6-1157P,chr11:118593988-118594093,105
87470623,87512336,chr6,SLC35A1,chr6:87470623-87512336,41713
118644000,118644079,chr11,MIR6716,chr11:118644000-118644079,79
171314183,171342084,chr1,FMO4,chr1:171314183-171342084,27901
63079940,63144221,chr11,SLC22A24,chr11:63079940-63144221,64281
87322943,87345552,chr7,TP53TG1,chr7:87322943-87345552,22609
138331935,138349729,chr5,FAM53C,chr5:138331935-138349729,17794
9091644,9121635,chr16,C16orf72,chr16:9091644-9121635,29991
118304730,118316175,chr11,CD3E,chr11:118304730-118316175,11445
9156402,9156881,chr16,RPL21P119,chr16:9156402-9156881,479
8788823,8862534,chr16,PMM2,chr16:8788823-8862534,73711
213817751,213988508,chr1,PROX1-AS1,chr1:213817751-213988508,170757
38330978,38378804,chr7,TRG-AS1,chr7:38330978-38378804,47826
42567072,42573239,chr17,MLX,chr17:42567072-42573239,6167
90160604,90229679,chr15,SEMA4B,chr15:90160604-90229679,69075
87488445,87488552,chr6,RNU6-444P,chr6:87488445-87488552,107
138352685,138437028,chr5,KDM3B,chr5:138352685-138437028,84343
167694355,167694642,chr3,HMGN1P8,chr3:167694355-167694642,287
167735243,167825569,chr3,SERPINI1,chr3:167735243-167825569,90326
520391,530163,chr7,HRAT92,chr7:520391-530163,9772
87513459,87590028,chr6,RARS2,chr6:87513459-87590028,76569
118436456,118526832,chr11,KMT2A,chr11:118436456-118526832,90376
80561017,80561560,chr12,AKIRIN1P1,chr12:80561017-80561560,543
80099537,80380880,chr12,OTOGL,chr12:80099537-80380880,281343
77657659,77696277,chr7,APTR,chr7:77657659-77696277,38618
44983019,44986961,chr7,SNHG15,chr7:44983019-44986961,3942
167888414,167888715,chr3,MEMO1P3,chr3:167888414-167888715,301
146192335,146251179,chr3,PLSCR4,chr3:146192335-146251179,58844
185171335,185171710,chr1,RPL22P24,chr1:185171335-185171710,375
9910606,10198606,chr17,GAS7,chr17:9910606-10198606,288000
48529383,48598513,chr2,STON1,chr2:48529383-48598513,69130
162560227,162561308,chr1,UAP1-DT,chr1:162560227-162561308,1081
212726153,212791782,chr1,NSL1,chr1:212726153-212791782,65629
13116862,13141147,chr19,NACC1,chr19:13116862-13141147,24285
21764955,21775600,chr12,KCNJ8,chr12:21764955-21775600,10645
157318631,157327713,chr2,ERMN,chr2:157318631-157327713,9082
101562779,101569006,chr7,LINC01007,chr7:101562779-101569006,6227
56429133,56452199,chr16,NUDT21,chr16:56429133-56452199,23066
13144058,13150383,chr19,STX10,chr19:13144058-13150383,6325
104950315,105013068,chr7,LINC01004,chr7:104950315-105013068,62753
237948017,237949143,chr1,MTCYBP15,chr1:237948017-237949143,1126
91260766,91404856,chr1,HFM1,chr1:91260766-91404856,144090
112905856,112933219,chr12,OAS1,chr12:112905856-112933219,27363
79452877,79471208,chr7,MAGI2-AS3,chr7:79452877-79471208,18331
138465479,138469303,chr5,EGR1,chr5:138465479-138469303,3824
138473744,138474361,chr5,RPL7P19,chr5:138473744-138474361,617
37106228,37249376,chr5,CPLANE1,chr5:37106228-37249376,143148
197726879,197786762,chr2,BOLL,chr2:197726879-197786762,59883
145864245,145964423,chr6,SHPRH,chr6:145864245-145964423,100178
27235308,27258420,chr8,STMN4,chr8:27235308-27258420,23112
56465640,56582667,chr16,BBS2,chr16:56465640-56582667,117027
40331452,40340939,chr15,CCDC9B,chr15:40331452-40340939,9487
13150411,13154911,chr19,IER2,chr19:13150411-13154911,4500
93894431,93984150,chr15,LINC01580,chr15:93894431-93984150,89719
13157959,13158788,chr19,RPL12P42,chr19:13157959-13158788,829
146391421,146495991,chr3,PLSCR2,chr3:146391421-146495991,104570
13206442,13633025,chr19,CACNA1A,chr19:13206442-13633025,426583
69462921,69843120,chr15,DRAIC,chr15:69462921-69843120,380199
107650260,107662204,chr7,SLC26A4-AS1,chr7:107650260-107662204,11944
248083522,248087522,chr1,OR2T32P,chr1:248083522-248087522,4000
160151586,160186980,chr1,ATP1A4,chr1:160151586-160186980,35394
168456249,168775134,chr2,CERS6,chr2:168456249-168775134,318885
75359194,75395383,chr7,STAG3L1,chr7:75359194-75395383,36189
146515180,146544856,chr3,PLSCR1,chr3:146515180-146544856,29676
45190931,45222222,chr17,FMNL1-DT,chr17:45190931-45222222,31291
171782432,171796126,chr5,SMIM23,chr5:171782432-171796126,13694
45245186,45251129,chr17,EFCAB15P,chr17:45245186-45251129,5943
171861549,172006873,chr5,FBXW11,chr5:171861549-172006873,145324
112953282,112995696,chr7,HRAT17,chr7:112953282-112995696,42414
45247916,45269824,chr17,MAP3K14-AS1,chr17:45247916-45269824,21908
86784610,86808396,chr2,CD8A,chr2:86784610-86808396,23786
176367699,176368401,chr1,MORF4L1P7,chr1:176367699-176368401,702
45254393,45262094,chr17,SPATA32,chr17:45254393-45262094,7701
81440326,81447439,chr8,PMP2,chr8:81440326-81447439,7113
149883179,149898113,chr6,RAET1E,chr6:149883179-149898113,14934
185435839,185436047,chr1,MCRIP2P2,chr1:185435839-185436047,208
213924749,213926654,chr1,LINC00538,chr1:213924749-213926654,1905
230057990,230282122,chr1,GALNT2,chr1:230057990-230282122,224132
132410636,132488702,chr5,IRF1-AS1,chr5:132410636-132488702,78066
45263119,45317029,chr17,MAP3K14,chr17:45263119-45317029,53910
81458253,81461579,chr8,FABP9,chr8:81458253-81461579,3326
81478419,81483236,chr8,FABP4,chr8:81478419-81483236,4817
17393595,17557780,chr6,CAP2,chr6:17393595-17557780,164185
234724042,234736720,chr1,LINC01132,chr1:234724042-234736720,12678
132419416,132426714,chr5,LINC02863,chr5:132419416-132426714,7298
48902556,48903891,chr7,GDI2P1,chr7:48902556-48903891,1335
171248471,171285978,chr1,FMO1,chr1:171248471-171285978,37507
132541445,132556838,chr5,IL5,chr5:132541445-132556838,15393
48924547,48927454,chr7,CDC14C,chr7:48924547-48927454,2907
1530702,1543043,chr7,MAFK,chr7:1530702-1543043,12341
9403475,9423528,chr2,ITGB1BP1,chr2:9403475-9423528,20053
112938051,112976460,chr12,OAS3,chr12:112938051-112976460,38409
81521682,81522232,chr8,FTH1P11,chr8:81521682-81522232,550
45929319,46121454,chr11,PHF21A,chr11:45929319-46121454,192135
81605569,81631134,chr8,IMPA1P1,chr8:81605569-81631134,25565
81617220,81618560,chr8,NIPA2P4,chr8:81617220-81618560,1340
1542235,1560821,chr7,TMEM184A,chr7:1542235-1560821,18586
81627269,81627617,chr8,RPS26P34,chr8:81627269-81627617,348
81634357,81635662,chr8,SLC10A5P1,chr8:81634357-81635662,1305
153887428,153898987,chr5,LINC01861,chr5:153887428-153898987,11559
45327366,45327497,chr17,RNA5SP443,chr17:45327366-45327497,131
81656914,81686331,chr8,IMPA1,chr8:81656914-81686331,29417
153990148,154038936,chr5,FAM114A2,chr5:153990148-154038936,48788
40654665,40665181,chr17,KRT222,chr17:40654665-40665181,10516
146571477,146571583,chr3,RNU6-428P,chr3:146571477-146571583,106
146589602,146590325,chr3,PLSCR5-AS1,chr3:146589602-146590325,723
160399274,160434954,chr3,SMC4,chr3:160399274-160434954,35680
40687038,40689360,chr17,KRT224P,chr17:40687038-40689360,2322
40697991,40703752,chr17,KRT24,chr17:40697991-40703752,5761
231337104,231355023,chr1,SPRTN,chr1:231337104-231355023,17919
34755084,34813505,chr15,GJD2-DT,chr15:34755084-34813505,58421
40748021,40755331,chr17,KRT25,chr17:40748021-40755331,7310
1567332,1571005,chr7,PSMG3,chr7:1567332-1571005,3673
40766238,40772162,chr17,KRT26,chr17:40766238-40772162,5924
84080168,84165291,chr15,EFL1P1,chr15:84080168-84165291,85123
1570073,1589626,chr7,PSMG3-AS1,chr7:1570073-1589626,19553
231363751,231422287,chr1,EGLN1,chr1:231363751-231422287,58536
40776808,40782550,chr17,KRT27,chr17:40776808-40782550,5742
1665745,1747946,chr7,ELFN1,chr7:1665745-1747946,82201
40792196,40799959,chr17,KRT28,chr17:40792196-40799959,7763
98323902,98421021,chr15,LINC02351,chr15:98323902-98421021,97119
53035170,53130344,chr15,LINC02490,chr15:53035170-53130344,95174
23912411,24090821,chr15,PWRN4,chr15:23912411-24090821,178410
40818117,40822614,chr17,KRT10,chr17:40818117-40822614,4497
182182730,182183096,chr1,YPEL5P1,chr1:182182730-182183096,366
234757619,234760056,chr1,PP2672,chr1:234757619-234760056,2437
185226808,185227700,chr1,RPL5P5,chr1:185226808-185227700,892
40861303,40867223,chr17,KRT12,chr17:40861303-40867223,5920
157794403,157820120,chr1,FCRL1,chr1:157794403-157820120,25717
40875889,40885242,chr17,KRT20,chr17:40875889-40885242,9353
17530899,17531652,chr6,RPL7P26,chr6:17530899-17531652,753
17582034,17582305,chr6,SUMO2P13,chr6:17582034-17582305,271
112978395,113011723,chr12,OAS2,chr12:112978395-113011723,33328
17600302,17611719,chr6,FAM8A1,chr6:17600302-17611719,11417
84631451,84647478,chr15,SCAND2P,chr15:84631451-84647478,16027
40922700,40937646,chr17,KRT23,chr17:40922700-40937646,14946
17619533,17619634,chr6,RNU6-190P,chr6:17619533-17619634,101
57537595,57550272,chr11,SMTNL1,chr11:57537595-57550272,12677
12716312,13290446,chr6,PHACTR1,chr6:12716312-13290446,574134
4593750,4595013,chr11,OR52I1,chr11:4593750-4595013,1263
4704784,4992431,chr11,MMP26,chr11:4704784-4992431,287647
227918656,227947932,chr1,WNT9A,chr1:227918656-227947932,29276
95186634,95327129,chr15,LETR1,chr15:95186634-95327129,140495
135859369,137092183,chr8,LINC02055,chr8:135859369-137092183,1232814
235547685,235650754,chr1,GNG4,chr1:235547685-235650754,103069
237966827,238042782,chr2,UBE2F,chr2:237966827-238042782,75955
4848237,4849208,chr11,OR51S1,chr11:4848237-4849208,971
154038959,154220478,chr5,MFAP3,chr5:154038959-154220478,181519
128899565,128906044,chr11,C11orf45,chr11:128899565-128906044,6479
64606174,64723197,chr11,NRXN2,chr11:64606174-64723197,117023
218442626,218443996,chr1,TGFB2-OT1,chr1:218442626-218443996,1370
227493029,227495142,chr1,TUBB8P10,chr1:227493029-227495142,2113
234629311,234634780,chr1,LINC00184,chr1:234629311-234634780,5469
178542752,178548889,chr1,C1orf220,chr1:178542752-178548889,6137
63917200,63918839,chr17,GH1,chr17:63917200-63918839,1639
222261833,222262796,chr1,QRSL1P2,chr1:222261833-222262796,963
176463171,176845601,chr1,PAPPA2,chr1:176463171-176845601,382430
121000486,121016502,chr12,C12orf43,chr12:121000486-121016502,16016
41636882,41654244,chr6,MDFI,chr6:41636882-41654244,17362
98645118,98647389,chr15,IRAIN,chr15:98645118-98647389,2271
132440440,132508719,chr5,IRF1,chr5:132440440-132508719,68279
93835490,93878822,chr15,LINC02207,chr15:93835490-93878822,43332
33162681,33192499,chr6,COL11A2,chr6:33162681-33192499,29818
63928740,63932336,chr17,CD79B,chr17:63928740-63932336,3596
179550539,179575952,chr1,NPHS2,chr1:179550539-179575952,25413
231528653,231819244,chr1,TSNAX-DISC1,chr1:231528653-231819244,290591
39250682,39254845,chr15,LINC02915,chr15:39250682-39254845,4163
56445807,56556513,chr8,PENK-AS1,chr8:56445807-56556513,110706
12794243,12818292,chr8,LINC00681,chr8:12794243-12818292,24049
102239386,102253750,chr8,UBR5-DT,chr8:102239386-102253750,14364
63938554,63972918,chr17,SCN4A,chr17:63938554-63972918,34364
85255369,85330334,chr15,ADAMTS7P4,chr15:85255369-85330334,74965
121053732,121059670,chr12,OASL2P,chr12:121053732-121059670,5938
56494923,56559823,chr8,LINC00968,chr8:56494923-56559823,64900
160404588,160404685,chr3,MIR15B,chr3:160404588-160404685,97
160404745,160404825,chr3,MIR16-2,chr3:160404745-160404825,80
160432445,160485773,chr3,TRIM59,chr3:160432445-160485773,53328
121017763,121039242,chr12,OASL,chr12:121017763-121039242,21479
142701857,142727047,chr8,LNCOC1,chr8:142701857-142727047,25190
91408708,91653389,chr15,CRAT37,chr15:91408708-91653389,244681
212653305,212665638,chr1,LINC02773,chr1:212653305-212665638,12333
160452598,160453403,chr3,B3GAT3P1,chr3:160452598-160453403,805
69834087,69854971,chr8,SLCO5A1-AS1,chr8:69834087-69854971,20884
160472348,160472416,chr3,RNU7-136P,chr3:160472348-160472416,68
189035961,189036444,chr1,CLPTM1LP1,chr1:189035961-189036444,483
63995418,63999899,chr17,PRR29-AS1,chr17:63995418-63999899,4481
205373252,205387440,chr1,LEMD1-AS1,chr1:205373252-205387440,14188
160495007,160565571,chr3,KPNA4,chr3:160495007-160565571,70564
125859721,126292788,chr8,LINC00861,chr8:125859721-126292788,433067
173141100,173142350,chr1,GOT2P2,chr1:173141100-173142350,1250
63998351,64004305,chr17,PRR29,chr17:63998351-64004305,5954
204617170,204685738,chr1,LRRN2,chr1:204617170-204685738,68568
71808439,71885268,chr16,ATXN1L,chr16:71808439-71885268,76829
71845996,71931199,chr16,IST1,chr16:71845996-71931199,85203
64803510,64811294,chr11,MEN1,chr11:64803510-64811294,7784
212285410,212361853,chr1,PPP2R5A,chr1:212285410-212361853,76443
100892343,100919391,chr15,ALDH1A3-AS1,chr15:100892343-100919391,27048
140564446,140569100,chr5,SLC35A4,chr5:140564446-140569100,4654
79123939,79283964,chr15,ANKRD34C-AS1,chr15:79123939-79283964,160025
64002594,64020634,chr17,ICAM2,chr17:64002594-64020634,18040
32477382,32477471,chr12,RNU6-494P,chr12:32477382-32477471,89
94553668,94570652,chr8,VIRMA-DT,chr8:94553668-94570652,16984
155845437,155845528,chr5,RNA5SP199,chr5:155845437-155845528,91
45215987,45482280,chr12,ANO6,chr12:45215987-45482280,266293
156814130,156814234,chr5,RNU6-556P,chr5:156814130-156814234,104
156850295,156852528,chr5,PPP1R2B,chr5:156850295-156852528,2233
155870344,156767788,chr5,SGCD,chr5:155870344-156767788,897444
28589476,28685264,chr15,HERC2P9,chr15:28589476-28685264,95788
79768110,79802848,chr8,LINC01607,chr8:79768110-79802848,34738
160514907,160515236,chr3,SCARNA7,chr3:160514907-160515236,329
160565447,160569248,chr3,KRT8P12,chr3:160565447-160569248,3801
160584945,160585787,chr3,RPL6P8,chr3:160584945-160585787,842
160677160,160678448,chr3,ARL14,chr3:160677160-160678448,1288
160753428,160755142,chr3,PPM1L-DT,chr3:160753428-160755142,1714
124823702,124962531,chr8,LINC00964,chr8:124823702-124962531,138829
87226189,87226277,chr3,MIR4795,chr3:87226189-87226277,88
87227271,87255556,chr3,CHMP2B,chr3:87227271-87255556,28285
64039080,64130819,chr17,ERN1,chr17:64039080-64130819,91739
162631373,162787405,chr1,DDR2,chr1:162631373-162787405,156032
47656487,47695192,chr6,ADGRF2,chr6:47656487-47695192,38705
47715283,47715601,chr6,RN7SKP116,chr6:47715283-47715601,318
47823390,47823550,chr6,RNU1-105P,chr6:47823390-47823550,160
32393339,32407181,chr6,BTNL2,chr6:32393339-32407181,13842
62347284,62403943,chr5,DIMT1,chr5:62347284-62403943,56659
83853360,83857515,chr6,RIPPLY2,chr6:83853360-83857515,4155
87323268,87324723,chr3,KRT8P25,chr3:87323268-87324723,1455
55465715,55490539,chr3,WNT5A,chr3:55465715-55490539,24824
127708072,127918631,chr6,THEMIS,chr6:127708072-127918631,210559
43726918,43747094,chr15,CATSPER2P1,chr15:43726918-43747094,20176
64146083,64146152,chr17,SNORD104,chr17:64146083-64146152,69
64146339,64146471,chr17,SNORA50C,chr17:64146339-64146471,132
13786557,13814568,chr6,MCUR1,chr6:13786557-13814568,28011
45894527,46028334,chr17,MAPT,chr17:45894527-46028334,133807
119703022,119767102,chr3,CFAP91,chr3:119703022-119767102,64080
58796237,58796854,chr11,TMA16P1,chr11:58796237-58796854,617
58834065,58904215,chr11,GLYATL2,chr11:58834065-58904215,70150
28789664,28859007,chr15,PDCD6IPP2,chr15:28789664-28859007,69343
143536845,143831185,chr6,PHACTR2,chr6:143536845-143831185,294340
58878302,58893460,chr11,GLYATL1P2,chr11:58878302-58893460,15158
81324338,81518200,chr15,TMC3-AS1,chr15:81324338-81518200,193862
65444458,65444557,chr11,MIR612,chr11:65444458-65444557,99
65487241,65488714,chr11,LINC02736,chr11:65487241-65488714,1473
65514403,65514923,chr11,SNRPGP19,chr11:65514403-65514923,520
65568482,65570423,chr11,ZNRD2-DT,chr11:65568482-65570423,1941
65570460,65573942,chr11,ZNRD2,chr11:65570460-65573942,3482
227975390,227978193,chr1,CICP26,chr1:227975390-227978193,2803
123193651,123202743,chr8,FAM83A-AS1,chr8:123193651-123202743,9092
24010081,24063321,chr2,MFSD2B,chr2:24010081-24063321,53240
203494153,203508949,chr1,OPTC,chr1:203494153-203508949,14796
72407778,72475168,chr15,TMEM202-AS1,chr15:72407778-72475168,67390
65572349,65574198,chr11,FAM89B,chr11:65572349-65574198,1849
96110040,96327361,chr15,NR2F2-AS1,chr15:96110040-96327361,217321
244352635,244389663,chr1,C1orf100,chr1:244352635-244389663,37028
65576046,65592650,chr11,EHBP1L1,chr11:65576046-65592650,16604
8228595,8244865,chr8,FAM86B3P,chr8:8228595-8244865,16270
119791829,119792553,chr3,PHBP8,chr3:119791829-119792553,724
171687409,171750158,chr2,DYNC1I2,chr2:171687409-171750158,62749
172532349,172611833,chr1,SUCO,chr1:172532349-172611833,79484
120110498,120110786,chr3,RN7SL762P,chr3:120110498-120110786,288
120121909,120122206,chr3,RN7SL397P,chr3:120121909-120122206,297
12673699,12673883,chr3,CRIP1P1,chr3:12673699-12673883,184
51933429,51941904,chr3,RRP9,chr3:51933429-51941904,8475
75727670,75738629,chr15,DNM1P35,chr15:75727670-75738629,10959
143039209,143060684,chr8,LINC02904,chr8:143039209-143060684,21475
65592836,65595996,chr11,KCNK7,chr11:65592836-65595996,3160
51955381,51957499,chr3,GPR62,chr3:51955381-51957499,2118
37980676,38062340,chr15,LINC02345,chr15:37980676-38062340,81664
72725419,72726151,chr5,RPL7P22,chr5:72725419-72726151,732
72733833,72734209,chr5,H2BL1P,chr5:72733833-72734209,376
51974706,51989183,chr3,ABHD14A-ACY1,chr3:51974706-51989183,14477
57300365,57307769,chr15,LINC00926,chr15:57300365-57307769,7404
72794405,72816565,chr5,TNPO1-DT,chr5:72794405-72816565,22160
65597756,65615382,chr11,MAP3K11,chr11:65597756-65615382,17626
76491200,76683504,chr8,ZFHX4-AS1,chr8:76491200-76683504,192304
72878591,72878663,chr5,MIR4804,chr5:72878591-72878663,72
72878868,72879185,chr5,RPL35AP13,chr5:72878868-72879185,317
72955206,72955699,chr5,FCHO2-DT,chr5:72955206-72955699,493
31142439,31158238,chr6,CCHCR1,chr6:31142439-31158238,15799
50354950,50372202,chr15,GABPB1-AS1,chr15:50354950-50372202,17252
73020700,73021279,chr5,CHP1P1,chr5:73020700-73021279,579
107376894,107670937,chr5,EFNA5,chr5:107376894-107670937,294043
123671110,123708399,chr12,TCTN2,chr12:123671110-123708399,37289
60289928,60516815,chr8,LINC01301,chr8:60289928-60516815,226887
107734773,107735066,chr5,RN7SL782P,chr5:107734773-107735066,293
107810629,107810924,chr5,RN7SKP122,chr5:107810629-107810924,295
40835808,40844409,chr15,SPINT1-AS1,chr15:40835808-40844409,8601
127511464,127512842,chr5,HNRNPKP1,chr5:127511464-127512842,1378
127517640,127555085,chr5,PRRC1,chr5:127517640-127555085,37445
74461248,74513636,chr15,UBL7-DT,chr15:74461248-74513636,52388
64373105,64383787,chr8,MIR124-2HG,chr8:64373105-64383787,10682
65615776,65637439,chr11,PCNX3,chr11:65615776-65637439,21663
71859680,71895336,chr16,ZNF821,chr16:71859680-71895336,35656
8234341,8244667,chr8,ALG1L13P,chr8:8234341-8244667,10326
44527257,44537046,chr15,EIF3J-DT,chr15:44527257-44537046,9789
144973589,145002912,chr8,ZNF252P,chr8:144973589-145002912,29323
65636310,65636369,chr11,MIR4690,chr11:65636310-65636369,59
65638101,65650918,chr11,SIPA1,chr11:65638101-65650918,12817
73908071,73928248,chr15,LOXL1-AS1,chr15:73908071-73928248,20177
51983340,51989197,chr3,ACY1,chr3:51983340-51989197,5857
127784618,127787042,chr5,CUL1P1,chr5:127784618-127787042,2424
110429959,110430282,chr12,HMGA1P3,chr12:110429959-110430282,323
145858521,145937126,chr5,GRXCR2,chr5:145858521-145937126,78605
110434823,110450422,chr12,ARPC3,chr12:110434823-110450422,15599
82217934,82261129,chr17,SLC16A3,chr17:82217934-82261129,43195
91059318,91070583,chr8,OTUD6B-AS1,chr8:91059318-91070583,11265
69234795,69277430,chr5,CDK7,chr5:69234795-69277430,42635
103132963,103141520,chr8,BAALC-AS2,chr8:103132963-103141520,8557
40039242,40080614,chr15,SRP14-DT,chr15:40039242-40080614,41372
9899871,9919155,chr8,MIR124-1HG,chr8:9899871-9919155,19284
92819540,92899701,chr15,CHASERR,chr15:92819540-92899701,80161
95204456,95811254,chr8,CFAP418-AS1,chr8:95204456-95811254,606798
65649192,65649253,chr11,MIR4489,chr11:65649192-65649253,61
65695552,65695837,chr11,RN7SL309P,chr11:65695552-65695837,285
60200270,60243137,chr11,MS4A4E,chr11:60200270-60243137,42867
237949214,237949734,chr1,MTND6P15,chr1:237949214-237949734,520
22495570,22590820,chr15,HERC2P2,chr15:22495570-22590820,95250
110452486,110469268,chr12,GPN3,chr12:110452486-110469268,16782
1971153,1974768,chr8,KBTBD11-AS1,chr8:1971153-1974768,3615
212565334,212620777,chr1,ATF3,chr1:212565334-212620777,55443
43917194,43917985,chr17,FAM215A,chr17:43917194-43917985,791
65538559,65558930,chr11,LTBP3,chr11:65538559-65558930,20371
43940804,43942476,chr17,PPY,chr17:43940804-43942476,1672
127794526,128187101,chr8,PVT1,chr8:127794526-128187101,392575
92713477,92734219,chr15,H2AZ2P1,chr15:92713477-92734219,20742
44004622,44009068,chr17,NAGS,chr17:44004622-44009068,4446
76188555,76311730,chr15,ETFA,chr15:76188555-76311730,123175
71991151,71991305,chr16,RPL39P31,chr16:71991151-71991305,154
72005037,72006543,chr16,ATP5F1AP3,chr16:72005037-72006543,1506
182573634,182589256,chr1,RNASEL,chr1:182573634-182589256,15622
72008588,72027664,chr16,DHODH,chr16:72008588-72027664,19076
44011188,44023946,chr17,TMEM101,chr17:44011188-44023946,12758
110460988,110461362,chr12,RPL31P49,chr12:110460988-110461362,374
247980872,247991204,chr1,OR2L1P,chr1:247980872-247991204,10332
110468415,110490385,chr12,FAM216A,chr12:110468415-110490385,21970
69280175,69332809,chr5,CCDC125,chr5:69280175-69332809,52634
208022242,208244384,chr1,PLXNA2,chr1:208022242-208244384,222142
72044289,72094431,chr16,TXNL4B,chr16:72044289-72094431,50142
44034328,44067619,chr17,LSM12,chr17:44034328-44067619,33291
69313371,69313872,chr5,CFL1P5,chr5:69313371-69313872,501
69333929,69334249,chr5,CHCHD2P2,chr5:69333929-69334249,320
69349936,69350445,chr5,NDUFB9P1,chr5:69349936-69350445,509
110491083,110502111,chr12,VPS29,chr12:110491083-110502111,11028
69350984,69370013,chr5,AK6,chr5:69350984-69370013,19029
44070735,44076344,chr17,G6PC3,chr17:44070735-44076344,5609
72093613,72112912,chr16,DHX38,chr16:72093613-72112912,19299
110501655,110533556,chr12,RAD9B,chr12:110501655-110533556,31901
69369293,69414801,chr5,RAD17,chr5:69369293-69414801,45508
44135883,44135989,chr17,RNU6-131P,chr17:44135883-44135989,106
44141906,44162476,chr17,HROB,chr17:44141906-44162476,20570
214532195,214533467,chr1,KRT18P12,chr1:214532195-214533467,1272
212830141,212847649,chr1,SPATA45,chr1:212830141-212847649,17508
186828949,186988981,chr1,PLA2G4A,chr1:186828949-186988981,160032
44170447,44179084,chr17,ASB16,chr17:44170447-44179084,8637
147204417,147390476,chr6,STXBP5,chr6:147204417-147390476,186059
44186970,44191929,chr17,TMUB2,chr17:44186970-44191929,4959
182336001,182336334,chr1,EIF1P3,chr1:182336001-182336334,333
171339299,171339959,chr1,TOP1P1,chr1:171339299-171339959,660
188694320,188695111,chr1,RPS3AP9,chr1:188694320-188695111,791
218459265,218525978,chr1,LINC02869,chr1:218459265-218525978,66713
44205033,44221626,chr17,UBTF,chr17:44205033-44221626,16593
204131062,204152044,chr1,ETNK2,chr1:204131062-204152044,20982
7795974,7796942,chr11,OR5P2,chr11:7795974-7796942,968
70056230,70065371,chr11,LINC02753,chr11:70056230-70065371,9141
70072434,70075433,chr11,LINC02584,chr11:70072434-70075433,2999
66908122,66918917,chr16,CDH16,chr16:66908122-66918917,10795
51993522,51995895,chr3,RPL29,chr3:51993522-51995895,2373
70075363,70075469,chr11,RNU6-1175P,chr11:70075363-70075469,106
70187788,70188509,chr11,ANO1-AS1,chr11:70187788-70188509,721
70203296,70207390,chr11,FADD,chr11:70203296-70207390,4094
70278921,70279297,chr11,H2AZP4,chr11:70278921-70279297,376
70283955,70284070,chr11,MIR548K,chr11:70283955-70284070,115
125946044,125958647,chr11,VSIG10L2,chr11:125946044-125958647,12603
110533245,110583318,chr12,PPTC7,chr12:110533245-110583318,50073
69985907,70189530,chr11,ANO1,chr11:69985907-70189530,203623
154154496,154356803,chr6,IPCEF1,chr6:154154496-154356803,202307
110625645,110625917,chr12,RN7SL387P,chr12:110625645-110625917,272
110627841,110704950,chr12,HVCN1,chr12:110627841-110704950,77109
6412418,6424670,chr1,HES2,chr1:6412418-6424670,12252
52048919,52056571,chr3,DUSP7,chr3:52048919-52056571,7652
52075226,52154690,chr3,POC1A,chr3:52075226-52154690,79464
182899865,182953525,chr1,SHCBP1L,chr1:182899865-182953525,53660
42494569,42756947,chr2,MTA3,chr2:42494569-42756947,262378
110719680,110742939,chr12,PPP1CC,chr12:110719680-110742939,23259
52193170,52194785,chr3,ALDOAP1,chr3:52193170-52194785,1615
52198086,52214327,chr3,ALAS1,chr3:52198086-52214327,16241
193756815,193757267,chr1,RPL23AP22,chr1:193756815-193757267,452
209756032,209782320,chr1,TRAF3IP3,chr1:209756032-209782320,26288
142981738,143018437,chr8,LY6E-DT,chr8:142981738-143018437,36699
74949261,74979033,chr11,SPCS2,chr11:74949261-74979033,29772
124462485,124474582,chr8,RNF139-DT,chr8:124462485-124474582,12097
52228612,52246788,chr3,TWF2,chr3:52228612-52246788,18176
110841538,110842387,chr12,RPL29P25,chr12:110841538-110842387,849
66921679,66925536,chr16,RRAD,chr16:66921679-66925536,3857
65653599,65663090,chr11,RELA,chr11:65653599-65663090,9491
110614027,110663431,chr12,TCTN1,chr12:110614027-110663431,49404
52245759,52250599,chr3,PPM1M,chr3:52245759-52250599,4840
66932065,66934423,chr16,CIAO2B,chr16:66932065-66934423,2358
83552880,83709691,chr6,SNAP91,chr6:83552880-83709691,156811
66934444,66945096,chr16,CES2,chr16:66934444-66945096,10652
69415065,69444330,chr5,MARVELD2,chr5:69415065-69444330,29265
44207771,44207839,chr17,MIR6782,chr17:44207771-44207839,68
52254434,52288020,chr3,WDR82,chr3:52254434-52288020,33586
36861674,36936670,chr17,LHX1-DT,chr17:36861674-36936670,74996
6617310,6708224,chr8,MCPH1-AS1,chr8:6617310-6708224,90914
36936785,36944612,chr17,LHX1,chr17:36936785-36944612,7827
52268278,52268361,chr3,MIRLET7G,chr3:52268278-52268361,83
52287089,52295257,chr3,GLYCTK,chr3:52287089-52295257,8168
1761054,1764508,chr8,CLN8-AS1,chr8:1761054-1764508,3454
37033745,37033813,chr17,MIR2909,chr17:37033745-37033813,68
141124717,141130070,chr8,DENND3-AS1,chr8:141124717-141130070,5353
69469883,69470136,chr5,RPS27P14,chr5:69469883-69470136,253
37143607,37144463,chr17,HMGB1P24,chr17:37143607-37144463,856
69478997,69479265,chr5,RN7SL616P,chr5:69478997-69479265,268
69530613,69530717,chr5,RNU6-724P,chr5:69530613-69530717,104
127289808,127482139,chr8,CASC8,chr8:127289808-127482139,192331
52288580,52299067,chr3,GLYCTK-AS1,chr3:52288580-52299067,10487
208236229,208266074,chr2,IDH1,chr2:208236229-208266074,29845
52294219,52294308,chr3,MIR135A1,chr3:52294219-52294308,89
52373652,52374882,chr3,PPP2R5CP,chr3:52373652-52374882,1230
69560191,69595221,chr5,GTF2H2C,chr5:69560191-69595221,35030
36948925,37056871,chr17,AATF,chr17:36948925-37056871,107946
52401008,52410008,chr3,BAP1,chr3:52401008-52410008,9000
242365189,242365822,chr1,RPL10AP5,chr1:242365189-242365822,633
227980051,227980227,chr1,SEPTIN14P17,chr1:227980051-227980227,176
66961245,66975149,chr16,CES3,chr16:66961245-66975149,13904
211743457,211830763,chr1,LPGAT1,chr1:211743457-211830763,87306
89545424,89757812,chr8,RIPK2-DT,chr8:89545424-89757812,212388
81804132,81814008,chr17,GCGR,chr17:81804132-81814008,9876
213983181,214041510,chr1,PROX1,chr1:213983181-214041510,58329
212309051,212309518,chr1,RPL23AP18,chr1:212309051-212309518,467
186900198,186900557,chr3,RPS20P14,chr3:186900198-186900557,359
66988589,67009758,chr16,CES4A,chr16:66988589-67009758,21169
190478551,190480735,chr1,LINC01351,chr1:190478551-190480735,2184
187120948,187180908,chr3,RPL39L,chr3:187120948-187180908,59960
166868748,166869209,chr1,DUTP6,chr1:166868748-166869209,461
207034366,207081024,chr1,PFKFB2,chr1:207034366-207081024,46658
186930325,187078553,chr3,ST6GAL1,chr3:186930325-187078553,148228
81822361,81833302,chr17,MCRIP1,chr17:81822361-81833302,10941
144049079,144051655,chr8,SMPD5,chr8:144049079-144051655,2576
72114869,72139892,chr11,FOLR3,chr11:72114869-72139892,25023
98957575,99013743,chr8,VPS13B-DT,chr8:98957575-99013743,56168
48324920,48325955,chr11,OR4C3,chr11:48324920-48325955,1035
90221341,90687863,chr8,LINC00534,chr8:90221341-90687863,466522
117204337,117232525,chr11,PCSK7,chr11:117204337-117232525,28188
228850526,229271287,chr2,PID1,chr2:228850526-229271287,420761
81833492,81835050,chr17,PPP1R27,chr17:81833492-81835050,1558
223975045,224039318,chr2,SERPINE2,chr2:223975045-224039318,64273
126556323,127419050,chr8,PCAT1,chr8:126556323-127419050,862727
81867721,81871378,chr17,ARHGDIA,chr17:81867721-81871378,3657
67019519,67019817,chr16,RN7SL543P,chr16:67019519-67019817,298
126342635,126357408,chr3,KLF15,chr3:126342635-126357408,14773
67028984,67101058,chr16,CBFB,chr16:67028984-67101058,72074
126393032,126394851,chr3,CFAP100-DT,chr3:126393032-126394851,1819
126394909,126436556,chr3,CFAP100,chr3:126394909-126436556,41647
231475956,231476288,chr1,SNRPD2P2,chr1:231475956-231476288,332
212432920,212446379,chr1,NENF,chr1:212432920-212446379,13459
143280158,143281692,chr8,MINCR,chr8:143280158-143281692,1534
27889941,28338901,chr2,BABAM2,chr2:27889941-28338901,448960
69492292,69558104,chr5,OCLN,chr5:69492292-69558104,65812
67164681,67169945,chr16,HSF4,chr16:67164681-67169945,5264
66920561,66926398,chr8,SNHG6,chr8:66920561-66926398,5837
126437601,126475891,chr3,ZXDC,chr3:126437601-126475891,38290
118747763,118791164,chr11,DDX6,chr11:118747763-118791164,43401
176616273,176616786,chr1,PTP4A1P7,chr1:176616273-176616786,513
212545694,212556065,chr1,LINC01740,chr1:212545694-212556065,10371
212791828,212816830,chr1,TATDN3,chr1:212791828-212816830,25002
128538013,129033642,chr5,SLC27A6,chr5:128538013-129033642,495629
6403551,6407142,chr8,MCPH1-DT,chr8:6403551-6407142,3591
126481166,126517773,chr3,UROC1,chr3:126481166-126517773,36607
81693631,81695058,chr8,SLC10A5,chr8:81693631-81695058,1427
49184686,49189080,chr12,TUBA1A,chr12:49184686-49189080,4394
81701334,81732903,chr8,ZFAND1,chr8:81701334-81732903,31569
47659591,47715389,chr11,AGBL2,chr11:47659591-47715389,55798
129094749,129114028,chr5,ISOC1,chr5:129094749-129114028,19279
49292631,49324576,chr12,TROAP-AS1,chr12:49292631-49324576,31945
126526999,126558965,chr3,C3orf22,chr3:126526999-126558965,31966
49293252,49298686,chr12,PRPH,chr12:49293252-49298686,5434
126564565,126564678,chr3,RNA5SP138,chr3:126564565-126564678,113
129097688,129097766,chr5,MIR4633,chr5:129097688-129097766,78
126660609,126671939,chr3,NUP210P1,chr3:126660609-126671939,11330
710355,784729,chr5,ZDHHC11B,chr5:710355-784729,74374
81887835,81891586,chr17,ALYREF,chr17:81887835-81891586,3751
126766434,126767475,chr3,RCC2P4,chr3:126766434-126767475,1041
196639694,196662004,chr3,NRROS,chr3:196639694-196662004,22310
30957754,30984664,chr16,SETD1A,chr16:30957754-30984664,26910
196708859,196708964,chr3,RNU6-646P,chr3:196708859-196708964,105
16180238,16185585,chr5,MARCHF11-DT,chr5:16180238-16185585,5347
196739857,196832647,chr3,PAK2,chr3:196739857-196832647,92790
16192088,16192709,chr5,NACAP6,chr5:16192088-16192709,621
16373361,16440081,chr5,LINC02150,chr5:16373361-16440081,66720
16451519,16465800,chr5,ZNF622,chr5:16451519-16465800,14281
81890790,81900991,chr17,ANAPC11,chr17:81890790-81900991,10201
3188925,3377830,chr2,EIPR1,chr2:3188925-3377830,188905
49323236,49331731,chr12,TROAP,chr12:49323236-49331731,8495
118572390,118603033,chr11,ARCN1,chr11:118572390-118603033,30643
196747192,196747324,chr3,RNU4-89P,chr3:196747192-196747324,132
196784980,196785086,chr3,RNU6-42P,chr3:196784980-196785086,106
196706277,196712250,chr3,CEP19,chr3:196706277-196712250,5973
271670,438291,chr5,PDCD6-AHRR,chr5:271670-438291,166621
84881984,84893379,chr3,LINC02025,chr3:84881984-84893379,11395
74627406,74641424,chr5,ENC1,chr5:74627406-74641424,14018
84958989,86074429,chr3,CADM2,chr3:84958989-86074429,1115440
1770320,1771561,chr16,NME3,chr16:1770320-1771561,1241
150778757,150796734,chr5,SMIM3,chr5:150778757-150796734,17977
86302211,86345943,chr11,HIKESHI,chr11:86302211-86345943,43732
109689927,109869625,chr5,MAN2A1,chr5:109689927-109869625,179698
98608579,98618515,chr2,UNC50,chr2:98608579-98618515,9936
61258286,61295316,chr11,VWCE,chr11:61258286-61295316,37030
85385710,85385792,chr3,MIR5688,chr3:85385710-85385792,82
85799987,85828050,chr3,CADM2-AS2,chr3:85799987-85828050,28063
85992183,86028007,chr3,CADM2-AS1,chr3:85992183-86028007,35824
182942115,182942404,chr1,HMGN1P4,chr1:182942115-182942404,289
86012561,86015120,chr3,THAP12P2,chr3:86012561-86015120,2559
237949736,237951536,chr1,MTND5P18,chr1:237949736-237951536,1800
169588849,169630193,chr1,SELP,chr1:169588849-169630193,41344
139353946,139389736,chr3,COPB2,chr3:139353946-139389736,35790
57976435,57988116,chr16,TEPP,chr16:57976435-57988116,11681
173314723,173328447,chr5,STC2,chr5:173314723-173328447,13724
170178145,170655171,chr2,MYO3B,chr2:170178145-170655171,477026
11254417,11256204,chr16,SOCS1,chr16:11254417-11256204,1787
72002864,72080693,chr11,NUMA1,chr11:72002864-72080693,77829
181147586,181159285,chr5,OR2V2,chr5:181147586-181159285,11699
3611728,3680143,chr16,DNASE1,chr16:3611728-3680143,68415
43039233,43043170,chr5,ANXA2R,chr5:43039233-43043170,3937
140558268,140564781,chr5,APBB3,chr5:140558268-140564781,6513
49332409,49337188,chr12,C1QL4,chr12:49332409-49337188,4779
49346888,49357546,chr12,DNAJC22,chr12:49346888-49357546,10658
81732448,81759515,chr8,CHMP4C,chr8:81732448-81759515,27067
49029707,49094363,chr3,QRICH1,chr3:49029707-49094363,64656
113291523,113291608,chr12,MIR6762,chr12:113291523-113291608,85
113358566,113391629,chr12,PLBD2,chr12:113358566-113391629,33063
81807772,81808726,chr8,HNRNPA1P36,chr8:81807772-81808726,954
81524981,81590139,chr8,FABP12,chr8:81524981-81590139,65158
41509593,41578421,chr8,GPAT4-AS1,chr8:41509593-41578421,68828
187706561,187708898,chr1,SLC4A1APP2,chr1:187706561-187708898,2337
242772620,242773103,chr1,RSL24D1P4,chr1:242772620-242773103,483
41511240,41512521,chr8,KRT18P37,chr8:41511240-41512521,1281
81900745,81902905,chr17,NPB,chr17:81900745-81902905,2160
41529218,41545030,chr8,GINS4,chr8:41529218-41545030,15812
198638457,198757476,chr1,PTPRC,chr1:198638457-198757476,119019
81900958,81911432,chr17,PCYT2,chr17:81900958-81911432,10474
113392445,113426301,chr12,SDS,chr12:113392445-113426301,33856
49083233,49083532,chr3,RN7SL182P,chr3:49083233-49083532,299
49095932,49105130,chr3,QARS1,chr3:49095932-49105130,9198
28822999,28837237,chr16,ATXN2L,chr16:28822999-28837237,14238
113422380,113438276,chr12,SDSL,chr12:113422380-113438276,15896
41577187,41625001,chr8,GPAT4,chr8:41577187-41625001,47814
113462033,113472280,chr12,LHX5,chr12:113462033-113472280,10247
116529013,116561127,chr6,CALHM4,chr6:116529013-116561127,32114
113298759,113359493,chr12,SLC8B1,chr12:113298759-113359493,60734
31639028,31652705,chr6,BAG6,chr6:31639028-31652705,13677
41488200,41511095,chr8,GOLGA7,chr8:41488200-41511095,22895
130755540,130768134,chr2,AMER3,chr2:130755540-130768134,12594
32063556,32157637,chr2,SPAST,chr2:32063556-32157637,94081
210462345,210463012,chr1,BPNT2P1,chr1:210462345-210463012,667
55973913,55996683,chr12,RAB5B,chr12:55973913-55996683,22770
209583714,209613939,chr1,CAMK1G,chr1:209583714-209613939,30225
9627347,9712378,chr5,TAS2R1,chr5:9627347-9712378,85031
177501904,177511274,chr5,DOK3,chr5:177501904-177511274,9370
248838210,248849517,chr1,ZNF672,chr1:248838210-248849517,11307
55997180,56006641,chr12,SUOX,chr12:55997180-56006641,9461
162561506,162599842,chr1,UAP1,chr1:162561506-162599842,38336
82273320,82278396,chr5,RPS23,chr5:82273320-82278396,5076
112976702,113022195,chr5,DCP2,chr5:112976702-113022195,45493
162497251,162529631,chr1,UHMK1,chr1:162497251-162529631,32380
81911939,81921323,chr17,SIRT7,chr17:81911939-81921323,9384
56007659,56038435,chr12,IKZF4,chr12:56007659-56038435,30776
1772810,1781708,chr16,EME2,chr16:1772810-1781708,8898
212466699,212472905,chr1,LINC02771,chr1:212466699-212472905,6206
208606564,208614295,chr1,LINC01735,chr1:208606564-208614295,7731
209779208,209784559,chr1,C1orf74,chr1:209779208-209784559,5351
209614870,209652425,chr1,LAMB3,chr1:209614870-209652425,37555
89657740,89671272,chr16,SPATA33,chr16:89657740-89671272,13532
124636913,124748807,chr5,ZNF608,chr5:124636913-124748807,111894
84218657,84240012,chr16,KCNG4,chr16:84218657-84240012,21355
23061406,23149452,chr16,USP31,chr16:23061406-23149452,88046
56041351,56044697,chr12,RPS26,chr12:56041351-56044697,3346
4556340,4600758,chr16,C16orf96,chr16:4556340-4600758,44418
56104537,56113910,chr12,PA2G4,chr12:56104537-56113910,9373
205142505,205211702,chr1,DSTYK,chr1:205142505-205211702,69197
71929538,72000402,chr16,PKD1L3,chr16:71929538-72000402,70864
232543883,232550557,chr2,TIGD1,chr2:232543883-232550557,6674
74529725,74533332,chr2,HTRA2,chr2:74529725-74533332,3607
159950493,159951498,chr5,GAPDHP40,chr5:159950493-159951498,1005
160009113,160065543,chr5,TTC1,chr5:160009113-160065543,56430
81918270,81927735,chr17,MAFG,chr17:81918270-81927735,9465
2209253,2210905,chr16,BRICD5,chr16:2209253-2210905,1652
81927829,81930753,chr17,MAFG-DT,chr17:81927829-81930753,2924
81932384,81942412,chr17,PYCR1,chr17:81932384-81942412,10028
5239802,7713340,chr16,RBFOX1,chr16:5239802-7713340,2473538
55519604,55545079,chr2,CFAP36,chr2:55519604-55545079,25475
205381378,205455954,chr1,LEMD1,chr1:205381378-205455954,74576
56116590,56117967,chr12,RPL41,chr12:56116590-56117967,1377
160061801,160119450,chr5,PWWP2A,chr5:160061801-160119450,57649
56118250,56144674,chr12,ESYT1,chr12:56118250-56144674,26424
160195744,160204826,chr5,FABP6-AS1,chr5:160195744-160204826,9082
102347211,102378670,chr11,BIRC2,chr11:102347211-102378670,31459
129460281,129738683,chr5,ADAMTS19,chr5:129460281-129738683,278402
218912757,218918714,chr1,LINC01710,chr1:218912757-218918714,5957
210859177,210862285,chr1,IPO8P1,chr1:210859177-210862285,3108
248721993,248722201,chr1,AHCYP8,chr1:248721993-248722201,208
17539698,17697874,chr1,ARHGEF10L,chr1:17539698-17697874,158176
101029624,101129813,chr11,PGR,chr11:101029624-101129813,100189
58453982,58460139,chr5,PLK2,chr5:58453982-58460139,6157
63840952,63891562,chr2,UGP2,chr2:63840952-63891562,50610
231528541,231566524,chr1,TSNAX,chr1:231528541-231566524,37983
56118260,56127514,chr12,ZC3H10,chr12:56118260-56127514,9254
123358428,123627774,chr11,GRAMD1B,chr11:123358428-123627774,269346
56150796,56158220,chr12,MYL6B-AS1,chr12:56150796-56158220,7424
29425504,29457071,chr6,OR11A1,chr6:29425504-29457071,31567
235328570,235448952,chr1,TBCE,chr1:235328570-235448952,120382
56152256,56159647,chr12,MYL6B,chr12:56152256-56159647,7391
108984309,109094846,chr6,SESN1,chr6:108984309-109094846,110537
58530043,58530109,chr5,MIR548AE2,chr5:58530043-58530109,66
58541567,58558243,chr5,LINC02108,chr5:58541567-58558243,16676
102581368,102617589,chr5,LINC00492,chr5:102581368-102617589,36221
102604220,102671765,chr5,LINC00491,chr5:102604220-102671765,67545
103032376,103033031,chr5,EIF3KP1,chr5:103032376-103033031,655
103086000,103120138,chr5,GIN1,chr5:103086000-103120138,34138
148290889,148519604,chr1,LINC01138,chr1:148290889-148519604,228715
56158346,56163496,chr12,MYL6,chr12:56158346-56163496,5150
192716132,192716653,chr1,RPS27AP5,chr1:192716132-192716653,521
181123122,181131169,chr5,OR2V1,chr5:181123122-181131169,8047
208626741,208628085,chr1,LINC02769,chr1:208626741-208628085,1344
75538598,75538658,chr5,RNU7-175P,chr5:75538598-75538658,60
75225424,75225668,chr5,SUMO2P5,chr5:75225424-75225668,244
162069691,162370475,chr1,NOS1AP,chr1:162069691-162370475,300784
71886550,72403145,chr6,RIMS1,chr6:71886550-72403145,516595
75356345,75512138,chr5,CERT1,chr5:75356345-75512138,155793
49099854,49099914,chr3,MIR6890,chr3:49099854-49099914,60
49121114,49133118,chr3,LAMB2,chr3:49121114-49133118,12004
212624474,212626775,chr1,FAM71A,chr1:212624474-212626775,2301
201982372,202006147,chr1,RNPEP,chr1:201982372-202006147,23775
81939645,81947233,chr17,MYADML2,chr17:81939645-81947233,7588
81952507,81961840,chr17,NOTUM,chr17:81952507-81961840,9333
49140086,49160851,chr3,LAMB2P1,chr3:49140086-49160851,20765
49162535,49166331,chr3,CCDC71,chr3:49162535-49166331,3796
49171598,49176486,chr3,KLHDC8B,chr3:49171598-49176486,4888
12938578,12944489,chr19,CALR,chr19:12938578-12944489,5911
49177634,49191858,chr3,C3orf84,chr3:49177634-49191858,14224
81509413,81523847,chr17,ACTG1,chr17:81509413-81523847,14434
49024325,49029447,chr3,IMPDH2,chr3:49024325-49029447,5122
148863564,148863804,chr2,UBBP3,chr2:148863564-148863804,240
148866470,148888823,chr2,KIF5C-AS1,chr2:148866470-148888823,22353
148870024,148870381,chr2,RPS20P13,chr2:148870024-148870381,357
17390509,17394158,chr19,CCDC194,chr19:17390509-17394158,3649
148872253,148872797,chr2,USP8P2,chr2:148872253-148872797,544
17402939,17405630,chr19,BST2,chr19:17402939-17405630,2691
149068596,149068910,chr2,TXNP5,chr2:149068596-149068910,314
196639554,196763490,chr2,CCDC150,chr2:196639554-196763490,123936
56162359,56189567,chr12,SMARCC2,chr12:56162359-56189567,27208
17405686,17419324,chr19,BISPR,chr19:17405686-17419324,13638
102942995,102955732,chr11,MMP13,chr11:102942995-102955732,12737
212992182,213015867,chr1,ANGEL2,chr1:212992182-213015867,23685
17405722,17433724,chr19,MVB12A,chr19:17405722-17433724,28002
694438,727727,chr11,EPS8L2,chr11:694438-727727,33289
150926163,150972727,chr3,CLRN1,chr3:150926163-150972727,46564
160876540,160885180,chr1,ITLN1,chr1:160876540-160885180,8640
196763035,196799725,chr2,GTF3C3,chr2:196763035-196799725,36690
132558138,132660082,chr3,ACAD11,chr3:132558138-132660082,101944
175156986,175192999,chr1,KIAA0040,chr1:175156986-175192999,36013
17435509,17448668,chr19,TMEM221,chr19:17435509-17448668,13159
17455425,17460926,chr19,NXNL1,chr19:17455425-17460926,5501
182409192,182560599,chr1,RGSL1,chr1:182409192-182560599,151407
48720585,48740610,chr19,RASIP1,chr19:48720585-48740610,20025
3065297,3082192,chr16,IL32,chr16:3065297-3082192,16895
196804417,196809355,chr2,C2orf66,chr2:196804417-196809355,4938
5830408,5839722,chr19,FUT6,chr19:5830408-5839722,9314
196833004,196927796,chr2,PGAP1,chr2:196833004-196927796,94792
132558142,132722459,chr3,NPHP3-ACAD11,chr3:132558142-132722459,164317
132597270,132618967,chr3,ACKR4,chr3:132597270-132618967,21697
5865826,5870540,chr19,FUT5,chr19:5865826-5870540,4714
132645831,132650383,chr3,HSPA8P19,chr3:132645831-132650383,4552
453134,453245,chr19,RNA5SP462,chr19:453134-453245,111
1620958,1622138,chr11,KRTAP5-4,chr11:1620958-1622138,1180
489176,505343,chr19,MADCAM1,chr19:489176-505343,16167
47980559,48170839,chr11,PTPRJ,chr11:47980559-48170839,190280
66293114,66293220,chr3,RNU6-787P,chr3:66293114-66293220,106
66323855,66324152,chr3,RN7SL482P,chr3:66323855-66324152,297
195836193,195860404,chr3,LINC01983,chr3:195836193-195860404,24211
195843986,195844596,chr3,KIF3AP1,chr3:195843986-195844596,610
195882329,195882395,chr3,MIR6829,chr3:195882329-195882395,66
195908076,195913986,chr3,TNK2-AS1,chr3:195908076-195913986,5910
195928589,195928775,chr3,RNU2-11P,chr3:195928589-195928775,186
195959748,195990318,chr3,SDHAP1,chr3:195959748-195990318,30570
81843159,81860856,chr17,P4HB,chr17:81843159-81860856,17697
571277,583494,chr19,BSG,chr19:571277-583494,12217
63985853,64001811,chr11,OTUB1,chr11:63985853-64001811,15958
196027183,196082096,chr3,TFRC,chr3:196027183-196082096,54913
209675412,209676390,chr1,G0S2,chr1:209675412-209676390,978
231925834,231945233,chr1,DISC1-IT1,chr1:231925834-231945233,19399
56202179,56221933,chr12,RNF41,chr12:56202179-56221933,19754
3940486,3955262,chr1,LINC01346,chr1:3940486-3955262,14776
208697369,208697698,chr1,RPS26P13,chr1:208697369-208697698,329
197014990,197016015,chr2,HNRNPA3P15,chr2:197014990-197016015,1025
231332753,231337852,chr1,EXOC8,chr1:231332753-231337852,5099
197028711,197030143,chr2,RPL4P7,chr2:197028711-197030143,1432
205434885,205457091,chr1,BLACAT1,chr1:205434885-205457091,22206
71581855,71603353,chr11,KRTAP5-11,chr11:71581855-71603353,21498
102064544,102179874,chr2,IL1R1,chr2:102064544-102179874,115330
189132350,189133292,chr1,GAPDHP75,chr1:189132350-189133292,942
196761,200261,chr11,ODF3,chr11:196761-200261,3500
182598623,182604389,chr1,RGS16,chr1:182598623-182604389,5766
75511756,75601144,chr5,POLK,chr5:75511756-75601144,89388
236966,252984,chr11,PSMD13,chr11:236966-252984,16018
200213678,200214322,chr1,CCNQP1,chr1:200213678-200214322,644
177170958,177282422,chr1,BRINP2,chr1:177170958-177282422,111464
42458844,42522582,chr17,ATP6V0A1,chr17:42458844-42522582,63738
211132588,211133374,chr1,KCNH1-IT1,chr1:211132588-211133374,786
198156994,198322420,chr1,NEK7,chr1:198156994-198322420,165426
56222015,56229854,chr12,NABP2,chr12:56222015-56229854,7839
196072819,196072880,chr3,RNU7-18P,chr3:196072819-196072880,61
12733528,12769457,chr3,TMEM40,chr3:12733528-12769457,35929
230314490,230426332,chr1,PGBD5,chr1:230314490-230426332,111842
179255733,179256081,chr1,COX5BP8,chr1:179255733-179256081,348
48393668,48444931,chr19,GRIN2D,chr19:48393668-48444931,51263
56230049,56237846,chr12,SLC39A5,chr12:56230049-56237846,7797
173608336,173669851,chr1,ANKRD45,chr1:173608336-173669851,61515
48599961,48615076,chr19,FAM83E,chr19:48599961-48615076,15115
202590596,202710454,chr1,SYT2,chr1:202590596-202710454,119858
35431823,35530300,chr11,PAMR1,chr11:35431823-35530300,98477
3594507,3606875,chr19,TBXA2R,chr19:3594507-3606875,12368
246945547,247008093,chr1,ZNF695,chr1:246945547-247008093,62546
3607247,3613930,chr19,CACTIN-AS1,chr19:3607247-3613930,6683
3610645,3626815,chr19,CACTIN,chr19:3610645-3626815,16170
102172621,102182108,chr2,IL1R1-AS1,chr2:102172621-102182108,9487
102187006,102240002,chr2,IL1RL2,chr2:102187006-102240002,52996
56237807,56258384,chr12,ANKRD52,chr12:56237807-56258384,20577
246321663,246322438,chr1,SMYD3-IT1,chr1:246321663-246322438,775
178479247,178499634,chr1,CLEC20A,chr1:178479247-178499634,20387
199148598,199393307,chr1,LINC02789,chr1:199148598-199393307,244709
238107736,238108567,chr1,YWHAQP9,chr1:238107736-238108567,831
213051233,213274774,chr1,RPS6KC1,chr1:213051233-213274774,223541
102249857,102250255,chr2,FAM183DP,chr2:102249857-102250255,398
75611182,75681773,chr5,ANKDD1B,chr5:75611182-75681773,70591
102311502,102352037,chr2,IL1RL1,chr2:102311502-102352037,40535
56266890,56270966,chr12,COQ10A,chr12:56266890-56270966,4076
12787393,12788671,chr3,KRT18P17,chr3:12787393-12788671,1278
3630183,3700468,chr19,PIP5K1C,chr19:3630183-3700468,70285
12796472,12871916,chr3,CAND2,chr3:12796472-12871916,75444
74696429,74731426,chr11,CHRDL2,chr11:74696429-74731426,34997
13690328,14011818,chr5,DNAH5,chr5:13690328-14011818,321490
56271699,56300391,chr12,CS,chr12:56271699-56300391,28692
102411243,102412108,chr2,SDR42E1P5,chr2:102411243-102412108,865
102432289,102432366,chr2,MIR4772,chr2:102432289-102432366,77
102473226,102533972,chr2,SLC9A4,chr2:102473226-102533972,60746
12834485,12841582,chr3,RPL32,chr3:12834485-12841582,7097
99154955,99163157,chr2,LIPT1,chr2:99154955-99163157,8202
18455824,18479601,chr11,LDHAL6A,chr11:18455824-18479601,23777
12840312,12840450,chr3,SNORA7A,chr3:12840312-12840450,138
15353385,15379815,chr19,AKAP8,chr19:15353385-15379815,26430
99161427,99181058,chr2,MITD1,chr2:99161427-99181058,19631
6448613,6474459,chr11,TRIM3,chr11:6448613-6474459,25846
119821321,120094994,chr3,GSK3B,chr3:119821321-120094994,273673
182959074,182960405,chr1,KRT18P28,chr1:182959074-182960405,1331
205227946,205285632,chr1,TMCC2,chr1:205227946-205285632,57686
99181152,99199561,chr2,MRPL30,chr2:99181152-99199561,18409
150219491,150290093,chr5,CAMK2A,chr5:150219491-150290093,70602
168053095,168101511,chr6,FRMD1,chr6:168053095-168101511,48416
205828025,205850132,chr1,PM20D1,chr1:205828025-205850132,22107
34994784,35026471,chr19,GRAMD1A,chr19:34994784-35026471,31687
99284238,99304742,chr2,LYG1,chr2:99284238-99304742,20504
57741491,57743554,chr11,SELENOH,chr11:57741491-57743554,2063
42609641,42615238,chr17,TUBG1,chr17:42609641-42615238,5597
46380756,46383837,chr11,MDK,chr11:46380756-46383837,3081
99318982,99340702,chr2,TXNDC9,chr2:99318982-99340702,21720
42678889,42683917,chr17,CCR10,chr17:42678889-42683917,5028
42682531,42699993,chr17,CNTNAP1,chr17:42682531-42699993,17462
182615254,182616629,chr1,LINC01686,chr1:182615254-182616629,1375
244394976,244395660,chr1,TGIF2P1,chr1:244394976-244395660,684
199371877,199372297,chr1,RPL23AP16,chr1:199371877-199372297,420
246945547,247078811,chr1,ZNF670-ZNF695,chr1:246945547-247078811,133264
229440259,229508341,chr1,NUP133,chr1:229440259-229508341,68082
199659551,199660729,chr2,SEPHS1P6,chr2:199659551-199660729,1178
1838981,1841680,chr11,TNNI2,chr11:1838981-1841680,2699
42700275,42745049,chr17,EZH1,chr17:42700275-42745049,44774
65525077,65538704,chr11,SCYL1,chr11:65525077-65538704,13627
220748225,220784815,chr1,MTARC2,chr1:220748225-220784815,36590
167111807,167139141,chr6,CCR6,chr6:167111807-167139141,27334
133824235,133895882,chr3,RAB6B,chr3:133824235-133895882,71647
199901081,199901377,chr2,RN7SL717P,chr2:199901081-199901377,296
199911293,199955935,chr2,C2orf69,chr2:199911293-199955935,44642
5993164,6199572,chr19,RFX2,chr19:5993164-6199572,206408
33586104,33593338,chr6,LINC00336,chr6:33586104-33593338,7234
208728665,208736286,chr1,LINC01717,chr1:208728665-208736286,7621
199928913,199955736,chr2,TYW5,chr2:199928913-199955736,26823
158131983,158149810,chr1,LINC01704,chr1:158131983-158149810,17827
134343307,134504581,chr6,LINC01010,chr6:134343307-134504581,161274
211207239,211207897,chr1,PRELID1P5,chr1:211207239-211207897,658
246516039,246524287,chr1,LINC01743,chr1:246516039-246524287,8248
149998019,150005166,chr6,RAET1K,chr6:149998019-150005166,7147
192316992,192367285,chr1,RGS21,chr1:192316992-192367285,50293
132954257,133107410,chr6,LINC00326,chr6:132954257-133107410,153153
17406760,17407382,chr1,RCC2-AS1,chr1:17406760-17407382,622
133928145,133929812,chr3,C3orf36,chr3:133928145-133929812,1667
192575763,192580024,chr1,RGS1,chr1:192575763-192580024,4261
49268596,49277232,chr3,C3orf62,chr3:49268596-49277232,8636
25328640,25328721,chr2,MIR1301,chr2:25328640-25328721,81
25369136,25375845,chr2,ARNILA,chr2:25369136-25375845,6709
25421117,25427643,chr2,DTNB-AS1,chr2:25421117-25427643,6526
167784537,167796872,chr6,LINC01558,chr6:167784537-167796872,12335
49274120,49274186,chr3,MIR4271,chr3:49274120-49274186,66
49277144,49340712,chr3,USP4,chr3:49277144-49340712,63568
121216587,121285202,chr2,TFCP2L1,chr2:121216587-121285202,68615
56309842,56316119,chr12,CNPY2,chr12:56309842-56316119,6277
169157162,169163007,chr6,LINC01615,chr6:169157162-169163007,5845
31197760,31203968,chr6,HCG27,chr6:31197760-31203968,6208
121337776,121649476,chr2,CLASP1,chr2:121337776-121649476,311700
163161675,163213023,chr1,RGS5-AS1,chr1:163161675-163213023,51348
208972454,208975307,chr1,LINC01774,chr1:208972454-208975307,2853
158878746,158883500,chr1,PYHIN5P,chr1:158878746-158883500,4754
113868013,113873390,chr6,MROCKI,chr6:113868013-113873390,5377
159062484,159147096,chr1,AIM2,chr1:159062484-159147096,84612
33249534,33255167,chr6,HCG25,chr6:33249534-33255167,5633
56334174,56340410,chr12,IL23A,chr12:56334174-56340410,6236
179099330,179229684,chr1,ABL2,chr1:179099330-179229684,130354
1601654,1607354,chr6,FOXCUT,chr6:1601654-1607354,5700
6210381,6279975,chr19,MLLT1,chr19:6210381-6279975,69594
56341597,56360167,chr12,STAT2,chr12:56341597-56360167,18570
113969701,114471705,chr6,HDAC2-AS2,chr6:113969701-114471705,502004
60866454,60945073,chr5,ERCC8,chr5:60866454-60945073,78619
6306142,6333612,chr19,ACER1,chr19:6306142-6333612,27470
68008578,68029282,chr11,ALDH3B1,chr11:68008578-68029282,20704
42708084,42708151,chr17,MIR6780A,chr17:42708084-42708151,67
42753530,42753799,chr17,HMGN2P15,chr17:42753530-42753799,269
42753914,42761257,chr17,RAMP2-AS1,chr17:42753914-42761257,7343
6361531,6370242,chr19,CLPP,chr19:6361531-6370242,8711
28091137,28093664,chr6,ZSCAN12P1,chr6:28091137-28093664,2527
42758447,42763041,chr17,RAMP2,chr17:42758447-42763041,4594
6372794,6375250,chr19,ALKBH7,chr19:6372794-6375250,2456
42773449,42779599,chr17,VPS25,chr17:42773449-42779599,6150
81844602,82169391,chr6,LINC02542,chr6:81844602-82169391,324789
6379572,6393981,chr19,GTF2F1,chr19:6379572-6393981,14409
105995623,106022403,chr11,MSANTD4,chr11:105995623-106022403,26780
8435568,9294133,chr6,HULC,chr6:8435568-9294133,858565
656794,657547,chr17,RPS4XP17,chr17:656794-657547,753
732412,742968,chr17,TLCD3A,chr17:732412-742968,10556
6395125,6419414,chr11,APBB1,chr11:6395125-6419414,24289
49365145,49367006,chr3,RHOA-IT1,chr3:49365145-49367006,1861
72151236,72207776,chr3,LINC00870,chr3:72151236-72207776,56540
72691705,72691811,chr3,RNA5SP136,chr3:72691705-72691811,106
744421,753999,chr17,GEMIN4,chr17:744421-753999,9578
194587673,194633689,chr3,TMEM44,chr3:194587673-194633689,46016
95477164,95484731,chr2,TRIM43B,chr2:95477164-95484731,7567
95514827,95520107,chr2,TRIM64FP,chr2:95514827-95520107,5280
752660,755336,chr17,DBIL5P,chr17:752660-755336,2676
782353,792509,chr17,MRM3,chr17:782353-792509,10156
95546531,95547545,chr2,OR7E102P,chr2:95546531-95547545,1014
95574901,95580769,chr2,TRIM51JP,chr2:95574901-95580769,5868
95592001,95599778,chr2,TRIM43,chr2:95592001-95599778,7777
35005990,35089319,chr17,RFFL,chr17:35005990-35089319,83329
6389638,6389703,chr19,MIR6885,chr19:6389638-6389703,65
6392921,6392983,chr19,MIR6790,chr19:6392921-6392983,62
95625213,95626236,chr2,UBTFL3,chr2:95625213-95626236,1023
6416410,6416511,chr19,MIR3940,chr19:6416410-6416511,101
6426037,6433779,chr19,SLC25A41,chr19:6426037-6433779,7742
56352387,56352450,chr12,RNU7-40P,chr12:56352387-56352450,63
56360568,56362857,chr12,APOF,chr12:56360568-56362857,2289
56376818,56377331,chr12,APONP,chr12:56376818-56377331,513
197379701,197380892,chr2,NPM1P46,chr2:197379701-197380892,1191
21131194,21239796,chr12,SLCO1B1,chr12:21131194-21239796,108602
197388515,197435079,chr2,SF3B1,chr2:197388515-197435079,46564
6436079,6465203,chr19,SLC25A23,chr19:6436079-6465203,29124
71220356,71259238,chr5,GUSBP17,chr5:71220356-71259238,38882
71337182,71446772,chr5,LINC02197,chr5:71337182-71446772,109590
21354959,21379980,chr12,IAPP,chr12:21354959-21379980,25021
71375786,71385993,chr5,PMCHL2,chr5:71375786-71385993,10207
105136308,105199559,chr6,BVES-AS1,chr6:105136308-105199559,63251
71537652,71537846,chr5,HMGN1P12,chr5:71537652-71537846,194
71719275,71721048,chr5,CARTPT,chr5:71719275-71721048,1773
21437615,21471250,chr12,PYROXD1,chr12:21437615-21471250,33635
184276011,184293031,chr3,ECE2,chr3:184276011-184293031,17020
248906196,248919946,chr1,PGBD2,chr1:248906196-248919946,13750
119445716,119445833,chr5,RNA5SP190,chr5:119445716-119445833,117
119555250,119555658,chr5,FABP5P6,chr5:119555250-119555658,408
160848010,160848502,chr1,PPIAP37,chr1:160848010-160848502,492
119629559,119635822,chr5,FAM170A,chr5:119629559-119635822,6263
29976042,30061640,chr6,ZNRD1ASP,chr6:29976042-30061640,85598
147155106,147172550,chr1,PRKAB2,chr1:147155106-147172550,17444
35093909,35093973,chr17,RNU6-840P,chr17:35093909-35093973,64
35121615,35130732,chr17,FNDC8,chr17:35121615-35130732,9117
119652523,119653000,chr5,TUBAP15,chr5:119652523-119653000,477
21447545,21448314,chr12,ELOCP31,chr12:21447545-21448314,769
234026851,234027227,chr1,RAC1P7,chr1:234026851-234027227,376
35128730,35142304,chr17,NLE1,chr17:35128730-35142304,13574
8065402,8149592,chr19,FBN3,chr19:8065402-8149592,84190
21468910,21501669,chr12,RECQL,chr12:21468910-21501669,32759
212858275,212899363,chr1,FLVCR1,chr1:212858275-212899363,41088
119452465,119637199,chr5,HSD17B4,chr5:119452465-119637199,184734
197447745,197447851,chr2,RNU6-1029P,chr2:197447745-197447851,106
197500140,197503449,chr2,HSPE1,chr2:197500140-197503449,3309
145799409,145887430,chr6,FBXO30-DT,chr6:145799409-145887430,88021
205455929,205469024,chr1,LEMD1-DT,chr1:205455929-205469024,13095
205789094,205813748,chr1,SLC41A1,chr1:205789094-205813748,24654
197500413,197550726,chr2,HSPE1-MOB4,chr2:197500413-197550726,50313
197515571,197553699,chr2,MOB4,chr2:197515571-197553699,38128
146824539,147204614,chr6,STXBP5-AS1,chr6:146824539-147204614,380075
21501781,21518408,chr12,GOLT1B,chr12:21501781-21518408,16627
118606440,118658031,chr11,PHLDB1,chr11:118606440-118658031,51591
215622891,216423448,chr1,USH2A,chr1:215622891-216423448,800557
51957454,51974016,chr3,PCBP4,chr3:51957454-51974016,16562
35147817,35189345,chr17,UNC45B,chr17:35147817-35189345,41528
21526296,21541249,chr12,SPX,chr12:21526296-21541249,14953
32727490,32755897,chr12,YARS2,chr12:32727490-32755897,28407
32863118,32863433,chr12,RPL35AP27,chr12:32863118-32863433,315
48771975,48772037,chr12,MIR4701,chr12:48771975-48772037,62
48789147,48790535,chr12,ADCY6-DT,chr12:48789147-48790535,1388
48813794,48828941,chr12,CACNB3,chr12:48813794-48828941,15147
169645425,169694405,chr2,CCDC173,chr2:169645425-169694405,48980
43891045,43938212,chr6,LINC01512,chr6:43891045-43938212,47167
109165831,109355063,chr6,CCDC162P,chr6:109165831-109355063,189232
169694454,169701708,chr2,PHOSPHO2,chr2:169694454-169701708,7254
169694488,169776989,chr2,KLHL23,chr2:169694488-169776989,82501
31863633,31864876,chr16,RBM22P13,chr16:31863633-31864876,1243
31873807,31917357,chr16,ZNF267,chr16:31873807-31917357,43550
35243071,35273655,chr17,SLFN5,chr17:35243071-35273655,30584
221330080,221336489,chr1,LINC02817,chr1:221330080-221336489,6409
169767185,169768799,chr2,PTCHD3P2,chr2:169767185-169768799,1614
169790093,169790885,chr2,CYB5AP2,chr2:169790093-169790885,792
26421391,26432383,chr6,BTN2A3P,chr6:26421391-26432383,10992
169791933,169812064,chr2,SSB,chr2:169791933-169812064,20131
248936581,248937043,chr1,RPL23AP25,chr1:248936581-248937043,462
35092221,35121522,chr17,RAD51D,chr17:35092221-35121522,29301
158869848,158919105,chr6,LINC02901,chr6:158869848-158919105,49257
32034853,32035326,chr16,IGHV1OR16-1,chr16:32034853-32035326,473
213428708,213429077,chr1,RPL31P13,chr1:213428708-213429077,369
32059084,32059372,chr16,IGHV1OR16-3,chr16:32059084-32059372,288
182096338,182314061,chr1,LINC01344,chr1:182096338-182314061,217723
32066065,32066358,chr16,IGHV3OR16-9,chr16:32066065-32066358,293
32103245,32188107,chr16,HERC2P4,chr16:32103245-32188107,84862
169810081,169824931,chr2,METTL5,chr2:169810081-169824931,14850
246108626,246113866,chr1,SMYD3-AS1,chr1:246108626-246113866,5240
247034637,247078811,chr1,ZNF670,chr1:247034637-247078811,44174
48829756,48852842,chr12,DDX23,chr12:48829756-48852842,23086
76186325,76210736,chr11,WNT11,chr11:76186325-76210736,24411
244408494,244451909,chr1,ADSS2,chr1:244408494-244451909,43415
32199902,32202822,chr16,ABHD17AP8,chr16:32199902-32202822,2920
172750682,172821474,chr3,ECT2,chr3:172750682-172821474,70792
32252719,32255922,chr16,TP53TG3D,chr16:32252719-32255922,3203
72216601,72221950,chr11,FOLR2,chr11:72216601-72221950,5349
242082986,242524697,chr1,PLD5,chr1:242082986-242524697,441711
28751787,28772807,chr16,NPIPB9,chr16:28751787-28772807,21020
48857145,48865870,chr12,RND1,chr12:48857145-48865870,8725
2783953,2787948,chr16,PRSS33,chr16:2783953-2787948,3995
48766194,48789089,chr12,ADCY6,chr12:48766194-48789089,22895
170077224,170078294,chr2,NSA2P5,chr2:170077224-170078294,1070
218881600,218882650,chr1,NXNP1,chr1:218881600-218882650,1050
201995696,202010463,chr1,ELF3-AS1,chr1:201995696-202010463,14767
170119996,170120098,chr2,RNU6-1006P,chr2:170119996-170120098,102
174756850,174757119,chr1,BANF1P4,chr1:174756850-174757119,269
201896456,201946588,chr1,LMOD1,chr1:201896456-201946588,50132
57338352,57372396,chr11,P2RX3,chr11:57338352-57372396,34044
53054991,53329150,chr16,CHD9,chr16:53054991-53329150,274159
124644434,124963165,chr6,RNF217-AS1,chr6:124644434-124963165,318731
197486584,197516737,chr2,HSPD1,chr2:197486584-197516737,30153
123152320,123244014,chr12,MPHOSPH9,chr12:123152320-123244014,91694
180269653,180502954,chr1,ACBD6,chr1:180269653-180502954,233301
135497422,135813990,chr6,LINC00271,chr6:135497422-135813990,316568
72223701,72239147,chr11,INPPL1,chr11:72223701-72239147,15446
15380050,15419141,chr19,AKAP8L,chr19:15380050-15419141,39091
210676823,211134165,chr1,KCNH1,chr1:210676823-211134165,457342
16761138,16763947,chr6,ATXN1-AS1,chr6:16761138-16763947,2809
41452889,41548621,chr6,FOXP4-AS1,chr6:41452889-41548621,95732
43931572,44074655,chr6,SCIRT,chr6:43931572-44074655,143083
46029916,46225389,chr17,KANSL1,chr17:46029916-46225389,195473
30286690,30327382,chr6,HCG18,chr6:30286690-30327382,40692
35138882,35232402,chr11,CD44,chr11:35138882-35232402,93520
123250112,123272334,chr12,CDK2AP1,chr12:123250112-123272334,22222
123282916,123283034,chr12,RNA5SP375,chr12:123282916-123283034,118
123289109,123364847,chr12,SBNO1,chr12:123289109-123364847,75738
16473038,16617101,chr5,RETREG1,chr5:16473038-16617101,144063
142306607,142448062,chr3,XRN1,chr3:142306607-142448062,141455
123364764,123364843,chr12,MIR8072,chr12:123364764-123364843,79
123233385,123258079,chr12,MTRFR,chr12:123233385-123258079,24694
112523514,112620825,chr1,ST7L,chr1:112523514-112620825,97311
75528530,75536108,chr16,CHST5,chr16:75528530-75536108,7578
124946825,124989131,chr12,DHX37,chr12:124946825-124989131,42306
72816312,72916733,chr5,TNPO1,chr5:72816312-72916733,100421
169827454,170084131,chr2,UBR3,chr2:169827454-170084131,256677
28846600,28874212,chr16,SH2B1,chr16:28846600-28874212,27612
75284992,75317525,chr6,TMEM30A-DT,chr6:75284992-75317525,32533
37507348,37536266,chr6,LINC02520,chr6:37507348-37536266,28918
13731760,13763296,chr19,YJU2B,chr19:13731760-13763296,31536
25061626,25452263,chr6,CMAHP,chr6:25061626-25452263,390637
161931199,161931466,chr2,RPEP5,chr2:161931199-161931466,267
162077357,162077651,chr2,TIMM8AP1,chr2:162077357-162077651,294
162088259,162090072,chr2,EIF3EP2,chr2:162088259-162090072,1813
124993645,125031231,chr12,BRI3BP,chr12:124993645-125031231,37586
162142882,162152404,chr2,GCG,chr2:162142882-162152404,9522
125025434,125027410,chr12,THRIL,chr12:125025434-125027410,1976
13764522,13774282,chr19,MRI1,chr19:13764522-13774282,9760
125065434,125143333,chr12,AACS,chr12:125065434-125143333,77899
508503,721717,chr17,VPS53,chr17:508503-721717,213214
29871159,29899550,chr16,SEZ6L2,chr16:29871159-29899550,28391
177138699,177138797,chr2,RNA5SP112,chr2:177138699-177138797,98
79803577,79833387,chr6,LINC01621,chr6:79803577-79833387,29810
177177695,177178255,chr2,STUB1P1,chr2:177177695-177178255,560
177197985,177198547,chr2,KRT8P40,chr2:177197985-177198547,562
177212726,177212799,chr2,MIR4444-1,chr2:177212726-177212799,73
53616471,53631400,chr6,LINC01564,chr6:53616471-53631400,14929
4610539,4611919,chr6,KU-MEL-3,chr6:4610539-4611919,1380
177227595,177392697,chr2,NFE2L2,chr2:177227595-177392697,165102
13774456,13778773,chr19,C19orf53,chr19:13774456-13778773,4317
2851230,2881407,chr6,SERPINB9P1,chr6:2851230-2881407,30177
13906201,13930879,chr19,CC2D1A,chr19:13906201-13930879,24678
137943079,137957657,chr6,LINC02528,chr6:137943079-137957657,14578
27694027,27713706,chr6,LINC01012,chr6:27694027-27713706,19679
158988178,159088114,chr6,TAGAP-AS1,chr6:158988178-159088114,99936
197042560,197299330,chr3,DLG1,chr3:197042560-197299330,256770
177229191,177229506,chr2,DNAJC19P5,chr2:177229191-177229506,315
177255945,177256010,chr2,MIR3128,chr2:177255945-177256010,65
177313806,177313882,chr2,MIR6512,chr2:177313806-177313882,76
13437942,13982002,chr12,GRIN2B,chr12:13437942-13982002,544060
177344443,177344836,chr2,H3P7,chr2:177344443-177344836,393
177548998,177552796,chr2,TTC30B,chr2:177548998-177552796,3798
177612999,177618742,chr2,TTC30A,chr2:177612999-177618742,5743
161992245,162074394,chr2,DPP4,chr2:161992245-162074394,82149
2621911,2634619,chr6,LINC01600,chr6:2621911-2634619,12708
8052318,8062660,chr19,CCL25,chr19:8052318-8062660,10342
163306907,163324530,chr6,PACRG-AS1,chr6:163306907-163324530,17623
234268583,234272500,chr1,SLC35F3-AS1,chr1:234268583-234272500,3917
106705328,106788148,chr6,LINC02532,chr6:106705328-106788148,82820
205086142,205122015,chr1,RBBP5,chr1:205086142-205122015,35873
6135247,6193094,chr19,ACSBG2,chr19:6135247-6193094,57847
66116555,66130750,chr12,LLPH,chr12:66116555-66130750,14195
89195761,89201651,chr16,SLC22A31,chr16:89195761-89201651,5890
66130751,66134449,chr12,LLPH-DT,chr12:66130751-66134449,3698
66189195,66254622,chr12,IRAK3,chr12:66189195-66254622,65427
28637654,28658744,chr16,NPIPB8,chr16:28637654-28658744,21090
140537340,140557677,chr5,SRA1,chr5:140537340-140557677,20337
56288462,56292254,chr11,OR8H1,chr11:56288462-56292254,3792
47331406,47352702,chr11,MYBPC3,chr11:47331406-47352702,21296
180632022,180890279,chr1,XPR1,chr1:180632022-180890279,258257
30259548,30293015,chr6,HLA-L,chr6:30259548-30293015,33467
87949244,88077318,chr16,BANP,chr16:87949244-88077318,128074
15397435,15397782,chr2,RPS26P18,chr2:15397435-15397782,347
66234079,66235234,chr12,RBMS1P1,chr12:66234079-66235234,1155
134524312,134583230,chr5,JADE2,chr5:134524312-134583230,58918
66251082,66251157,chr12,MIR6502,chr12:66251082-66251157,75
15690782,15744339,chr2,LINC01804,chr2:15690782-15744339,53557
66275940,66276651,chr12,PDCL3P7,chr12:66275940-66276651,711
66292683,66292987,chr12,RN7SKP166,chr12:66292683-66292987,304
231559903,231560364,chr2,RPL21P35,chr2:231559903-231560364,461
66302493,66343643,chr12,HELB,chr12:66302493-66343643,41150
231585864,231586327,chr2,RPL23AP26,chr2:231585864-231586327,463
231592864,231594276,chr2,TEX44,chr2:231592864-231594276,1412
231645998,231646273,chr2,RN7SL499P,chr2:231645998-231646273,275
15591178,15634346,chr2,DDX1,chr2:15591178-15634346,43168
2245718,2525976,chr6,GMDS-DT,chr6:2245718-2525976,280258
205351247,205351471,chr1,SNRPGP10,chr1:205351247-205351471,224
181236388,181238604,chr1,LINC01699,chr1:181236388-181238604,2216
56207567,56208456,chr1,RPSAP20,chr1:56207567-56208456,889
246178778,246179204,chr1,CHCHD4P5,chr1:246178778-246179204,426
66347431,67069162,chr12,GRIP1,chr12:66347431-67069162,721731
200551497,200620751,chr1,KIF14,chr1:200551497-200620751,69254
140664868,140674124,chr5,WDR55,chr5:140664868-140674124,9256
77128246,77215241,chr11,MYO7A,chr11:77128246-77215241,86995
233288868,233289447,chr1,RPS7P3,chr1:233288868-233289447,579
167094075,167129165,chr1,STYXL2,chr1:167094075-167129165,35090
139471004,139473700,chr5,SMIM33,chr5:139471004-139473700,2696
143812161,143820716,chr5,HMHB1,chr5:143812161-143820716,8555
127703391,127941507,chr5,CCDC192,chr5:127703391-127941507,238116
55851357,55922854,chr5,IL31RA,chr5:55851357-55922854,71497
38200234,38200532,chr19,RN7SL663P,chr19:38200234-38200532,298
38244035,38292615,chr19,SPINT2,chr19:38244035-38292615,48580
183929854,184037729,chr1,COLGALT2,chr1:183929854-184037729,107875
34696317,34697478,chr6,ILRUN-AS1,chr6:34696317-34697478,1161
32254640,32407763,chr6,TSBP1-AS1,chr6:32254640-32407763,153123
248739415,248755759,chr1,LYPD8,chr1:248739415-248755759,16344
167822103,167826833,chr6,AFDN-DT,chr6:167822103-167826833,4730
94302038,94303022,chr1,GAPDHP29,chr1:94302038-94303022,984
38251237,38256532,chr19,PPP1R14A,chr19:38251237-38256532,5295
232983435,233295725,chr1,PCNX2,chr1:232983435-233295725,312290
96199840,96521717,chr6,UFL1-AS1,chr6:96199840-96521717,321877
18417325,18562211,chr16,NOMO2,chr16:18417325-18562211,144886
63805852,63822699,chr6,SCAT8,chr6:63805852-63822699,16847
38303558,38317273,chr19,YIF1B,chr19:38303558-38317273,13715
30742816,30743638,chr6,IER3-AS1,chr6:30742816-30743638,822
33112440,33129084,chr6,HLA-DPB2,chr6:33112440-33129084,16644
167228200,167237517,chr6,HPAT5,chr6:167228200-167237517,9317
111483496,111598302,chr6,TRAF3IP2-AS1,chr6:111483496-111598302,114806
169790038,169802873,chr6,LINC00574,chr6:169790038-169802873,12835
28015122,28137313,chr6,ZSCAN16-AS1,chr6:28015122-28137313,122191
180739123,180740058,chr5,OR2Y1,chr5:180739123-180740058,935
146513144,146516190,chr5,GPR151,chr5:146513144-146516190,3046
79233699,79236797,chr6,HMGN3-AS1,chr6:79233699-79236797,3098
146447311,146511961,chr5,TCERG1,chr5:146447311-146511961,64650
66563524,66563694,chr12,OSBPL9P5,chr12:66563524-66563694,170
30798211,30830659,chr6,LINC00243,chr6:30798211-30830659,32448
66563967,66569194,chr12,OSBPL9P4,chr12:66563967-66569194,5227
224434660,224740554,chr1,CNIH3,chr1:224434660-224740554,305894
67131567,67132205,chr12,RAB11AP2,chr12:67131567-67132205,638
50979401,51028566,chr12,SLC11A2,chr12:50979401-51028566,49165
21664184,22654455,chr6,CASC15,chr6:21664184-22654455,990271
1469457,1501247,chr11,MOB2,chr11:1469457-1501247,31790
147172744,147179622,chr1,PDIA3P1,chr1:147172744-147179622,6878
214612960,214613398,chr1,UBE2V1P13,chr1:214612960-214613398,438
243256034,243500091,chr1,SDCCAG8,chr1:243256034-243500091,244057
6431049,6442617,chr11,HPX,chr11:6431049-6442617,11568
30370934,30377991,chr16,MYLPF,chr16:30370934-30377991,7057
109249539,109275751,chr1,CELSR2,chr1:109249539-109275751,26212
119044188,119057227,chr11,HYOU1,chr11:119044188-119057227,13039
71281389,71289715,chr16,CMTR2,chr16:71281389-71289715,8326
38304164,38305006,chr19,C19orf33,chr19:38304164-38305006,842
71358713,71390436,chr16,CALB2,chr16:71358713-71390436,31723
141330514,141512975,chr5,PCDHGA1,chr5:141330514-141512975,182461
141338760,141512975,chr5,PCDHGA2,chr5:141338760-141512975,174215
48748011,48755390,chr19,FUT1,chr19:48748011-48755390,7379
179447602,179457315,chr1,HNRNPA1P54,chr1:179447602-179457315,9713
13104902,13117567,chr19,TRMT1,chr19:13104902-13117567,12665
233904676,234324511,chr1,SLC35F3,chr1:233904676-234324511,419835
141343829,141512975,chr5,PCDHGA3,chr5:141343829-141512975,169146
248771635,248773792,chr1,DPY19L4P1,chr1:248771635-248773792,2157
141350099,141512975,chr5,PCDHGB1,chr5:141350099-141512975,162876
235839483,235840182,chr1,LYST-AS1,chr1:235839483-235840182,699
200404940,200410056,chr1,ZNF281,chr1:200404940-200410056,5116
141355021,141512975,chr5,PCDHGA4,chr5:141355021-141512975,157954
180434800,180435936,chr1,VDAC1P4,chr1:180434800-180435936,1136
141359994,141512975,chr5,PCDHGB2,chr5:141359994-141512975,152981
166975582,167022214,chr1,MAEL,chr1:166975582-167022214,46632
141364162,141512975,chr5,PCDHGA5,chr5:141364162-141512975,148813
71366933,71426464,chr16,LINC02136,chr16:71366933-71426464,59531
141370242,141512975,chr5,PCDHGB3,chr5:141370242-141512975,142733
71447597,71463095,chr16,ZNF23,chr16:71447597-71463095,15498
141373891,141512975,chr5,PCDHGA6,chr5:141373891-141512975,139084
141382739,141512975,chr5,PCDHGA7,chr5:141382739-141512975,130236
123389421,123511509,chr6,TRDN-AS1,chr6:123389421-123511509,122088
141387698,141512975,chr5,PCDHGB4,chr5:141387698-141512975,125277
141390157,141512975,chr5,PCDHGA8,chr5:141390157-141512975,122818
231453531,231483641,chr2,NCL,chr2:231453531-231483641,30110
141402778,141512975,chr5,PCDHGA9,chr5:141402778-141512975,110197
29731051,29731404,chr16,RN7SKP127,chr16:29731051-29731404,353
141412987,141512975,chr5,PCDHGA10,chr5:141412987-141512975,99988
29742463,29745990,chr16,C16orf54,chr16:29742463-29745990,3527
141417645,141512975,chr5,PCDHGB7,chr5:141417645-141512975,95330
29778256,29782973,chr16,ZG16,chr16:29778256-29782973,4717
36014660,36033343,chr19,CLIP3,chr19:36014660-36033343,18683
141421047,141512975,chr5,PCDHGA11,chr5:141421047-141512975,91928
29811382,29815892,chr16,PRRT2,chr16:29811382-29815892,4510
141426286,141429158,chr5,PCDHGB8P,chr5:141426286-141429158,2872
141430507,141512975,chr5,PCDHGA12,chr5:141430507-141512975,82468
174934947,174954261,chr1,RABGAP1L-AS1,chr1:174934947-174954261,19314
141439853,141442449,chr5,PCDHGB9P,chr5:141439853-141442449,2596
141475947,141512977,chr5,PCDHGC3,chr5:141475947-141512977,37030
235131634,235328219,chr1,ARID4B,chr1:235131634-235328219,196585
36034984,36054739,chr19,THAP8,chr19:36034984-36054739,19755
56951431,56959374,chr12,RDH16,chr12:56951431-56959374,7943
29816152,29822489,chr16,PAGR1,chr16:29816152-29822489,6337
55820960,55830824,chr12,DNAJC14,chr12:55820960-55830824,9864
36113709,36115213,chr19,POLR2I,chr19:36113709-36115213,1504
29820394,29848039,chr16,MVP,chr16:29820394-29848039,27645
100199122,100241865,chr12,ACTR6,chr12:100199122-100241865,42743
36114289,36125947,chr19,TBCB,chr19:36114289-36125947,11658
141479316,141479625,chr5,RN7SL68P,chr5:141479316-141479625,309
141484997,141512975,chr5,PCDHGC4,chr5:141484997-141512975,27978
177212563,177223958,chr2,HNRNPA3,chr2:177212563-177223958,11395
34105617,34147670,chr11,NAT10,chr11:34105617-34147670,42053
141489081,141512975,chr5,PCDHGC5,chr5:141489081-141512975,23894
141558311,141565263,chr5,DIAPH1-AS1,chr5:141558311-141565263,6952
141588935,141589142,chr5,RPS27AP10,chr5:141588935-141589142,207
29790727,29805385,chr16,KIF22,chr16:29790727-29805385,14658
141620876,141636849,chr5,HDAC3,chr5:141620876-141636849,15973
36139953,36150353,chr19,CAPNS1,chr19:36139953-36150353,10400
122271432,122422669,chr12,CLIP1,chr12:122271432-122422669,151237
141636950,141641064,chr5,RELL2,chr5:141636950-141641064,4114
81681187,81683797,chr17,ARL16,chr17:81681187-81683797,2610
229249636,229251810,chr1,TMEM78,chr1:229249636-229251810,2174
248810446,248825915,chr1,SH3BP5L,chr1:248810446-248825915,15469
99020949,100358885,chr11,CNTN5,chr11:99020949-100358885,1337936
112466541,112530165,chr1,WNT2B,chr1:112466541-112530165,63624
141397947,141512975,chr5,PCDHGB5,chr5:141397947-141512975,115028
441498,443160,chr5,EXOC3-AS1,chr5:441498-443160,1662
76142465,76240493,chr17,RNF157,chr17:76142465-76240493,98028
321714,438291,chr5,AHRR,chr5:321714-438291,116577
174110268,174160165,chr1,RABGAP1L-DT,chr1:174110268-174160165,49897
179183734,179184547,chr1,SETP10,chr1:179183734-179184547,813
1706166,1770351,chr16,MAPK8IP3,chr16:1706166-1770351,64185
235738005,235738989,chr1,LDHAP2,chr1:235738005-235738989,984
89993593,89994321,chr1,GEMIN8P4,chr1:89993593-89994321,728
198679139,198680033,chr1,PEBP1P3,chr1:198679139-198680033,894
205712822,205750182,chr1,NUCKS1,chr1:205712822-205750182,37360
102753981,103029730,chr5,PAM,chr5:102753981-103029730,275749
52838010,52857649,chr19,ZNF468,chr19:52838010-52857649,19639
239943015,239943094,chr2,MIR4786,chr2:239943015-239943094,79
240079433,240080362,chr2,OR9S24P,chr2:240079433-240080362,929
240109102,240110052,chr2,OR5S1P,chr2:240109102-240110052,950
240126563,240136807,chr2,COPS9,chr2:240126563-240136807,10244
7390522,7395039,chr19,ARHGEF18-AS1,chr19:7390522-7395039,4517
76202644,76202796,chr17,ATP5MGP6,chr17:76202644-76202796,152
76225751,76226806,chr17,ATF4P3,chr17:76225751-76226806,1055
233327724,233385148,chr1,MAP3K21,chr1:233327724-233385148,57424
76265348,76271298,chr17,UBALD2,chr17:76265348-76271298,5950
240139026,240144562,chr2,OTOS,chr2:240139026-240144562,5536
36054649,36105108,chr19,WDR62,chr19:36054649-36105108,50459
7834217,7854796,chr17,KDM6B,chr17:7834217-7854796,20579
19350724,20121601,chr11,NAV2,chr11:19350724-20121601,770877
56718789,56819696,chr1,FYB2,chr1:56718789-56819696,100907
239892450,240025743,chr2,NDUFA10,chr2:239892450-240025743,133293
201955503,201970664,chr1,TIMM17A,chr1:201955503-201970664,15161
43065176,43192021,chr5,ZNF131,chr5:43065176-43192021,126845
91500851,91525764,chr1,CDC7,chr1:91500851-91525764,24913
41314912,41315710,chr17,KRTAP17-1,chr17:41314912-41315710,798
41323427,41329545,chr17,TBC1D3P7,chr17:41323427-41329545,6118
41346092,41350828,chr17,KRT33A,chr17:41346092-41350828,4736
41363498,41369813,chr17,KRT33B,chr17:41363498-41369813,6315
41393721,41397608,chr17,KRT31,chr17:41393721-41397608,3887
173635338,173637130,chr1,TEX50,chr1:173635338-173637130,1792
244835616,244845057,chr1,COX20,chr1:244835616-244845057,9441
41406512,41411775,chr17,KRT41P,chr17:41406512-41411775,5263
41420547,41424585,chr17,KRT37,chr17:41420547-41424585,4038
174849667,174850168,chr1,NDUFAF4P4,chr1:174849667-174850168,501
68535113,68601367,chr17,FAM20A,chr17:68535113-68601367,66254
174896958,174897996,chr1,RABGAP1L-IT1,chr1:174896958-174897996,1038
121573946,121580524,chr1,LINC01691,chr1:121573946-121580524,6578
127045235,127073506,chr5,C5orf63,chr5:127045235-127073506,28271
119636457,119665324,chr3,POPDC2,chr3:119636457-119665324,28867
51859778,51860135,chr1,TSEN15P2,chr1:51859778-51860135,357
167175363,167195792,chr1,LINC01363,chr1:167175363-167195792,20429
54102728,54109257,chr19,NDUFA3,chr19:54102728-54109257,6529
84819985,84920768,chr16,CRISPLD2,chr16:84819985-84920768,100783
210231456,210234047,chr1,SERTAD4-AS1,chr1:210231456-210234047,2591
73626158,73941993,chr5,ARHGEF28,chr5:73626158-73941993,315835
174447964,174449545,chr1,GPR52,chr1:174447964-174449545,1581
22063773,22437041,chr12,ST8SIA1,chr12:22063773-22437041,373268
201978642,201978949,chr1,RPL10P4,chr1:201978642-201978949,307
108043091,108091862,chr3,CD47,chr3:108043091-108091862,48771
91328369,91329513,chr1,FEN1P1,chr1:91328369-91329513,1144
245749342,246507312,chr1,SMYD3,chr1:245749342-246507312,757970
119654513,119677454,chr3,COX17,chr3:119654513-119677454,22941
133080474,133107526,chr12,ZNF140,chr12:133080474-133107526,27052
50362613,50504244,chr3,CACNA2D2,chr3:50362613-50504244,141631
54115410,54131719,chr19,PRPF31,chr19:54115410-54131719,16309
68259182,68422731,chr17,ARSG,chr17:68259182-68422731,163549
84928353,84939603,chr16,LINC02176,chr16:84928353-84939603,11250
84974175,85011535,chr16,ZDHHC7,chr16:84974175-85011535,37360
106063345,106138954,chr12,NUAK1,chr12:106063345-106138954,75609
85098358,85112472,chr16,CIBAR2,chr16:85098358-85112472,14114
173714941,173786692,chr1,KLHL20,chr1:173714941-173786692,71751
71839707,71927248,chr12,TBC1D15,chr12:71839707-71927248,87541
68205481,68257712,chr17,AMZ2,chr17:68205481-68257712,52231
85137150,85149443,chr16,LINC02139,chr16:85137150-85149443,12293
85278820,85279035,chr16,COX6CP16,chr16:85278820-85279035,215
85282958,85285963,chr16,LINC00311,chr16:85282958-85285963,3005
85306226,85306325,chr16,MIR5093,chr16:85306226-85306325,99
85027782,85094230,chr16,KIAA0513,chr16:85027782-85094230,66448
179201705,179201926,chr1,EIF4A1P11,chr1:179201705-179201926,221
154272589,154275875,chr1,HAX1,chr1:154272589-154275875,3286
22345936,22437165,chr16,CDR2,chr16:22345936-22437165,91229
22374859,22378180,chr16,CDR2-DT,chr16:22374859-22378180,3321
22382436,22407598,chr16,MFSD13B,chr16:22382436-22407598,25162
54137749,54155681,chr19,CNOT3,chr19:54137749-54155681,17932
22418672,22437715,chr16,RRN3P3,chr16:22418672-22437715,19043
22545698,22576865,chr16,OTOAP1,chr16:22545698-22576865,31167
232950605,232983882,chr1,NTPCR,chr1:232950605-232983882,33277
22612543,22613483,chr16,LINC02890,chr16:22612543-22613483,940
22479121,22536521,chr16,NPIPB5,chr16:22479121-22536521,57400
164356767,164357364,chr1,HMGB3P6,chr1:164356767-164357364,597
214605470,214608840,chr1,ABHD17AP3,chr1:214605470-214608840,3370
205767986,205775482,chr1,RAB29,chr1:205767986-205775482,7496
75441159,75500452,chr17,TMEM94,chr17:75441159-75500452,59293
17208153,17349980,chr11,NUCB2,chr11:17208153-17349980,141827
119037772,119249138,chr5,DMXL1,chr5:119037772-119249138,211366
56854797,56918223,chr1,C8A,chr1:56854797-56918223,63426
170173865,170304358,chr1,LINC01681,chr1:170173865-170304358,130493
20780193,20900349,chr16,ERI2,chr16:20780193-20900349,120156
94128841,94181968,chr11,PANX1,chr11:94128841-94181968,53127
210232796,210246631,chr1,SERTAD4,chr1:210232796-210246631,13835
48328980,48330279,chr12,H1-7,chr12:48328980-48330279,1299
94188449,94188997,chr11,ARPC3P3,chr11:94188449-94188997,548
94377316,94401419,chr11,GPR83,chr11:94377316-94401419,24103
180509380,180566523,chr1,OVAAL,chr1:180509380-180566523,57143
76764103,76853696,chr12,ZDHHC17,chr12:76764103-76853696,89593
215567304,215621807,chr1,KCTD3,chr1:215567304-215621807,54503
66480013,66509657,chr11,DPP3,chr11:66480013-66509657,29644
54155161,54159721,chr19,LENG1,chr19:54155161-54159721,4560
20854925,20900358,chr16,DCUN1D3,chr16:20854925-20900358,45433
54160108,54173250,chr19,TMC4,chr19:54160108-54173250,13142
20899868,20925006,chr16,LYRM1,chr16:20899868-20925006,25138
39779969,39781418,chr1,BMP8B-AS1,chr1:39779969-39781418,1449
20933111,21159441,chr16,DNAH3,chr16:20933111-21159441,226330
229812917,229892046,chr1,LINC01682,chr1:229812917-229892046,79129
54033050,54035361,chr12,HOXC5,chr12:54033050-54035361,2311
120302316,120313249,chr12,SIRT4,chr12:120302316-120313249,10933
37474580,37484377,chr1,ZC3H12A,chr1:37474580-37484377,9797
178431292,178451512,chr2,PRKRA,chr2:178431292-178451512,20220
55572468,55575612,chr12,OR2AP1,chr12:55572468-55575612,3144
55444069,55453347,chr12,OR6C2,chr12:55444069-55453347,9278
8123617,8138607,chr12,CLEC4A,chr12:8123617-8138607,14990
159081133,159081795,chr1,RAD1P2,chr1:159081133-159081795,662
210328252,210676296,chr1,HHAT,chr1:210328252-210676296,348044
150894392,150904983,chr5,ZNF300,chr5:150894392-150904983,10591
75498548,75498628,chr17,MIR6785,chr17:75498548-75498628,80
75500261,75515537,chr17,CASKIN2,chr17:75500261-75515537,15276
54173412,54189882,chr19,MBOAT7,chr19:54173412-54189882,16470
151504092,151591331,chr5,FAT2,chr5:151504092-151591331,87239
48918821,48986382,chr3,ARIH2,chr3:48918821-48986382,67561
76025447,76031776,chr12,PHLDA1,chr12:76025447-76031776,6329
103988987,104064183,chr12,GLT8D2,chr12:103988987-104064183,75196
135579202,135889770,chr5,SLC25A48,chr5:135579202-135889770,310568
30698209,30741409,chr16,SRCAP,chr16:30698209-30741409,43200
160830160,160862887,chr1,CD244,chr1:160830160-160862887,32727
75515944,75524735,chr17,TSEN54,chr17:75515944-75524735,8791
33698261,33700826,chr11,C11orf91,chr11:33698261-33700826,2565
80792520,80937934,chr12,LIN7A,chr12:80792520-80937934,145414
33703010,33736479,chr11,CD59,chr11:33703010-33736479,33469
94150851,94618604,chr5,KIAA0825,chr5:94150851-94618604,467753
54189938,54194536,chr19,TSEN34,chr19:54189938-54194536,4598
178451346,178462102,chr2,PJVK,chr2:178451346-178462102,10756
27081057,27082578,chr12,C12orf71,chr12:27081057-27082578,1521
51817899,51848718,chr12,FIGNL2,chr12:51817899-51848718,30819
133104779,133130274,chr12,ZNF891,chr12:133104779-133130274,25495
145471799,145835369,chr5,PRELID2,chr5:145471799-145835369,363570
75525080,75575209,chr17,LLGL2,chr17:75525080-75575209,50129
49097136,49110900,chr12,LMBR1L,chr12:49097136-49110900,13764
921033,934495,chr16,LMF1-AS1,chr16:921033-934495,13462
975761,981596,chr16,CEROX1,chr16:975761-981596,5835
207454230,207489895,chr1,CR2,chr1:207454230-207489895,35665
178454716,178455428,chr2,NUDCP2,chr2:178454716-178455428,712
981770,986979,chr16,SOX8,chr16:981770-986979,5209
178480457,178516463,chr2,PLEKHA3,chr2:178480457-178516463,36006
54200809,54249003,chr19,RPS9,chr19:54200809-54249003,48194
79612120,79688246,chr5,TENT2,chr5:79612120-79688246,76126
2830253,2839585,chr16,ZG16B,chr16:2830253-2839585,9332
70281362,70293740,chr2,SNRPG,chr2:70281362-70293740,12378
33740939,33774543,chr11,FBXO3,chr11:33740939-33774543,33604
68310951,68360852,chr16,PRMT7,chr16:68310951-68360852,49901
70295975,70302090,chr2,FAM136A,chr2:70295975-70302090,6115
235131183,235161283,chr1,RBM34,chr1:235131183-235161283,30100
134477706,134486716,chr3,ANAPC13,chr3:134477706-134486716,9010
70353010,70355915,chr2,BRD7P6,chr2:70353010-70355915,2905
70467385,70468495,chr2,TGFA-IT1,chr2:70467385-70468495,1110
235295865,235296335,chr1,RPL23AP23,chr1:235295865-235296335,470
54236592,54242791,chr19,LILRA6,chr19:54236592-54242791,6199
233614106,233672514,chr1,KCNK1,chr1:233614106-233672514,58408
231056845,231173116,chr2,PSMD1,chr2:231056845-231173116,116271
71579531,71658706,chr5,MCCC2,chr5:71579531-71658706,79175
134355347,134375479,chr3,AMOTL2,chr3:134355347-134375479,20132
182398117,182400667,chr1,TEDDM1,chr1:182398117-182400667,2550
164343005,164343864,chr1,NMNAT1P2,chr1:164343005-164343864,859
86424171,86456553,chr1,CLCA2,chr1:86424171-86456553,32382
123415039,123436684,chr12,RILPL2,chr12:123415039-123436684,21645
19129733,19376400,chr12,PLEKHA5,chr12:19129733-19376400,246667
33774699,33775670,chr11,FBXO3-DT,chr11:33774699-33775670,971
33804768,33805641,chr11,LINC02722,chr11:33804768-33805641,873
33813873,33822378,chr11,LINC02721,chr11:33813873-33822378,8505
7924592,7931268,chr11,OR10A6,chr11:7924592-7931268,6676
58438994,58442236,chr11,OR5B12,chr11:58438994-58442236,3242
182407621,182414815,chr1,LINC00272,chr1:182407621-182414815,7194
5199735,5200682,chr11,OR51V1,chr11:5199735-5200682,947
215376484,215377374,chr1,VDAC1P10,chr1:215376484-215377374,890
38129464,38140593,chr1,LINC02786,chr1:38129464-38140593,11129
56315144,56320639,chr11,OR8K3,chr11:56315144-56320639,5495
146957117,146957659,chr1,PFN1P8,chr1:146957117-146957659,542
56741223,56748697,chr11,OR9G4,chr11:56741223-56748697,7474
231591292,231612090,chr1,LINC00582,chr1:231591292-231612090,20798
10308313,10507579,chr11,AMPD3,chr11:10308313-10507579,199266
54249421,54257301,chr19,LILRB5,chr19:54249421-54257301,7880
48165773,48247568,chr16,ABCC11,chr16:48165773-48247568,81795
2752131,2755397,chr5,C5orf38,chr5:2752131-2755397,3266
126006357,126101561,chr3,SLC41A3,chr3:126006357-126101561,95204
181178821,181191852,chr5,LINC01962,chr5:181178821-181191852,13031
244840638,244864560,chr1,HNRNPU,chr1:244840638-244864560,23922
181193924,181205293,chr5,TRIM7,chr5:181193924-181205293,11369
5419641,5432877,chr17,RPAIN,chr17:5419641-5432877,13236
54263951,54264053,chr19,RNU6-1307P,chr19:54263951-54264053,102
54273812,54281184,chr19,LILRB2,chr19:54273812-54281184,7372
181195496,181203103,chr5,TRIM7-AS1,chr5:181195496-181203103,7607
181222499,181235808,chr5,TRIM41,chr5:181222499-181235808,13309
167784,207399,chr11,BET1L,chr11:167784-207399,39615
181222566,181222633,chr5,MIR4638,chr5:181222566-181222633,67
22625509,22813001,chr11,GAS2,chr11:22625509-22813001,187492
54930865,54934485,chr16,IRX5,chr16:54930865-54934485,3620
181236897,181248096,chr5,RACK1,chr5:181236897-181248096,11199
32142454,32253374,chr17,RHOT1,chr17:32142454-32253374,110920
752579,911452,chr12,WNK1,chr12:752579-911452,158873
70661204,70686053,chr16,MTSS2,chr16:70661204-70686053,24849
21597218,21657471,chr16,METTL9,chr16:21597218-21657471,60253
133038391,133397775,chr3,TMEM108,chr3:133038391-133397775,359384
119093874,119095465,chr11,H2AX,chr11:119093874-119095465,1591
57233577,57237250,chr11,APLNR,chr11:57233577-57237250,3673
113904796,113949079,chr11,HTR3B,chr11:113904796-113949079,44283
125082636,125212864,chr3,SLC12A8,chr3:125082636-125212864,130228
3382081,3401065,chr16,ZSCAN32,chr16:3382081-3401065,18984
303655,309397,chr11,IFITM2,chr11:303655-309397,5742
72106378,72112780,chr11,ANAPC15,chr11:72106378-72112780,6402
54282109,54282180,chr19,MIR4752,chr19:54282109-54282180,71
7348937,7472485,chr19,ARHGEF18,chr19:7348937-7472485,123548
28494643,28498964,chr16,APOBR,chr16:28494643-28498964,4321
21834569,21880827,chr16,NPIPB4,chr16:21834569-21880827,46258
40875439,40882752,chr19,CYP2A7,chr19:40875439-40882752,7313
193593144,193697811,chr3,OPA1,chr3:193593144-193697811,104667
8413270,8439017,chr19,MARCHF2,chr19:8413270-8439017,25747
30085793,30091924,chr16,TBX6,chr16:30085793-30091924,6131
37735833,37817300,chr19,ZNF573,chr19:37735833-37817300,81467
19555240,19706793,chr16,VPS35L,chr16:19555240-19706793,151553
34172504,34229288,chr19,LSM14A,chr19:34172504-34229288,56784
77821109,77918432,chr11,AAMDC,chr11:77821109-77918432,97323
181241814,181241892,chr5,SNORD96A,chr5:181241814-181241892,78
181243312,181243379,chr5,SNORD95,chr5:181243312-181243379,67
181301967,181302070,chr5,RNU6-705P,chr5:181301967-181302070,103
181254077,181261150,chr5,TRIM52,chr5:181254077-181261150,7073
32679200,32745650,chr12,DNM1L,chr12:32679200-32745650,66450
135236234,135248179,chr5,LINC02900,chr5:135236234-135248179,11945
135334381,135399914,chr5,MACROH2A1,chr5:135334381-135399914,65533
72080337,72096895,chr11,LRRC51,chr11:72080337-72096895,16558
2037465,2051244,chr19,MKNK2,chr19:2037465-2051244,13779
7824818,7830840,chr11,OR5P3,chr11:7824818-7830840,6022
60867542,60875693,chr11,ZP1,chr11:60867542-60875693,8151
35248330,35267964,chr19,LSR,chr19:35248330-35267964,19634
169479480,169506655,chr2,BBS5,chr2:169479480-169506655,27175
18278668,18322198,chr11,HPS5,chr11:18278668-18322198,43530
214870734,214871716,chr1,GAPDHP24,chr1:214870734-214871716,982
105927620,106028277,chr1,LINC01677,chr1:105927620-106028277,100657
185734391,186190949,chr1,HMCN1,chr1:185734391-186190949,456558
42287547,42311943,chr17,STAT5A,chr17:42287547-42311943,24396
169509702,169526258,chr2,KLHL41,chr2:169509702-169526258,16556
169528508,169573875,chr2,FASTKD1,chr2:169528508-169573875,45367
135444214,135447348,chr5,DCANP1,chr5:135444214-135447348,3134
135444226,135452351,chr5,TIFAB,chr5:135444226-135452351,8125
271621,314974,chr5,PDCD6,chr5:271621-314974,43353
12825478,12835428,chr19,RTBDN,chr19:12825478-12835428,9950
185558371,185628944,chr1,LINC01350,chr1:185558371-185628944,70573
18322295,18367045,chr11,GTF2H1,chr11:18322295-18367045,44750
169584342,169641406,chr2,PPIG,chr2:169584342-169641406,57064
50666300,50681353,chr16,SNX20,chr16:50666300-50681353,15053
186423481,186521147,chr1,PDC-AS1,chr1:186423481-186521147,97666
186443566,186461114,chr1,PDC,chr1:186443566-186461114,17548
14833721,14896157,chr16,NOMO1,chr16:14833721-14896157,62436
187891,187958,chr1,MIR6859-2,chr1:187891-187958,67
1339650,1339708,chr1,MIR6808,chr1:1339650-1339708,58
7219360,7219524,chr1,RNU1-8P,chr1:7219360-7219524,164
5862672,5862741,chr1,MIR4689,chr1:5862672-5862741,69
8979576,8979874,chr1,RN7SL451P,chr1:8979576-8979874,298
9947318,9947636,chr1,RN7SKP269,chr1:9947318-9947636,318
9967381,9967458,chr1,MIR5697,chr1:9967381-9967458,77
11226254,11226360,chr1,RNU6-291P,chr1:11226254-11226360,106
6429834,6429896,chr1,MIR4252,chr1:6429834-6429896,62
10616836,10617115,chr1,RN7SL614P,chr1:10616836-10617115,279
8883427,8883533,chr1,RNU6-304P,chr1:8883427-8883533,106
12922554,12922660,chr1,RNU6-1072P,chr1:12922554-12922660,106
8866502,8866590,chr1,MIR6728,chr1:8866502-8866590,88
13279125,13279231,chr1,RNU6-771P,chr1:13279125-13279231,106
12507246,12507397,chr1,SNORA59A,chr1:12507246-12507397,151
14124233,14124335,chr1,RNU6-1265P,chr1:14124233-14124335,102
1296110,1296170,chr1,MIR6726,chr1:1296110-1296170,60
3560695,3560790,chr1,MIR551A,chr1:3560695-3560790,95
177086905,177098144,chr5,FGFR4,chr5:177086905-177098144,11239
15608078,15608145,chr1,RNU7-179P,chr1:15608078-15608145,67
8206434,8206597,chr1,RNU1-7P,chr1:8206434-8206597,163
12569972,12570072,chr1,RNU6ATAC18P,chr1:12569972-12570072,100
12578957,12579023,chr1,MIR6730,chr1:12578957-12579023,66
1312502,1312566,chr1,MIR6727,chr1:1312502-1312566,64
22863159,22863226,chr1,MIR4253,chr1:22863159-22863226,67
19510593,19510733,chr1,RNU4-28P,chr1:19510593-19510733,140
24777873,24777979,chr1,RNU6-1208P,chr1:24777873-24777979,106
9437669,9437778,chr1,RNA5SP40,chr1:9437669-9437778,109
35040506,35066573,chr19,HPN,chr19:35040506-35066573,26067
18883202,18883275,chr1,MIR4695,chr1:18883202-18883275,73
18897071,18897148,chr1,MIR1290,chr1:18897071-18897148,77
9151668,9151777,chr1,MIR34A,chr1:9151668-9151777,109
24919345,24919416,chr1,MIR6731,chr1:24919345-24919416,71
26593243,26593546,chr1,RN7SL679P,chr1:26593243-26593546,303
25964197,25964300,chr1,RNU6-110P,chr1:25964197-25964300,103
30843823,30844110,chr1,RN7SKP91,chr1:30843823-30844110,287
27325219,27325325,chr1,RNU6-48P,chr1:27325219-27325325,106
30918469,30918735,chr1,RN7SL371P,chr1:30918469-30918735,266
15542165,15542304,chr1,SCARNA21B,chr1:15542165-15542304,139
25023503,25023586,chr1,MIR4425,chr1:25023503-25023586,83
28142737,28142841,chr1,RNU6-176P,chr1:28142737-28142841,104
34669599,34669694,chr1,MIR552,chr1:34669599-34669694,95
30739156,30739232,chr1,MIR4420,chr1:30739156-30739232,76
37885023,37885117,chr1,RNU6-584P,chr1:37885023-37885117,94
38926870,38926977,chr1,RNU6-605P,chr1:38926870-38926977,107
37161563,37161634,chr1,MIR4255,chr1:37161563-37161634,71
37203610,37203716,chr1,RNU6-636P,chr1:37203610-37203716,106
37264677,37264786,chr1,RNA5SP43,chr1:37264677-37264786,109
26554542,26554593,chr1,MIR1976,chr1:26554542-26554593,51
18387787,18387860,chr11,MIR3159,chr11:18387787-18387860,73
26602369,26602432,chr1,RNU7-29P,chr1:26602369-26602432,63
38089231,38089329,chr1,MIR3659,chr1:38089231-38089329,98
37991462,37991569,chr1,RNU6-510P,chr1:37991462-37991569,107
38396659,38396765,chr1,RNU6-753P,chr1:38396659-38396765,106
51995740,51996039,chr1,RN7SL290P,chr1:51995740-51996039,299
43196417,43196536,chr1,RNA5SP46,chr1:43196417-43196536,119
18394560,18408425,chr11,LDHA,chr11:18394560-18408425,13865
37480230,37480289,chr1,MIR6732,chr1:37480230-37480289,59
43171652,43171712,chr1,MIR6733,chr1:43171652-43171712,60
52754322,52754462,chr1,RNU2-30P,chr1:52754322-52754462,140
52805108,52805212,chr1,RNU6-969P,chr1:52805108-52805212,104
40177843,40177949,chr1,RNU6-1237P,chr1:40177843-40177949,106
50582404,50582511,chr1,RNU6-1026P,chr1:50582404-50582511,107
43838622,43838683,chr1,MIR6079,chr1:43838622-43838683,61
37500935,37500994,chr1,MIR5581,chr1:37500935-37500994,59
31497577,31497683,chr1,RNU6-40P,chr1:31497577-31497683,106
55225641,55225723,chr1,MIR4422,chr1:55225641-55225723,82
64384398,64384459,chr1,RNU7-62P,chr1:64384398-64384459,61
61816419,61816522,chr1,RNU6-414P,chr1:61816419-61816522,103
61852499,61852602,chr1,RNU6-1177P,chr1:61852499-61852602,103
62072448,62072741,chr1,RN7SL180P,chr1:62072448-62072741,293
62078786,62078859,chr1,MIR3116-1,chr1:62078786-62078859,73
62078789,62078856,chr1,MIR3116-2,chr1:62078789-62078856,67
58565631,58565932,chr1,RN7SL713P,chr1:58565631-58565932,301
32457835,32458135,chr1,RN7SL122P,chr1:32457835-32458135,300
76753135,76753240,chr1,RNU6-161P,chr1:76753135-76753240,105
73191604,73191855,chr1,RN7SKP19,chr1:73191604-73191855,251
62298149,62298256,chr1,RNU6-371P,chr1:62298149-62298256,107
65415816,65416006,chr1,RNU2-15P,chr1:65415816-65416006,190
67772593,67772653,chr1,RNU7-80P,chr1:67772593-67772653,60
75183045,75183147,chr1,RNU6-622P,chr1:75183045-75183147,102
66094461,66094546,chr1,RNU4-88P,chr1:66094461-66094546,85
78375164,78375268,chr1,RNA5SP23,chr1:78375164-78375268,104
77060143,77060202,chr1,MIR7156,chr1:77060143-77060202,59
52714399,52714695,chr1,RN7SL62P,chr1:52714399-52714695,296
75538015,75538119,chr1,RNU6-503P,chr1:75538015-75538119,104
77614869,77614952,chr1,RNA5SP20,chr1:77614869-77614952,83
65761058,65761352,chr1,RN7SL854P,chr1:65761058-65761352,294
77779904,77779999,chr1,RNA5SP21,chr1:77779904-77779999,95
54054079,54054154,chr1,MIR4781,chr1:54054079-54054154,75
78088988,78089083,chr1,RNU6-1102P,chr1:78088988-78089083,95
77420325,77420386,chr1,RNU7-8P,chr1:77420325-77420386,61
77645324,77645618,chr1,RN7SL370P,chr1:77645324-77645618,294
78094807,78094915,chr1,RNA5SP22,chr1:78094807-78094915,108
49665142,49673916,chr19,BCL2L12,chr19:49665142-49673916,8774
87453240,87453373,chr1,RNA5SP52,chr1:87453240-87453373,133
85133794,85133873,chr1,MIR4423,chr1:85133794-85133873,79
90657750,90657964,chr1,SNORD3G,chr1:90657750-90657964,214
29806106,29811164,chr16,MAZ,chr16:29806106-29811164,5058
63326925,63326984,chr1,MIR6068,chr1:63326925-63326984,59
73749517,73749623,chr1,RNA5SP50,chr1:73749517-73749623,106
67656831,67657129,chr1,RN7SL392P,chr1:67656831-67657129,298
72717663,72717769,chr1,RNU6-1246P,chr1:72717663-72717769,106
85883680,85883798,chr1,RNA5SP51,chr1:85883680-85883798,118
98045242,98045351,chr1,MIR2682,chr1:98045242-98045351,109
51973410,51973535,chr1,RNA5SP48,chr1:51973410-51973535,125
94150738,94151080,chr1,RN7SL440P,chr1:94150738-94151080,342
63529613,63529898,chr1,RN7SL488P,chr1:63529613-63529898,285
64579847,64579923,chr1,MIR4794,chr1:64579847-64579923,76
65022968,65023074,chr1,RNU6-1176P,chr1:65022968-65023074,106
7351889,7354944,chr17,KCTD11,chr17:7351889-7354944,3055
88477828,88478114,chr1,RN7SL583P,chr1:88477828-88478114,286
98046070,98046171,chr1,MIR137,chr1:98046070-98046171,101
63536711,63536770,chr1,RNU7-123P,chr1:63536711-63536770,59
65057755,65057842,chr1,MIR3671,chr1:65057755-65057842,87
40754355,40754446,chr1,MIR30E,chr1:40754355-40754446,91
99978939,99979045,chr1,RNU6-750P,chr1:99978939-99979045,106
65058434,65058508,chr1,MIR101-1,chr1:65058434-65058508,74
40757284,40757372,chr1,MIR30C1,chr1:40757284-40757372,88
48548870,48604912,chr17,HOXB3,chr17:48548870-48604912,56042
88816779,88816885,chr1,RNU6-125P,chr1:88816779-88816885,106
100000637,100000739,chr1,RNU6-1318P,chr1:100000637-100000739,102
90253456,90253559,chr1,RNU6-695P,chr1:90253456-90253559,103
94745860,94745900,chr1,MIR378G,chr1:94745860-94745900,40
93846832,93846911,chr1,MIR760,chr1:93846832-93846911,79
63655743,63656047,chr1,RN7SL130P,chr1:63655743-63656047,304
99784740,99784885,chr1,RNU4-75P,chr1:99784740-99784885,145
55376526,55376852,chr1,RN7SKP291,chr1:55376526-55376852,326
107897223,107897304,chr1,MIR7852,chr1:107897223-107897304,81
55398514,55398620,chr1,RNU6-830P,chr1:55398514-55398620,106
51836344,51836402,chr1,MIR761,chr1:51836344-51836402,58
96225901,96226060,chr1,RNU1-130P,chr1:96225901-96226060,159
101728642,101728737,chr1,RNU6-965P,chr1:101728642-101728737,95
116671749,116671827,chr1,MIR320B1,chr1:116671749-116671827,78
89987713,89987944,chr1,RN7SKP272,chr1:89987713-89987944,231
118264372,118264489,chr1,RNA5SP56,chr1:118264372-118264489,117
117094643,117094728,chr1,MIR942,chr1:117094643-117094728,85
86357632,86357687,chr1,MIR7856,chr1:86357632-86357687,55
116560024,116560111,chr1,MIR548AC,chr1:116560024-116560111,87
103523562,103523879,chr1,RN7SKP285,chr1:103523562-103523879,317
146409903,146410062,chr1,RNVU1-25,chr1:146409903-146410062,159
148263476,148263632,chr1,RNVU1-22,chr1:148263476-148263632,156
146539541,146539663,chr1,RNA5SP536,chr1:146539541-146539663,122
148334479,148334554,chr1,MIR5087,chr1:148334479-148334554,75
73883714,73883822,chr1,RNU4ATAC8P,chr1:73883714-73883822,108
116962347,116962471,chr1,RNA5SP55,chr1:116962347-116962471,124
148362370,148362533,chr1,RNVU1-1,chr1:148362370-148362533,163
143439605,143439714,chr1,RNA5SP533,chr1:143439605-143439714,109
150211632,150211925,chr1,RN7SL480P,chr1:150211632-150211925,293
145431527,145431693,chr1,RNU1-154P,chr1:145431527-145431693,166
148385829,148385963,chr1,RNU1-155P,chr1:148385829-148385963,134
148388282,148388363,chr1,MIR6077,chr1:148388282-148388363,81
148388490,148388651,chr1,RNVU1-2,chr1:148388490-148388651,161
148402715,148402875,chr1,RNVU1-3,chr1:148402715-148402875,160
148334612,148334767,chr1,RNVU1-21,chr1:148334612-148334767,155
146376807,146376970,chr1,RNVU1-29,chr1:146376807-146376970,163
59209400,59215239,chr17,SMG8,chr17:59209400-59215239,5839
147079746,147079870,chr1,RNU1-151P,chr1:147079746-147079870,124
153704088,153704385,chr1,RN7SL372P,chr1:153704088-153704385,297
115606471,115606768,chr1,RN7SL420P,chr1:115606471-115606768,297
150236967,150237156,chr1,RNU2-17P,chr1:150236967-150237156,189
112461770,112461833,chr1,MIR4256,chr1:112461770-112461833,63
145465617,145465780,chr1,RNVU1-31,chr1:145465617-145465780,163
101859851,101859957,chr1,RNU6-352P,chr1:101859851-101859957,106
63186336,63186450,chr1,RNA5SP49,chr1:63186336-63186450,114
119331397,119331525,chr1,RNU1-75P,chr1:119331397-119331525,128
151545796,151545891,chr1,MIR554,chr1:151545796-151545891,95
153689705,153689793,chr1,MIR8083,chr1:153689705-153689793,88
148839483,148839732,chr1,RN7SKP88,chr1:148839483-148839732,249
148939739,148939817,chr1,RNU2-38P,chr1:148939739-148939817,78
153331622,153331728,chr1,RNU6-160P,chr1:153331622-153331728,106
164980035,164980137,chr1,RNU6-755P,chr1:164980035-164980137,102
179576268,179576349,chr1,RNU5F-2P,chr1:179576268-179576349,81
36495636,36543435,chr17,MYO19,chr17:36495636-36543435,47799
166042244,166042350,chr1,RNA5SP64,chr1:166042244-166042350,106
182982212,182982318,chr1,RNU6-41P,chr1:182982212-182982318,106
168263375,168263481,chr1,RNU6-1310P,chr1:168263375-168263481,106
174996524,174996629,chr1,RNU6-307P,chr1:174996524-174996629,105
164351273,164351388,chr1,RNU5F-6P,chr1:164351273-164351388,115
185434244,185434305,chr1,RNU7-183P,chr1:185434244-185434305,61
194488103,194488205,chr1,RNU6-983P,chr1:194488103-194488205,102
185014951,185015067,chr1,RNA5SP72,chr1:185014951-185015067,116
200008505,200008607,chr1,RNU6-716P,chr1:200008505-200008607,102
172613428,172613534,chr1,RNU6-693P,chr1:172613428-172613534,106
154295503,154295601,chr1,RNU6-239P,chr1:154295503-154295601,98
168375524,168375621,chr1,MIR557,chr1:168375524-168375621,97
1088226,1096244,chr16,C1QTNF8,chr16:1088226-1096244,8018
218129795,218129952,chr1,RNU1-141P,chr1:218129795-218129952,157
166154743,166154798,chr1,MIR921,chr1:166154743-166154798,55
199888159,199888261,chr1,RNU6-778P,chr1:199888159-199888261,102
148193716,148193838,chr1,RNA5SP57,chr1:148193716-148193838,122
179900262,179900564,chr1,RN7SL230P,chr1:179900262-179900564,302
151300665,151300964,chr1,RN7SL444P,chr1:151300665-151300964,299
81444808,81711762,chr16,CMIP,chr16:81444808-81711762,266954
198858873,198858982,chr1,MIR181B1,chr1:198858873-198858982,109
198859044,198859153,chr1,MIR181A1,chr1:198859044-198859153,109
176243862,176244029,chr1,RNU2-12P,chr1:176243862-176244029,167
162157107,162157182,chr1,MIR4654,chr1:162157107-162157182,75
212352816,212352950,chr1,SNORA16B,chr1:212352816-212352950,134
164639565,164639671,chr1,RNU6-171P,chr1:164639565-164639671,106
162338643,162338742,chr1,RNA5SP61,chr1:162338643-162338742,99
9843443,9934416,chr2,TAF1B,chr2:9843443-9934416,90973
167998660,167998726,chr1,MIR1255B2,chr1:167998660-167998726,66
175968398,175968540,chr1,SCARNA3,chr1:175968398-175968540,142
162342546,162342640,chr1,MIR556,chr1:162342546-162342640,94
200014689,200014795,chr1,RNU6-609P,chr1:200014689-200014795,106
196582413,196582481,chr1,MIR4735,chr1:196582413-196582481,68
232222866,232223145,chr1,RN7SL299P,chr1:232222866-232223145,279
170151378,170151462,chr1,MIR3119-1,chr1:170151378-170151462,84
200054061,200054165,chr1,RNU6-570P,chr1:200054061-200054165,104
233448626,233448781,chr1,RNU4-77P,chr1:233448626-233448781,155
235915415,235915521,chr1,RNU6-968P,chr1:235915415-235915521,106
209623444,209623510,chr1,MIR4260,chr1:209623444-209623510,66
170151378,170151462,chr1,MIR3119-2,chr1:170151378-170151462,84
181771566,181771644,chr1,RNA5SP70,chr1:181771566-181771644,78
235127803,235127937,chr1,SNORA14B,chr1:235127803-235127937,134
233624152,233624219,chr1,MIR4427,chr1:233624152-233624219,67
234306467,234306539,chr1,MIR4671,chr1:234306467-234306539,72
120126974,120127074,chr1,RNU6-465P,chr1:120126974-120127074,100
148739379,148739479,chr1,RNU6-1171P,chr1:148739379-148739479,100
181839473,181839774,chr1,RN7SKP229,chr1:181839473-181839774,301
165907921,165907976,chr1,MIR3658,chr1:165907921-165907976,55
154193665,154193743,chr1,MIR190B,chr1:154193665-154193743,78
209432133,209432242,chr1,MIR205,chr1:209432133-209432242,109
205448302,205448398,chr1,MIR135B,chr1:205448302-205448398,96
234837976,234838069,chr1,RNY4P16,chr1:234837976-234838069,93
169859756,169860052,chr1,RN7SL333P,chr1:169859756-169860052,296
243081156,243081259,chr1,RNU6-747P,chr1:243081156-243081259,103
238325687,238325788,chr1,RNU6-725P,chr1:238325687-238325788,101
154166245,154166549,chr1,RN7SL431P,chr1:154166245-154166549,304
221837334,221837437,chr1,RNU6-403P,chr1:221837334-221837437,103
234904186,234904488,chr1,RN7SL668P,chr1:234904186-234904488,302
246189014,246189118,chr1,RNU6-1283P,chr1:246189014-246189118,104
211792111,211792406,chr1,RN7SL344P,chr1:211792111-211792406,295
202003124,202003236,chr1,MIR6740,chr1:202003124-202003236,112
235190034,235190116,chr1,MIR4753,chr1:235190034-235190116,82
151439000,151439095,chr1,RNY4P25,chr1:151439000-151439095,95
192875686,192875985,chr1,RN7SKP126,chr1:192875686-192875985,299
160392768,160392909,chr1,RNU4-42P,chr1:160392768-160392909,141
203318996,203319099,chr1,RNU6-487P,chr1:203318996-203319099,103
154297650,154297748,chr1,RNU6-121P,chr1:154297650-154297748,98
231281414,231281524,chr1,RNA5SP80,chr1:231281414-231281524,110
231670635,231670750,chr1,RNU5A-5P,chr1:231670635-231670750,115
180438314,180438390,chr1,MIR3121,chr1:180438314-180438390,76
202410108,202410207,chr1,RNU6-89P,chr1:202410108-202410207,99
223690051,223690114,chr1,RNU6-1248P,chr1:223690051-223690114,63
248912690,248912795,chr1,RNU6-1205P,chr1:248912690-248912795,105
177029363,177029445,chr1,MIR488,chr1:177029363-177029445,82
227941590,227941683,chr1,MIR5008,chr1:227941590-227941683,93
189666149,189666256,chr1,RNA5SP73,chr1:189666149-189666256,107
178560913,178561029,chr1,RNA5SP69,chr1:178560913-178561029,116
182327068,182327174,chr1,RNU6-152P,chr1:182327068-182327174,106
188155839,188156180,chr1,RN7SKP156,chr1:188155839-188156180,341
201978461,201978595,chr1,SNORA70H,chr1:201978461-201978595,134
205566716,205566799,chr1,RNU2-19P,chr1:205566716-205566799,83
167005959,167006077,chr1,RNA5SP65,chr1:167005959-167006077,118
224107282,224107541,chr1,RN7SKP49,chr1:224107282-224107541,259
235853000,235853060,chr1,MIR1537,chr1:235853000-235853060,60
163468496,163468605,chr1,RNA5SP62,chr1:163468496-163468605,109
219761789,219761875,chr1,RNA5SP76,chr1:219761789-219761875,86
210374154,210374267,chr1,RNU5A-8P,chr1:210374154-210374267,113
169957942,169958246,chr1,RN7SL269P,chr1:169957942-169958246,304
223976146,223976249,chr1,RNU6-1319P,chr1:223976146-223976249,103
42302098,42310814,chr19,PRR19,chr19:42302098-42310814,8716
212077613,212077685,chr1,MIR3122,chr1:212077613-212077685,72
9951693,10002277,chr2,GRHL1,chr2:9951693-10002277,50584
163509484,163509595,chr1,RNA5SP63,chr1:163509484-163509595,111
212099521,212099676,chr1,RN7SKP98,chr1:212099521-212099676,155
227561181,227561300,chr1,RNA5SP77,chr1:227561181-227561300,119
28984826,28990784,chr16,LAT,chr16:28984826-28990784,5958
205595041,205595147,chr1,RNU6-418P,chr1:205595041-205595147,106
242188647,242188789,chr1,RN7SKP12,chr1:242188647-242188789,142
248826377,248826443,chr1,MIR3124,chr1:248826377-248826443,66
186311825,186311928,chr1,RNU6-1240P,chr1:186311825-186311928,103
154259727,154259862,chr1,SNORA58B,chr1:154259727-154259862,135
192716328,192716390,chr1,MIR4426,chr1:192716328-192716390,62
4675224,4724673,chr19,DPP9,chr19:4675224-4724673,49449
165768929,165775176,chr1,TMCO1-AS1,chr1:165768929-165775176,6247
20482391,20486210,chr1,CAMK2N1,chr1:20482391-20486210,3819
20499448,20508151,chr1,MUL1,chr1:20499448-20508151,8703
20525989,20526751,chr1,RPS4XP4,chr1:20525989-20526751,762
177265580,177266588,chr5,PRMT1P1,chr5:177265580-177266588,1008
20552573,20555020,chr1,FAM43B,chr1:20552573-20555020,2447
177301198,177303744,chr5,RAB24,chr5:177301198-177303744,2546
20589086,20618903,chr1,CDA,chr1:20589086-20618903,29817
20633458,20651511,chr1,PINK1,chr1:20633458-20651511,18053
64759484,64881033,chr12,TBC1D30,chr12:64759484-64881033,121549
18266260,18269977,chr11,SAA1,chr11:18266260-18269977,3717
20633679,20633788,chr1,MIR6084,chr1:20633679-20633788,109
20642657,20652193,chr1,PINK1-AS,chr1:20642657-20652193,9536
192993449,192994677,chr1,ZNF101P2,chr1:192993449-192994677,1228
193057281,193057415,chr1,SCARNA18B,chr1:193057281-193057415,134
193121983,193254815,chr1,CDC73,chr1:193121983-193254815,132832
10042849,10054836,chr2,KLF11,chr2:10042849-10054836,11987
92420094,92428148,chr12,CLLU1-AS1,chr12:92420094-92428148,8054
92421531,92431002,chr12,CLLU1,chr12:92421531-92431002,9471
111347757,111347824,chr11,MIR4491,chr11:111347757-111347824,67
94834147,94835158,chr12,KRT19P2,chr12:94834147-94835158,1011
111352255,111455630,chr11,POU2AF1,chr11:111352255-111455630,103375
94834398,94834513,chr12,MIR492,chr12:94834398-94834513,115
95020229,95073628,chr12,NR2C1,chr12:95020229-95073628,53399
177303799,177306949,chr5,PRELID1,chr5:177303799-177306949,3150
10120698,10211725,chr2,RRM2,chr2:10120698-10211725,91027
193136503,193136583,chr1,MIR1278,chr1:193136503-193136583,80
193178730,193186613,chr1,B3GALT2,chr1:193178730-193186613,7883
193304745,193365953,chr1,LINC01031,chr1:193304745-193365953,61208
111383092,111383219,chr11,RNU2-60P,chr11:111383092-111383219,127
22523415,22524663,chr17,MTRNR2L1,chr17:22523415-22524663,1248
69433255,69435409,chr1,LINC01758,chr1:69433255-69435409,2154
75633434,75641404,chr17,SMIM5,chr17:75633434-75641404,7970
69606855,69608301,chr1,SGO1P1,chr1:69606855-69608301,1446
69879592,69879895,chr1,RN7SL538P,chr1:69879592-69879895,303
111512938,111513021,chr11,MIR34B,chr11:111512938-111513021,83
69919322,69920317,chr1,PIN1P1,chr1:69919322-69920317,995
111513439,111513515,chr11,MIR34C,chr11:111513439-111513515,76
7913339,7916289,chr17,RNF227,chr17:7913339-7916289,2950
70013982,70031222,chr1,LRRC7-AS1,chr1:70013982-70031222,17240
70144805,70205579,chr1,LRRC40,chr1:70144805-70205579,60774
48540894,48545109,chr17,HOXB2,chr17:48540894-48545109,4215
111540280,111561745,chr11,LAYN,chr11:111540280-111561745,21465
48591257,48593779,chr17,HOXB5,chr17:48591257-48593779,2522
58166982,58171411,chr17,OR4D2,chr17:58166982-58171411,4429
70180144,70180440,chr1,RN7SL242P,chr1:70180144-70180440,296
177331567,177351668,chr5,LMAN2,chr5:177331567-177351668,20101
70258999,70354734,chr1,ANKRD13C,chr1:70258999-70354734,95735
77280569,77500596,chr17,SEPTIN9,chr17:77280569-77500596,220027
67438014,67481181,chr16,ATP6V0D1,chr16:67438014-67481181,43167
70359562,70360437,chr1,HHLA3-AS1,chr1:70359562-70360437,875
70411218,70439851,chr1,CTH,chr1:70411218-70439851,28633
111602449,111730855,chr11,SIK2,chr11:111602449-111730855,128406
111683111,111683424,chr11,RN7SKP273,chr11:111683111-111683424,313
111467526,111514367,chr11,BTG4,chr11:111467526-111514367,46841
120164645,120285222,chr3,GPR156,chr3:120164645-120285222,120577
70530526,70531492,chr1,CHORDC1P5,chr1:70530526-70531492,966
70660657,70661265,chr1,CASP3P1,chr1:70660657-70661265,608
10192614,10192671,chr2,MIR4261,chr2:10192614-10192671,57
10280628,10280891,chr2,RN7SL66P,chr2:10280628-10280891,263
111514778,111537043,chr11,HOATZ,chr11:111514778-111537043,22265
23506438,23531233,chr1,E2F2,chr1:23506438-23531233,24795
10302889,10427617,chr2,HPCAL1,chr2:10302889-10427617,124728
156037701,156539138,chr3,KCNAB1,chr3:156037701-156539138,501437
94895297,95003748,chr12,NDUFA12,chr12:94895297-95003748,108451
9323772,9351162,chr19,ZNF559,chr19:9323772-9351162,27390
18693122,18704785,chr11,TMEM86A,chr11:18693122-18704785,11663
177357924,177372596,chr5,RGS14,chr5:177357924-177372596,14672
23557926,23559501,chr1,ID3,chr1:23557926-23559501,1575
18704312,18726230,chr11,IGSF22,chr11:18704312-18726230,21918
23691742,23696835,chr1,RPL11,chr1:23691742-23696835,5093
72063148,72077246,chr16,HPR,chr16:72063148-72077246,14098
120533480,120577588,chr12,RNF10,chr12:120533480-120577588,44108
18706537,18740568,chr11,IGSF22-AS1,chr11:18706537-18740568,34031
18727928,18792721,chr11,PTPN5,chr11:18727928-18792721,64793
14974591,15139339,chr16,PDXDC1,chr16:14974591-15139339,164748
23778418,23788232,chr1,PITHD1,chr1:23778418-23788232,9814
850291,892801,chr5,BRD9,chr5:850291-892801,42510
10439968,10448327,chr2,ODC1,chr2:10439968-10448327,8359
23791145,23795539,chr1,LYPLA2,chr1:23791145-23795539,4394
45687460,45692569,chr19,SNRPD2,chr19:45687460-45692569,5109
15728024,15729052,chr19,OR10H2,chr19:15728024-15729052,1028
7914830,7919097,chr19,TGFBR3L,chr19:7914830-7919097,4267
49423749,49428987,chr19,GFY,chr19:49423749-49428987,5238
12965159,12974760,chr19,DAND5,chr19:12965159-12974760,9601
10446714,10446849,chr2,SNORA80B,chr2:10446714-10446849,135
15787661,15800357,chr19,OR10H5,chr19:15787661-15800357,12696
15737985,15742343,chr19,OR10H3,chr19:15737985-15742343,4358
9247344,9252625,chr19,OR7E24,chr19:9247344-9252625,5281
15082211,15092970,chr19,OR1I1,chr19:15082211-15092970,10759
219434843,219493629,chr2,SPEG,chr2:219434843-219493629,58786
18836304,18837081,chr11,MRGPRX8P,chr11:18836304-18837081,777
1065923,1086628,chr19,ARHGAP45,chr19:1065923-1086628,20705
18863558,18864509,chr11,MRGPRX7P,chr11:18863558-18864509,951
18886933,18887920,chr11,MRGPRX6P,chr11:18886933-18887920,987
18910436,18911396,chr11,MRGPRX5P,chr11:18910436-18911396,960
23795599,23800781,chr1,GALE,chr1:23795599-23800781,5182
18956055,18957015,chr11,MRGPRX11P,chr11:18956055-18957015,960
18971746,18972703,chr11,MRGPRX10P,chr11:18971746-18972703,957
19029697,19030438,chr11,MRGPRX9P,chr11:19029697-19030438,741
19054455,19060717,chr11,MRGPRX2,chr11:19054455-19060717,6262
18933499,18939414,chr11,MRGPRX1,chr11:18933499-18939414,5915
134008215,134030167,chr11,LINC02730,chr11:134008215-134030167,21952
134069071,134152001,chr11,JAM3,chr11:134069071-134152001,82930
892884,919357,chr5,TRIP13,chr5:892884-919357,26473
98593591,98606379,chr12,SLC25A3,chr12:98593591-98606379,12788
88051944,88149885,chr3,CGGBP1,chr3:88051944-88149885,97941
1008802,1038943,chr5,NKD2,chr5:1008802-1038943,30141
88059255,88144660,chr3,ZNF654,chr3:88059255-88144660,85405
196943738,196959622,chr1,CFHR2,chr1:196943738-196959622,15884
87910220,87910345,chr3,RNU6ATAC6P,chr3:87910220-87910345,125
134123828,134124329,chr11,PTP4A2P2,chr11:134123828-134124329,501
38548057,38649687,chr3,SCN5A,chr3:38548057-38649687,101630
134224671,134247788,chr11,VPS26B,chr11:134224671-134247788,23117
219482073,219516877,chr2,ASIC4-AS1,chr2:219482073-219516877,34804
196977556,197009678,chr1,CFHR5,chr1:196977556-197009678,32122
1050384,1112063,chr5,SLC12A7,chr5:1050384-1112063,61679
219549073,219549147,chr2,MIR3132,chr2:219549073-219549147,74
219550728,219571859,chr2,OBSL1,chr2:219550728-219571859,21131
197138748,197139307,chr1,SEPTIN14P12,chr1:197138748-197139307,559
134248279,134253370,chr11,THYN1,chr11:134248279-134253370,5091
197363817,197364078,chr1,MRPS21P3,chr1:197363817-197364078,261
38836370,38852347,chr19,HNRNPL,chr19:38836370-38852347,15977
240769420,240771534,chr1,THAP12P8,chr1:240769420-240771534,2114
240823006,240823433,chr1,RFKP1,chr1:240823006-240823433,427
240919653,240920609,chr1,HNRNPA1P42,chr1:240919653-240920609,956
241132272,241132346,chr1,MIR3123,chr1:241132272-241132346,74
1062896,1062974,chr5,MIR4635,chr5:1062896-1062974,78
132848577,132848696,chr5,RNA5SP192,chr5:132848577-132848696,119
132866630,132868847,chr5,UQCRQ,chr5:132866630-132868847,2217
159587826,159588865,chr1,APCS,chr1:159587826-159588865,1039
98645290,98735433,chr12,APAF1,chr12:98645290-98735433,90143
132873444,132875046,chr5,LEAP2,chr5:132873444-132875046,1602
159704983,159705607,chr1,CRPP1,chr1:159704983-159705607,624
159712289,159714589,chr1,CRP,chr1:159712289-159714589,2300
134253548,134265855,chr11,ACAD8,chr11:134253548-134265855,12307
177131830,177300213,chr5,NSD1,chr5:177131830-177300213,168383
159780932,159782543,chr1,DUSP23,chr1:159780932-159782543,1611
159800511,159816257,chr1,FCRL6,chr1:159800511-159816257,15746
15804549,15815664,chr19,OR10H1,chr19:15804549-15815664,11115
219569162,219575711,chr2,INHA,chr2:219569162-219575711,6549
14840466,14848922,chr19,OR7A10,chr19:14840466-14848922,8456
150166778,150184558,chr5,CDX1,chr5:150166778-150184558,17780
17231883,17245919,chr19,NR2F6,chr19:17231883-17245919,14036
219590687,219590984,chr2,RN7SKP213,chr2:219590687-219590984,297
169637268,170083382,chr5,DOCK2,chr5:169637268-170083382,446114
219597857,219616451,chr2,STK11IP,chr2:219597857-219616451,18594
54107020,54115657,chr19,TFPT,chr19:54107020-54115657,8637
80976454,80976948,chr17,RPL12P37,chr17:80976454-80976948,494
80991598,81009517,chr17,CHMP6,chr17:80991598-81009517,17919
159826811,159837492,chr1,SLAMF8,chr1:159826811-159837492,10681
108223044,108369102,chr11,ATM,chr11:108223044-108369102,146058
159854316,159862657,chr1,VSIG8,chr1:159854316-159862657,8341
81739097,81962685,chr16,PLCG2,chr16:81739097-81962685,223588
463346,474983,chr19,ODF3L2,chr19:463346-474983,11637
44846175,44889223,chr19,NECTIN2,chr19:44846175-44889223,43048
159872364,159900165,chr1,CFAP45,chr1:159872364-159900165,27801
81029130,81034881,chr17,BAIAP2-DT,chr17:81029130-81034881,5751
81110487,81166221,chr17,AATK,chr17:81110487-81166221,55734
219627394,219641980,chr2,SLC4A3,chr2:219627394-219641980,14586
44890569,44903689,chr19,TOMM40,chr19:44890569-44903689,13120
159899979,159900079,chr1,MIR4259,chr1:159899979-159900079,100
159951492,159954237,chr1,SLAMF9,chr1:159951492-159954237,2745
81125276,81125373,chr17,MIR657,chr17:81125276-81125373,97
81125877,81125955,chr17,MIR3065,chr17:81125877-81125955,78
81125883,81125949,chr17,MIR338,chr17:81125883-81125949,66
81133196,81133308,chr17,MIR1250,chr17:81133196-81133308,112
81165507,81183166,chr17,PVALEF,chr17:81165507-81183166,17659
81228277,81239091,chr17,TEPSIN,chr17:81228277-81239091,10814
159834480,159855071,chr1,SNHG28,chr1:159834480-159855071,20591
31758660,31758735,chr1,MIR4254,chr1:31758660-31758735,75
44905791,44909393,chr19,APOE,chr19:44905791-44909393,3602
75751594,75765236,chr17,GALK1,chr17:75751594-75765236,13642
116372668,116410261,chr1,ATP1A1,chr1:116372668-116410261,37593
134274245,134319564,chr11,GLB1L3,chr11:134274245-134319564,45319
44914247,44919349,chr19,APOC1,chr19:44914247-44919349,5102
29484690,29505999,chr16,NPIPB12,chr16:29484690-29505999,21309
219684030,219684795,chr2,DNAJB6P3,chr2:219684030-219684795,765
219685381,219737937,chr2,LINC02832,chr2:219685381-219737937,52556
219697799,219698214,chr2,RPL23P4,chr2:219697799-219698214,415
58231157,58283836,chr16,CCDC113,chr16:58231157-58283836,52679
997129,1003671,chr17,TIMM22,chr17:997129-1003671,6542
10971836,11904446,chr5,CTNND2,chr5:10971836-11904446,932610
61417244,61417378,chr2,SNORA70B,chr2:61417244-61417378,134
1022476,1022559,chr17,MIR3183,chr17:1022476-1022559,83
61589498,61589663,chr2,RPS29P10,chr2:61589498-61589663,165
61605616,61605722,chr2,RNU6-1145P,chr2:61605616-61605722,106
56252254,56253222,chr11,OR5T3,chr11:56252254-56253222,968
1270444,1271815,chr17,BHLHA9,chr17:1270444-1271815,1371
44942237,44945496,chr19,APOC4,chr19:44942237-44945496,3259
20200797,20225433,chr2,SDC1,chr2:20200797-20225433,24636
1279662,1300978,chr17,TRARG1,chr17:1279662-1300978,21316
5893208,5902730,chr11,OR52E5,chr11:5893208-5902730,9522
45095806,45235110,chr11,PRDM11,chr11:45095806-45235110,139304
44942238,44949565,chr19,APOC4-APOC2,chr19:44942238-44949565,7327
1344275,1400222,chr17,YWHAE,chr17:1344275-1400222,55947
44946035,44949565,chr19,APOC2,chr19:44946035-44949565,3530
67723070,67806560,chr16,RANBP10,chr16:67723070-67806560,83490
20239892,20241046,chr2,DRG1P1,chr2:20239892-20241046,1154
20246326,20246387,chr2,RNU7-113P,chr2:20246326-20246387,61
20386386,20396588,chr2,SLC7A15P,chr2:20386386-20396588,10202
644233,707118,chr11,DEAF1,chr11:644233-707118,62885
20401627,20401724,chr2,RNA5SP86,chr2:20401627-20401724,97
20447074,20449440,chr2,RHOB,chr2:20447074-20449440,2366
44954585,44993341,chr19,CLPTM1,chr19:44954585-44993341,38756
116413766,116413869,chr1,RNU6-817P,chr1:116413766-116413869,103
116423724,116478842,chr1,LINC01762,chr1:116423724-116478842,55118
173871653,173872465,chr2,RPL5P7,chr2:173871653-173872465,812
174025280,174027163,chr2,LINC01960,chr2:174025280-174027163,1883
174043008,174043880,chr2,RPSAP24,chr2:174043008-174043880,872
174072447,174248599,chr2,OLA1,chr2:174072447-174248599,176152
197153682,197201293,chr1,ZBTB41,chr1:197153682-197201293,47611
1003519,1229738,chr17,ABR,chr17:1003519-1229738,226219
155063737,155069553,chr1,EFNA4,chr1:155063737-155069553,5816
155078837,155087538,chr1,EFNA3,chr1:155078837-155087538,8701
18804860,18926408,chr16,SMG1,chr16:18804860-18926408,121548
155127876,155134899,chr1,EFNA1,chr1:155127876-155134899,7023
189631389,189897276,chr3,TP63,chr3:189631389-189897276,265887
70467854,71252577,chr11,SHANK2,chr11:70467854-71252577,784723
174240143,174240457,chr2,RN7SL65P,chr2:174240143-174240457,314
174299324,174300956,chr2,LRRC2P1,chr2:174299324-174300956,1632
155135344,155138857,chr1,SLC50A1,chr1:155135344-155138857,3513
174310015,174310974,chr2,HNRNPA1P39,chr2:174310015-174310974,959
174326027,174330643,chr2,LINC01305,chr2:174326027-174330643,4616
174334954,174338500,chr2,SP9,chr2:174334954-174338500,3546
174348022,174395712,chr2,CIR1,chr2:174348022-174395712,47690
174395730,174429575,chr2,SCRN3,chr2:174395730-174429575,33845
12224686,12294883,chr19,ZNF44,chr19:12224686-12294883,70197
12317477,12333720,chr19,ZNF563,chr19:12317477-12333720,16243
12345944,12365905,chr19,ZNF442,chr19:12345944-12365905,19961
12373609,12373731,chr19,RPS29P23,chr19:12373609-12373731,122
155148544,155148813,chr1,HMGN2P18,chr1:155148544-155148813,269
155169408,155173475,chr1,KRTCAP2,chr1:155169408-155173475,4067
174501952,174502312,chr2,RPA3P1,chr2:174501952-174502312,360
12390016,12401271,chr19,ZNF799,chr19:12390016-12401271,11255
174557966,174558072,chr2,RNU6-5P,chr2:174557966-174558072,106
94304580,94308146,chr11,IZUMO1R,chr11:94304580-94308146,3566
12429706,12441021,chr19,ZNF443,chr19:12429706-12441021,11315
155195177,155195272,chr1,MIR92B,chr1:155195177-155195272,95
134150113,134225504,chr11,NCAPD3,chr11:134150113-134225504,75391
12461184,12513854,chr19,ZNF709,chr19:12461184-12513854,52670
155195588,155209051,chr1,THBS3,chr1:155195588-155209051,13463
232697299,232860605,chr2,GIGYF2,chr2:232697299-232860605,163306
12502675,12504106,chr19,MTND2P40,chr19:12502675-12504106,1431
12504665,12504890,chr19,MTCO1P27,chr19:12504665-12504890,225
12504905,12505976,chr19,MTCO2P27,chr19:12504905-12505976,1071
12506249,12508030,chr19,MTATP6P27,chr19:12506249-12508030,1781
12508129,12508263,chr19,PPIAP20,chr19:12508129-12508263,134
12891160,12914207,chr19,GCDH,chr19:12891160-12914207,23047
56791913,56838773,chr17,C17orf67,chr17:56791913-56838773,46860
179835133,179862173,chr5,MRNIP,chr5:179835133-179862173,27040
56834107,56869567,chr17,DGKE,chr17:56834107-56869567,35460
12611827,12645108,chr12,CREBL2,chr12:12611827-12645108,33281
12614359,12615907,chr12,RPL21P136,chr12:12614359-12615907,1548
12660890,12696207,chr12,GPR19,chr12:12660890-12696207,35317
12898786,12919293,chr19,SYCE2,chr19:12898786-12919293,20507
53766534,53766632,chr19,RNU6-165P,chr19:53766534-53766632,98
53767971,53768553,chr19,HMGN1P32,chr19:53767971-53768553,582
53772506,53773280,chr19,SEPTIN7P8,chr19:53772506-53773280,774
12725917,12829975,chr12,APOLD1,chr12:12725917-12829975,104058
53787675,53787741,chr19,MIR371A,chr19:53787675-53787741,66
53787677,53787742,chr19,MIR371B,chr19:53787677-53787742,65
53787890,53787956,chr19,MIR372,chr19:53787890-53787956,66
53788705,53788773,chr19,MIR373,chr19:53788705-53788773,68
53793741,53824394,chr19,NLRP12,chr19:53793741-53824394,30653
56836387,56914080,chr17,TRIM25,chr17:56836387-56914080,77693
89267630,89490561,chr16,ANKRD11,chr16:89267630-89490561,222931
12764649,12764743,chr12,MIR613,chr12:12764649-12764743,94
12771351,12771705,chr12,STX8P1,chr12:12771351-12771705,354
12813316,12829981,chr12,DDX47,chr12:12813316-12829981,16665
187217282,187291980,chr3,MASP1,chr3:187217282-187291980,74698
155230975,155234325,chr1,MTX1P1,chr1:155230975-155234325,3350
155234452,155244699,chr1,GBA,chr1:155234452-155244699,10247
82614562,82648553,chr17,WDR45B,chr17:82614562-82648553,33991
53854581,53869107,chr19,MYADM-AS1,chr19:53854581-53869107,14526
53864763,53876435,chr19,MYADM,chr19:53864763-53876435,11672
120914400,120915123,chr12,CLIC1P1,chr12:120914400-120915123,723
120916745,120917236,chr12,RPL12P33,chr12:120916745-120917236,491
120941728,120980965,chr12,HNF1A-AS1,chr12:120941728-120980965,39237
69093991,69131069,chr5,SLC30A5,chr5:69093991-69131069,37078
120978543,121002512,chr12,HNF1A,chr12:120978543-121002512,23969
133664926,133665034,chr3,RNU6-678P,chr3:133664926-133665034,108
133710076,133710167,chr3,RNA5SP140,chr3:133710076-133710167,91
133746040,133796641,chr3,TF,chr3:133746040-133796641,50601
53879190,53907652,chr19,PRKCG,chr19:53879190-53907652,28462
82654973,82698698,chr17,RAB40B,chr17:82654973-82698698,43725
155255979,155262430,chr1,SCAMP3,chr1:155255979-155262430,6451
107859035,108382098,chr5,FBXL17,chr5:107859035-108382098,523063
924881,1012245,chr11,AP2A2,chr11:924881-1012245,87364
82668233,82668307,chr17,MIR4525,chr17:82668233-82668307,74
133932701,134052184,chr3,SLCO2A1,chr3:133932701-134052184,119483
82716706,82730328,chr17,FN3KRP,chr17:82716706-82730328,13622
53883942,54310582,chr5,ARL15,chr5:53883942-54310582,426640
155262868,155278491,chr1,CLK2,chr1:155262868-155278491,15623
55256055,55307694,chr5,DHX29,chr5:55256055-55307694,51639
53909278,53943950,chr19,CACNG7,chr19:53909278-53943950,34672
49357176,49358353,chr3,GPX1,chr3:49357176-49358353,1177
53962937,53990215,chr19,CACNG8,chr19:53962937-53990215,27278
53982307,53982397,chr19,MIR935,chr19:53982307-53982397,90
179649494,179650200,chr3,H3P13,chr3:179649494-179650200,706
53991637,54012666,chr19,CACNG6,chr19:53991637-54012666,21029
179875376,179881609,chr3,PEX5L-AS1,chr3:179875376-179881609,6233
82735615,82751196,chr17,FN3K,chr17:82735615-82751196,15581
179898199,179921895,chr3,PEX5L-AS2,chr3:179898199-179921895,23696
70140217,70140488,chr3,UQCRHP4,chr3:70140217-70140488,271
70194479,70312638,chr3,MDFIC2,chr3:70194479-70312638,118159
155277463,155289848,chr1,HCN3,chr1:155277463-155289848,12385
148791102,148860187,chr3,CPB1,chr3:148791102-148860187,69085
54040825,54063953,chr19,VSTM1,chr19:54040825-54063953,23128
71428193,71452868,chr11,DHCR7,chr11:71428193-71452868,24675
82752042,82945914,chr17,TBCD,chr17:82752042-82945914,193872
155289293,155301438,chr1,PKLR,chr1:155289293-155301438,12145
72054505,72061055,chr16,HP,chr16:72054505-72061055,6550
110280756,110351093,chr12,ATP2A2,chr12:110280756-110351093,70337
41904188,41921636,chr5,C5orf51,chr5:41904188-41921636,17448
138439057,138446969,chr5,REEP2,chr5:138439057-138446969,7912
67138907,67259979,chr1,IL23R,chr1:67138907-67259979,121072
148697784,148743008,chr3,AGTR1,chr3:148697784-148743008,45224
18001132,18014102,chr19,ARRDC2,chr19:18001132-18014102,12970
58162547,58170636,chr3,FLNB-AS1,chr3:58162547-58170636,8089
67196140,67196243,chr1,RNU6-586P,chr1:67196140-67196243,103
58192257,58214697,chr3,DNASE1L3,chr3:58192257-58214697,22440
67267601,67267726,chr1,RNU4ATAC4P,chr1:67267601-67267726,125
67278052,67278779,chr1,DNAJB6P4,chr1:67278052-67278779,727
67417214,67417318,chr1,RNU6-387P,chr1:67417214-67417318,104
67541127,67541233,chr1,RNU6-1031P,chr1:67541127-67541233,106
207645113,207738416,chr1,CR1L,chr1:207645113-207738416,93303
178602664,178630615,chr5,CLK4,chr5:178602664-178630615,27951
207645234,207657410,chr1,CD46P1,chr1:207645234-207657410,12176
207658454,207659142,chr1,CDCA4P3,chr1:207658454-207659142,688
207708898,207708981,chr1,RNA5SP534,chr1:207708898-207708981,83
58237532,58295693,chr3,ABHD6,chr3:58237532-58295693,58161
3506311,3538334,chr19,FZR1,chr19:3506311-3538334,32023
207752054,207795513,chr1,CD46,chr1:207752054-207795513,43459
110360452,110360746,chr12,RN7SL769P,chr12:110360452-110360746,294
55901413,55932618,chr12,PYM1,chr12:55901413-55932618,31205
58306245,58324695,chr3,RPP14,chr3:58306245-58324695,18450
55954105,55973317,chr12,PMEL,chr12:55954105-55973317,19212
126269024,126278131,chr11,FOXRED1,chr11:126269024-126278131,9107
58332880,58426127,chr3,PXK,chr3:58332880-58426127,93247
151020591,151028988,chr5,GPX3,chr5:151020591-151028988,8397
842812,867116,chr11,TSPAN4,chr11:842812-867116,24304
218303,257082,chr5,SDHA,chr5:218303-257082,38779
30222937,30254510,chr16,NPIPB13,chr16:30222937-30254510,31573
1072747,1081454,chr16,SSTR5,chr16:1072747-1081454,8707
51107571,51108021,chr16,SOD1P2,chr16:51107571-51108021,450
51135982,51152334,chr16,SALL1,chr16:51135982-51152334,16352
3538261,3574290,chr19,MFSD12,chr19:3538261-3574290,36029
30378135,30395991,chr16,SEPTIN1,chr16:30378135-30395991,17856
58969038,60522120,chr5,PDE4D,chr5:58969038-60522120,1553082
69950705,69964452,chr16,CLEC18A,chr16:69950705-69964452,13747
55966781,55972789,chr12,CDK2,chr12:55966781-55972789,6008
3572777,3579088,chr19,HMG20B,chr19:3572777-3579088,6311
6606294,6612539,chr11,TAF10,chr11:6606294-6612539,6245
3585478,3593541,chr19,GIPC3,chr19:3585478-3593541,8063
75334670,75370560,chr12,GLIPR1L1,chr12:75334670-75370560,35890
17933015,17943991,chr19,CCDC124,chr19:17933015-17943991,10976
61392393,61398866,chr11,TMEM216,chr11:61392393-61398866,6473
119024114,119030906,chr11,SLC37A4,chr11:119024114-119030906,6792
75391089,75432688,chr12,GLIPR1L2,chr12:75391089-75432688,41599
3539171,3544030,chr19,C19orf71,chr19:3539171-3544030,4859
18531751,18544077,chr19,FKBP8,chr19:18531751-18544077,12326
75480753,75503863,chr12,GLIPR1,chr12:75480753-75503863,23110
70579895,70660682,chr16,IL34,chr16:70579895-70660682,80787
1221651,1225268,chr16,TPSG1,chr16:1221651-1225268,3617
207762584,207763263,chr1,CDCA4P4,chr1:207762584-207763263,679
207801518,207879115,chr1,MIR29B2CHG,chr1:207801518-207879115,77597
27550133,27780344,chr16,KATNIP,chr16:27550133-27780344,230211
75490863,75511636,chr12,KRR1,chr12:75490863-75511636,20773
207801852,207801939,chr1,MIR29C,chr1:207801852-207801939,87
207802443,207802523,chr1,MIR29B2,chr1:207802443-207802523,80
207880972,207911402,chr1,CD34,chr1:207880972-207911402,30430
232729523,232730198,chr2,EEF1B2P7,chr2:232729523-232730198,675
232765802,232776565,chr2,KCNJ13,chr2:232765802-232776565,10763
232857270,232878708,chr2,SNORC,chr2:232857270-232878708,21438
207959292,207969329,chr1,LINC02767,chr1:207959292-207969329,10037
159598298,159599227,chr1,OR10J6P,chr1:159598298-159599227,929
10163268,10163374,chr1,RNU6-828P,chr1:10163268-10163374,106
10298966,10299072,chr1,RNU6-37P,chr1:10298966-10299072,106
10306465,10306757,chr1,RN7SL731P,chr1:10306465-10306757,292
83968244,84002776,chr16,NECAB2,chr16:83968244-84002776,34532
232878701,233013256,chr2,NGEF,chr2:232878701-233013256,134555
10398592,10420511,chr1,PGD,chr1:10398592-10420511,21919
55549602,55555832,chr12,OR6C4,chr12:55549602-55555832,6230
30024427,30052978,chr16,TLCD3B,chr16:30024427-30052978,28551
25409307,25648579,chr12,LMNTD1,chr12:25409307-25648579,239272
10430102,10452153,chr1,CENPS-CORT,chr1:10430102-10452153,22051
84053761,84116942,chr16,MBTPS1,chr16:84053761-84116942,63181
58427630,58433857,chr3,PDHB,chr3:58427630-58433857,6227
18557762,18569387,chr19,KXD1,chr19:18557762-18569387,11625
8693351,8910951,chr11,DENND2B,chr11:8693351-8910951,217600
10430433,10442808,chr1,CENPS,chr1:10430433-10442808,12375
10456522,10472529,chr1,DFFA,chr1:10456522-10472529,16007
233032672,233035057,chr2,NEU2,chr2:233032672-233035057,2385
174719908,174720318,chr2,H3P6,chr2:174719908-174720318,410
174747592,174787935,chr2,CHRNA1,chr2:174747592-174787935,40343
72249964,72276954,chr12,TRHDE-AS1,chr12:72249964-72276954,26990
67307364,67398724,chr1,IL12RB2,chr1:67307364-67398724,91360
72431722,72432075,chr12,H3P35,chr12:72431722-72432075,353
72610678,72611316,chr12,CHCHD3P2,chr12:72610678-72611316,638
74220929,74221427,chr16,PPIAP49,chr16:74220929-74221427,498
74296814,74306288,chr16,PSMD7,chr16:74296814-74306288,9474
179794958,180037053,chr3,PEX5L,chr3:179794958-180037053,242095
56076799,56103505,chr12,ERBB3,chr12:56076799-56103505,26706
18571730,18577550,chr19,UBA52,chr19:18571730-18577550,5820
74332402,74368240,chr16,PDPR2P,chr16:74332402-74368240,35838
151788984,151828492,chr2,ARL5A,chr2:151788984-151828492,39508
74408631,74421478,chr16,CLEC18B,chr16:74408631-74421478,12847
174559572,174682916,chr2,WIPF1,chr2:174559572-174682916,123344
74456541,74456611,chr16,RNU6-237P,chr16:74456541-74456611,70
74376306,74392115,chr16,NPIPB15,chr16:74376306-74392115,15809
203656969,203657760,chr1,NSA2P1,chr1:203656969-203657760,791
48080882,48156018,chr16,ABCC12,chr16:48080882-48156018,75136
203729581,203729705,chr1,SNORA77,chr1:203729581-203729705,124
203765177,203776372,chr1,LAX1,chr1:203765177-203776372,11195
203795714,203854999,chr1,ZBED6,chr1:203795714-203854999,59285
203835585,203835912,chr1,RPL35AP5,chr1:203835585-203835912,327
203861599,203871152,chr1,SNRPE,chr1:203861599-203871152,9553
176383946,176388927,chr5,NOP16,chr5:176383946-176388927,4981
18572220,18607741,chr19,CRLF1,chr19:18572220-18607741,35521
203872574,203874187,chr1,KRT8P29,chr1:203872574-203874187,1613
27935000,27959157,chr1,SMPDL3B,chr1:27935000-27959157,24157
75536741,75556289,chr16,TMEM231,chr16:75536741-75556289,19548
72087266,72670758,chr12,TRHDE,chr12:72087266-72670758,583492
18588685,18592337,chr19,REX1BD,chr19:18588685-18592337,3652
160249083,160345396,chr5,CCNJL,chr5:160249083-160345396,96313
38769265,38770124,chr2,NPLP1,chr2:38769265-38770124,859
38797729,38875934,chr2,DHX57,chr2:38797729-38875934,78205
18607430,18621039,chr19,TMEM59L,chr19:18607430-18621039,13609
28031884,28032180,chr1,RN7SL559P,chr1:28031884-28032180,296
27959588,27968093,chr1,XKR8,chr1:27959588-27968093,8505
2771414,2777289,chr16,ELOB,chr16:2771414-2777289,5875
14143342,14532128,chr5,TRIO,chr5:14143342-14532128,388786
231018958,231040254,chr1,FAM89A,chr1:231018958-231040254,21296
55342841,55343774,chr12,OR6C7P,chr12:55342841-55343774,933
231019828,231019924,chr1,MIR1182,chr1:231019828-231019924,96
55362975,55369279,chr12,OR6C75,chr12:55362975-55369279,6304
231184098,231187627,chr1,TRIM67-AS1,chr1:231184098-231187627,3529
55376742,55378797,chr12,OR6C71P,chr12:55376742-55378797,2055
55385837,55392964,chr12,OR6C66P,chr12:55385837-55392964,7127
231223763,231241187,chr1,C1orf131,chr1:231223763-231241187,17424
55396340,55396697,chr12,OR6C73P,chr12:55396340-55396697,357
18631646,18631908,chr19,RN7SL155P,chr19:18631646-18631908,262
55411727,55414787,chr12,PHC1P1,chr12:55411727-55414787,3060
11887782,11914329,chr19,ZNF69,chr19:11887782-11914329,26547
55426254,55427192,chr12,OR6C76,chr12:55426254-55427192,938
32790755,32896777,chr12,PKP2,chr12:32790755-32896777,106022
11925068,11950773,chr19,ZNF700,chr19:11925068-11950773,25705
69007052,69007155,chr16,RNU6-898P,chr16:69007052-69007155,103
69033675,69036042,chr16,RPS2P45,chr16:69033675-69036042,2367
38810432,38811654,chr2,ASS1P2,chr2:38810432-38811654,1222
69105653,69118719,chr16,HAS3,chr16:69105653-69118719,13066
38884560,38884666,chr2,RNU6-851P,chr2:38884560-38884666,106
180161886,180161977,chr3,RNA5SP149,chr3:180161886-180161977,91
38936876,38937158,chr2,RN7SL96P,chr2:38936876-38937158,282
180212191,180213108,chr3,GAPDHP36,chr3:180212191-180213108,917
38992279,38993857,chr2,SOS1-IT1,chr2:38992279-38993857,1578
180323107,180325059,chr3,RALBP1P1,chr3:180323107-180325059,1952
39082589,39082692,chr2,RNU6-198P,chr2:39082589-39082692,103
39098149,39098445,chr2,HSPE1P13,chr2:39098149-39098445,296
179604690,179627647,chr3,NDUFB5,chr3:179604690-179627647,22957
11965037,11980617,chr19,ZNF763,chr19:11965037-11980617,15580
74120680,74123218,chr2,FNBP1P1,chr2:74120680-74123218,2538
74135400,74147912,chr2,BOLA3,chr2:74135400-74147912,12512
45303910,45305619,chr1,LINC01144,chr1:45303910-45305619,1709
69118010,69132588,chr16,CHTF8,chr16:69118010-69132588,14578
11987617,12046275,chr19,ZNF433-AS1,chr19:11987617-12046275,58658
45340052,45343973,chr1,TOE1,chr1:45340052-45343973,3921
74152528,74178898,chr2,MOB1A,chr2:74152528-74178898,26370
11996809,11996916,chr19,RNA5SP464,chr19:11996809-11996916,107
12027913,12028021,chr19,RNA5SP465,chr19:12027913-12028021,108
12070164,12070271,chr19,RNA5SP466,chr19:12070164-12070271,107
12092263,12137235,chr19,ZNF788P,chr19:12092263-12137235,44972
69175671,69175777,chr16,RNU6-22P,chr16:69175671-69175777,106
69118010,69132588,chr16,DERPC,chr16:69118010-69132588,14578
45343883,45491163,chr1,TESK2,chr1:45343883-45491163,147280
32985838,32987070,chr12,ASS1P14,chr12:32985838-32987070,1232
12092843,12140355,chr19,ZNF20,chr19:12092843-12140355,47512
74186172,74217565,chr2,MTHFD2,chr2:74186172-74217565,31393
55262539,55263431,chr12,OR6C69P,chr12:55262539-55263431,892
55283750,55284641,chr12,OR6C72P,chr12:55283750-55284641,891
1938229,1943199,chr16,MSRB1,chr16:1938229-1943199,4970
55293988,55296569,chr12,OR6C6,chr12:55293988-55296569,2581
55311835,55312757,chr12,OR6C5P,chr12:55311835-55312757,922
48472559,48473622,chr12,ANP32D,chr12:48472559-48473622,1063
48482498,48496524,chr12,C12orf54,chr12:48482498-48496524,14026
1943974,1957606,chr16,RPL3L,chr16:1943974-1957606,13632
12096424,12096915,chr19,RSL24D1P8,chr19:12096424-12096915,491
12106497,12106614,chr19,RNA5SP467,chr19:12106497-12106614,117
45415020,45415344,chr1,PPIAP36,chr1:45415020-45415344,324
12132117,12156731,chr19,ZNF625-ZNF20,chr19:12132117-12156731,24614
45493866,45500079,chr1,CCDC163,chr1:45493866-45500079,6213
133052013,133106449,chr5,HSPA4,chr5:133052013-133106449,54436
48487946,48488408,chr12,RPS10P20,chr12:48487946-48488408,462
12142090,12156734,chr19,ZNF625,chr19:12142090-12156734,14644
48525632,48526570,chr12,OR8S1,chr12:48525632-48526570,938
48559882,48562956,chr12,OR5BS1P,chr12:48559882-48562956,3074
48567684,48570066,chr12,LALBA,chr12:48567684-48570066,2382
9776776,10304877,chr11,SBF2,chr11:9776776-10304877,528101
1959538,1961975,chr16,NDUFB10,chr16:1959538-1961975,2437
179653032,179804366,chr3,USP13,chr3:179653032-179804366,151334
55019974,55030017,chr12,NEUROD4,chr12:55019974-55030017,10043
55113077,55118632,chr12,OR9K1P,chr12:55113077-55118632,5555
58012589,58025926,chr19,VN2R19P,chr19:58012589-58025926,13337
55126406,55132750,chr12,OR9K2,chr12:55126406-55132750,6344
45332698,45333124,chr19,RPS16P9,chr19:45332698-45333124,426
45500300,45513382,chr1,MMACHC,chr1:45500300-45513382,13082
55158847,55159723,chr12,OR9R1P,chr12:55158847-55159723,876
45333434,45351520,chr19,KLC3,chr19:45333434-45351520,18086
12473282,12562863,chr12,DUSP16,chr12:12473282-12562863,89581
1962058,1964841,chr16,RPS2,chr16:1962058-1964841,2783
247110160,247112417,chr1,LINC02897,chr1:247110160-247112417,2257
247119669,247120278,chr1,FGFR3P6,chr1:247119669-247120278,609
132656263,132661110,chr5,IL13,chr5:132656263-132661110,4847
247189851,247210856,chr1,ZNF731P,chr1:247189851-247210856,21005
247201967,247202060,chr1,MIR3916,chr1:247201967-247202060,93
247204570,247204661,chr1,RNA5SP82,chr1:247204570-247204661,91
247236868,247237957,chr1,VN1R17P,chr1:247236868-247237957,1089
247255972,247257210,chr1,VN1R5,chr1:247255972-247257210,1238
247488093,247492415,chr1,OR2W5P,chr1:247488093-247492415,4322
71455651,71567820,chr5,BDP1,chr5:71455651-71567820,112169
12875499,12876107,chr12,RPL13AP20,chr12:12875499-12876107,608
12891559,12917937,chr12,GPRC5A,chr12:12891559-12917937,26378
247507058,247577690,chr1,GCSAML,chr1:247507058-247577690,70632
218450251,218568351,chr2,USP37,chr2:218450251-218568351,118100
12915829,12915918,chr12,MIR614,chr12:12915829-12915918,89
12940775,12952147,chr12,GPRC5D,chr12:12940775-12952147,11372
12974870,13000265,chr12,HEBP1,chr12:12974870-13000265,25395
45379638,45406349,chr19,PPP1R13L,chr19:45379638-45406349,26711
13000420,13004830,chr12,HTR7P1,chr12:13000420-13004830,4410
82829434,82840022,chr17,ZNF750,chr17:82829434-82840022,10588
2219485,2223479,chr12,CACNA1C-AS4,chr12:2219485-2223479,3994
2269776,2288937,chr12,CACNA1C-IT3,chr12:2269776-2288937,19161
2603350,2607440,chr12,CACNA1C-AS3,chr12:2603350-2607440,4090
2668500,2672220,chr12,CACNA1C-AS2,chr12:2668500-2672220,3720
2676001,2691200,chr12,CACNA1C-AS1,chr12:2676001-2691200,15199
83079609,83095122,chr17,METRNL,chr17:83079609-83095122,15513
99083783,99083905,chr12,RNA5SP366,chr12:99083783-99083905,122
99647753,99650114,chr12,FAM71C,chr12:99647753-99650114,2361
108747841,109196841,chr5,FER,chr5:108747841-109196841,449000
42968088,42980433,chr17,PTGES3L,chr17:42968088-42980433,12345
122980060,122982913,chr12,ARL6IP4,chr12:122980060-122982913,2853
115962454,116027619,chr5,LVRN,chr5:115962454-116027619,65165
1962334,1962466,chr16,SNORA10,chr16:1962334-1962466,132
247588360,247589313,chr1,OR2G2,chr1:247588360-247589313,953
1962973,1963106,chr16,SNORA64,chr16:1962973-1963106,133
50094737,50112152,chr17,PDK2,chr17:50094737-50112152,17415
247605586,247606515,chr1,OR2G3,chr1:247605586-247606515,929
1965184,1965310,chr16,SNORA78,chr16:1965184-1965310,126
155024124,155183704,chr3,MME,chr3:155024124-155183704,159580
247666887,247667841,chr1,OR3D1P,chr1:247666887-247667841,954
1966823,1968975,chr16,RNF151,chr16:1966823-1968975,2152
45406644,45410737,chr19,POLR1G,chr19:45406644-45410737,4093
247416156,247449108,chr1,NLRP3,chr1:247416156-247449108,32952
1972053,1982929,chr16,TBL3,chr16:1972053-1982929,10876
45349837,45370918,chr19,ERCC2,chr19:45349837-45370918,21081
8937578,8943016,chr11,ASCL3,chr11:8937578-8943016,5438
4768979,4769938,chr11,OR51F1,chr11:4768979-4769938,959
119067818,119081972,chr11,VPS11,chr11:119067818-119081972,14154
50110040,50130160,chr17,SAMD14,chr17:50110040-50130160,20120
111040098,111040208,chr11,RNA5SP350,chr11:111040098-111040208,110
111091932,111179641,chr11,LINC02550,chr11:111091932-111179641,87709
111105547,111105895,chr11,RPS17P15,chr11:111105547-111105895,348
218500729,218501037,chr2,RN7SKP38,chr2:218500729-218501037,308
111245725,111286401,chr11,C11orf53,chr11:111245725-111286401,40676
141515016,141619055,chr5,DIAPH1,chr5:141515016-141619055,104039
218568580,218597080,chr2,CNOT9,chr2:218568580-218597080,28500
111290787,111305498,chr11,COLCA1,chr11:111290787-111305498,14711
49002274,49018807,chr12,PRKAG1,chr12:49002274-49018807,16533
111298546,111308735,chr11,COLCA2,chr11:111298546-111308735,10189
1978917,1984192,chr16,NOXO1,chr16:1978917-1984192,5275
108690289,108690956,chr11,RPS2P39,chr11:108690289-108690956,667
108665058,108940999,chr11,DDX10,chr11:108665058-108940999,275941
50133737,50150677,chr17,PPP1R9B,chr17:50133737-50150677,16940
8292157,8292263,chr1,RNU6-991P,chr1:8292157-8292263,106
239703381,239770130,chr1,CHRM3-AS2,chr1:239703381-239770130,66749
50184101,50201632,chr17,COL1A1,chr17:50184101-50201632,17531
239898016,239899872,chr1,CHRM3-AS1,chr1:239898016-239899872,1856
58306262,58320193,chr3,HTD2,chr3:58306262-58320193,13931
240012646,240013226,chr1,RPS7P5,chr1:240012646-240013226,580
218589214,218589320,chr2,RNU6-136P,chr2:218589214-218589320,106
240170155,240171291,chr1,ADH5P3,chr1:240170155-240171291,1136
218607855,218637184,chr2,PLCD4,chr2:218607855-218637184,29329
239386565,239915452,chr1,CHRM3,chr1:239386565-239915452,528887
119334527,119337309,chr11,RNF26,chr11:119334527-119337309,2782
119338942,119340940,chr11,C1QTNF5,chr11:119338942-119340940,1998
186439239,186457299,chr3,LINC02020,chr3:186439239-186457299,18060
119338942,119346705,chr11,MFRP,chr11:119338942-119346705,7763
108560089,108644900,chr1,FAM102B,chr1:108560089-108644900,84811
131641714,131797017,chr5,FNIP1,chr5:131641714-131797017,155303
1984193,1987749,chr16,GFER,chr16:1984193-1987749,3556
186454969,186493661,chr3,LINC02052,chr3:186454969-186493661,38692
119355215,119381711,chr11,USP2,chr11:119355215-119381711,26496
1989660,1994275,chr16,SYNGR3,chr16:1989660-1994275,4615
186476727,186478370,chr3,LINC02051,chr3:186476727-186478370,1643
186538441,186546702,chr3,CRYGS,chr3:186538441-186546702,8261
186546067,186570543,chr3,TBCCD1,chr3:186546067-186570543,24476
108648290,108661526,chr1,HENMT1,chr1:108648290-108661526,13236
51888025,51900463,chr19,ZNF649-AS1,chr19:51888025-51900463,12438
51889235,51905040,chr19,ZNF649,chr19:51889235-51905040,15805
2009926,2020755,chr16,NPW,chr16:2009926-2020755,10829
12685498,12722369,chr12,CDKN1B,chr12:12685498-12722369,36871
2013181,2013476,chr16,RN7SL219P,chr16:2013181-2013476,295
2025356,2039026,chr16,SLC9A3R2,chr16:2025356-2039026,13670
112013348,112023449,chr12,ERP29,chr12:112013348-112023449,10101
51927147,51948759,chr19,ZNF613,chr19:51927147-51948759,21612
186613060,186621318,chr3,AHSG,chr3:186613060-186621318,8258
218658764,218663443,chr2,BCS1L,chr2:218658764-218663443,4679
119415476,119424985,chr11,THY1,chr11:119415476-119424985,9509
51964340,51986856,chr19,ZNF350,chr19:51964340-51986856,22516
186635969,186653141,chr3,FETUB,chr3:186635969-186653141,17172
50235845,50236129,chr17,SUMO2P7,chr17:50235845-50236129,284
50271406,50281485,chr17,TMEM92,chr17:50271406-50281485,10079
112026689,112108796,chr12,NAA25,chr12:112026689-112108796,82107
175628188,175628462,chr5,RN7SKP148,chr5:175628188-175628462,274
175703898,175704004,chr5,RNU6-226P,chr5:175703898-175704004,106
175658030,175710756,chr5,HRH2,chr5:175658030-175710756,52726
73498408,73505667,chr5,BTF3,chr5:73498408-73505667,7259
10718055,10833488,chr19,DNM2,chr19:10718055-10833488,115433
50281577,50287855,chr17,TMEM92-AS1,chr17:50281577-50287855,6278
119417951,119419114,chr11,THY1-AS1,chr11:119417951-119419114,1163
119444991,119445519,chr11,DUXAP5,chr11:119444991-119445519,528
50346126,50363138,chr17,XYLT2,chr17:50346126-50363138,17012
119190250,119196769,chr11,CCDC153,chr11:119190250-119196769,6519
108692310,108702928,chr1,PRPF38B,chr1:108692310-108702928,10618
69294151,69341682,chr11,MYEOV,chr11:69294151-69341682,47531
186660216,186678234,chr3,HRG,chr3:186660216-186678234,18018
69303412,69303807,chr11,IFITM9P,chr11:69303412-69303807,395
150846521,150900736,chr5,IRGM,chr5:150846521-150900736,54215
69475567,69481545,chr11,LINC02747,chr11:69475567-69481545,5978
69481662,69494952,chr11,LINC01488,chr11:69481662-69494952,13290
108712908,108742749,chr1,FNDC7,chr1:108712908-108742749,29841
69641156,69654474,chr11,CCND1,chr11:69641156-69654474,13318
66596380,67169593,chr5,MAST4,chr5:66596380-67169593,573213
2985231,2985575,chr3,DNAJC19P4,chr3:2985231-2985575,344
3039033,3069242,chr3,CNTN4-AS1,chr3:3039033-3069242,30209
50367857,50373207,chr17,MRPL27,chr17:50367857-50373207,5350
3066324,3126613,chr3,IL5RA,chr3:3066324-3126613,60289
2039815,2047866,chr16,NTHL1,chr16:2039815-2047866,8051
108746674,108809523,chr1,STXBP3,chr1:108746674-108809523,62849
69653076,69675416,chr11,LTO1,chr11:69653076-69675416,22340
50373220,50381483,chr17,EME1,chr17:50373220-50381483,8263
112037599,112037715,chr12,MIR3657,chr12:112037599-112037715,116
9087061,9095669,chr19,OR1M1,chr19:9087061-9095669,8608
112125538,112153604,chr12,TRAFD1,chr12:112125538-112153604,28066
9114828,9115763,chr19,OR7G1,chr19:9114828-9115763,935
9122160,9122492,chr19,OR7G15P,chr19:9122160-9122492,332
9126012,9126950,chr19,OR7G3,chr19:9126012-9126950,938
9140397,9163424,chr19,ZNF317,chr19:9140397-9163424,23027
50375059,50397523,chr17,LRRC59,chr17:50375059-50397523,22464
2090195,2090284,chr16,MIR1225,chr16:2090195-2090284,89
1997654,2009821,chr16,ZNF598,chr16:1997654-2009821,12167
69698238,69704022,chr11,FGF19,chr11:69698238-69704022,5784
50164214,50175928,chr17,SGCA,chr17:50164214-50175928,11714
218663892,218672002,chr2,RNF25,chr2:218663892-218672002,8110
108857217,108858524,chr1,SPATA42,chr1:108857217-108858524,1307
69737298,69738017,chr11,DNAJB6P5,chr11:69737298-69738017,719
69771022,69775341,chr11,FGF4,chr11:69771022-69775341,4319
9178979,9188818,chr19,OR7D2,chr19:9178979-9188818,9839
109046828,109047482,chr1,RANP5,chr1:109046828-109047482,654
118833846,118834556,chr11,SETP16,chr11:118833846-118834556,710
109087971,109090858,chr1,TMEM167B-DT,chr1:109087971-109090858,2887
118883892,118897787,chr11,CXCR5,chr11:118883892-118897787,13895
109090764,109096934,chr1,TMEM167B,chr1:109090764-109096934,6170
9182369,9183048,chr19,ELOCP29,chr19:9182369-9183048,679
9191286,9192170,chr19,OR7E16P,chr19:9191286-9192170,884
9198354,9210067,chr19,OR7E25P,chr19:9198354-9210067,11713
9210276,9219589,chr19,OR7D4,chr19:9210276-9219589,9313
118893875,118925926,chr11,BCL9L,chr11:118893875-118925926,32051
109100193,109100612,chr1,SCARNA2,chr1:109100193-109100612,419
42268537,42295797,chr19,CIC,chr19:42268537-42295797,27260
247617143,247622372,chr1,OR14L1P,chr1:247617143-247622372,5229
112163258,112163321,chr12,MIR6861,chr12:112163258-112163321,63
112267077,112267394,chr12,RN7SKP71,chr12:112267077-112267394,317
112301870,112302663,chr12,RPL7AP60,chr12:112301870-112302663,793
118910708,118910787,chr11,MIR4492,chr11:118910708-118910787,79
112160188,112382439,chr12,HECTD4,chr12:112160188-112382439,222251
118925164,118958559,chr11,UPK2,chr11:118925164-118958559,33395
155687960,155739010,chr1,DAP3,chr1:155687960-155739010,51050
218672069,218702716,chr2,STK36,chr2:218672069-218702716,30647
118931216,118931490,chr11,RN7SL688P,chr11:118931216-118931490,274
118971712,118981287,chr11,FOXR1,chr11:118971712-118981287,9575
2047967,2089491,chr16,TSC2,chr16:2047967-2089491,41524
62264705,62275655,chr17,TBC1D3P2,chr17:62264705-62275655,10950
119084866,119093834,chr11,HMBS,chr11:119084866-119093834,8968
62343941,62416480,chr17,EFCAB3,chr17:62343941-62416480,72539
177456608,177474401,chr5,DBN1,chr5:177456608-177474401,17793
62383104,62383166,chr17,RNU7-52P,chr17:62383104-62383166,62
62397397,62398142,chr17,RPS23P7,chr17:62397397-62398142,745
3126933,3150879,chr3,TRNT1,chr3:3126933-3150879,23946
62423875,62453385,chr17,METTL2A,chr17:62423875-62453385,29510
7089587,7109238,chr12,C1RL,chr12:7089587-7109238,19651
29665459,29675477,chr19,PLEKHF1,chr19:29665459-29675477,10018
62627670,62693597,chr17,MRC2,chr17:62627670-62693597,65927
14878203,14886132,chr19,OR7A17,chr19:14878203-14886132,7929
14886839,14887115,chr19,OR7A18P,chr19:14886839-14887115,276
45769709,45782552,chr19,DMPK,chr19:45769709-45782552,12843
218710835,218755416,chr2,TTLL4,chr2:218710835-218755416,44581
2752597,2753132,chr12,IQSEC3P1,chr12:2752597-2753132,535
49359139,49412998,chr3,RHOA,chr3:49359139-49412998,53859
155745829,155750137,chr1,MSTO2P,chr1:155745829-155750137,4308
155859567,155885199,chr1,SYT11,chr1:155859567-155885199,25632
1970772,2697950,chr12,CACNA1C,chr12:1970772-2697950,727178
141408021,141512975,chr5,PCDHGB6,chr5:141408021-141512975,104954
155897808,155911404,chr1,RIT1,chr1:155897808-155911404,13596
94703690,95285094,chr5,MCTP1,chr5:94703690-95285094,581404
128879596,128924003,chr3,ACAD9,chr3:128879596-128924003,44407
16719847,16817963,chr19,NWD1,chr19:16719847-16817963,98116
62683905,62684010,chr17,RNU6-446P,chr17:62683905-62684010,105
155913045,155934413,chr1,KHDC4,chr1:155913045-155934413,21368
62458658,62615481,chr17,TLK2,chr17:62458658-62615481,156823
218781749,218815293,chr2,CYP27A1,chr2:218781749-218815293,33544
218822383,218832086,chr2,PRKAG3,chr2:218822383-218832086,9703
155919909,155920045,chr1,SNORA80E,chr1:155919909-155920045,136
155925958,155926085,chr1,SCARNA4,chr1:155925958-155926085,127
155951273,155951336,chr1,MIR6738,chr1:155951273-155951336,63
155978799,155982986,chr1,ARHGEF2-AS2,chr1:155978799-155982986,4187
155991390,156001787,chr1,ARHGEF2-AS1,chr1:155991390-156001787,10397
156009048,156020951,chr1,SSR2,chr1:156009048-156020951,11903
22448583,22544546,chr12,C2CD5,chr12:22448583-22544546,95963
218823090,218823154,chr2,MIR9500,chr2:218823090-218823154,64
218841599,218842065,chr2,RPL23AP31,chr2:218841599-218842065,466
225010461,225010540,chr2,MIR4439,chr2:225010461-225010540,79
188734155,188790104,chr2,DIRC1,chr2:188734155-188790104,55949
16829398,16880353,chr19,SIN3B,chr19:16829398-16880353,50955
69396113,69437628,chr2,NFU1,chr2:69396113-69437628,41515
92168,189972,chr5,PLEKHG4B,chr5:92168-189972,97804
129060779,129062406,chr3,GP9,chr3:129060779-129062406,1627
129087569,129122801,chr3,RAB43,chr3:129087569-129122801,35232
156035299,156053798,chr1,UBQLN4,chr1:156035299-156053798,18499
63158437,63243599,chr11,SLC22A25,chr11:63158437-63243599,85162
149857953,149944793,chr5,PDE6A,chr5:149857953-149944793,86840
69516751,69517046,chr2,RN7SL604P,chr2:69516751-69517046,295
69520043,69520174,chr2,SNORA36C,chr2:69520043-69520174,131
69594741,69595058,chr2,RPL36AP16,chr2:69594741-69595058,317
69597353,69598951,chr2,B3GALNT1P1,chr2:69597353-69598951,1598
156054782,156058506,chr1,LAMTOR2,chr1:156054782-156058506,3724
218633329,218659655,chr2,ZNF142,chr2:218633329-218659655,26326
129087575,129161036,chr3,ISY1-RAB43,chr3:129087575-129161036,73461
47465933,47565569,chr11,CELF1,chr11:47465933-47565569,99636
156061160,156070504,chr1,RAB25,chr1:156061160-156070504,9344
129127415,129161063,chr3,ISY1,chr3:129127415-129161063,33648
156212982,156243332,chr1,PMF1-BGLAP,chr1:156212982-156243332,30350
16888999,16892606,chr19,F2RL3,chr19:16888999-16892606,3607
149932014,149932668,chr5,MFFP2,chr5:149932014-149932668,654
149960758,149993455,chr5,SLC26A2,chr5:149960758-149993455,32697
16892951,17026815,chr19,CPAMD8,chr19:16892951-17026815,133864
151832771,152099167,chr2,CACNB4,chr2:151832771-152099167,266396
132369710,132395613,chr5,SLC22A5,chr5:132369710-132395613,25903
156242184,156243317,chr1,BGLAP,chr1:156242184-156243317,1133
156249224,156282825,chr1,SMG5,chr1:156249224-156282825,33601
45676369,45689200,chr3,LIMD1-AS1,chr3:45676369-45689200,12831
45689056,45745409,chr3,SACM1L,chr3:45689056-45745409,56353
16907462,16907723,chr19,RN7SL835P,chr19:16907462-16907723,261
16910490,16910784,chr19,RN7SL823P,chr19:16910490-16910784,294
17049729,17075625,chr19,HAUS8,chr19:17049729-17075625,25896
78002326,78294698,chr5,AP3B1,chr5:78002326-78294698,292372
156282935,156293185,chr1,TMEM79,chr1:156282935-156293185,10250
44228760,44230228,chr17,SHC1P2,chr17:44228760-44230228,1468
44248390,44268141,chr17,SLC4A1,chr17:44248390-44268141,19751
69155478,69162440,chr11,SMIM38,chr11:69155478-69162440,6962
60455846,60470752,chr11,MS4A1,chr11:60455846-60470752,14906
156290089,156295689,chr1,GLMP,chr1:156290089-156295689,5600
7957537,7965447,chr11,NLRP10,chr11:7957537-7965447,7910
58905398,59043527,chr11,GLYATL1,chr11:58905398-59043527,138129
156308968,156367873,chr1,CCT3,chr1:156308968-156367873,58905
1238179,1239522,chr19,CBARP-DT,chr19:1238179-1239522,1343
45755449,45796536,chr3,SLC6A20,chr3:45755449-45796536,41087
1241746,1244825,chr19,ATP5F1D,chr19:1241746-1244825,3079
4428155,4445815,chr12,FGF6,chr12:4428155-4445815,17660
57516588,57521737,chr12,DDIT3,chr12:57516588-57521737,5149
78222184,78222517,chr5,ATP6V1G1P6,chr5:78222184-78222517,333
78314916,78315025,chr5,RNU6-183P,chr5:78314916-78315025,109
132861181,132866884,chr5,GDF9,chr5:132861181-132866884,5703
118003634,118088299,chr11,SMIM35,chr11:118003634-118088299,84665
795605,858973,chr5,ZDHHC11,chr5:795605-858973,63368
110372900,110403730,chr12,ANAPC7,chr12:110372900-110403730,30830
69083176,69083258,chr11,MIR3164,chr11:69083176-69083258,82
35030470,35040449,chr19,SCN1B,chr19:35030470-35040449,9979
61361964,61377890,chr11,TMEM138,chr11:61361964-61377890,15926
44290856,44291151,chr17,RN7SL507P,chr17:44290856-44291151,295
44299574,44315315,chr17,RUNDC3A-AS1,chr17:44299574-44315315,15741
44307088,44307172,chr17,RNU6-453P,chr17:44307088-44307172,84
44308413,44318670,chr17,RUNDC3A,chr17:44308413-44318670,10257
45883640,45884113,chr3,SDHDP4,chr3:45883640-45884113,473
45940933,45948351,chr3,CXCR6,chr3:45940933-45948351,7418
61444149,61444423,chr11,RN7SL23P,chr11:61444149-61444423,274
141094606,141098703,chr5,PCDHB2,chr5:141094606-141098703,4097
46023296,46024156,chr3,NRBF2P2,chr3:46023296-46024156,860
61508596,61508657,chr11,MIR4488,chr11:61508596-61508657,61
8169167,8178903,chr11,RIC3-DT,chr11:8169167-8178903,9736
93843764,93843862,chr3,RNU6-488P,chr3:93843764-93843862,98
8224309,8268716,chr11,LMO1,chr11:8224309-8268716,44407
93873051,93980003,chr3,PROS1,chr3:93873051-93980003,106952
141100473,141103827,chr5,PCDHB3,chr5:141100473-141103827,3354
141121818,141125623,chr5,PCDHB4,chr5:141121818-141125623,3805
8391868,8594289,chr11,STK33,chr11:8391868-8594289,202421
141135206,141138615,chr5,PCDHB5,chr5:141135206-141138615,3409
55428740,55443300,chr19,SHISA7,chr19:55428740-55443300,14560
141150057,141153287,chr5,PCDHB6,chr5:141150057-141153287,3230
141155996,141159061,chr5,PCDHB17P,chr5:141155996-141159061,3065
44474428,44500524,chr19,ZNF180,chr19:44474428-44500524,26096
141172644,141176383,chr5,PCDHB7,chr5:141172644-141176383,3739
141177790,141180539,chr5,PCDHB8,chr5:141177790-141180539,2749
141182387,141186226,chr5,PCDHB16,chr5:141182387-141186226,3839
44319625,44324870,chr17,SLC25A39,chr17:44319625-44324870,5245
564296,663589,chr12,NINJ2,chr12:564296-663589,99293
141187127,141191541,chr5,PCDHB9,chr5:141187127-141191541,4414
141192353,141195647,chr5,PCDHB10,chr5:141192353-141195647,3294
141199610,141203779,chr5,PCDHB11,chr5:141199610-141203779,4169
128267170,128707911,chr12,TMEM132C,chr12:128267170-128707911,440741
141208697,141212571,chr5,PCDHB12,chr5:141208697-141212571,3874
55400529,55401467,chr12,OR6C65,chr12:55400529-55401467,938
141213919,141218979,chr5,PCDHB13,chr5:141213919-141218979,5060
52069246,52077495,chr12,ATG101,chr12:52069246-52077495,8249
141223343,141227759,chr5,PCDHB14,chr5:141223343-141227759,4416
141234333,141237529,chr5,PCDHB18P,chr5:141234333-141237529,3196
141239923,141243034,chr5,PCDHB19P,chr5:141239923-141243034,3111
141245395,141249365,chr5,PCDHB15,chr5:141245395-141249365,3970
141259884,141320784,chr5,TAF7,chr5:141259884-141320784,60900
46424697,46428936,chr19,PNMA8C,chr19:46424697-46428936,4239
10010627,10018796,chr12,CLEC12B,chr12:10010627-10018796,8169
141302635,141304049,chr5,SLC25A2,chr5:141302635-141304049,1414
35115823,35124324,chr19,FXYD3,chr19:35115823-35124324,8501
156369211,156385219,chr1,RHBG,chr1:156369211-156385219,16008
69362026,69370013,chr5,TAF9,chr5:69362026-69370013,7987
48202339,48203292,chr12,OR10AD1,chr12:48202339-48203292,953
10995961,10998304,chr12,TAS2R20,chr12:10995961-10998304,2343
61708273,62279150,chr12,TAFA2,chr12:61708273-62279150,570877
93977029,93977135,chr3,RNU6-511P,chr3:93977029-93977135,106
93988634,93988946,chr3,HMGN1P7,chr3:93988634-93988946,312
94014365,94028597,chr3,STX19,chr3:94014365-94028597,14232
67414968,67425607,chr11,CARNS1,chr11:67414968-67425607,10639
94047836,94063389,chr3,DHFR2,chr3:94047836-94063389,15553
137745651,137754363,chr5,HNRNPA0,chr5:137745651-137754363,8712
137809780,137889394,chr5,PKD2L2-DT,chr5:137809780-137889394,79614
94062980,94131832,chr3,NSUN3,chr3:94062980-94131832,68852
137867858,137887851,chr5,MYOT,chr5:137867858-137887851,19993
51813921,51814925,chr12,TMDD1,chr12:51813921-51814925,1004
6666477,6689572,chr12,ZNF384,chr12:6666477-6689572,23095
94075912,94077175,chr3,RBBP4P2,chr3:94075912-94077175,1263
83132056,83134737,chr11,BCAS2P1,chr11:83132056-83134737,2681
156420341,156420429,chr1,MIR9-1,chr1:156420341-156420429,88
156072013,156082465,chr1,MEX3A,chr1:156072013-156082465,10452
83184491,83193794,chr11,ANKRD42-DT,chr11:83184491-83193794,9303
47023669,47050751,chr1,CYP4X1,chr1:47023669-47050751,27082
93980139,94055678,chr3,ARL13B,chr3:93980139-94055678,75539
83185521,83187036,chr11,PCF11-AS1,chr11:83185521-83187036,1515
44345246,44353106,chr17,GRN,chr17:44345246-44353106,7860
47067231,47118318,chr1,CYP4Z1,chr1:47067231-47118318,51087
83193712,83260694,chr11,ANKRD42,chr11:83193712-83260694,66982
137887968,137942747,chr5,PKD2L2,chr5:137887968-137942747,54779
47074778,47075979,chr1,TUBAP9,chr1:47074778-47075979,1201
47096653,47179271,chr1,CYP4A22-AS1,chr1:47096653-47179271,82618
47164510,47165920,chr1,MTND1P34,chr1:47164510-47165920,1410
47179250,47180339,chr1,LINC00853,chr1:47179250-47180339,1089
47183582,47191044,chr1,PDZK1IP1,chr1:47183582-47191044,7462
47380928,47408477,chr1,LINC01389,chr1:47380928-47408477,27549
47416285,47418052,chr1,FOXE3,chr1:47416285-47418052,1767
47432133,47434641,chr1,FOXD2-AS1,chr1:47432133-47434641,2508
156298624,156299307,chr1,VHLL,chr1:156298624-156299307,683
165544000,165563957,chr1,LRRC52,chr1:165544000-165563957,19957
116574399,116667755,chr1,IGSF3,chr1:116574399-116667755,93356
83209399,83209634,chr11,CKS1BP4,chr11:83209399-83209634,235
83213005,83213404,chr11,RPL32P24,chr11:83213005-83213404,399
83156988,83187451,chr11,PCF11,chr11:83156988-83187451,30463
140647058,140662480,chr5,IK,chr5:140647058-140662480,15422
9853718,9936515,chr19,OLFM2,chr19:9853718-9936515,82797
12847377,12848720,chr1,HNRNPCL1,chr1:12847377-12848720,1343
182378098,182392206,chr1,GLUL,chr1:182378098-182392206,14108
13931187,13953392,chr19,PODNL1,chr19:13931187-13953392,22205
190077,214570,chr12,SLC6A12,chr12:190077-214570,24493
118401346,118433278,chr11,ATP5MG,chr11:118401346-118433278,31932
44353215,44363853,chr17,FAM171A2,chr17:44353215-44363853,10638
5856749,5857690,chr11,OR52E8,chr11:5856749-5857690,941
57743514,57752675,chr11,BTBD18,chr11:57743514-57752675,9161
44365014,44365751,chr17,RPL7L1P5,chr17:44365014-44365751,737
18588781,18610255,chr11,SPTY2D1OS,chr11:18588781-18610255,21474
44372180,44389649,chr17,ITGA2B,chr17:44372180-44389649,17469
55463001,55464751,chr19,C19orf85,chr19:55463001-55464751,1750
42469640,42469879,chr3,RPL35AP8,chr3:42469640-42469879,239
416589,461033,chr19,SHC2,chr19:416589-461033,44444
42489299,42537573,chr3,VIPR1,chr3:42489299-42537573,48274
1828307,1837521,chr11,SYT8,chr11:1828307-1837521,9214
32691821,32713792,chr19,NUDT19,chr19:32691821-32713792,21971
12802031,12813581,chr19,THSD8,chr19:12802031-12813581,11550
1554672,1568325,chr19,MEX3D,chr19:1554672-1568325,13653
45488777,45502513,chr19,PPM1N,chr19:45488777-45502513,13736
170145959,170168866,chr1,NTMT2,chr1:170145959-170168866,22907
83259081,83286390,chr11,CCDC90B,chr11:83259081-83286390,27309
44409059,44409358,chr17,RN7SL258P,chr17:44409059-44409358,299
37514807,37609472,chr17,SYNRG,chr17:37514807-37609472,94665
50024029,50203772,chr1,ELAVL4,chr1:50024029-50203772,179743
18868545,18896727,chr19,CERS1,chr19:18868545-18896727,28182
82279462,82386977,chr5,ATP6AP1L,chr5:82279462-82386977,107515
76376675,76377149,chr5,SNRPCP2,chr5:76376675-76377149,474
76403285,76708132,chr5,IQGAP2,chr5:76403285-76708132,304847
41907704,41928449,chr19,ERFL,chr19:41907704-41928449,20745
111360651,111369121,chr12,PHETA1,chr12:111360651-111369121,8470
49047638,49049111,chr19,CGB8,chr19:49047638-49049111,1473
38770968,38773517,chr19,LGALS7,chr19:38770968-38773517,2549
42506465,42533258,chr3,VIPR1-AS1,chr3:42506465-42533258,26793
53107879,53133077,chr19,ZNF415,chr19:53107879-53133077,25198
54121277,54189008,chr12,SMUG1,chr12:54121277-54189008,67731
42547969,42601080,chr3,SEC22C,chr3:42547969-42601080,53111
234373456,234385080,chr1,COA6,chr1:234373456-234385080,11624
49067397,49072699,chr19,KCNA7,chr19:49067397-49072699,5302
10450031,10451998,chr1,CORT,chr1:10450031-10451998,1967
38908980,38912186,chr19,CCER2,chr19:38908980-38912186,3206
246839098,246931948,chr1,AHCTF1,chr1:246839098-246931948,92850
15912367,15934867,chr19,CYP4F11,chr19:15912367-15934867,22500
21264600,21419594,chr12,SLCO1A2,chr12:21264600-21419594,154994
42581840,42596934,chr3,SS18L2,chr3:42581840-42596934,15094
57454790,57457140,chr19,VN1R1,chr19:57454790-57457140,2350
42676189,42676491,chr3,RN7SL567P,chr3:42676189-42676491,302
10092338,10102678,chr19,ANGPTL6,chr19:10092338-10102678,10340
42685537,42692544,chr3,KLHL40,chr3:42685537-42692544,7007
42692663,42702824,chr3,HHATL,chr3:42692663-42702824,10161
62662817,62672267,chr11,LBHD1,chr11:62662817-62672267,9450
48485271,48513935,chr19,LMTK3,chr19:48485271-48513935,28664
219543663,219550595,chr2,TMEM198,chr2:219543663-219550595,6932
105041326,105101431,chr11,CARD16,chr11:105041326-105101431,60105
107326360,107457825,chr11,CWF19L2,chr11:107326360-107457825,131465
49022869,49024333,chr19,CGB3,chr19:49022869-49024333,1464
96325317,96330517,chr2,ITPRIPL1,chr2:96325317-96330517,5200
38889875,38975454,chr2,ARHGEF33,chr2:38889875-38975454,85579
305573,344815,chr19,MIER2,chr19:305573-344815,39242
92702843,92772455,chr12,PLEKHG7,chr12:92702843-92772455,69612
99703970,99766635,chr1,FRRS1,chr1:99703970-99766635,62665
131527675,131533666,chr2,CCDC74A,chr2:131527675-131533666,5991
42702541,42706776,chr3,HHATL-AS1,chr3:42702541-42706776,4235
68272443,68332381,chr12,MDM1,chr12:68272443-68332381,59938
9412429,9435573,chr19,ZNF266,chr19:9412429-9435573,23144
42705756,42773253,chr3,CCDC13,chr3:42705756-42773253,67497
37609739,37643446,chr17,DDX52,chr17:37609739-37643446,33707
69567922,70151945,chr1,LRRC7,chr1:69567922-70151945,584023
76615482,76623413,chr5,F2RL2,chr5:76615482-76623413,7931
76716126,76735770,chr5,F2R,chr5:76716126-76735770,19644
76818933,76835315,chr5,F2RL1,chr5:76818933-76835315,16382
42732575,42746768,chr3,CCDC13-AS1,chr3:42732575-42746768,14193
76836900,76837195,chr5,RN7SL208P,chr5:76836900-76837195,295
42782908,42804490,chr3,HIGD1A,chr3:42782908-42804490,21582
172768096,172771195,chr5,DUSP1,chr5:172768096-172771195,3099
31784779,31817961,chr11,PAX6,chr11:31784779-31817961,33182
58395656,58397079,chr19,RNF225,chr19:58395656-58397079,1423
37614931,37615039,chr17,MIR378J,chr17:37614931-37615039,108
172958729,172969771,chr5,RPL26L1,chr5:172958729-172969771,11042
130611440,130658037,chr2,POTEJ,chr2:130611440-130658037,46597
42804752,42887974,chr3,ACKR2,chr3:42804752-42887974,83222
10960932,11079426,chr19,SMARCA4,chr19:10960932-11079426,118494
37686431,37745059,chr17,HNF1B,chr17:37686431-37745059,58628
29443230,29454651,chr16,BOLA2-SMG1P6,chr16:29443230-29454651,11421
101007228,101252866,chr2,TBC1D8,chr2:101007228-101252866,245638
29453590,29454351,chr16,BOLA2,chr16:29453590-29454351,761
42856005,42875898,chr3,CYP8B1,chr3:42856005-42875898,19893
122983480,123151090,chr12,PITPNM2,chr12:122983480-123151090,167610
42889361,42890306,chr3,HNRNPA1P22,chr3:42889361-42890306,945
1419752,1420756,chr16,C16orf91,chr16:1419752-1420756,1004
42653697,42667580,chr3,ZBTB47,chr3:42653697-42667580,13883
198523222,198540945,chr1,ATP6V1G3,chr1:198523222-198540945,17723
1431078,1434441,chr16,PERCC1,chr16:1431078-1434441,3363
172983771,173035445,chr5,ATP6V0E1,chr5:172983771-173035445,51674
1434383,1444556,chr16,CCDC154,chr16:1434383-1444556,10173
197038741,197067260,chr1,F13B,chr1:197038741-197067260,28519
51894876,51903353,chr3,IQCF1,chr3:51894876-51903353,8477
73254682,73284478,chr2,FBXO41,chr2:73254682-73284478,29796
24661422,24671062,chr16,LINC01567,chr16:24661422-24671062,9640
51817603,51819635,chr3,IQCF4P,chr3:51817603-51819635,2032
173020728,173020928,chr5,SNORA74B,chr5:173020728-173020928,200
65420652,65641559,chr1,LEPR,chr1:65420652-65641559,220907
173056352,173139284,chr5,CREBRF,chr5:173056352-173139284,82932
24919389,25015666,chr16,ARHGAP17,chr16:24919389-25015666,96277
37828305,37884743,chr17,YWHAEP7,chr17:37828305-37884743,56438
51861615,51863424,chr3,IQCF2,chr3:51861615-51863424,1809
37907957,37908063,chr17,RNU6-489P,chr17:37907957-37908063,106
37924415,37935365,chr17,TBC1D3K,chr17:37924415-37935365,10950
51872178,51872464,chr3,RN7SL504P,chr3:51872178-51872464,286
51873596,51875767,chr3,IQCF5-AS1,chr3:51873596-51875767,2171
51873721,51875601,chr3,IQCF5,chr3:51873721-51875601,1880
51942345,51948867,chr3,PARP3,chr3:51942345-51948867,6522
28855010,28861061,chr17,ERAL1,chr17:28855010-28861061,6051
86907953,87013976,chr2,RGPD1,chr2:86907953-87013976,106023
130162459,130165740,chr12,FZD10,chr12:130162459-130165740,3281
173085342,173086210,chr5,CDC42P5,chr5:173085342-173086210,868
10170542,10191804,chr12,TMEM52B,chr12:10170542-10191804,21262
173144442,173164387,chr5,BNIP1,chr5:173144442-173164387,19945
10248023,10281218,chr3,TATDN2,chr3:10248023-10281218,33195
100203669,100267079,chr12,DEPDC4,chr12:100203669-100267079,63410
10394489,10394562,chr3,MIR885,chr3:10394489-10394562,73
44424134,44429529,chr3,LINC01988,chr3:44424134-44429529,5395
44494847,44510636,chr3,ZNF852,chr3:44494847-44510636,15789
28861369,28861440,chr17,MIR451A,chr17:28861369-28861440,71
28861371,28861438,chr17,MIR451B,chr17:28861371-28861438,67
44524744,44525805,chr3,EI24P3,chr3:44524744-44525805,1061
28861533,28861618,chr17,MIR144,chr17:28861533-28861618,85
28861655,28861730,chr17,MIR4732,chr17:28861655-28861730,75
175176258,175181710,chr2,ATP5MC3,chr2:175176258-175181710,5452
28879335,28897733,chr17,FLOT2,chr17:28879335-28897733,18398
44555193,44594173,chr3,ZKSCAN7,chr3:44555193-44594173,38980
6310436,6328506,chr12,PLEKHG6,chr12:6310436-6328506,18070
64690442,64718190,chr5,SHISAL2B,chr5:64690442-64718190,27748
64718148,64768691,chr5,SREK1IP1,chr5:64718148-64768691,50543
231706895,231713551,chr2,PTMA,chr2:231706895-231713551,6656
172834251,172952792,chr5,ERGIC1,chr5:172834251-172952792,118541
164555584,164899296,chr1,PBX1,chr1:164555584-164899296,343712
69398402,69466264,chr16,CYB5B,chr16:69398402-69466264,67862
44578223,44599694,chr3,ZNF660,chr3:44578223-44599694,21471
44579938,44581026,chr3,MPRIPP1,chr3:44579938-44581026,1088
44584888,44648471,chr3,ZNF197,chr3:44584888-44648471,63583
24845841,24911628,chr16,SLC5A11,chr16:24845841-24911628,65787
104801801,104958744,chr12,SLC41A2,chr12:104801801-104958744,156943
28897781,28903079,chr17,DHRS13,chr17:28897781-28903079,5298
151254709,151267479,chr1,PSMD4,chr1:151254709-151267479,12770
64766368,65102412,chr5,CWC27,chr5:64766368-65102412,336044
44617128,44624797,chr3,ZNF197-AS1,chr3:44617128-44624797,7669
107685799,107713162,chr12,PWP1,chr12:107685799-107713162,27363
205681990,205798133,chr2,NRP2,chr2:205681990-205798133,116143
44648732,44660791,chr3,ZNF35,chr3:44648732-44660791,12059
28905250,28951771,chr17,PHF12,chr17:28905250-28951771,46521
44709311,44710886,chr3,SOCS5P3,chr3:44709311-44710886,1575
38696802,38816286,chr3,SCN10A,chr3:38696802-38816286,119484
107732871,107761272,chr12,PRDM4,chr12:107732871-107761272,28401
176526712,176538025,chr5,RNF44,chr5:176526712-176538025,11313
159918107,159925507,chr1,TAGLN2,chr1:159918107-159925507,7400
160205380,160215376,chr1,PEA15,chr1:160205380-160215376,9996
15206152,15252916,chr3,CAPN7,chr3:15206152-15252916,46764
176743205,176743871,chr5,LINC01574,chr5:176743205-176743871,666
176542511,176595974,chr5,CDHR2,chr5:176542511-176595974,53463
160541095,160579516,chr1,CD84,chr1:160541095-160579516,38421
30530367,30535347,chr16,ZNF747,chr16:30530367-30535347,4980
107774704,107776644,chr12,ASCL4,chr12:107774704-107776644,1940
125186386,125662377,chr12,TMEM132B,chr12:125186386-125662377,475991
22007638,22087534,chr16,MOSMO,chr16:22007638-22087534,79896
22092538,22156964,chr16,VWA3A,chr16:22092538-22156964,64426
9234774,9271337,chr1,H6PD,chr1:9234774-9271337,36563
53452102,53481162,chr12,PCBP2,chr12:53452102-53481162,29060
74862497,74873031,chr17,FDXR,chr17:74862497-74873031,10534
47438044,47440691,chr1,FOXD2,chr1:47438044-47440691,2647
20651767,20661544,chr1,DDOST,chr1:20651767-20661544,9777
15254184,15264515,chr3,SH3BP5-AS1,chr3:15254184-15264515,10331
19596979,19658456,chr1,NBL1,chr1:19596979-19658456,61477
15254353,15341368,chr3,SH3BP5,chr3:15254353-15341368,87015
65148738,65481920,chr5,ADAMTS6,chr5:65148738-65481920,333182
22162492,22192208,chr16,SDR42E2,chr16:22162492-22192208,29716
22206278,22288738,chr16,EEF2K,chr16:22206278-22288738,82460
186296279,186314567,chr1,PRG4,chr1:186296279-186314567,18288
31680847,31682101,chr16,RBM22P12,chr16:31680847-31682101,1254
31713229,31794869,chr16,ZNF720,chr16:31713229-31794869,81640
139396563,139404089,chr5,SPATA24,chr5:139396563-139404089,7526
15339749,15339855,chr3,RNU6-454P,chr3:15339749-15339855,106
15375373,15375645,chr3,HMGN2P7,chr3:15375373-15375645,272
15381275,15440566,chr3,METTL6,chr3:15381275-15440566,59291
15427598,15450635,chr3,EAF1,chr3:15427598-15450635,23037
58491435,58497090,chr5,GAPT,chr5:58491435-58497090,5655
15433110,15433216,chr3,RNU6-1024P,chr3:15433110-15433216,106
31801585,31802497,chr16,VN1R67P,chr16:31801585-31802497,912
15436171,15455940,chr3,EAF1-AS1,chr3:15436171-15455940,19769
31807926,31808844,chr16,VN1R3,chr16:31807926-31808844,918
46407,53608,chr16,POLR3K,chr16:46407-53608,7201
138032774,138037266,chr5,FAM13B-AS1,chr5:138032774-138037266,4492
138069355,138069458,chr5,RNU6-1148P,chr5:138069355-138069458,103
138083990,138092365,chr5,WNT8A,chr5:138083990-138092365,8375
15450133,15521751,chr3,COLQ,chr3:15450133-15521751,71618
53828,57669,chr16,SNRNP25,chr16:53828-57669,3841
219372043,219400022,chr2,DNPEP,chr2:219372043-219400022,27979
138115175,138139443,chr5,NME5,chr5:138115175-138139443,24268
77007,85851,chr16,MPG,chr16:77007-85851,8844
43705824,43931165,chr1,ST3GAL3,chr1:43705824-43931165,225341
138116573,138116680,chr5,RNU6-460P,chr5:138116573-138116680,107
138123011,138123111,chr5,RNU6-888P,chr5:138123011-138123111,100
137937960,138051961,chr5,FAM13B,chr5:137937960-138051961,114001
29940885,29973050,chr16,TMEM219,chr16:29940885-29973050,32165
74877302,74893781,chr17,FADS6,chr17:74877302-74893781,16479
74916083,74923256,chr17,USH1G,chr17:74916083-74923256,7173
89613308,89638456,chr16,DPEP1,chr16:89613308-89638456,25148
74922950,74933912,chr17,OTOP2,chr17:74922950-74933912,10962
74935898,74949992,chr17,OTOP3,chr17:74935898-74949992,14094
15496239,15496308,chr3,MIR4270,chr3:15496239-15496308,69
15506623,15506905,chr3,RN7SL110P,chr3:15506623-15506905,282
15560699,15601852,chr3,HACL1,chr3:15560699-15601852,41153
74950742,74973166,chr17,HID1,chr17:74950742-74973166,22424
53464468,53465057,chr12,PCBP2-OT1,chr12:53464468-53465057,589
53479669,53500063,chr12,MAP3K12,chr12:53479669-53500063,20394
10326434,10483638,chr16,ATF7IP2,chr16:10326434-10483638,157204
74970704,74975728,chr17,HID1-AS1,chr17:74970704-74975728,5024
74987632,75005800,chr17,CDR2L,chr17:74987632-75005800,18168
74721206,74767147,chr5,GFM2,chr5:74721206-74767147,45941
75012670,75021261,chr17,MRPL58,chr17:75012670-75021261,8591
53500921,53506431,chr12,TARBP2,chr12:53500921-53506431,5510
75031097,75031186,chr17,RNU6-362P,chr17:75031097-75031186,89
75038863,75046985,chr17,ATP5PD,chr17:75038863-75046985,8122
75041740,75042015,chr17,RN7SL573P,chr17:75041740-75042015,275
3088484,3104422,chr17,OR1D2,chr17:3088484-3104422,15938
224765090,225042468,chr2,DOCK10,chr2:224765090-225042468,277378
61590421,61591219,chr17,NACA2,chr17:61590421-61591219,798
61865367,61928016,chr17,INTS2,chr17:61865367-61928016,62649
56989485,57083531,chr16,NLRC5,chr16:56989485-57083531,94046
74725099,74725204,chr5,RNU6-658P,chr5:74725099-74725204,105
74766991,74780113,chr5,NSA2,chr5:74766991-74780113,13122
130314993,130403657,chr11,ZBTB44-DT,chr11:130314993-130403657,88664
45771416,45773295,chr11,LINC02716,chr11:45771416-45773295,1879
74779309,74779413,chr5,RNU6-1330P,chr5:74779309-74779413,104
1983237,1989964,chr11,MRPL23-AS1,chr11:1983237-1989964,6727
124759129,124766119,chr11,ESAM-AS1,chr11:124759129-124766119,6990
74777574,74866966,chr5,FAM169A,chr5:74777574-74866966,89392
75803431,75815406,chr11,UVRAG-DT,chr11:75803431-75815406,11975
58476138,58476950,chr17,SETP3,chr17:58476138-58476950,812
58519837,58557799,chr17,SEPTIN4-AS1,chr17:58519837-58557799,37962
64889560,64893455,chr11,MIR194-2HG,chr11:64889560-64893455,3895
53506691,53625979,chr12,ATF7-NPFF,chr12:53506691-53625979,119288
58489529,58517905,chr17,MTMR4,chr17:58489529-58517905,28376
15601341,15722311,chr3,BTD,chr3:15601341-15722311,120970
53507856,53626410,chr12,ATF7,chr12:53507856-53626410,118554
134032216,134067936,chr11,LINC02731,chr11:134032216-134067936,35720
20248691,20352234,chr2,PUM2,chr2:20248691-20352234,103543
115753889,115760646,chr11,LINC00900,chr11:115753889-115760646,6757
116032324,116060118,chr5,ARL14EPL,chr5:116032324-116060118,27794
150401637,150412969,chr5,CD74,chr5:150401637-150412969,11332
127649082,127658630,chr5,CTXN3,chr5:127649082-127658630,9548
15697298,15697371,chr3,MIR3134,chr3:15697298-15697371,73
15738515,15738809,chr3,RN7SL4P,chr3:15738515-15738809,294
61679139,61863559,chr17,BRIP1,chr17:61679139-61863559,184420
40759389,40798374,chr5,PRKAA1,chr5:40759389-40798374,38985
50267558,50277546,chr3,SEMA3B,chr3:50267558-50277546,9988
53632726,53677408,chr12,ATP5MC2,chr12:53632726-53677408,44682
3609901,3637672,chr11,TRPC2,chr11:3609901-3637672,27771
3380918,3408981,chr11,TSSC2,chr11:3380918-3408981,28063
85800703,85836409,chr12,RASSF9,chr12:85800703-85836409,35706
85874295,85882992,chr12,NTS,chr12:85874295-85882992,8697
81412804,81751797,chr5,SSBP2,chr5:81412804-81751797,338993
85955666,86838904,chr12,MGAT4C,chr12:85955666-86838904,883238
46256270,46274547,chr11,LINC02489,chr11:46256270-46274547,18277
230327184,230403732,chr2,SP140L,chr2:230327184-230403732,76548
32399558,32646050,chr12,FGD4,chr12:32399558-32646050,246492
50273236,50273297,chr3,MIR6872,chr3:50273236-50273297,61
50279087,50288114,chr3,LSMEM2,chr3:50279087-50288114,9027
17013998,17053024,chr11,OR7E14P,chr11:17013998-17053024,39026
50292831,50299405,chr3,HYAL3,chr3:50292831-50299405,6574
50258255,50298499,chr11,SEPTIN7P11,chr11:50258255-50298499,40244
1826941,1840207,chr16,FAHD1,chr16:1826941-1840207,13266
3291017,3298360,chr17,OR3A1,chr17:3291017-3298360,7343
3309986,3311446,chr17,OR3A4P,chr17:3309986-3311446,1460
3377527,3377602,chr17,OR1AC1P,chr17:3377527-3377602,75
50065967,50107272,chr16,HEATR3,chr16:50065967-50107272,41305
3385930,3386874,chr17,OR1R1P,chr17:3385930-3386874,944
3397104,3398410,chr17,OR1E1,chr17:3397104-3398410,1306
3411370,3424070,chr17,OR3A3,chr17:3411370-3424070,12700
3432870,3433841,chr17,OR1E2,chr17:3432870-3433841,971
67612651,67616257,chr11,DOC2GP,chr11:67612651-67616257,3606
50296402,50299416,chr3,NAA80,chr3:50296402-50299416,3014
3440019,3513852,chr17,SPATA22,chr17:3440019-3513852,73833
99141707,99151669,chr2,C2orf15,chr2:99141707-99151669,9962
192093122,192093436,chr3,RN7SKP222,chr3:192093122-192093436,314
64245942,64248218,chr11,PPP1R14B-AS1,chr11:64245942-64248218,2276
192238037,192283097,chr3,FGF12-AS1,chr3:192238037-192283097,45060
174431571,174487094,chr2,GPR155,chr2:174431571-174487094,55523
192515022,192516573,chr3,FGF12-AS2,chr3:192515022-192516573,1551
28603944,28623625,chr16,SULT1A1,chr16:28603944-28623625,19681
192516831,192521398,chr3,FGF12-AS3,chr3:192516831-192521398,4567
192729555,192729716,chr3,RNU1-20P,chr3:192729555-192729716,161
4393775,4520905,chr11,OR52K3P,chr11:4393775-4520905,127130
186567403,186585800,chr3,DNAJB11,chr3:186567403-186585800,18397
43120762,43269396,chr11,HNRNPKP3,chr11:43120762-43269396,148634
8537605,8590511,chr16,TMEM114,chr16:8537605-8590511,52906
1995171,2001470,chr11,H19,chr11:1995171-2001470,6299
12484421,12541549,chr3,TSEN2,chr3:12484421-12541549,57128
58462846,58513628,chr16,NDRG4,chr16:58462846-58513628,50782
565657,568457,chr11,MIR210HG,chr11:565657-568457,2800
71787480,71804995,chr11,FAM86C1P,chr11:71787480-71804995,17515
3472374,3503405,chr17,ASPA,chr17:3472374-3503405,31031
48403854,48430086,chr3,PLXNB1,chr3:48403854-48430086,26232
32435518,32500632,chr11,WT1-AS,chr11:32435518-32500632,65114
7884796,7912760,chr17,CHD3,chr17:7884796-7912760,27964
113067970,113075843,chr2,IL1F10,chr2:113067970-113075843,7873
86955616,87021909,chr11,FZD4-DT,chr11:86955616-87021909,66293
65497688,65506516,chr11,MALAT1,chr11:65497688-65506516,8828
68041130,68110948,chr2,C1D,chr2:68041130-68110948,69818
128691672,128696023,chr11,SENCR,chr11:128691672-128696023,4351
10541258,10599939,chr11,IRAG1-AS1,chr11:10541258-10599939,58681
24967127,24967504,chr12,BRI3P2,chr12:24967127-24967504,377
104901549,104919073,chr11,CASP4LP,chr11:104901549-104919073,17524
25004342,25108335,chr12,IRAG2,chr12:25004342-25108335,103993
28956611,29052230,chr2,TOGARAM2,chr2:28956611-29052230,95619
70372246,70398488,chr11,CTTN-DT,chr11:70372246-70398488,26242
65663001,65671718,chr11,RELA-DT,chr11:65663001-65671718,8717
20043767,20049458,chr11,NAV2-AS2,chr11:20043767-20049458,5691
6713536,6746494,chr11,GVINP1,chr11:6713536-6746494,32958
215360440,215436073,chr2,FN1,chr2:215360440-215436073,75633
104445868,104609498,chr11,LINC02552,chr11:104445868-104609498,163630
59560234,59566283,chr11,LINC02739,chr11:59560234-59566283,6049
66473490,66480269,chr11,DPP3-DT,chr11:66473490-66480269,6779
45355371,45367577,chr11,LINC02696,chr11:45355371-45367577,12206
113278250,113314482,chr11,TTC12-DT,chr11:113278250-113314482,36232
126340882,126355587,chr11,GSEC,chr11:126340882-126355587,14705
8964502,8977527,chr11,TMEM9B-AS1,chr11:8964502-8977527,13025
177301461,177312757,chr5,MXD3,chr5:177301461-177312757,11296
46846410,46874421,chr11,LRP4-AS1,chr11:46846410-46874421,28011
76435559,76444690,chr11,EMSY-DT,chr11:76435559-76444690,9131
10858179,10908972,chr11,ZBED5-AS1,chr11:10858179-10908972,50793
34590644,34677159,chr19,SCGB2B2,chr19:34590644-34677159,86515
30584118,30632583,chr11,MPPED2-AS1,chr11:30584118-30632583,48465
48432164,48440456,chr3,CCDC51,chr3:48432164-48440456,8292
83072052,83107789,chr11,RAB30-DT,chr11:83072052-83107789,35737
21358930,21388582,chr19,ZNF738,chr19:21358930-21388582,29652
154682986,154817605,chr5,LARP1,chr5:154682986-154817605,134619
49054274,49058860,chr19,CGB7,chr19:49054274-49058860,4586
48440257,48444208,chr3,TMA7,chr3:48440257-48444208,3951
14950033,15022990,chr19,SLC1A6,chr19:14950033-15022990,72957
48465811,48467645,chr3,TREX1,chr3:48465811-48467645,1834
62851978,62855953,chr11,SNHG1,chr11:62851978-62855953,3975
6996049,7010754,chr17,ALOX12,chr17:6996049-7010754,14705
48517684,48562015,chr3,PFKFB4,chr3:48517684-48562015,44331
53506688,53507484,chr12,NPFF,chr12:53506688-53507484,796
113054062,113054435,chr12,RPS15AP32,chr12:113054062-113054435,373
113149724,113159276,chr12,CFAP73,chr12:113149724-113159276,9552
7012417,7014532,chr17,RNASEK,chr17:7012417-7014532,2115
113157173,113185479,chr12,DDX54,chr12:113157173-113185479,28306
17075777,17214537,chr19,MYO9B,chr19:17075777-17214537,138760
7012635,7017520,chr17,RNASEK-C17orf49,chr17:7012635-7017520,4885
7014495,7017525,chr17,C17orf49,chr17:7014495-7017525,3030
7015818,7019659,chr17,MIR497HG,chr17:7015818-7019659,3841
7017615,7017701,chr17,MIR195,chr17:7017615-7017701,86
7017911,7018022,chr17,MIR497,chr17:7017911-7018022,111
7023050,7030290,chr17,BCL6B,chr17:7023050-7030290,7240
113159113,113159177,chr12,MIR7106,chr12:113159113-113159177,64
113185526,113192368,chr12,RITA1,chr12:113185526-113192368,6842
170307722,170335508,chr5,LINC01366,chr5:170307722-170335508,27786
113195441,113221094,chr12,IQCD,chr12:113195441-113221094,25653
7036015,7040117,chr17,SLC16A13,chr17:7036015-7040117,4102
113056730,113098028,chr12,DTX1,chr12:113056730-113098028,41298
88676033,88779088,chr5,MEF2C-AS2,chr5:88676033-88779088,103055
7074537,7080307,chr17,CLEC10A,chr17:7074537-7080307,5770
78342338,78360507,chr5,SCAMP1-AS1,chr5:78342338-78360507,18169
51093656,51173135,chr12,TFCP2,chr12:51093656-51173135,79479
149063254,149129578,chr5,SH3TC2-DT,chr5:149063254-149129578,66324
3177835,3181489,chr5,LINC01377,chr5:3177835-3181489,3654
118000253,118562199,chr5,LINC02208,chr5:118000253-118562199,561946
7140930,7141592,chr17,RPL7AP64,chr17:7140930-7141592,662
7173431,7179564,chr17,ASGR1,chr17:7173431-7179564,6133
56219670,56368383,chr19,ZSCAN5A,chr19:56219670-56368383,148713
48549961,48550021,chr3,MIR6823,chr3:48549961-48550021,60
48561718,48563781,chr3,UCN2,chr3:48561718-48563781,2063
48578902,48578977,chr3,MIR711,chr3:48578902-48578977,75
51124099,51125385,chr12,PHBP19,chr12:51124099-51125385,1286
48599002,48610976,chr3,UQCRC1,chr3:48599002-48610976,11974
177438503,177447982,chr5,PRR7-AS1,chr5:177438503-177447982,9479
28319335,28319463,chr12,RNU4-54P,chr12:28319335-28319463,128
28505394,28505528,chr12,RNA5SP355,chr12:28505394-28505528,134
28133249,28581511,chr12,CCDC91,chr12:28133249-28581511,448262
33795933,33815763,chr19,KCTD15,chr19:33795933-33815763,19830
87662040,87705337,chr5,LINC02488,chr5:87662040-87705337,43297
7187187,7219841,chr17,DLG4,chr17:7187187-7219841,32654
112628436,112682077,chr5,LINC02200,chr5:112628436-112682077,53641
48620759,48621769,chr3,TMEM89,chr3:48620759-48621769,1010
174336295,174532457,chr5,LINC01411,chr5:174336295-174532457,196162
48625723,48635493,chr3,SLC26A6,chr3:48625723-48635493,9770
159100483,159117478,chr5,LINC02202,chr5:159100483-159117478,16995
140370891,140401460,chr5,ANKHD1-DT,chr5:140370891-140401460,30569
69187147,69309052,chr16,SNTB2,chr16:69187147-69309052,121905
11848726,11883750,chr19,ZNF439,chr19:11848726-11883750,35024
55330043,55332687,chr12,OR6C3,chr12:55330043-55332687,2644
91054834,91314547,chr5,LUCAT1,chr5:91054834-91314547,259713
54617158,54638022,chr19,LILRB1,chr19:54617158-54638022,20864
52789685,52796117,chr12,KRT3,chr12:52789685-52796117,6432
28950807,28967092,chr16,NFATC2IP,chr16:28950807-28967092,16285
52806549,52814116,chr12,KRT4,chr12:52806549-52814116,7567
112270749,112362534,chr11,LINC02762,chr11:112270749-112362534,91785
117288453,117293578,chr11,BACE1-AS,chr11:117288453-117293578,5125
65422774,65445540,chr11,NEAT1,chr11:65422774-65445540,22766
52821408,52834311,chr12,KRT79,chr12:52821408-52834311,12903
66408516,66412135,chr16,LINC00920,chr16:66408516-66412135,3619
75499788,75517260,chr16,TMEM231P1,chr16:75499788-75517260,17472
86195954,86199937,chr16,LINC01082,chr16:86195954-86199937,3983
52837804,52849092,chr12,KRT78,chr12:52837804-52849092,11288
122028325,122556721,chr11,MIR100HG,chr11:122028325-122556721,528396
72236281,72665014,chr16,LINC01572,chr16:72236281-72665014,428733
52885429,52886385,chr12,RPL7P41,chr12:52885429-52886385,956
52948871,52952906,chr12,KRT18,chr12:52948871-52952906,4035
37613749,37692337,chr19,ZFP30,chr19:37613749-37692337,78588
38682581,38845829,chr5,OSMR-DT,chr5:38682581-38845829,163248
86565145,86567845,chr16,FOXC2-AS1,chr16:86565145-86567845,2700
14001198,14016056,chr16,LINC02185,chr16:14001198-14016056,14858
30267553,30335381,chr16,SMG1P5,chr16:30267553-30335381,67828
142325293,142672001,chr5,SPRY4-AS1,chr5:142325293-142672001,346708
52897187,52949954,chr12,KRT8,chr12:52897187-52949954,52767
9324174,9382617,chr19,ZNF559-ZNF177,chr19:9324174-9382617,58443
2660348,2682390,chr16,ERVK13-1,chr16:2660348-2682390,22042
55995167,56003649,chr5,FLJ31104,chr5:55995167-56003649,8482
149406689,149432835,chr5,CARMN,chr5:149406689-149432835,26146
85855101,85920021,chr11,CCDC83,chr11:85855101-85920021,64920
18571162,18598328,chr16,ABCC6P1,chr16:18571162-18598328,27166
48633636,48633698,chr3,MIR6824,chr3:48633636-48633698,62
48636463,48662886,chr3,CELSR3,chr3:48636463-48662886,26423
50727417,50742815,chr16,CYLD-AS1,chr16:50727417-50742815,15398
85694224,85811159,chr11,SYTL2,chr11:85694224-85811159,116935
40319536,40348527,chr19,C19orf47,chr19:40319536-40348527,28991
90102261,90178344,chr16,FAM157C,chr16:90102261-90178344,76083
82807475,82860008,chr5,LINC01338,chr5:82807475-82860008,52533
22437008,22492220,chr16,SMG1P1,chr16:22437008-22492220,55212
55244609,55256625,chr12,OR6C74,chr12:55244609-55256625,12016
33229257,33284642,chr5,LINC02160,chr5:33229257-33284642,55385
52064465,52095765,chr19,ZNF841,chr19:52064465-52095765,31300
21797389,21942543,chr12,ABCC9,chr12:21797389-21942543,145154
48644194,48644280,chr3,MIR4793,chr3:48644194-48644280,86
48673844,48686364,chr3,NCKIPSD,chr3:48673844-48686364,12520
52429148,52452315,chr19,ZNF534,chr19:52429148-52452315,23167
17684584,17955857,chr5,LINC02223,chr5:17684584-17955857,271273
79715220,79770651,chr16,MAFTRR,chr16:79715220-79770651,55431
12699201,12724011,chr19,TNPO2,chr19:12699201-12724011,24810
6765891,6833120,chr5,LINC02236,chr5:6765891-6833120,67229
9546170,9550725,chr5,SNHG18,chr5:9546170-9550725,4555
89972581,90002161,chr16,AFG3L1P,chr16:89972581-90002161,29580
48663776,48669174,chr3,LINC02585,chr3:48663776-48669174,5398
48688003,48740353,chr3,IP6K2,chr3:48688003-48740353,52350
150930456,150946598,chr5,ZNF300P1,chr5:150930456-150946598,16142
1567495,1594651,chr5,SDHAP3,chr5:1567495-1594651,27156
85935276,85936223,chr16,LINC02132,chr16:85935276-85936223,947
61610424,61793401,chr5,C5orf64,chr5:61610424-61793401,182977
30354665,30357116,chr16,CD2BP2-DT,chr16:30354665-30357116,2451
1064087,1078731,chr16,SSTR5-AS1,chr16:1064087-1078731,14644
48564073,48595329,chr3,COL7A1,chr3:48564073-48595329,31256
4243943,4253847,chr16,LINC01569,chr16:4243943-4253847,9904
5132084,5140153,chr5,ADAMTS16-DT,chr5:5132084-5140153,8069
84382424,84490765,chr5,EDIL3-DT,chr5:84382424-84490765,108341
31700558,31711986,chr16,CLUHP3,chr16:31700558-31711986,11428
33424025,33440645,chr5,TARS1-DT,chr5:33424025-33440645,16620
98726457,99984936,chr12,ANKS1B,chr12:98726457-99984936,1258479
117415509,117546298,chr5,LINC00992,chr5:117415509-117546298,130789
14661808,14664604,chr5,OTULIN-DT,chr5:14661808-14664604,2796
91380349,91612566,chr5,ARRDC3-AS1,chr5:91380349-91612566,232217
1353896,1380107,chr5,LINC01511,chr5:1353896-1380107,26211
148088125,148383907,chr5,FBXO38-DT,chr5:148088125-148383907,295782
21796106,21820441,chr16,RRN3P1,chr16:21796106-21820441,24335
181246493,181272167,chr5,CTC-338M12.4,chr5:181246493-181272167,25674
88883328,89466398,chr5,MEF2C-AS1,chr5:88883328-89466398,583070
19385826,19508932,chr19,GATAD2A,chr19:19385826-19508932,123106
54845189,54929189,chr16,CRNDE,chr16:54845189-54929189,84000
53431984,53461862,chr19,ZNF761,chr19:53431984-53461862,29878
37217926,37248740,chr19,ZNF383,chr19:37217926-37248740,30814
1883315,1884758,chr5,IRX4-AS1,chr5:1883315-1884758,1443
147559994,147694827,chr5,JAKMIP2-AS1,chr5:147559994-147694827,134833
50840017,50901063,chr16,LINC02128,chr16:50840017-50901063,61046
127939152,128083172,chr5,LINC01184,chr5:127939152-128083172,144020
57681969,57717301,chr19,ZNF551,chr19:57681969-57717301,35332
57696275,57709204,chr19,ZNF154,chr19:57696275-57709204,12929
57719751,57727624,chr19,ZNF671,chr19:57719751-57727624,7873
1964899,1965509,chr16,SNHG9,chr16:1964899-1965509,610
57746815,57758148,chr19,ZNF776,chr19:57746815-57758148,11333
30875222,30895220,chr16,MIR762HG,chr16:30875222-30895220,19998
30096430,30104116,chr16,YPEL3-DT,chr16:30096430-30104116,7686
2839568,2842744,chr16,PRSS30P,chr16:2839568-2842744,3176
12557057,12586208,chr3,MKRN2,chr3:12557057-12586208,29151
40069152,40090943,chr19,ZNF780A,chr19:40069152-40090943,21791
181261169,181272307,chr5,TRIM52-AS1,chr5:181261169-181272307,11138
67001383,67004080,chr5,MAST4-AS1,chr5:67001383-67004080,2697
98929171,98995013,chr5,CHD1-DT,chr5:98929171-98995013,65842
137801193,137810755,chr5,NPY6R,chr5:137801193-137810755,9562
178960121,179072215,chr3,ZMAT3,chr3:178960121-179072215,112094
61162070,61232040,chr5,SMIM15-AS1,chr5:61162070-61232040,69970
69726768,69742563,chr16,NQO1-DT,chr16:69726768-69742563,15795
88507546,88691057,chr5,LINC00461,chr5:88507546-88691057,183511
3100696,3143734,chr16,ZNF213-AS1,chr16:3100696-3143734,43038
7217125,7225266,chr17,ACADVL,chr17:7217125-7225266,8141
179148114,179240093,chr3,PIK3CA,chr3:179148114-179240093,91979
52928475,52962823,chr19,ZNF816-ZNF321P,chr19:52928475-52962823,34348
52927135,52942601,chr19,ZNF321P,chr19:52927135-52942601,15466
52949379,52962911,chr19,ZNF816,chr19:52949379-52962911,13532
56643610,56644942,chr16,MT1DP,chr16:56643610-56644942,1332
28878957,28879938,chr16,ATP2A1-AS1,chr16:28878957-28879938,981
67481314,67505977,chr16,ATP6V0D1-DT,chr16:67481314-67505977,24663
53124072,53159075,chr19,ZNF347,chr19:53124072-53159075,35003
2154792,2155405,chr16,SNHG19,chr16:2154792-2155405,613
53159213,53193386,chr19,ZNF665,chr19:53159213-53193386,34173
56617428,56618830,chr16,MT1L,chr16:56617428-56618830,1402
53223973,53224879,chr19,NDUFV2P1,chr19:53223973-53224879,906
87317491,87318043,chr16,C16orf95-DT,chr16:87317491-87318043,552
53235381,53254898,chr19,ZNF677,chr19:53235381-53254898,19517
67207139,67227048,chr16,LRRC29,chr16:67207139-67227048,19909
27217714,27496994,chr5,PURPL,chr5:27217714-27496994,279280
53258292,53261837,chr19,VN1R2,chr19:53258292-53261837,3545
53266676,53267723,chr19,VN1R4,chr19:53266676-53267723,1047
9792495,9807101,chr3,ARPC4,chr3:9792495-9807101,14606
53281559,53284944,chr19,FAM90A27P,chr19:53281559-53284944,3385
53289601,53291426,chr19,BIRC8,chr19:53289601-53291426,1825
3037400,3059370,chr16,MMP25-AS1,chr16:3037400-3059370,21970
53066606,53103434,chr19,ZNF160,chr19:53066606-53103434,36828
47849309,47887130,chr16,LINC02192,chr16:47849309-47887130,37821
88663298,88687282,chr16,SNAI3-AS1,chr16:88663298-88687282,23984
112160526,112164818,chr5,EPB41L4A-AS1,chr5:112160526-112164818,4292
180826871,180831618,chr5,HEIH,chr5:180826871-180831618,4747
196639775,196736007,chr3,PIGX,chr3:196639775-196736007,96232
56202273,56209200,chr19,ZSCAN5C,chr19:56202273-56209200,6927
17403889,17443619,chr5,LINC02217,chr5:17403889-17443619,39730
56375846,56393538,chr19,ZNF582,chr19:56375846-56393538,17692
100009052,100009838,chr12,RPS4XP1,chr12:100009052-100009838,786
25085168,25111555,chr16,LCMT1-AS1,chr16:25085168-25111555,26387
81201341,81301565,chr5,CKMT2-AS1,chr5:81201341-81301565,100224
109900264,109983841,chr12,TCHP,chr12:109900264-109983841,83577
44051367,44067999,chr19,ZNF223,chr19:44051367-44067999,16632
82626965,83800640,chr16,CDH13,chr16:82626965-83800640,1173675
39096599,39107863,chr3,GORASP1,chr3:39096599-39107863,11264
44072159,44089613,chr19,ZNF284,chr19:44072159-44089613,17454
44085213,44085303,chr19,RNU6-902P,chr19:44085213-44085303,90
44094361,44109886,chr19,ZNF224,chr19:44094361-44109886,15525
7223297,7223379,chr17,MIR324,chr17:7223297-7223379,82
7225342,7234517,chr17,DVL2,chr17:7225342-7234517,9175
44112181,44134822,chr19,ZNF225,chr19:44112181-44134822,22641
109999186,110039763,chr12,ANKRD13A,chr12:109999186-110039763,40577
82688931,82689019,chr16,MIR8058,chr16:82688931-82689019,88
44141554,44160313,chr19,ZNF234,chr19:44141554-44160313,18759
16129126,16141737,chr5,MARCHF11-AS1,chr5:16129126-16141737,12611
82844455,82844757,chr16,RN7SL134P,chr16:82844455-82844757,302
269305,271516,chr5,PDCD6-DT,chr5:269305-271516,2211
83508346,83508408,chr16,MIR3182,chr16:83508346-83508408,62
21341833,21589372,chr5,GUSBP1,chr5:21341833-21589372,247539
83719311,83819737,chr16,HSBP1,chr16:83719311-83819737,100426
44165073,44178381,chr19,ZNF226,chr19:44165073-44178381,13308
126571779,126655124,chr3,TXNRD3,chr3:126571779-126655124,83345
110124335,110218793,chr12,IFT81,chr12:110124335-110218793,94458
88268868,88439337,chr5,TMEM161B-DT,chr5:88268868-88439337,170469
7235029,7239722,chr17,PHF23,chr17:7235029-7239722,4693
87792706,87993839,chr3,HTR1F,chr3:87792706-87993839,201133
51968510,51983409,chr3,ABHD14B,chr3:51968510-51983409,14899
31657912,32077580,chr3,OSBPL10,chr3:31657912-32077580,419668
7240008,7242449,chr17,GABARAP,chr17:7240008-7242449,2441
44207547,44237268,chr19,ZNF227,chr19:44207547-44237268,29721
7243591,7252491,chr17,CTDNEP1,chr17:7243591-7252491,8900
8839699,8898052,chr5,LINC02199,chr5:8839699-8898052,58353
148202794,148215137,chr5,SPINK6,chr5:148202794-148215137,12343
52221080,52225645,chr3,TLR9,chr3:52221080-52225645,4565
44259880,44275317,chr19,ZNF233,chr19:44259880-44275317,15437
52694486,52706032,chr3,GLT8D1,chr3:52694486-52706032,11546
91327045,91368607,chr12,LINC02823,chr12:91327045-91368607,41562
148221360,148221642,chr5,HMGN1P16,chr5:148221360-148221642,282
148221650,148243580,chr5,MARCOL,chr5:148221650-148243580,21930
148268180,148286255,chr5,SPINK13,chr5:148268180-148286255,18075
51002508,51009634,chr19,KLK9,chr19:51002508-51009634,7126
91876924,91880659,chr12,LINC02404,chr12:91876924-91880659,3735
148168546,148175619,chr5,SPINK14,chr5:148168546-148175619,7073
110948029,110950780,chr5,BCLAF1P1,chr5:110948029-110950780,2751
51012739,51020175,chr19,KLK10,chr19:51012739-51020175,7436
14612632,14696599,chr12,GUCY2C,chr12:14612632-14696599,83967
111070062,111078026,chr5,TSLP,chr5:111070062-111078026,7964
53087179,53142638,chr1,SLC1A7,chr1:53087179-53142638,55459
111092321,111130502,chr5,WDR36,chr5:111092321-111130502,38181
51022216,51028039,chr19,KLK11,chr19:51022216-51028039,5823
7259903,7263983,chr17,CLDN7,chr17:7259903-7263983,4080
14774405,14778002,chr12,H2AJ,chr12:14774405-14778002,3597
14784582,14803486,chr12,WBP11,chr12:14784582-14803486,18904
111192226,111193042,chr5,RPS3AP21,chr5:111192226-111193042,816
186789880,186807058,chr3,RFC4,chr3:186789880-186807058,17178
7281718,7288257,chr17,SLC2A4,chr17:7281718-7288257,6539
14803666,14906586,chr12,C12orf60,chr12:14803666-14906586,102920
14804650,14814182,chr12,SMCO3,chr12:14804650-14814182,9532
51029092,51035230,chr19,KLK12,chr19:51029092-51035230,6138
14825569,14843526,chr12,ART4,chr12:14825569-14843526,17957
160225422,160228213,chr3,C3orf80,chr3:160225422-160228213,2791
98463201,98472924,chr3,OR5K1,chr3:98463201-98472924,9723
14880864,14885857,chr12,MGP,chr12:14880864-14885857,4993
9749944,9788219,chr3,OGG1,chr3:9749944-9788219,38275
248850006,248859144,chr1,ZNF692,chr1:248850006-248859144,9138
14914039,14938537,chr12,ERP27,chr12:14914039-14938537,24498
14942031,14961728,chr12,ARHGDIB,chr12:14942031-14961728,19697
51055626,51065114,chr19,KLK13,chr19:51055626-51065114,9488
7288263,7294639,chr17,YBX2,chr17:7288263-7294639,6376
3276942,3386317,chr17,OR3A2,chr17:3276942-3386317,109375
76274049,76308276,chr17,QRICH2,chr17:76274049-76308276,34227
14973042,14981865,chr12,PDE6H,chr12:14973042-14981865,8823
15001787,15006999,chr12,LINC01489,chr12:15001787-15006999,5212
55636892,55637833,chr12,OR10P1,chr12:55636892-55637833,941
55684568,55716404,chr12,ITGA7,chr12:55684568-55716404,31836
51077495,51084245,chr19,KLK14,chr19:51077495-51084245,6750
35731639,35743521,chr17,RASL10B,chr17:35731639-35743521,11882
59296638,59810647,chr1,FGGY,chr1:59296638-59810647,514009
51097606,51108409,chr19,CTU1,chr19:51097606-51108409,10803
35744511,35753239,chr17,GAS2L2,chr17:35744511-35753239,8728
51119987,51122965,chr19,SIGLEC18P,chr19:51119987-51122965,2978
51124906,51136651,chr19,SIGLEC9,chr19:51124906-51136651,11745
35756249,35795707,chr17,MMP28,chr17:35756249-35795707,39458
36380503,36548007,chr3,STAC,chr3:36380503-36548007,167504
51142299,51153526,chr19,SIGLEC7,chr19:51142299-51153526,11227
35760887,35765079,chr17,C17orf50,chr17:35760887-35765079,4192
35854946,35868891,chr17,HEATR9,chr17:35854946-35868891,13945
51184905,51190809,chr19,SIGLEC20P,chr19:51184905-51190809,5904
51198855,51201449,chr19,SIGLEC21P,chr19:51198855-51201449,2594
51206929,51207009,chr19,MIR8074,chr19:51206929-51207009,80
190428655,190449901,chr3,TMEM207,chr3:190428655-190449901,21246
51211080,51212088,chr19,SIGLEC22P,chr19:51211080-51212088,1008
146576555,146605346,chr3,PLSCR5,chr3:146576555-146605346,28791
51225064,51243860,chr19,CD33,chr19:51225064-51243860,18796
8750381,8769628,chr3,OXTR,chr3:8750381-8769628,19247
119780484,119818487,chr3,NR1I2,chr3:119780484-119818487,38003
51271266,51281234,chr19,LINC01872,chr19:51271266-51281234,9968
51280862,51283022,chr19,SIGLEC24P,chr19:51280862-51283022,2160
51311644,51330891,chr19,IGLON5,chr19:51311644-51330891,19247
51331536,51342139,chr19,VSIG10L,chr19:51331536-51342139,10603
51340695,51344117,chr19,VSIG10L-AS1,chr19:51340695-51344117,3422
231626790,232041272,chr1,DISC1,chr1:231626790-232041272,414482
51345169,51366388,chr19,ETFB,chr19:51345169-51366388,21219
35871491,35880793,chr17,CCL5,chr17:35871491-35880793,9302
186717348,186744410,chr3,KNG1,chr3:186717348-186744410,27062
51367098,51369003,chr19,CLDND2,chr19:51367098-51369003,1905
35912635,35918010,chr17,LRRC37A9P,chr17:35912635-35918010,5375
44903159,44916937,chr17,GFAP,chr17:44903159-44916937,13778
51371606,51372701,chr19,NKG7,chr19:51371606-51372701,1095
4414580,4414960,chr3,MRPS10P2,chr3:4414580-4414960,380
4749192,4751590,chr3,EGOT,chr3:4749192-4751590,2398
4896809,4980414,chr3,BHLHE40-AS1,chr3:4896809-4980414,83605
51379909,51387974,chr19,LIM2,chr19:51379909-51387974,8065
52433035,52445103,chr3,SEMA3G,chr3:52433035-52445103,12068
51388289,51390591,chr19,C19orf84,chr19:51388289-51390591,2302
51396755,51403526,chr19,NIFKP6,chr19:51396755-51403526,6771
52451100,52454041,chr3,TNNC1,chr3:52451100-52454041,2941
51410020,51417803,chr19,SIGLEC10,chr19:51410020-51417803,7783
52455118,52493068,chr3,NISCH,chr3:52455118-52493068,37950
14356842,14365503,chr12,RPL30P11,chr12:14356842-14365503,8661
14365676,14502931,chr12,ATF7IP,chr12:14365676-14502931,137255
52316319,52400492,chr3,DNAH1,chr3:52316319-52400492,84173
29560547,29567037,chr17,ABHD15,chr17:29560547-29567037,6490
29560547,29707090,chr17,ABHD15-AS1,chr17:29560547-29707090,146543
29566052,29573157,chr17,TP53I13,chr17:29566052-29573157,7105
14503661,14567883,chr12,PLBD1,chr12:14503661-14567883,64222
47379089,47380999,chr3,PTPN23-DT,chr3:47379089-47380999,1910
47381011,47413435,chr3,PTPN23,chr3:47381011-47413435,32424
51415724,51417425,chr19,SIGLEC10-AS1,chr19:51415724-51417425,1701
14553702,14553970,chr12,RN7SKP134,chr12:14553702-14553970,268
120628830,120641591,chr12,CABP1-DT,chr12:120628830-120641591,12761
120687149,120701859,chr12,MLEC,chr12:120687149-120701859,14710
51246348,51269330,chr19,SIGLECL1,chr19:51246348-51269330,22982
29573475,29594054,chr17,GIT1,chr17:29573475-29594054,20579
120710458,120723640,chr12,UNC119B,chr12:120710458-120723640,13182
58216180,58216561,chr19,RPS15AP36,chr19:58216180-58216561,381
54069895,54081365,chr19,TARM1,chr19:54069895-54081365,11470
120723193,120723266,chr12,MIR4700,chr12:120723193-120723266,73
120725774,120740008,chr12,ACADS,chr12:120725774-120740008,14234
54216278,54223506,chr19,LILRB3,chr19:54216278-54223506,7228
47495640,47513712,chr3,ELP6,chr3:47495640-47513712,18072
120762510,120904358,chr12,SPPL3,chr12:120762510-120904358,141848
110633947,110634333,chr2,RPL22P12,chr2:110633947-110634333,386
120845110,120845647,chr12,ARF1P2,chr12:120845110-120845647,537
47499841,47500407,chr3,BOLA2P2,chr3:47499841-47500407,566
47560229,47560524,chr3,RN7SL870P,chr3:47560229-47560524,295
110637528,110678063,chr2,BUB1,chr2:110637528-110678063,40535
120640626,120667324,chr12,CABP1,chr12:120640626-120667324,26698
47562238,47580792,chr3,CSPG5,chr3:47562238-47580792,18554
47663626,47663934,chr3,HIGD2AP2,chr3:47663626-47663934,308
54307070,54313166,chr19,LILRA5,chr19:54307070-54313166,6096
158571163,158607252,chr3,MLF1,chr3:158571163-158607252,36089
49018975,49060794,chr12,KMT2D,chr12:49018975-49060794,41819
54320204,54321212,chr19,VN1R104P,chr19:54320204-54321212,1008
54333185,54339162,chr19,LILRA4,chr19:54333185-54339162,5977
29589769,29614761,chr17,ANKRD13B,chr17:29589769-29614761,24992
54351384,54370558,chr19,LAIR1,chr19:54351384-54370558,19174
29641611,29641702,chr17,RNU6-920P,chr17:29641611-29641702,91
29716279,29716685,chr17,RPL21P123,chr17:29716279-29716685,406
28755980,28855232,chr17,FAM222B,chr17:28755980-28855232,99252
28950513,29057216,chr17,PIPOX,chr17:28950513-29057216,106703
54415219,54436904,chr19,TTYH1,chr19:54415219-54436904,21685
158609610,158610857,chr3,MTAPP1,chr3:158609610-158610857,1247
158105855,158545730,chr3,RSRC1,chr3:158105855-158545730,439875
29073521,29078857,chr17,TIAF1,chr17:29073521-29078857,5336
110732539,111120610,chr2,ACOXL,chr2:110732539-111120610,388071
25205246,25250936,chr12,KRAS,chr12:25205246-25250936,45690
58520250,58544368,chr17,SEPTIN4,chr17:58520250-58544368,24118
112405189,112418838,chr12,RPL6,chr12:112405189-112418838,13649
110967834,110968719,chr2,RPL5P9,chr2:110967834-110968719,885
111098345,111116407,chr2,ACOXL-AS1,chr2:111098345-111116407,18062
54448887,54462016,chr19,LENG8,chr19:54448887-54462016,13129
111119378,111168445,chr2,BCL2L11,chr2:111119378-111168445,49067
132680609,132722432,chr3,NPHP3,chr3:132680609-132722432,41823
54461732,54463778,chr19,LENG9,chr19:54461732-54463778,2046
54465026,54473296,chr19,CDC42EP5,chr19:54465026-54473296,8270
47802909,47850195,chr3,DHX30,chr3:47802909-47850195,47286
58278955,58302791,chr19,ZNF8,chr19:58278955-58302791,23836
19910263,19990105,chr2,WDR35,chr2:19910263-19990105,79842
58228594,58277495,chr19,ZNF544,chr19:58228594-58277495,48901
112418351,112509918,chr12,PTPN11,chr12:112418351-112509918,91567
110027028,110073636,chr12,C12orf76,chr12:110027028-110073636,46608
75234740,75298508,chr12,CAPS2-AS1,chr12:75234740-75298508,63768
75257635,75258634,chr12,CCNG2P1,chr12:75257635-75258634,999
75275979,75390928,chr12,CAPS2,chr12:75275979-75390928,114949
219685427,219958647,chr1,SLC30A10,chr1:219685427-219958647,273220
47849555,47849629,chr3,MIR1226,chr3:47849555-47849629,74
47960327,47961081,chr3,VPS26BP1,chr3:47960327-47961081,754
48094801,48095105,chr3,RN7SL664P,chr3:48094801-48095105,304
31520155,31554803,chr19,LINC02841,chr19:31520155-31554803,34648
48157146,48188417,chr3,CDC25A,chr3:48157146-48188417,31271
20139323,20150381,chr1,PLA2G2F,chr1:20139323-20150381,11058
230165186,230225729,chr2,SP110,chr2:230165186-230225729,60543
39955112,39969968,chr1,MFSD2A,chr1:39955112-39969968,14856
50311937,50333515,chr19,KCNC3,chr19:50311937-50333515,21578
41377669,41382306,chr17,KRT34,chr17:41377669-41382306,4637
50329653,50383388,chr19,NR1H2,chr19:50329653-50383388,53735
76672551,76711004,chr17,MXRA7,chr17:76672551-76711004,38453
48161176,48161417,chr3,SNRPFP4,chr3:48161176-48161417,241
48180328,48180389,chr3,RNU7-128P,chr3:48180328-48180389,61
48181547,48181726,chr3,NDUFB1P1,chr3:48181547-48181726,179
48196564,48196616,chr3,MIR4443,chr3:48196564-48196616,52
48223347,48225491,chr3,CAMP,chr3:48223347-48225491,2144
48241100,48299253,chr3,ZNF589,chr3:48241100-48299253,58153
26457203,26558756,chr2,OTOF,chr2:26457203-26558756,101553
81035122,81117434,chr17,BAIAP2,chr17:81035122-81117434,82312
48256350,48256938,chr3,MRPS18AP1,chr3:48256350-48256938,588
48290722,48301685,chr3,NME6,chr3:48290722-48301685,10963
1253909,1273864,chr1,UBE2J2,chr1:1253909-1273864,19955
48978322,48982620,chr12,WNT1,chr12:48978322-48982620,4298
121804009,121832656,chr12,SETD1B,chr12:121804009-121832656,28647
123384132,123409353,chr12,KMT5A,chr12:123384132-123409353,25221
94306449,94459988,chr12,CEP83,chr12:94306449-94459988,153539
48290793,48291375,chr3,FCF1P2,chr3:48290793-48291375,582
48316360,48316459,chr3,MIR2115,chr3:48316360-48316459,99
48372219,48401259,chr3,FBXW12,chr3:48372219-48401259,29040
101802560,101996926,chr1,OLFM3,chr1:101802560-101996926,194366
50358477,50365830,chr19,NAPSA,chr19:50358477-50365830,7353
48379834,48380132,chr3,RN7SL321P,chr3:48379834-48380132,298
48446710,48467645,chr3,ATRIP,chr3:48446710-48467645,20935
2586491,2591469,chr1,PRXL2B,chr1:2586491-2591469,4978
55681736,55684611,chr12,METTL7B,chr12:55681736-55684611,2875
117141991,117190470,chr12,FBXO21,chr12:117141991-117190470,48479
50418938,50431314,chr19,SPIB,chr19:50418938-50431314,12376
50432892,50466321,chr19,MYBPC2,chr19:50432892-50466321,33429
155139891,155140595,chr1,DPM3,chr1:155139891-155140595,704
155941638,155943087,chr1,RXFP4,chr1:155941638-155943087,1449
89364059,89388160,chr1,GBP6,chr1:89364059-89388160,24101
11857464,11858945,chr1,NPPB,chr1:11857464-11858945,1481
11877770,11880406,chr1,SBF1P2,chr1:11877770-11880406,2636
43353866,43552203,chr12,ADAMTS20,chr12:43353866-43552203,198337
11908152,11908271,chr1,RNU5E-1,chr1:11908152-11908271,119
11909808,11909927,chr1,RNU5E-4P,chr1:11909808-11909927,119
11919591,11926428,chr1,KIAA2013,chr1:11919591-11926428,6837
48744597,48847874,chr3,PRKAR2A,chr3:48744597-48847874,103277
68822855,68837235,chr2,LINC01890,chr2:68822855-68837235,14380
50466785,50476848,chr19,FAM71E1,chr19:50466785-50476848,10063
68832014,68837726,chr2,LINC01888,chr2:68832014-68837726,5712
11934205,11975538,chr1,PLOD1,chr1:11934205-11975538,41333
68860909,68871397,chr2,BMP10,chr2:68860909-68871397,10488
68921248,68926834,chr2,GKN3P,chr2:68921248-68926834,5586
68945232,68952893,chr2,GKN2,chr2:68945232-68952893,7661
50476400,50490871,chr19,EMC10,chr19:50476400-50490871,14471
68974573,68980980,chr2,GKN1,chr2:68974573-68980980,6407
126982693,127037389,chr3,PLXNA1,chr3:126982693-127037389,54696
69103682,69103755,chr2,MIR3126,chr2:69103682-69103755,73
69181897,69182003,chr2,RNA5SP96,chr2:69181897-69182003,106
69182877,69182983,chr2,RNU6-1216P,chr2:69182877-69182983,106
69013176,69249327,chr2,ANTXR1,chr2:69013176-69249327,236151
49188736,49274600,chr12,TUBA1C,chr12:49188736-49274600,85864
9621249,9674662,chr19,ZNF561-AS1,chr19:9621249-9674662,53413
142580910,142582399,chr3,RPL6P9,chr3:142580910-142582399,1489
70053429,70135608,chr17,KCNJ16,chr17:70053429-70135608,82179
142591677,142591791,chr3,RNA5SP143,chr3:142591677-142591791,114
117208142,117452170,chr12,NOS1,chr12:117208142-117452170,244028
142596393,142713664,chr3,PLS1,chr3:142596393-142713664,117271
58034025,58054631,chr19,ZSCAN1,chr19:58034025-58054631,20606
58044592,58046769,chr19,LETM1P2,chr19:58044592-58046769,2177
58049046,58049346,chr19,HNRNPDLP4,chr19:58049046-58049346,300
82371765,82377458,chr17,UTS2R,chr17:82371765-82377458,5693
38127951,38138868,chr17,TBC1D3E,chr17:38127951-38138868,10917
58059239,58086310,chr19,ZNF135,chr19:58059239-58086310,27071
12019466,12032045,chr1,MIIP,chr1:12019466-12032045,12579
3197519,3198448,chr17,OR1A2,chr17:3197519-3198448,929
15945130,15975746,chr17,ADORA2B,chr17:15945130-15975746,30616
3126610,3127551,chr17,OR1G1,chr17:3126610-3127551,941
38057693,38068634,chr17,TBC1D3C,chr17:38057693-38068634,10941
58069970,58070288,chr19,RN7SL526P,chr19:58069970-58070288,318
58083838,58118427,chr19,ZSCAN18,chr19:58083838-58118427,34589
3565444,3609411,chr17,TRPV1,chr17:3565444-3609411,43967
12029158,12029222,chr1,MIR6729,chr1:12029158-12029222,64
12036740,12037014,chr1,RN7SL649P,chr1:12036740-12037014,274
12063303,12144207,chr1,TNFRSF8,chr1:12063303-12144207,80904
142654784,142656745,chr3,PLS1-AS1,chr3:142654784-142656745,1961
142673597,142673904,chr3,RN7SKP25,chr3:142673597-142673904,307
142724034,142807888,chr3,TRPC1,chr3:142724034-142807888,83854
58126248,58155110,chr19,ZNF329,chr19:58126248-58155110,28862
124911604,124917368,chr12,UBC,chr12:124911604-124917368,5764
12077881,12077984,chr1,RNU6-777P,chr1:12077881-12077984,103
12080293,12080547,chr1,RPL23AP89,chr1:12080293-12080547,254
41425359,41428730,chr19,B3GNT8,chr19:41425359-41428730,3371
12166943,12167038,chr1,MIR7846,chr1:12166943-12167038,95
12191713,12191773,chr1,MIR4632,chr1:12191713-12191773,60
142801207,142801268,chr3,RNU7-47P,chr3:142801207-142801268,61
142815922,142889206,chr3,PCOLCE2,chr3:142815922-142889206,73284
5674947,5691875,chr19,RPL36,chr19:5674947-5691875,16928
32651142,32686211,chr1,RBBP4,chr1:32651142-32686211,35069
121429096,121581023,chr12,KDM2B,chr12:121429096-121581023,151927
5678421,5680516,chr19,MICOS13,chr19:5678421-5680516,2095
142949164,142963674,chr3,PAQR9,chr3:142949164-142963674,14510
18345377,18445588,chr3,SATB1,chr3:18345377-18445588,100211
5680604,5688523,chr19,HSD11B1L,chr19:5680604-5688523,7919
79135503,79138427,chr2,REG1CP,chr2:79135503-79138427,2924
79157003,79159753,chr2,REG3A,chr2:79157003-79159753,2750
79492704,79513900,chr2,CTNNA2-AS1,chr2:79492704-79513900,21196
79573764,79575593,chr2,GNA13P1,chr2:79573764-79575593,1829
79636862,79636963,chr2,RNU6-561P,chr2:79636862-79636963,101
79649294,79649359,chr2,MIR4264,chr2:79649294-79649359,65
79866495,79866583,chr2,MIR8080,chr2:79866495-79866583,88
80162428,80163135,chr2,RBM7P1,chr2:80162428-80163135,707
80288351,80304752,chr2,LRRTM1,chr2:80288351-80304752,16401
18538673,18539899,chr3,RAD23BP1,chr3:18538673-18539899,1226
18954943,18955049,chr3,RNU6-138P,chr3:18954943-18955049,106
132654446,132679794,chr3,UBA5,chr3:132654446-132679794,25348
79185231,80648861,chr2,CTNNA2,chr2:79185231-80648861,1463630
32679906,32703596,chr1,SYNC,chr1:32679906-32703596,23690
32741830,32774970,chr1,KIAA1522,chr1:32741830-32774970,33140
18445024,18923280,chr3,SATB1-AS1,chr3:18445024-18923280,478256
43758944,43789543,chr12,IRAK4,chr12:43758944-43789543,30599
32816767,32858875,chr1,S100PBP,chr1:32816767-32858875,42108
48762234,48817229,chr17,TTLL6,chr17:48762234-48817229,54995
32862268,32872482,chr1,FNDC5,chr1:32862268-32872482,10214
162267074,162318684,chr2,IFIH1,chr2:162267074-162318684,51610
32885994,32898441,chr1,HPCA,chr1:32885994-32898441,12447
4269259,4366675,chr17,UBE2G1,chr17:4269259-4366675,97416
162318840,162371595,chr2,GCA,chr2:162318840-162371595,52755
32894594,32901438,chr1,TMEM54,chr1:32894594-32901438,6844
9917074,9933630,chr3,IL17RC,chr3:9917074-9933630,16556
20449395,20467539,chr17,LGALS9B,chr17:20449395-20467539,18144
36165683,36176636,chr17,TBC1D3B,chr17:36165683-36176636,10953
161152776,161158856,chr1,UFC1,chr1:161152776-161158856,6080
162496936,162497051,chr2,RNA5SP109,chr2:162496936-162497051,115
161159450,161165723,chr1,USP21,chr1:161159450-161165723,6273
37099210,37157522,chr2,EIF2AK2,chr2:37099210-37157522,58312
7921859,7929856,chr17,KCNAB3,chr17:7921859-7929856,7997
5691834,5720572,chr19,LONP1,chr19:5691834-5720572,28738
109929804,109996389,chr12,GIT2,chr12:109929804-109996389,66585
7856685,7885238,chr17,NAA38,chr17:7856685-7885238,28553
161166056,161178013,chr1,PPOX,chr1:161166056-161178013,11957
38181659,38192555,chr17,TBC1D3,chr17:38181659-38192555,10896
58982638,59106921,chr17,TRIM37,chr17:58982638-59106921,124283
5720637,5778734,chr19,CATSPERD,chr19:5720637-5778734,58097
161171310,161177968,chr1,B4GALT3,chr1:161171310-161177968,6658
5782960,5784746,chr19,PRR22,chr19:5782960-5784746,1786
59059226,59059493,chr17,RN7SL716P,chr17:59059226-59059493,267
59174983,59181787,chr17,SPDYE22P,chr17:59174983-59181787,6804
5784832,5791225,chr19,DUS3L,chr19:5784832-5791225,6393
59220467,59275970,chr17,GDPD1,chr17:59220467-59275970,55503
98306752,98312843,chr3,OR5H8,chr3:98306752-98312843,6091
9649433,9702393,chr3,MTMR14,chr3:9649433-9702393,52960
161184302,161199054,chr1,ADAMTS4,chr1:161184302-161199054,14752
182716255,182794464,chr2,DNAJC10,chr2:182716255-182794464,78209
59281130,59281343,chr17,SNRPGP17,chr17:59281130-59281343,213
161215234,161220699,chr1,FCER1G,chr1:161215234-161220699,5465
59331655,59401729,chr17,YPEL2,chr17:59331655-59401729,70074
5805067,5828324,chr19,NRTN,chr19:5805067-5828324,23257
161222292,161223631,chr1,APOA2,chr1:161222292-161223631,1339
5842888,5851471,chr19,FUT3,chr19:5842888-5851471,8583
59366083,59366154,chr17,MIR4729,chr17:59366083-59366154,71
59422088,59526946,chr17,LINC01476,chr17:59422088-59526946,104858
59537359,59537499,chr17,RNU4-13P,chr17:59537359-59537499,140
7558292,7561608,chr17,TNFSF13,chr17:7558292-7561608,3316
5891276,5904006,chr19,NDUFA11,chr19:5891276-5904006,12730
182788098,182788435,chr2,RPL31P15,chr2:182788098-182788435,337
182833275,182866637,chr2,FRZB,chr2:182833275-182866637,33362
161225939,161230746,chr1,TOMM40L,chr1:161225939-161230746,4807
182873841,182873947,chr2,RNU6-1122P,chr2:182873841-182873947,106
5904872,5910853,chr19,VMAC,chr19:5904872-5910853,5981
3879864,3928082,chr19,ATCAY,chr19:3879864-3928082,48218
240713761,240824293,chr2,KIF1A,chr2:240713761-240824293,110532
161227186,161227261,chr1,MIR5187,chr1:161227186-161227261,75
3920245,3920506,chr19,RN7SL202P,chr19:3920245-3920506,261
3958453,3971123,chr19,DAPK3,chr19:3958453-3971123,12670
161229666,161238244,chr1,NR1I3,chr1:161229666-161238244,8578
74424851,74451653,chr17,GPRC5C,chr17:74424851-74451653,26802
98100793,98105672,chr3,OR5AC4P,chr3:98100793-98105672,4879
98119191,98119731,chr3,POU5F1P7,chr3:98119191-98119731,540
98130721,98138548,chr3,OR5H1,chr3:98130721-98138548,7827
98147479,98156614,chr3,OR5H14,chr3:98147479-98156614,9135
5531869,5946232,chr12,ANO2,chr12:5531869-5946232,414363
98197211,98198138,chr3,OR5H5P,chr3:98197211-98198138,927
98207423,98208341,chr3,OR5H3P,chr3:98207423-98208341,918
98222044,98222966,chr3,OR5H4P,chr3:98222044-98222966,922
98238352,98239281,chr3,OR5H7P,chr3:98238352-98239281,929
98263252,98265356,chr3,OR5H6,chr3:98263252-98265356,2104
3961414,3961512,chr19,MIR637,chr19:3961414-3961512,98
3976056,3985463,chr19,EEF2,chr19:3976056-3985463,9407
9731729,9748019,chr3,BRPF1,chr3:9731729-9748019,16290
74466399,74484794,chr17,CD300A,chr17:74466399-74484794,18395
3982507,3982572,chr19,SNORD37,chr19:3982507-3982572,65
4007736,4039386,chr19,PIAS4,chr19:4007736-4039386,31650
122920951,122981649,chr12,ABCB9,chr12:122920951-122981649,60698
74521174,74531475,chr17,CD300LB,chr17:74521174-74531475,10301
74541073,74546115,chr17,CD300C,chr17:74541073-74546115,5042
74560701,74567343,chr17,CD300H,chr17:74560701-74567343,6642
4043303,4066899,chr19,ZBTB7A,chr19:4043303-4066899,23596
74579365,74592283,chr17,CD300LD,chr17:74579365-74592283,12918
74584679,74594209,chr17,CD300LD-AS1,chr17:74584679-74594209,9530
4090321,4124122,chr19,MAP2K2,chr19:4090321-4124122,33801
82047902,82051831,chr17,RFNG,chr17:82047902-82051831,3929
4153631,4173054,chr19,CREB3L3,chr19:4153631-4173054,19423
45388561,45554726,chr3,LARS2,chr3:45388561-45554726,166165
82057506,82065887,chr17,DUS1L,chr17:82057506-82065887,8381
4174109,4182566,chr19,SIRT6,chr19:4174109-4182566,8457
121210065,121234106,chr12,P2RX4,chr12:121210065-121234106,24041
45483974,45509545,chr3,LARS2-AS1,chr3:45483974-45509545,25571
45555394,45686341,chr3,LIMD1,chr3:45555394-45686341,130947
82078338,82098294,chr17,FASN,chr17:82078338-82098294,19956
45886509,45903174,chr3,CCR9,chr3:45886509-45903174,16665
46142358,46143677,chr3,FLT1P1,chr3:46142358-46143677,1319
46201711,46208313,chr3,CCR1,chr3:46201711-46208313,6602
46310591,46311922,chr3,UQCRC2P1,chr3:46310591-46311922,1331
46353864,46360940,chr3,CCR2,chr3:46353864-46360940,7076
46407166,46412997,chr3,CCRL2,chr3:46407166-46412997,5831
1203209,1203842,chr19,HMGB2P1,chr19:1203209-1203842,633
46416524,46423591,chr3,LINC02009,chr3:46416524-46423591,7067
46612525,46626543,chr3,FAM240A,chr3:46612525-46626543,14018
1248553,1259143,chr19,MIDN,chr19:1248553-1259143,10590
1259384,1274880,chr19,CIRBP,chr19:1259384-1274880,15496
45823316,45916042,chr3,LZTFL1,chr3:45823316-45916042,92726
10426854,10442300,chr12,KLRC2,chr12:10426854-10442300,15446
53157663,53180925,chr12,CSAD,chr12:53157663-53180925,23262
46016990,46085825,chr3,XCR1,chr3:46016990-46085825,68835
46130890,46266706,chr3,CCR3,chr3:46130890-46266706,135816
40958417,40966948,chr17,KRT39,chr17:40958417-40966948,8531
46435645,46485234,chr3,LTF,chr3:46435645-46485234,49589
40993430,40994164,chr17,KRTAP3-3,chr17:40993430-40994164,734
40999193,40999906,chr17,KRTAP3-2,chr17:40999193-40999906,713
41004481,41004760,chr17,KRTAP3-4P,chr17:41004481-41004760,279
41008521,41019324,chr17,KRTAP3-1,chr17:41008521-41019324,10803
41026026,41027208,chr17,KRTAP1-5,chr17:41026026-41027208,1182
41033884,41034874,chr17,KRTAP1-3,chr17:41033884-41034874,990
41040541,41041450,chr17,KRTAP1-1,chr17:41040541-41041450,909
41059240,41060114,chr17,KRTAP2-3,chr17:41059240-41060114,874
41065116,41065879,chr17,KRTAP2-4,chr17:41065116-41065879,763
41071946,41072341,chr17,KRTAP2-5P,chr17:41071946-41072341,395
41101502,41102209,chr17,KRTAP4-16,chr17:41101502-41102209,707
41117181,41118373,chr17,KRTAP4-11,chr17:41117181-41118373,1192
41123091,41124182,chr17,KRTAP4-12,chr17:41123091-41124182,1091
41139433,41140487,chr17,KRTAP4-6,chr17:41139433-41140487,1054
41148924,41149825,chr17,KRTAP4-5,chr17:41148924-41149825,901
41159649,41160748,chr17,KRTAP4-4,chr17:41159649-41160748,1099
8878911,8965712,chr17,PIK3R5,chr17:8878911-8965712,86801
55882301,56517016,chr17,ANKFN1,chr17:55882301-56517016,634715
16548372,16610594,chr12,LMO3,chr12:16548372-16610594,62222
44076746,44123702,chr17,HDAC5,chr17:44076746-44123702,46956
46494611,46500950,chr3,RTP3,chr3:46494611-46500950,6339
46515385,46606948,chr3,LRRC2,chr3:46515385-46606948,91563
161258745,161285450,chr1,PCP4L1,chr1:161258745-161285450,26705
161364733,161367876,chr1,CFAP126,chr1:161364733-161367876,3143
9933793,9945413,chr3,CRELD1,chr3:9933793-9945413,11620
161378707,161379358,chr1,RRM2P2,chr1:161378707-161379358,651
161401289,161401395,chr1,RNU6-481P,chr1:161401289-161401395,106
147689256,147689537,chr1,RN7SL261P,chr1:147689256-147689537,281
147756199,147773362,chr1,GJA5,chr1:147756199-147773362,17163
66135846,66170027,chr12,TMBIM4,chr12:66135846-66170027,34181
147902795,147909269,chr1,GJA8,chr1:147902795-147909269,6474
147928393,147993592,chr1,GPR89B,chr1:147928393-147993592,65199
3207539,3218896,chr17,OR1A1,chr17:3207539-3218896,11357
17810399,17837002,chr17,SREBF1,chr17:17810399-17837002,26603
6988259,7071032,chr12,C1S,chr12:6988259-7071032,82773
147993862,148014956,chr1,PDZK1P1,chr1:147993862-148014956,21094
148013203,148025934,chr1,LINC02804,chr1:148013203-148025934,12731
148014417,148014583,chr1,RNU1-129P,chr1:148014417-148014583,166
148038753,148038916,chr1,RNVU1-7,chr1:148038753-148038916,163
148080598,148093883,chr1,PDE4DIPP1,chr1:148080598-148093883,13285
148129497,148129898,chr1,PFN1P4,chr1:148129497-148129898,401
148146395,148149566,chr1,ABHD17AP1,chr1:148146395-148149566,3171
232700204,232700308,chr1,RNU6-1211P,chr1:232700204-232700308,104
232718071,232722250,chr1,LINC01745,chr1:232718071-232722250,4179
232727251,232751299,chr1,LINC01744,chr1:232727251-232751299,24048
64028894,64029000,chr1,RNU6-809P,chr1:64028894-64029000,106
64094379,64171342,chr1,ROR1-AS1,chr1:64094379-64171342,76963
11980181,12015211,chr1,MFN2,chr1:11980181-12015211,35030
54830518,54896008,chr12,MUCL1,chr12:54830518-54896008,65490
39927732,39944999,chr17,LRRC3C,chr17:39927732-39944999,17267
64854130,64919480,chr17,LRRC37A3,chr17:64854130-64919480,65350
50392383,50480004,chr12,LARP4,chr12:50392383-50480004,87621
39904595,39919854,chr17,GSDMB,chr17:39904595-39919854,15259
6728177,6770311,chr2,LINC00487,chr2:6728177-6770311,42134
6819463,6840464,chr2,NRIR,chr2:6819463-6840464,21001
6865557,6898239,chr2,RSAD2,chr2:6865557-6898239,32682
6911754,6918734,chr2,GRASLND,chr2:6911754-6918734,6980
6917412,7068286,chr2,RNF144A,chr2:6917412-7068286,150874
61065871,61138034,chr2,SANBR,chr2:61065871-61138034,72163
12287368,12434356,chr3,PPARG,chr3:12287368-12434356,146988
29614756,29622912,chr17,CORO6,chr17:29614756-29622912,8156
1267471,1270260,chr19,CIRBP-AS1,chr19:1267471-1270260,2789
1275530,1279244,chr19,FAM174C,chr19:1275530-1279244,3714
1285873,1301431,chr19,EFNA2,chr19:1285873-1301431,15558
12884422,12887201,chr19,KLF1,chr19:12884422-12887201,2779
12995475,13098796,chr19,NFIX,chr19:12995475-13098796,103321
40245947,40251684,chr1,TMCO2,chr1:40245947-40251684,5737
40256427,40257967,chr1,ZMPSTE24-DT,chr1:40256427-40257967,1540
40258041,40294180,chr1,ZMPSTE24,chr1:40258041-40294180,36139
61177418,61191203,chr2,AHSA2P,chr2:61177418-61191203,13785
28703197,28711888,chr17,PROCA1,chr17:28703197-28711888,8691
40300489,40317813,chr1,COL9A2,chr1:40300489-40317813,17324
95217746,95302799,chr12,VEZT,chr12:95217746-95302799,85053
40977715,40987135,chr17,KRT40,chr17:40977715-40987135,9420
58148384,58159585,chr17,OR4D1,chr17:58148384-58159585,11201
15627960,15684311,chr17,TRIM16,chr17:15627960-15684311,56351
151270470,151289894,chr2,NMI,chr2:151270470-151289894,19424
151357592,151380046,chr2,TNFAIP6,chr2:151357592-151380046,22454
151368334,151368411,chr2,MIR4773-2,chr2:151368334-151368411,77
151368334,151368411,chr2,MIR4773-1,chr2:151368334-151368411,77
151372003,151372287,chr2,RN7SL124P,chr2:151372003-151372287,284
151409883,151508013,chr2,RIF1,chr2:151409883-151508013,98130
23597341,23597592,chr19,RPS27P29,chr19:23597341-23597592,251
23602567,23603106,chr19,VN1R93P,chr19:23602567-23603106,539
23739195,23758891,chr19,ZNF681,chr19:23739195-23758891,19696
40450102,40463718,chr1,ZFP69B,chr1:40450102-40463718,13616
23798924,23799477,chr19,BNIP3P39,chr19:23798924-23799477,553
161304735,161309968,chr1,MPZ,chr1:161304735-161309968,5233
35683778,35684201,chr19,TYMSP2,chr19:35683778-35684201,423
35704558,35717038,chr19,ZBTB32,chr19:35704558-35717038,12480
56760933,56761215,chr19,OR5AH1P,chr19:56760933-56761215,282
56810077,56840728,chr19,PEG3,chr19:56810077-56840728,30651
15675476,15675643,chr17,ZNF29P,chr17:15675476-15675643,167
15699577,15720787,chr17,ZNF286A,chr17:15699577-15720787,21210
25818640,25832942,chr1,MTFR1L,chr1:25818640-25832942,14302
53156009,53192717,chr3,PRKCD,chr3:53156009-53192717,36708
25831913,25859458,chr1,AUNIP,chr1:25831913-25859458,27545
15704232,15704900,chr17,UBE2SP1,chr17:15704232-15704900,668
15735023,15749192,chr17,TBC1D26-AS1,chr17:15735023-15749192,14169
25861484,25875708,chr1,PAQR7,chr1:25861484-25875708,14224
52232520,52252186,chr12,KRT7,chr12:52232520-52252186,19666
15699552,15745940,chr17,ZNF286A-TBC1D26,chr17:15699552-15745940,46388
25884181,25906991,chr1,STMN1,chr1:25884181-25906991,22810
11351823,11355591,chr12,PRB1,chr12:11351823-11355591,3768
15732247,15746162,chr17,TBC1D26,chr17:15732247-15746162,13915
68808177,68845544,chr12,MDM2,chr12:68808177-68845544,37367
25887360,25887610,chr1,SNRPFP2,chr1:25887360-25887610,250
25906362,25906454,chr1,MIR3917,chr1:25906362-25906454,92
44390722,44390823,chr1,RNU6-369P,chr1:44390722-44390823,101
44405194,44651724,chr1,RNF220,chr1:44405194-44651724,246530
35490009,35491238,chr17,E2F3P1,chr17:35490009-35491238,1229
35498218,35499175,chr17,TAF5LP1,chr17:35498218-35499175,957
56840866,56848556,chr19,MIMT1,chr19:56840866-56848556,7690
35514766,35515186,chr17,TOMM20P2,chr17:35514766-35515186,420
16549459,16666331,chr2,CYRIA,chr2:16549459-16666331,116872
35543985,35560819,chr17,SLFN14,chr17:35543985-35560819,16834
56774547,56840731,chr19,ZIM2,chr19:56774547-56840731,66184
35573657,35573753,chr17,SNORD7,chr17:35573657-35573753,96
35574795,35578863,chr17,PEX12,chr17:35574795-35578863,4068
30906344,30959322,chr17,ADAP2,chr17:30906344-30959322,52978
96536743,96552634,chr2,ARID5A,chr2:96536743-96552634,15891
44545493,44545552,chr1,MIR5584,chr1:44545493-44545552,59
44635238,44674481,chr1,TMEM53,chr1:44635238-44674481,39243
53283429,53347586,chr3,DCP1A,chr3:53283429-53347586,64157
96593170,96642787,chr2,KANSL3,chr2:96593170-96642787,49617
36687612,36727701,chr19,ZNF567,chr19:36687612-36727701,40089
44674692,44725591,chr1,ARMH1,chr1:44674692-44725591,50899
53333060,53333128,chr3,SNORD38C,chr3:53333060-53333128,68
35717973,35738880,chr19,KMT2B,chr19:35717973-35738880,20907
53812335,53846419,chr3,CHDH,chr3:53812335-53846419,34084
30959564,30959850,chr17,RN7SL138P,chr17:30959564-30959850,286
53846568,53865794,chr3,IL17RB,chr3:53846568-53865794,19226
30970984,30999911,chr17,RNF135,chr17:30970984-30999911,28927
44721786,44721902,chr1,RNU5F-1,chr1:44721786-44721902,116
44731055,44731170,chr1,RNU5D-1,chr1:44731055-44731170,115
53867066,53882152,chr3,ACTR8,chr3:53867066-53882152,15086
30975387,30975954,chr17,DPRXP4,chr17:30975387-30975954,567
44739818,44767767,chr1,KIF2C,chr1:44739818-44767767,27949
31090787,31095450,chr17,MIR4733HG,chr17:31090787-31095450,4663
31094350,31094425,chr17,MIR4733,chr17:31094350-31094425,75
68974488,69060949,chr17,ABCA9,chr17:68974488-69060949,86461
53328963,53813733,chr3,CACNA1D,chr3:53328963-53813733,484770
69078702,69141895,chr17,ABCA6,chr17:69078702-69141895,63193
69094289,69095499,chr17,SEC24AP1,chr17:69094289-69095499,1210
69099542,69099656,chr17,MIR4524B,chr17:69099542-69099656,114
69099564,69099632,chr17,MIR4524A,chr17:69099564-69099632,68
69232963,69235012,chr17,PRO1804,chr17:69232963-69235012,2049
69318733,69318961,chr17,SNRPGP4,chr17:69318733-69318961,228
69147214,69244846,chr17,ABCA10,chr17:69147214-69244846,97632
96642737,96704887,chr2,FER1L5,chr2:96642737-96704887,62150
12163064,12189871,chr19,ZNF136,chr19:12163064-12189871,26807
44775251,44778779,chr1,RPS8,chr1:44775251-44778779,3528
35774532,35788822,chr19,ARHGAP33,chr19:35774532-35788822,14290
44775864,44775943,chr1,SNORD55,chr1:44775864-44775943,79
44776490,44776593,chr1,SNORD46,chr1:44776490-44776593,103
44777843,44777912,chr1,SNORD38A,chr1:44777843-44777912,69
44778390,44778456,chr1,SNORD38B,chr1:44778390-44778456,66
96705929,96740064,chr2,LMAN2L,chr2:96705929-96740064,34135
44780331,44780715,chr1,RPS15AP11,chr1:44780331-44780715,384
44783585,44788170,chr1,BEST4,chr1:44783585-44788170,4585
44800377,44805990,chr1,PLK3,chr1:44800377-44805990,5613
44808482,44815585,chr1,BTBD19,chr1:44808482-44815585,7103
96760902,96811874,chr2,CNNM4,chr2:96760902-96811874,50972
43584367,43596134,chr19,IRGQ,chr19:43584367-43596134,11767
43596392,43601157,chr19,ZNF576,chr19:43596392-43601157,4765
96798278,96798353,chr2,MIR3127,chr2:96798278-96798353,75
96812239,96813657,chr2,CNNM3-DT,chr2:96812239-96813657,1418
44819844,44843253,chr1,PTCH2,chr1:44819844-44843253,23409
96816245,96835382,chr2,CNNM3,chr2:96816245-96835382,19137
7380534,7389774,chr17,TNK1,chr17:7380534-7389774,9240
43596617,43614498,chr19,SRRM5,chr19:43596617-43614498,17881
44819883,44819997,chr1,RNU5E-6P,chr1:44819883-44819997,114
44850522,44986722,chr1,EIF2B3,chr1:44850522-44986722,136200
50384204,50418018,chr19,POLD1,chr19:50384204-50418018,33814
96824526,96857934,chr2,ANKRD23,chr2:96824526-96857934,33408
35377416,35377678,chr17,UFM1P2,chr17:35377416-35377678,262
35410922,35433283,chr17,SLFN12,chr17:35410922-35433283,22361
96836611,96858016,chr2,ANKRD39,chr2:96836611-96858016,21405
52285913,52291534,chr12,KRT81,chr12:52285913-52291534,5621
44932323,44932431,chr1,RNA5SP47,chr1:44932323-44932431,108
44958557,44959395,chr1,CCNB1IP1P1,chr1:44958557-44959395,838
44988234,44988725,chr1,PPIAP35,chr1:44988234-44988725,491
44988705,44991834,chr1,MRPS17P1,chr1:44988705-44991834,3129
45002540,45011324,chr1,HECTD3,chr1:45002540-45011324,8784
96859718,96870757,chr2,SEMA4C,chr2:96859718-96870757,11039
35435096,35448837,chr17,SLFN13,chr17:35435096-35448837,13741
104215779,104350307,chr12,TXNRD1,chr12:104215779-104350307,134528
45010950,45015575,chr1,UROD,chr1:45010950-45015575,4625
35350305,35373701,chr17,SLFN11,chr17:35350305-35373701,23396
237627587,237813682,chr2,LRRFIP1,chr2:237627587-237813682,186095
41436154,41440983,chr17,KRT38,chr17:41436154-41440983,4829
41448183,41454055,chr17,KRT43P,chr17:41448183-41454055,5872
41459513,41467386,chr17,KRT32,chr17:41459513-41467386,7873
41467956,41468146,chr17,RNU2-32P,chr17:41467956-41468146,190
41486136,41492546,chr17,KRT36,chr17:41486136-41492546,6410
41500981,41505705,chr17,KRT13,chr17:41500981-41505705,4724
45069977,45070429,chr1,OSTCP5,chr1:45069977-45070429,452
6521347,6554513,chr1,NOL9,chr1:6521347-6554513,33166
55314343,55322364,chr12,OR6C1,chr12:55314343-55322364,8021
7304072,7328719,chr12,ACSM4,chr12:7304072-7328719,24647
109116587,109268226,chr12,ACACB,chr12:109116587-109268226,151639
6555307,6579755,chr1,TAS1R1,chr1:6555307-6579755,24448
41513745,41522529,chr17,KRT15,chr17:41513745-41522529,8784
237858893,237912106,chr2,RAMP1,chr2:237858893-237912106,53213
6579994,6589280,chr1,ZBTB48,chr1:6579994-6589280,9286
222671658,222709930,chr2,MOGAT1,chr2:222671658-222709930,38272
222677677,222678289,chr2,RRAS2P2,chr2:222677677-222678289,612
41517164,41517217,chr17,MIR6510,chr17:41517164-41517217,53
41523617,41528308,chr17,KRT19,chr17:41523617-41528308,4691
222726457,222726834,chr2,RPL31P17,chr2:222726457-222726834,377
222904640,222905055,chr2,ATG12P2,chr2:222904640-222905055,415
222917387,222919363,chr2,ACSL3-AS1,chr2:222917387-222919363,1976
41549606,41554495,chr17,LINC00974,chr17:41549606-41554495,4889
41565836,41572059,chr17,KRT9,chr17:41565836-41572059,6223
222860942,222944639,chr2,ACSL3,chr2:222860942-222944639,83697
10026370,10101932,chr3,FANCD2,chr3:10026370-10101932,75562
41582279,41586895,chr17,KRT14,chr17:41582279-41586895,4616
89633072,89769903,chr1,LRRC8C,chr1:89633072-89769903,136831
49928702,49933935,chr19,ATF5,chr19:49928702-49933935,5233
41609778,41615899,chr17,KRT16,chr17:41609778-41615899,6121
22517474,22519708,chr1,ZBTB40-IT1,chr1:22517474-22519708,2234
22563489,22603595,chr1,EPHA8,chr1:22563489-22603595,40106
41626327,41640199,chr17,KRT42P,chr17:41626327-41640199,13872
12675717,12681880,chr19,DHPS,chr19:12675717-12681880,6163
22633258,22633366,chr1,MIR6127,chr1:22633258-22633366,108
41688885,41692668,chr17,EIF1,chr17:41688885-41692668,3783
22636628,22639678,chr1,C1QA,chr1:22636628-22639678,3050
22643633,22648110,chr1,C1QC,chr1:22643633-22648110,4477
22652762,22661637,chr1,C1QB,chr1:22652762-22661637,8875
41476710,41481151,chr17,KRT35,chr17:41476710-41481151,4441
22719517,22719598,chr1,MIR4684,chr1:22719517-22719598,81
236523052,236524508,chr1,LGALS8-AS1,chr1:236523052-236524508,1456
2720801,2749652,chr17,CCDC92B,chr17:2720801-2749652,28851
44899774,44905390,chr17,FAM187A,chr17:44899774-44905390,5616
236549005,236604516,chr1,HEATR1,chr1:236549005-236604516,55511
74203582,74210655,chr17,RPL38,chr17:74203582-74210655,7073
74209980,74213342,chr17,MGC16275,chr17:74209980-74213342,3362
74213571,74262020,chr17,TTYH2,chr17:74213571-74262020,48449
2163933,2232578,chr19,DOT1L,chr19:2163933-2232578,68645
192139390,192767764,chr3,FGF12,chr3:192139390-192767764,628374
51186936,51218062,chr12,POU6F1,chr12:51186936-51218062,31126
2230084,2237704,chr19,PLEKHJ1,chr19:2230084-2237704,7620
236819634,236820518,chr1,RPSAP21,chr1:236819634-236820518,884
74274234,74314884,chr17,DNAI2,chr17:74274234-74314884,40650
236981339,236981708,chr1,RPL35P1,chr1:236981339-236981708,369
10505602,10523135,chr12,EIF2S3B,chr12:10505602-10523135,17533
237004103,237004441,chr1,MT1HL1,chr1:237004103-237004441,338
124374332,124374437,chr3,MIR6083,chr3:124374332-124374437,105
124407691,124407783,chr3,RNU6-143P,chr3:124407691-124407783,92
55716038,55720087,chr12,BLOC1S1,chr12:55716038-55720087,4049
124730433,124749273,chr3,UMPS,chr3:124730433-124749273,18840
27675603,27675709,chr1,RNU6-949P,chr1:27675603-27675709,106
27686810,27687471,chr1,CHMP1AP1,chr1:27686810-27687471,661
27693731,27693835,chr1,RNU6-424P,chr1:27693731-27693835,104
27739954,27740629,chr1,RPEP3,chr1:27739954-27740629,675
2234062,2234149,chr19,MIR1227,chr19:2234062-2234149,87
2235829,2235926,chr19,MIR6789,chr19:2235829-2235926,97
27773219,27824443,chr1,STX12,chr1:27773219-27824443,51224
74306728,74308008,chr2,KRT18P26,chr2:74306728-74308008,1280
2236824,2248655,chr19,SF3A2,chr19:2236824-2248655,11831
74319399,74319501,chr2,RNU6-542P,chr2:74319399-74319501,102
74532258,74555690,chr2,LOXL3,chr2:74532258-74555690,23432
9985642,10013424,chr12,CLEC1B,chr12:9985642-10013424,27782
27824538,27824643,chr1,RNU6-1245P,chr1:27824538-27824643,105
27830782,27851676,chr1,PPP1R8,chr1:27830782-27851676,20894
14767999,14771131,chr12,H4-16,chr12:14767999-14771131,3132
74326210,74355820,chr17,KIF19,chr17:74326210-74355820,29610
103237591,103495978,chr12,C12orf42,chr12:103237591-103495978,258387
2249309,2252073,chr19,AMH,chr19:2249309-2252073,2764
2250639,2250718,chr19,MIR4321,chr19:2250639-2250718,79
39829716,39829802,chr19,MIR6719,chr19:39829716-39829802,86
39776595,39786291,chr19,LEUTX,chr19:39776595-39786291,9696
39825350,39834201,chr19,DYRK1B,chr19:39825350-39834201,8851
27834401,27834566,chr1,SCARNA1,chr1:27834401-27834566,165
27872543,27886685,chr1,THEMIS2,chr1:27872543-27886685,14142
124732439,124732516,chr3,MIR544B,chr3:124732439-124732516,77
124761948,124901418,chr3,ITGB5,chr3:124761948-124901418,139470
74356416,74361868,chr17,BTBD17,chr17:74356416-74361868,5452
130337887,130372637,chr12,PIWIL1,chr12:130337887-130372637,34750
74417594,74417704,chr17,RNA5SP448,chr17:74417594-74417704,110
22061961,22070538,chr17,NCOR1P2,chr17:22061961-22070538,8577
22221221,22221605,chr17,FTLP13,chr17:22221221-22221605,384
22233926,22266392,chr17,LINC02002,chr17:22233926-22266392,32466
22298691,22299893,chr17,FAM27E5,chr17:22298691-22299893,1202
27891524,27914746,chr1,RPA2,chr1:27891524-27914746,23222
78971238,78979947,chr17,LGALS3BP,chr17:78971238-78979947,8709
124781155,124787757,chr3,ITGB5-AS1,chr3:124781155-124787757,6602
124862094,124863317,chr3,ENO1P3,chr3:124862094-124863317,1223
124905442,124953819,chr3,MUC13,chr3:124905442-124953819,48377
39834458,39846379,chr19,FBL,chr19:39834458-39846379,11921
74618856,74620979,chr2,TOR1BP1,chr2:74618856-74620979,2123
74628328,74628942,chr2,TVP23BP2,chr2:74628328-74628942,614
74361154,74392087,chr2,DCTN1,chr2:74361154-74392087,30933
57800056,57801448,chr3,PDHA1P1,chr3:57800056-57801448,1392
57941818,57942304,chr3,PPIAP16,chr3:57941818-57942304,486
16855407,16859284,chr1,PDE4DIPP9,chr1:16855407-16859284,3877
16858949,16859021,chr1,MIR3675,chr1:16858949-16859021,72
16873708,16873851,chr1,RNU1-5P,chr1:16873708-16873851,143
58008398,58172251,chr3,FLNB,chr3:58008398-58172251,163853
16895980,16896143,chr1,RNU1-2,chr1:16895980-16896143,163
16974502,16980632,chr1,MFAP2,chr1:16974502-16980632,6130
130789600,130839266,chr12,STX2,chr12:130789600-130839266,49666
12064731,12081565,chr19,ZNF844,chr19:12064731-12081565,16834
16985958,17011928,chr1,ATP13A2,chr1:16985958-17011928,25970
78991716,79009867,chr17,CANT1,chr17:78991716-79009867,18151
19320829,19358754,chr19,MAU2,chr19:19320829-19358754,37925
130869736,130869837,chr12,RNU6-1077P,chr12:130869736-130869837,101
130872037,130877678,chr12,RAN,chr12:130872037-130877678,5641
79022814,79049788,chr17,C1QTNF1,chr17:79022814-79049788,26974
12043805,12052961,chr19,ZNF878,chr19:12043805-12052961,9156
7030578,7033011,chr19,MBD3L5,chr19:7030578-7033011,2433
7037749,7040179,chr19,MBD3L4,chr19:7037749-7040179,2430
7049321,7051735,chr19,MBD3L2,chr19:7049321-7051735,2414
7069703,7087968,chr19,ZNF557,chr19:7069703-7087968,18265
79074824,79088599,chr17,ENGASE,chr17:79074824-79088599,13775
46633953,46636541,chr19,GNG8,chr19:46633953-46636541,2588
21496682,21556270,chr19,ZNF429,chr19:21496682-21556270,59588
21932958,22010949,chr19,ZNF208,chr19:21932958-22010949,77991
79089345,79611051,chr17,RBFOX3,chr17:79089345-79611051,521706
36850361,36913029,chr19,ZNF345,chr19:36850361-36913029,62668
17018722,17054032,chr1,SDHB,chr1:17018722-17054032,35310
17215346,17219829,chr19,USE1,chr19:17215346-17219829,4483
17066761,17119451,chr1,PADI2,chr1:17066761-17119451,52690
130396133,130768228,chr12,RIMBP2,chr12:130396133-130768228,372095
79707176,79707249,chr17,MIR4739,chr17:79707176-79707249,73
79707266,79712317,chr17,LINC02078,chr17:79707266-79712317,5051
17189783,17197617,chr1,LINC02783,chr1:17189783-17197617,7834
79730943,79742219,chr17,ENPP7,chr17:79730943-79742219,11276
17205128,17246007,chr1,PADI1,chr1:17205128-17246007,40879
1177558,1228431,chr19,STK11,chr19:1177558-1228431,50873
79778148,79787983,chr17,CBX2,chr17:79778148-79787983,9835
17249098,17284233,chr1,PADI3,chr1:17249098-17284233,35135
8474207,8631376,chr17,MYH10,chr17:8474207-8631376,157169
17277889,17277975,chr1,MIR3972,chr1:17277889-17277975,86
10512742,10517931,chr19,S1PR5,chr19:10512742-10517931,5189
85580761,85584589,chr1,CCN1,chr1:85580761-85584589,3828
4815932,4831712,chr19,TICAM1,chr19:4815932-4831712,15780
58474017,58481230,chr19,ZNF446,chr19:58474017-58481230,7213
222468094,222470882,chr1,CICP13,chr1:222468094-222470882,2788
222503632,222503735,chr1,RNU6-791P,chr1:222503632-222503735,103
63779833,63809792,chr12,RXYLT1,chr12:63779833-63809792,29959
222522258,222548104,chr1,HHIPL2,chr1:222522258-222548104,25846
50854915,50860764,chr19,KLK3,chr19:50854915-50860764,5849
222557902,222589933,chr1,TAF1A,chr1:222557902-222589933,32031
63804739,63822156,chr12,RXYLT1-AS1,chr12:63804739-63822156,17417
63822021,63823895,chr12,PABPC1P4,chr12:63822021-63823895,1874
121580792,121593504,chr12,KDM2B-DT,chr12:121580792-121593504,12712
121604902,121605012,chr12,RNU6-1004P,chr12:121604902-121605012,110
121648742,121672631,chr12,MORN3,chr12:121648742-121672631,23889
121712752,121783001,chr12,TMEM120B,chr12:121712752-121783001,70249
222589825,222593843,chr1,TAF1A-AS1,chr1:222589825-222593843,4018
222618097,222668007,chr1,MIA3,chr1:222618097-222668007,49910
47778677,47784686,chr19,SELENOW,chr19:47778677-47784686,6009
121777754,121803403,chr12,RHOF,chr12:121777754-121803403,25649
48469208,48482314,chr19,CYTH2,chr19:48469208-48482314,13106
121795267,121803906,chr12,LINC01089,chr12:121795267-121803906,8639
37506939,37548762,chr19,ZNF793,chr19:37506939-37548762,41823
121626550,121642677,chr12,ORAI1,chr12:121626550-121642677,16127
57723761,57742157,chr12,AGAP2,chr12:57723761-57742157,18396
222668013,222713210,chr1,AIDA,chr1:222668013-222713210,45197
41262496,41307787,chr19,HNRNPUL1,chr19:41262496-41307787,45291
222712553,222735196,chr1,BROX,chr1:222712553-222735196,22643
57824609,57824692,chr12,MIR26A2,chr12:57824609-57824692,83
119989236,120094494,chr12,BICDL1,chr12:119989236-120094494,105258
124033369,124726325,chr3,KALRN,chr3:124033369-124726325,692956
120095099,120117502,chr12,RAB35,chr12:120095099-120117502,22403
120127202,120194715,chr12,GCN1,chr12:120127202-120194715,67513
222945725,222945900,chr1,NDUFB1P2,chr1:222945725-222945900,175
223109404,223143248,chr1,TLR5,chr1:223109404-223143248,33844
42817122,42844991,chr1,ERMAP,chr1:42817122-42844991,27869
61476032,61538741,chr2,XPO1,chr2:61476032-61538741,62709
87594838,87595376,chr3,APOOP2,chr3:87594838-87595376,538
87259404,87276584,chr3,POU1F1,chr3:87259404-87276584,17180
42846573,42852477,chr1,ZNF691,chr1:42846573-42852477,5904
52555822,52587174,chr19,ZNF701,chr19:52555822-52587174,31352
125790404,125790552,chr3,MIR548I1,chr3:125790404-125790552,148
125795106,125795885,chr3,RPS3AP14,chr3:125795106-125795885,779
125816082,125816286,chr3,SNRPCP11,chr3:125816082-125816286,204
120155434,120155499,chr12,MIR4498,chr12:120155434-120155499,65
125827238,125916384,chr3,LINC02614,chr3:125827238-125916384,89146
120196699,120201235,chr12,RPLP0,chr12:120196699-120201235,4536
42891094,42892430,chr1,MKRN8P,chr1:42891094-42892430,1336
42903232,42903912,chr1,ATP6V1E1P1,chr1:42903232-42903912,680
42952202,42952641,chr1,ATP6V0CP4,chr1:42952202-42952641,439
56439325,56478065,chr19,ZNF667,chr19:56439325-56478065,38740
125848223,125909372,chr3,ENPP7P4,chr3:125848223-125909372,61149
31094927,31382116,chr17,NF1,chr17:31094927-31382116,287189
42991438,42991544,chr1,RNU6-880P,chr1:42991438-42991544,106
222815022,223005995,chr1,DISP1,chr1:222815022-223005995,190973
125969160,125983454,chr3,ROPN1B,chr3:125969160-125983454,14294
39602524,39607474,chr19,LGALS13,chr19:39602524-39607474,4950
41708585,41730433,chr19,CEACAM5,chr19:41708585-41730433,21848
170369223,170370367,chr1,HAUS4P1,chr1:170369223-170370367,1144
170460453,170532647,chr1,GORAB-AS1,chr1:170460453-170532647,72194
121431431,121545988,chr3,POLQ,chr3:121431431-121545988,114557
119495836,119496841,chr1,GAPDHP58,chr1:119495836-119496841,1005
119507198,119515054,chr1,HSD3B1,chr1:119507198-119515054,7856
58432814,58440153,chr19,ZNF132,chr19:58432814-58440153,7339
119533749,119534746,chr1,GAPDHP32,chr1:119533749-119534746,997
119538509,119545913,chr1,HSD3BP3,chr1:119538509-119545913,7404
119558755,119559774,chr1,GAPDHP27,chr1:119558755-119559774,1019
119564066,119572067,chr1,HSD3BP4,chr1:119564066-119572067,8001
57231009,57235548,chr19,AURKC,chr19:57231009-57235548,4539
119596167,119597179,chr1,GAPDHP33,chr1:119596167-119597179,1012
119597702,119599271,chr1,LINC00622,chr1:119597702-119599271,1569
119601340,119609250,chr1,HSD3BP5,chr1:119601340-119609250,7910
119619377,119648266,chr1,ZNF697,chr1:119619377-119648266,28889
121494110,121494908,chr3,RPL7AP11,chr3:121494110-121494908,798
119748002,119768905,chr1,HMGCS2,chr1:119748002-119768905,20903
121567949,121590622,chr3,ARGFX,chr3:121567949-121590622,22673
121593379,121630295,chr3,FBXO40,chr3:121593379-121630295,36916
9249742,9257507,chr3,SRGAP3-AS4,chr3:9249742-9257507,7765
230957593,230957950,chr2,COX20P2,chr2:230957593-230957950,357
9348443,9349192,chr3,PGAM1P4,chr3:9348443-9349192,749
9362971,9386791,chr3,THUMPD3,chr3:9362971-9386791,23820
230990324,231025055,chr2,SPATA3,chr2:230990324-231025055,34731
119794017,119811580,chr1,REG4,chr1:119794017-119811580,17563
47994632,48025154,chr19,ELSPBP1,chr19:47994632-48025154,30522
164687643,164687777,chr2,SNORA70F,chr2:164687643-164687777,134
164858432,164858546,chr2,RNA5SP110,chr2:164858432-164858546,114
164492417,164621482,chr2,GRB14,chr2:164492417-164621482,129065
119834870,119844514,chr1,NBPF7P,chr1:119834870-119844514,9644
119853316,119853748,chr1,PFN1P9,chr1:119853316-119853748,432
49591182,49626439,chr19,PRR12,chr19:49591182-49626439,35257
119886304,119886927,chr1,NOTCH2P1,chr1:119886304-119886927,623
119893533,119896515,chr1,ADAM30,chr1:119893533-119896515,2982
9498361,9553822,chr3,LHFPL4,chr3:9498361-9553822,55461
119648411,119744218,chr1,PHGDH,chr1:119648411-119744218,95807
9600748,9602728,chr3,DUSP5P2,chr3:9600748-9602728,1980
50329782,50340980,chr3,RASSF1,chr3:50329782-50340980,11198
51991332,52008230,chr19,ZNF615,chr19:51991332-52008230,16898
165747588,165794659,chr2,GALNT3,chr2:165747588-165794659,47071
57466663,57477570,chr19,ZNF772,chr19:57466663-57477570,10907
120210439,120265771,chr12,PXN,chr12:120210439-120265771,55332
165857475,165953851,chr2,TTC21B,chr2:165857475-165953851,96376
49877666,49888750,chr19,TBC1D17,chr19:49877666-49888750,11084
183178041,183428778,chr3,MCF2L2,chr3:183178041-183428778,250737
7636881,7647873,chr19,STXBP2,chr19:7636881-7647873,10992
50287732,50292918,chr3,IFRD2,chr3:50287732-50292918,5186
156840063,156859117,chr1,INSRR,chr1:156840063-156859117,19054
96583209,96583527,chr1,RN7SL831P,chr1:96583209-96583527,318
96584422,96584727,chr1,NDUFS5P2,chr1:96584422-96584727,305
96678874,96679620,chr1,RPL7P9,chr1:96678874-96679620,746
96695856,96696167,chr1,RN7SKP270,chr1:96695856-96696167,311
120247460,120247791,chr12,RPS20P31,chr12:120247460-120247791,331
120282303,120282716,chr12,NME2P1,chr12:120282303-120282716,413
152243828,152465780,chr3,MBNL1,chr3:152243828-152465780,221952
115283034,115368072,chr1,NGF-AS1,chr1:115283034-115368072,85038
120291763,120291903,chr12,RNU4-2,chr12:120291763-120291903,140
120293097,120293237,chr12,RNU4-1,chr12:120293097-120293237,140
1151810,1153059,chr12,HTR1DP1,chr12:1151810-1153059,1249
3778559,3796498,chr1,LRRC47,chr1:3778559-3796498,17939
1500525,1504424,chr12,LINC00942,chr12:1500525-1504424,3899
1529891,1647212,chr12,WNT5B,chr12:1529891-1647212,117321
3782815,3783111,chr1,RN7SL574P,chr1:3782815-3783111,296
201288271,201357398,chr2,FLACC1,chr2:201288271-201357398,69127
1565993,1594581,chr12,FBXL14,chr12:1565993-1594581,28588
990509,1495933,chr12,ERC1,chr12:990509-1495933,505424
201377207,201451500,chr2,TRAK2,chr2:201377207-201451500,74293
44501677,44529788,chr19,CEACAM20,chr19:44501677-44529788,28111
2900928,2918473,chr19,ZNF57,chr19:2900928-2918473,17545
201387858,201480846,chr2,STRADB,chr2:201387858-201480846,92988
19865882,19894674,chr19,ZNF253,chr19:19865882-19894674,28792
45764785,45769252,chr19,SIX5,chr19:45764785-45769252,4467
36604817,36634114,chr19,ZNF382,chr19:36604817-36634114,29297
201410544,201413308,chr2,SCYL2P1,chr2:201410544-201413308,2764
21722771,21767579,chr19,ZNF100,chr19:21722771-21767579,44808
201487421,201619178,chr2,C2CD6,chr2:201487421-201619178,131757
26120030,26125037,chr12,BHLHE41,chr12:26120030-26125037,5007
45079288,45305284,chr19,MARK4,chr19:45079288-45305284,225996
108743424,108757410,chr3,RETNLB,chr3:108743424-108757410,13986
25958232,26079892,chr12,RASSF8,chr12:25958232-26079892,121660
98497681,98498631,chr3,OR5K2,chr3:98497681-98498631,950
38282294,38318575,chr3,SLC22A14,chr3:38282294-38318575,36281
31272013,31297539,chr17,OMG,chr17:31272013-31297539,25526
31303770,31314105,chr17,EVI2B,chr17:31303770-31314105,10335
201549631,201550307,chr2,MTCO2P16,chr2:201549631-201550307,676
201550524,201551049,chr2,MTATP6P16,chr2:201550524-201551049,525
201552859,201553612,chr2,MTCO3P16,chr2:201552859-201553612,753
201553688,201554031,chr2,MTND3P16,chr2:201553688-201554031,343
201554096,201554390,chr2,MTND4LP16,chr2:201554096-201554390,294
201554384,201556051,chr2,MTND4P29,chr2:201554384-201556051,1667
102099244,102479841,chr3,ZPLD1,chr3:102099244-102479841,380597
201556892,201558265,chr2,MTND5P31,chr2:201556892-201558265,1373
201621646,201623430,chr2,ENO1P4,chr2:201621646-201623430,1784
31316410,31321749,chr17,EVI2A,chr17:31316410-31321749,5339
201644870,201698694,chr2,MPP4,chr2:201644870-201698694,53824
40393395,40570832,chr12,MUC19,chr12:40393395-40570832,177437
31345519,31346190,chr17,AK4P1,chr17:31345519-31346190,671
31391675,31538211,chr17,RAB11FIP4,chr17:31391675-31538211,146536
55132698,55149206,chr19,TNNT1,chr19:55132698-55149206,16508
98282505,98284070,chr3,OR5H2,chr3:98282505-98284070,1565
12514934,12561059,chr3,MKRN2OS,chr3:12514934-12561059,46125
195863364,195911945,chr3,TNK2,chr3:195863364-195911945,48581
29149016,29341121,chr12,FAR2,chr12:29149016-29341121,192105
31465543,31465832,chr17,RN7SL79P,chr17:31465543-31465832,289
31518432,31518729,chr17,RN7SL45P,chr17:31518432-31518729,297
31534883,31534971,chr17,MIR4724,chr17:31534883-31534971,88
31559996,31560083,chr17,MIR193A,chr17:31559996-31560083,87
31563768,31563894,chr17,RNU6ATAC7P,chr17:31563768-31563894,126
31575269,31575358,chr17,MIR4725,chr17:31575269-31575358,89
31575411,31575521,chr17,MIR365B,chr17:31575411-31575521,110
37978155,37989060,chr17,TBC1D3L,chr17:37978155-37989060,10905
29337352,29381189,chr12,ERGIC2,chr12:29337352-29381189,43837
76735865,76781449,chr17,MFSD11,chr17:76735865-76781449,45584
29412474,29497686,chr12,OVCH1,chr12:29412474-29497686,85212
57797376,57818734,chr12,AVIL,chr12:57797376-57818734,21358
201646716,201646820,chr2,RNU6-651P,chr2:201646716-201646820,104
201762737,201763573,chr2,RPS2P16,chr2:201762737-201763573,836
201790461,201895550,chr2,CDK15,chr2:201790461-201895550,105089
9624122,9624228,chr12,RNU6-700P,chr12:9624122-9624228,106
9641723,9643011,chr12,GOT2P3,chr12:9641723-9643011,1288
76799044,76807102,chr17,LINC02080,chr17:76799044-76807102,8058
76849840,76861836,chr17,LINC00868,chr17:76849840-76861836,11996
9664969,9699553,chr12,CLEC2D,chr12:9664969-9699553,34584
76868404,76950393,chr17,MGAT5B,chr17:76868404-76950393,81989
235432985,235433231,chr1,RPS21P1,chr1:235432985-235433231,246
235519971,235520685,chr1,MTCYBP14,chr1:235519971-235520685,714
235537520,235538041,chr1,MTND6P14,chr1:235537520-235538041,521
235538052,235539845,chr1,MTND5P19,chr1:235538052-235539845,1793
235540053,235541415,chr1,MTND4P10,chr1:235540053-235541415,1362
235541412,235541706,chr1,MTND4LP21,chr1:235541412-235541706,294
235541759,235542097,chr1,MTND3P8,chr1:235541759-235542097,338
235542159,235542390,chr1,MTCO3P46,chr1:235542159-235542390,231
46489836,46516216,chr1,DMBX1,chr1:46489836-46516216,26380
9779967,9793011,chr3,TADA3,chr3:9779967-9793011,13044
153929501,153946718,chr1,DENND4B,chr1:153929501-153946718,17217
8322584,8343262,chr19,KANK3,chr19:8322584-8343262,20678
30726197,30894661,chr3,GADL1,chr3:30726197-30894661,168464
201824548,201824832,chr2,UBE2V1P11,chr2:201824548-201824832,284
201927439,201927543,chr2,RNU6-440P,chr2:201927439-201927543,104
6057807,6124427,chr17,WSCD1,chr17:6057807-6124427,66620
75664328,75667220,chr3,FRG2C,chr3:75664328-75667220,2892
9695384,9696227,chr12,NPM1P7,chr12:9695384-9696227,843
9704077,9709350,chr12,LINC02390,chr12:9704077-9709350,5273
9752486,9760901,chr12,CD69,chr12:9752486-9760901,8415
153947669,153958615,chr1,CRTC2,chr1:153947669-153958615,10946
201700267,201782112,chr2,ALS2,chr2:201700267-201782112,81845
50188186,50310542,chr19,MYH14,chr19:50188186-50310542,122356
4493345,4847506,chr3,ITPR1,chr3:4493345-4847506,354161
6207163,6207269,chr17,RNU6-1264P,chr17:6207163-6207269,106
6322413,6323228,chr17,BTF3P14,chr17:6322413-6323228,815
9817350,9818025,chr12,GCNAP1,chr12:9817350-9818025,675
78231310,78240987,chr17,TMEM235,chr17:78231310-78240987,9677
9827481,9845007,chr12,KLRF1,chr12:9827481-9845007,17526
45435900,45490749,chr17,PLEKHM1,chr17:45435900-45490749,54849
153962351,153962420,chr1,MIR6737,chr1:153962351-153962420,69
9852369,9869386,chr12,CLEC2B,chr12:9852369-9869386,17017
153967534,153974361,chr1,CREB3L4,chr1:153967534-153974361,6827
9881489,9895833,chr12,KLRF2,chr12:9881489-9895833,14344
45475363,45475435,chr17,MIR4315-1,chr17:45475363-45475435,72
9898673,9932370,chr12,CLEC2A,chr12:9898673-9932370,33697
45553710,45559070,chr17,RDM1P1,chr17:45553710-45559070,5360
45585871,45586929,chr17,DND1P1,chr17:45585871-45586929,1058
45600869,45602340,chr17,MAPK8IP1P2,chr17:45600869-45602340,1471
45608571,45608918,chr17,RPS26P8,chr17:45608571-45608918,347
45620328,45655156,chr17,LINC02210,chr17:45620328-45655156,34828
9936504,9943495,chr12,LINC02470,chr12:9936504-9943495,6991
9948137,9953336,chr12,CLEC12A-AS1,chr12:9948137-9953336,5199
9951316,9995694,chr12,CLEC12A,chr12:9951316-9995694,44378
60392429,60431426,chr17,C17orf64,chr17:60392429-60431426,38997
60433678,60435996,chr17,RPL12P38,chr17:60433678-60435996,2318
60443158,60526242,chr17,APPBP2,chr17:60443158-60526242,83084
60564547,60586623,chr17,LINC01999,chr17:60564547-60586623,22076
60564740,60565671,chr17,RPSAP66,chr17:60564740-60565671,931
60662333,60662437,chr17,RNU6-623P,chr17:60662333-60662437,104
60696313,60696605,chr17,RN7SL606P,chr17:60696313-60696605,292
153974269,153977674,chr1,JTB,chr1:153974269-153977674,3405
60810165,60811462,chr17,KRT18P61,chr17:60810165-60811462,1297
60851382,60851745,chr17,HMGN1P28,chr17:60851382-60851745,363
132822187,132956304,chr12,CHFR,chr12:132822187-132956304,134117
60899891,60900185,chr17,RN7SL448P,chr17:60899891-60900185,294
45393902,45434421,chr17,ARHGAP27,chr17:45393902-45434421,40519
153981617,153986358,chr1,RAB13,chr1:153981617-153986358,4741
35641745,35644871,chr19,ETV2,chr19:35641745-35644871,3126
153990762,153992155,chr1,RPS27,chr1:153990762-153992155,1393
154039916,154040022,chr1,RNU6-179P,chr1:154039916-154040022,106
154078866,154079963,chr1,RPS7P2,chr1:154078866-154079963,1097
154104521,154104592,chr1,MIR5698,chr1:154104521-154104592,71
85249953,85259672,chr1,C1orf52,chr1:85249953-85259672,9719
85265776,85276632,chr1,BCL10,chr1:85265776-85276632,10856
54803611,54814517,chr19,KIR2DL4,chr19:54803611-54814517,10906
42925353,42958893,chr1,SLC2A1,chr1:42925353-42958893,33540
67825503,67984378,chr17,BPTF,chr17:67825503-67984378,158875
3812086,3857396,chr1,CEP104,chr1:3812086-3857396,45310
132825701,132826184,chr12,RPS11P5,chr12:132825701-132826184,483
132835374,132835500,chr12,RNU6-327P,chr12:132835374-132835500,126
132918306,132956306,chr12,ZNF605,chr12:132918306-132956306,38000
132972338,132972890,chr12,NANOGNBP2,chr12:132972338-132972890,552
132986365,133032952,chr12,ZNF26,chr12:132986365-133032952,46587
58467056,58475436,chr19,ZNF324,chr19:58467056-58475436,8380
132995190,132995302,chr12,RNU4ATAC12P,chr12:132995190-132995302,112
133030389,133037222,chr12,ZNF84-DT,chr12:133030389-133037222,6833
133033503,133033956,chr12,PTP4A1P2,chr12:133033503-133033956,453
52153864,52171643,chr19,ZNF836,chr19:52153864-52171643,17779
133037292,133063304,chr12,ZNF84,chr12:133037292-133063304,26012
34677639,34686397,chr19,ZNF302,chr19:34677639-34686397,8758
30709552,30823302,chr12,CAPRIN2,chr12:30709552-30823302,113750
16044621,16044961,chr17,RPLP1P11,chr17:16044621-16044961,340
16084042,16084381,chr17,RPL22P21,chr17:16084042-16084381,339
16098704,16098807,chr17,RNU6-314P,chr17:16098704-16098807,103
16137768,16137872,chr17,RNU6-862P,chr17:16137768-16137872,104
16191832,16192151,chr17,RN7SL442P,chr17:16191832-16192151,319
16217191,16351797,chr17,PIGL,chr17:16217191-16351797,134606
57848731,57889074,chr19,ZNF814,chr19:57848731-57889074,40343
50723364,50725708,chr19,CLEC11A,chr19:50723364-50725708,2344
3857267,3885429,chr1,DFFB,chr1:3857267-3885429,28162
40466241,40576464,chr19,SPTBN4,chr19:40466241-40576464,110223
16282014,16282088,chr17,MIR1288,chr17:16282014-16282088,74
16342534,16353656,chr17,CENPV,chr17:16342534-16353656,11122
16380798,16382745,chr17,UBB,chr17:16380798-16382745,1947
147419053,147419900,chr1,OR13Z1P,chr1:147419053-147419900,847
147445579,147446133,chr1,OR13Z2P,chr1:147445579-147446133,554
147482238,147482628,chr1,OR13Z3P,chr1:147482238-147482628,390
16391434,16391882,chr17,FTLP12,chr17:16391434-16391882,448
147629652,147670524,chr1,ACP6,chr1:147629652-147670524,40872
16415571,16437003,chr17,TRPV2,chr17:16415571-16437003,21432
16439505,16439576,chr17,SNORD49B,chr17:16439505-16439576,71
16440036,16440106,chr17,SNORD49A,chr17:16440036-16440106,70
16441226,16441298,chr17,SNORD65,chr17:16441226-16441298,72
68511780,68551319,chr17,PRKAR1A,chr17:68511780-68551319,39539
184335658,184335949,chr1,RN7SL654P,chr1:184335658-184335949,291
184385753,184386704,chr1,C1orf21-DT,chr1:184385753-184386704,951
184387029,184629019,chr1,C1orf21,chr1:184387029-184629019,241990
23281307,23287488,chr1,LINC01355,chr1:23281307-23287488,6181
23359448,23369836,chr1,ZNF436,chr1:23359448-23369836,10388
54572920,54590287,chr19,LILRA2,chr19:54572920-54590287,17367
23380909,23424748,chr1,TCEA3,chr1:23380909-23424748,43839
30755167,30802602,chr12,LINC00941,chr12:30755167-30802602,47435
235447190,235504452,chr1,B3GALNT2,chr1:235447190-235504452,57262
30861921,30862179,chr12,PPIAP44,chr12:30861921-30862179,258
31363481,31369301,chr12,LINC02387,chr12:31363481-31369301,5820
1103994,1106791,chr19,GPX4,chr19:1103994-1106791,2797
31382226,31591136,chr12,DENND5B,chr12:31382226-31591136,208910
114279011,114279275,chr1,MRPL57P1,chr1:114279011-114279275,264
55999726,56061810,chr19,NLRP5,chr19:55999726-56061810,62084
41046541,41047316,chr17,KRTAP2-1,chr17:41046541-41047316,775
161524540,161526894,chr1,HSPA6,chr1:161524540-161526894,2354
41054498,41055230,chr17,KRTAP2-2,chr17:41054498-41055230,732
161536571,161538158,chr1,RPS23P10,chr1:161536571-161538158,1587
41096981,41098142,chr17,KRTAP4-8,chr17:41096981-41098142,1161
41029351,41030195,chr17,KRTAP1-4,chr17:41029351-41030195,844
41835685,41848384,chr17,KLHL10,chr17:41835685-41848384,12699
161606291,161608217,chr1,HSPA7,chr1:161606291-161608217,1926
161617992,161619585,chr1,RPS23P9,chr1:161617992-161619585,1593
161623196,161631963,chr1,FCGR3B,chr1:161623196-161631963,8767
38878555,38899862,chr19,SIRT2,chr19:38878555-38899862,21307
31396390,31396501,chr12,RNU6-618P,chr12:31396390-31396501,111
31534715,31535247,chr12,ANKRD49P2,chr12:31534715-31535247,532
31589923,31615666,chr12,DENND5B-AS1,chr12:31589923-31615666,25743
31594093,31594206,chr12,RNU5F-4P,chr12:31594093-31594206,113
31597114,31597409,chr12,RPL31P50,chr12:31597114-31597409,295
41848518,41865423,chr17,KLHL11,chr17:41848518-41865423,16905
31615023,31652095,chr12,AK4P3,chr12:31615023-31652095,37072
41866917,41930542,chr17,ACLY,chr17:41866917-41930542,63625
132768902,132829143,chr12,GOLGA3,chr12:132768902-132829143,60241
161683695,161685252,chr1,RPL31P11,chr1:161683695-161685252,1557
161505430,161524013,chr1,FCGR2A,chr1:161505430-161524013,18583
110451149,110457358,chr1,PROK1,chr1:110451149-110457358,6209
110480752,110491277,chr1,CYMP,chr1:110480752-110491277,10525
110487680,110490258,chr1,CYMP-AS1,chr1:110487680-110490258,2578
110517217,110519175,chr1,KCNA10,chr1:110517217-110519175,1958
110672465,110674940,chr1,KCNA3,chr1:110672465-110674940,2475
110848077,110848941,chr1,NRBF2P3,chr1:110848077-110848941,864
110853939,110854892,chr1,OR11I1P,chr1:110853939-110854892,953
177392746,177567024,chr2,AGPS,chr2:177392746-177567024,174278
110519837,110631474,chr1,KCNA2,chr1:110519837-110631474,111637
243917402,244047317,chr1,LINC02774,chr1:243917402-244047317,129915
134795260,135260467,chr3,EPHB1,chr3:134795260-135260467,465207
244103932,244104210,chr1,RN7SL148P,chr1:244103932-244104210,278
57487711,57496098,chr19,ZNF419,chr19:57487711-57496098,8387
244048939,244057476,chr1,ZBTB18,chr1:244048939-244057476,8537
155316863,155324176,chr1,RUSC1-AS1,chr1:155316863-155324176,7313
155320894,155331114,chr1,RUSC1,chr1:155320894-155331114,10220
43766533,43780976,chr19,KCNN4,chr19:43766533-43780976,14443
47850690,48089272,chr3,MAP4,chr3:47850690-48089272,238582
41930617,41966503,chr17,ODAD4,chr17:41930617-41966503,35886
41966763,41977740,chr17,CNP,chr17:41966763-41977740,10977
24676309,24676415,chr2,RNU6-936P,chr2:24676309-24676415,106
24793136,24822376,chr2,CENPO,chr2:24793136-24822376,29240
36916329,36998700,chr19,ZNF568,chr19:36916329-36998700,82371
41976421,42021376,chr17,DNAJC7,chr17:41976421-42021376,44955
24943636,24972094,chr2,DNAJC27,chr2:24943636-24972094,28458
45071500,45076478,chr19,ZNF296,chr19:45071500-45076478,4978
24968958,24969224,chr2,RPS13P5,chr2:24968958-24969224,266
24969388,24969477,chr2,SNORD14,chr2:24969388-24969477,89
39515113,39520686,chr19,SELENOV,chr19:39515113-39520686,5573
25058032,25058329,chr2,RN7SL856P,chr2:25058032-25058329,297
25079901,25081689,chr2,SUCLA2P3,chr2:25079901-25081689,1788
23914876,23945159,chr19,ZNF726,chr19:23914876-23945159,30283
24819169,24920237,chr2,ADCY3,chr2:24819169-24920237,101068
188153284,188890671,chr3,LPP,chr3:188153284-188890671,737387
867630,893218,chr19,MED16,chr19:867630-893218,25588
129001304,129040742,chr3,EFCC1,chr3:129001304-129040742,39438
155346350,155346445,chr1,MIR555,chr1:155346350-155346445,95
155358712,155358818,chr1,RNU6-106P,chr1:155358712-155358818,106
155396010,155396978,chr1,ASH1L-IT1,chr1:155396010-155396978,968
155419397,155419500,chr1,RNU6-1297P,chr1:155419397-155419500,103
155433178,155434262,chr1,POU5F1P4,chr1:155433178-155434262,1084
155586644,155602197,chr1,DAP3P1,chr1:155586644-155602197,15553
35638945,35794496,chr3,ARPP21,chr3:35638945-35794496,155551
127701027,127811187,chr2,WDR33,chr2:127701027-127811187,110160
155610205,155614951,chr1,MSTO1,chr1:155610205-155614951,4746
127701497,127705242,chr2,SFT2D3,chr2:127701497-127705242,3745
127798903,127798998,chr2,RNY4P7,chr2:127798903-127798998,95
127840606,127841763,chr2,ZFP91P1,chr2:127840606-127841763,1157
127843553,127858155,chr2,POLR2D,chr2:127843553-127858155,14602
127845236,127845341,chr2,RNU6-395P,chr2:127845236-127845341,105
127846736,127847084,chr2,RPS26P19,chr2:127846736-127847084,348
113098819,113136239,chr12,RASAL1,chr12:113098819-113136239,37420
127861630,127885967,chr2,AMMECR1L,chr2:127861630-127885967,24337
155308748,155320666,chr1,FDPS,chr1:155308748-155320666,11918
20619939,20661596,chr19,ZNF626,chr19:20619939-20661596,41657
127941217,128028120,chr2,SAP130,chr2:127941217-128028120,86903
18257098,18274500,chr19,IQCN,chr19:18257098-18274500,17402
22752183,22784151,chr19,ZNF99,chr19:22752183-22784151,31968
36636618,36666853,chr19,ZNF461,chr19:36636618-36666853,30235
1383527,1395589,chr19,NDUFS7,chr19:1383527-1395589,12062
108875350,108934545,chr1,GPSM2,chr1:108875350-108934545,59195
113107214,113134016,chr2,IL1RN,chr2:113107214-113134016,26802
10824960,11171608,chr12,PRH1,chr12:10824960-11171608,346648
42011382,42025644,chr17,NKIRAS2,chr17:42011382-42025644,14262
57253762,57431043,chr12,R3HDM2,chr12:57253762-57431043,177281
113157325,113209396,chr2,PSD4,chr2:113157325-113209396,52071
42038232,42050601,chr17,C17orf113,chr17:42038232-42050601,12369
42101404,42112714,chr17,DHX58,chr17:42101404-42112714,11310
113211421,113276581,chr2,PAX8-AS1,chr2:113211421-113276581,65160
39246314,39248856,chr19,IFNL4,chr19:39246314-39248856,2542
48954815,48961798,chr19,BAX,chr19:48954815-48961798,6983
42113111,42121367,chr17,KAT2A,chr17:42113111-42121367,8256
4562208,4615302,chr12,DYRK4,chr12:4562208-4615302,53094
46039182,46077118,chr19,IGFL4,chr19:46039182-46077118,37936
46189029,46203160,chr19,IGFL2-AS1,chr19:46189029-46203160,14131
51395867,51500015,chr3,DCAF1,chr3:51395867-51500015,104148
113215997,113278921,chr2,PAX8,chr2:113215997-113278921,62924
81251789,81252096,chr1,RN7SKP247,chr1:81251789-81252096,307
44805893,44807351,chr1,DYNLT4,chr1:44805893-44807351,1458
143652050,143652215,chr1,RNU1-114P,chr1:143652050-143652215,165
46196238,46197323,chr19,IGFL1P1,chr19:46196238-46197323,1085
143699456,143699619,chr1,RNVU1-17,chr1:143699456-143699619,163
143720510,143720644,chr1,RNVU1-23,chr1:143720510-143720644,134
143729407,143729570,chr1,RNVU1-18,chr1:143729407-143729570,163
143766540,143769083,chr1,FAM91A3P,chr1:143766540-143769083,2543
143790010,143797108,chr1,LINC02591,chr1:143790010-143797108,7098
46219423,46219920,chr19,RPL12P41,chr19:46219423-46219920,497
42122804,42123352,chr17,HSPB9,chr17:42122804-42123352,548
143791542,143791687,chr1,RNU1-143P,chr1:143791542-143791687,145
143811359,143825837,chr1,PDE4DIPP3,chr1:143811359-143825837,14478
46229742,46231243,chr19,IGFL1,chr19:46229742-46231243,1501
42025576,42098479,chr17,ZNF385C,chr17:42025576-42098479,72903
11265914,11269707,chr12,PRB3,chr12:11265914-11269707,3793
143874793,143883575,chr1,FCGR1CP,chr1:143874793-143883575,8782
143875171,143904650,chr1,H2BP2,chr1:143875171-143904650,29479
57668935,57679152,chr19,ZSCAN4,chr19:57668935-57679152,10217
57234903,57240715,chr12,NDUFA4L2,chr12:57234903-57240715,5812
113211003,113287459,chr3,BOC,chr3:113211003-113287459,76456
143929994,143930382,chr1,RPL22P5,chr1:143929994-143930382,388
7056207,7069665,chr19,MBD3L3,chr19:7056207-7069665,13458
143975087,144068350,chr1,SRGAP2D,chr1:143975087-144068350,93263
60600193,60666280,chr17,PPM1D,chr17:60600193-60666280,66087
144085628,144086098,chr1,IGKV1OR1-1,chr1:144085628-144086098,470
38433691,38595273,chr19,RYR1,chr19:38433691-38595273,161582
215005775,215237090,chr1,KCNK2,chr1:215005775-215237090,231315
95858952,95903828,chr12,SNRPF,chr12:95858952-95903828,44876
10407384,10409757,chr12,KLRC4,chr12:10407384-10409757,2373
56316223,56334053,chr12,PAN2,chr12:56316223-56334053,17830
82101460,82212830,chr17,CCDC57,chr17:82101460-82212830,111370
141324213,141449792,chr3,ZBTB38,chr3:141324213-141449792,125579
17681458,17811453,chr17,RAI1,chr17:17681458-17811453,129995
113406396,113406872,chr2,IGKV1OR2-108,chr2:113406396-113406872,476
154206696,154220637,chr1,C1orf43,chr1:154206696-154220637,13941
55231903,55235853,chr2,RPS27A,chr2:55231903-55235853,3950
64147227,64263260,chr17,TEX2,chr17:64147227-64263260,116033
25597984,25664907,chr3,TOP2B,chr3:25597984-25664907,66923
108167125,108217886,chr2,LINC01594,chr2:108167125-108217886,50761
108226015,108226331,chr2,SETD6P1,chr2:108226015-108226331,316
108276812,108277942,chr2,WASF1P1,chr2:108276812-108277942,1130
108288639,108309915,chr2,SULT1C2,chr2:108288639-108309915,21276
193059454,193091777,chr1,RO60,chr1:193059454-193091777,32323
41619442,41624842,chr17,KRT17,chr17:41619442-41624842,5400
50175788,50283520,chr12,LIMA1,chr12:50175788-50283520,107732
4932277,4935023,chr17,GP1BA,chr17:4932277-4935023,2746
65528563,65561648,chr17,AXIN2,chr17:65528563-65561648,33085
108317725,108318611,chr2,SULT1C2P2,chr2:108317725-108318611,886
108322238,108353799,chr2,SULT1C2P1,chr2:108322238-108353799,31561
108367116,108367938,chr2,GMCL1P2,chr2:108367116-108367938,822
108377911,108388989,chr2,SULT1C4,chr2:108377911-108388989,11078
108423612,108423885,chr2,SMIM12P1,chr2:108423612-108423885,273
99400475,99490035,chr2,REV1,chr2:99400475-99490035,89560
50532682,50543750,chr17,EPN3,chr17:50532682-50543750,11068
27332836,27425289,chr12,ARNTL2,chr12:27332836-27425289,92453
167478684,167653983,chr3,WDR49,chr3:167478684-167653983,175299
115700021,115768714,chr1,CASQ2,chr1:115700021-115768714,68693
114089291,114153880,chr1,SYT6,chr1:114089291-114153880,64589
49689594,49690575,chr19,ADM5,chr19:49689594-49690575,981
18097778,18151692,chr19,MAST3,chr19:18097778-18151692,53914
51538719,51668667,chr3,RAD54L2,chr3:51538719-51668667,129948
28744011,28750956,chr17,TRAF4,chr17:28744011-28750956,6945
156337314,156346995,chr1,TSACC,chr1:156337314-156346995,9681
39863323,39934626,chr19,FCGBP,chr19:39863323-39934626,71303
50659255,50719802,chr19,SHANK1,chr19:50659255-50719802,60547
43172330,43254358,chr1,CFAP57,chr1:43172330-43254358,82028
100208254,100251484,chr2,LINC01104,chr2:100208254-100251484,43230
18225635,18244875,chr17,LLGL1,chr17:18225635-18244875,19240
56620132,56683265,chr3,TASOR,chr3:56620132-56683265,63133
130036958,130038422,chr2,KLF2P1,chr2:130036958-130038422,1464
130048426,130049440,chr2,CYP4F27P,chr2:130048426-130049440,1014
130073535,130129222,chr2,POTEF,chr2:130073535-130129222,55687
130107684,130109741,chr2,POTEF-AS1,chr2:130107684-130109741,2057
130109204,130109310,chr2,RNU6-1049P,chr2:130109204-130109310,106
237798389,237842808,chr2,RBM44,chr2:237798389-237842808,44419
8721634,8732160,chr19,OR2Z1,chr19:8721634-8732160,10526
9100407,9107475,chr19,OR7G2,chr19:9100407-9107475,7068
191678068,191741097,chr2,NABP1,chr2:191678068-191741097,63029
107104,117102,chr19,OR4F17,chr19:107104-117102,9998
41184100,41184911,chr17,KRTAP4-1,chr17:41184100-41184911,811
63909597,63911341,chr17,CSHL1,chr17:63909597-63911341,1744
43164175,43270936,chr1,EBNA1BP2,chr1:43164175-43270936,106761
44662278,44684359,chr19,CEACAM19,chr19:44662278-44684359,22081
11273198,11296049,chr1,UBIAD1,chr1:11273198-11296049,22851
141763408,141819352,chr3,GRK7,chr3:141763408-141819352,55944
121400083,121430623,chr12,RNF34,chr12:121400083-121430623,30540
46143106,46161298,chr19,IGFL2,chr19:46143106-46161298,18192
68867289,68955392,chr17,ABCA8,chr17:68867289-68955392,88103
14402576,14489349,chr3,SLC6A6,chr3:14402576-14489349,86773
119031216,119140654,chr1,WARS2,chr1:119031216-119140654,109438
29525994,29564551,chr19,VSTM2B,chr19:29525994-29564551,38557
212363928,212414901,chr1,PACC1,chr1:212363928-212414901,50973
14072536,14075062,chr19,MISP3,chr19:14072536-14075062,2526
8832377,8843340,chr19,MBD3L1,chr19:8832377-8843340,10963
92466451,92492091,chr12,LINC02397,chr12:92466451-92492091,25640
41619015,41627074,chr19,CEACAM4,chr19:41619015-41627074,8059
68674371,68687755,chr12,NUP107-DT,chr12:68674371-68687755,13384
1352689,1361777,chr1,MXRA8,chr1:1352689-1361777,9088
130144315,130162256,chr12,FZD10-AS1,chr12:130144315-130162256,17941
41998321,42070206,chr19,GRIK5,chr19:41998321-42070206,71885
91984976,92142914,chr12,LINC01619,chr12:91984976-92142914,157938
191733428,191741097,chr2,NABP1-OT1,chr2:191733428-191741097,7669
98512973,98516422,chr12,TMPO-AS1,chr12:98512973-98516422,3449
191834310,191847088,chr2,CAVIN2,chr2:191834310-191847088,12778
191881182,191882205,chr2,DNAJB1P1,chr2:191881182-191882205,1023
29389289,29487488,chr12,OVCH1-AS1,chr12:29389289-29487488,98199
191199241,191265615,chr3,OSTN,chr3:191199241-191265615,66374
73892314,73919865,chr2,ACTG2,chr2:73892314-73919865,27551
132186735,132189728,chr12,LINC02361,chr12:132186735-132189728,2993
4247981,4276252,chr12,CCND2-AS1,chr12:4247981-4276252,28271
15667236,15859771,chr3,ANKRD28,chr3:15667236-15859771,192535
109052349,109053984,chr12,USP30-AS1,chr12:109052349-109053984,1635
27725961,27763116,chr1,FAM76A,chr1:27725961-27763116,37155
126729787,126772519,chr12,LINC00944,chr12:126729787-126772519,42732
14147743,14206187,chr19,ADGRL1,chr19:14147743-14206187,58444
89010681,89309566,chr12,LINC02458,chr12:89010681-89309566,298885
25936683,25959765,chr12,RASSF8-AS1,chr12:25936683-25959765,23082
73926826,73958961,chr2,DGUOK,chr2:73926826-73958961,32135
193090866,193106114,chr1,GLRX2,chr1:193090866-193106114,15248
10553362,10572688,chr12,LINC02446,chr12:10553362-10572688,19326
57119138,57131926,chr19,USP29,chr19:57119138-57131926,12788
65589111,65614169,chr12,LINC02454,chr12:65589111-65614169,25058
73968123,73968206,chr2,RNA5SP97,chr2:73968123-73968206,83
13952509,13961449,chr19,DCAF15,chr19:13952509-13961449,8940
6439001,6451568,chr12,CD27-AS1,chr12:6439001-6451568,12567
73984910,74108176,chr2,TET3,chr2:73984910-74108176,123266
77695987,77759852,chr1,USP33,chr1:77695987-77759852,63865
41105332,41106488,chr17,KRTAP4-9,chr17:41105332-41106488,1156
41084150,41085141,chr17,KRTAP4-7,chr17:41084150-41085141,991
38324571,38343956,chr17,GPR179,chr17:38324571-38343956,19385
113947901,113965401,chr3,ZDHHC23,chr3:113947901-113965401,17500
53013921,53016123,chr19,ERVV-1,chr19:53013921-53016123,2202
67377281,67697256,chr17,PITPNC1,chr17:67377281-67697256,319975
40216058,40218384,chr19,TTC9B,chr19:40216058-40218384,2326
54724442,54736632,chr19,KIR3DL3,chr19:54724442-54736632,12190
90576402,90889917,chr12,LINC02822,chr12:90576402-90889917,313515
39107680,39138903,chr3,TTC21A,chr3:39107680-39138903,31223
69319780,69387250,chr2,GFPT1,chr2:69319780-69387250,67470
97713412,97761859,chr12,PAFAH1B2P2,chr12:97713412-97761859,48447
3933069,3942416,chr19,NMRK2,chr19:3933069-3942416,9347
68267026,68291267,chr17,SLC16A6,chr17:68267026-68291267,24241
68332888,68451679,chr12,LINC02384,chr12:68332888-68451679,118791
16689537,16777881,chr17,CCDC144A,chr17:16689537-16777881,88344
40156113,40211419,chr12,LINC02471,chr12:40156113-40211419,55306
55891699,55932336,chr19,NLRP13,chr19:55891699-55932336,40637
2740047,2746665,chr12,LINC02371,chr12:2740047-2746665,6618
56300076,56317992,chr12,CNPY2-AS1,chr12:56300076-56317992,17916
95551582,95673999,chr12,PGAM1P5,chr12:95551582-95673999,122417
7728957,7733906,chr19,CLEC4G,chr19:7728957-7733906,4949
97430884,97598415,chr12,RMST,chr12:97430884-97598415,167531
38211006,38229714,chr19,DPF1,chr19:38211006-38229714,18708
69457997,69674349,chr2,AAK1,chr2:69457997-69674349,216352
33496245,33718356,chr3,CLASP2,chr3:33496245-33718356,222111
12789498,12991643,chr17,ARHGAP44,chr17:12789498-12991643,202145
148644440,148787569,chr2,EPC2,chr2:148644440-148787569,143129
58920639,59065312,chr12,LRIG3-DT,chr12:58920639-59065312,144673
7108052,7122524,chr12,C1RL-AS1,chr12:7108052-7122524,14472
3871579,3910384,chr12,PARP11-AS1,chr12:3871579-3910384,38805
30931506,31065991,chr1,PUM1,chr1:30931506-31065991,134485
55729094,55730857,chr12,CD63-AS1,chr12:55729094-55730857,1763
148825691,148825835,chr2,RNU2-9P,chr2:148825691-148825835,144
45172815,45216047,chr12,PLEKHA8P1,chr12:45172815-45216047,43232
148875227,149026759,chr2,KIF5C,chr2:148875227-149026759,151532
113583886,113773726,chr12,LINC01234,chr12:113583886-113773726,189840
12927712,12984645,chr12,GPRC5D-AS1,chr12:12927712-12984645,56933
12355403,12357067,chr12,LOH12CR2,chr12:12355403-12357067,1664
31019434,31073847,chr12,DDX11-AS1,chr12:31019434-31073847,54413
120488079,120495946,chr12,NRAV,chr12:120488079-120495946,7867
47205896,47216460,chr12,PCED1B-AS1,chr12:47205896-47216460,10564
38319845,38332076,chr19,KCNK6,chr19:38319845-38332076,12231
54126053,54147485,chr12,LINC02381,chr12:54126053-54147485,21432
1517718,1562792,chr17,PITPNA,chr17:1517718-1562792,45074
13862063,13880757,chr19,NANOS3,chr19:13862063-13880757,18694
53298655,53300364,chr12,MYG1-AS1,chr12:53298655-53300364,1709
13882348,13906452,chr19,BRME1,chr19:13882348-13906452,24104
8180209,8216151,chr12,FAM66C,chr12:8180209-8216151,35942
1782075,1812276,chr19,ATP8B3,chr19:1782075-1812276,30201
47706058,47742294,chr12,RPAP3-DT,chr12:47706058-47742294,36236
114408131,114412832,chr12,TBX5-AS1,chr12:114408131-114412832,4701
18327860,18363563,chr17,SHMT1,chr17:18327860-18363563,35703
92145573,92226557,chr12,BTG1-DT,chr12:92145573-92226557,80984
149038107,149215262,chr2,LYPD6B,chr2:149038107-149215262,177155
48998367,49019241,chr12,DDN-AS1,chr12:48998367-49019241,20874
31876969,31959316,chr12,LINC02422,chr12:31876969-31959316,82347
55829608,55836246,chr12,TMEM198B,chr12:55829608-55836246,6638
29698937,29715789,chr19,C19orf12,chr19:29698937-29715789,16852
149320593,149321436,chr2,FAM8A3P,chr2:149320593-149321436,843
149329985,149474138,chr2,LYPD6,chr2:149329985-149474138,144153
39243455,39245250,chr19,IFNL3,chr19:39243455-39245250,1795
16630751,16660442,chr19,SMIM7,chr19:16630751-16660442,29691
149439897,149440427,chr2,RPL17P13,chr2:149439897-149440427,530
120201274,120213231,chr12,PXN-AS1,chr12:120201274-120213231,11957
149569637,149587778,chr2,MMADHC,chr2:149569637-149587778,18141
28473293,28497781,chr17,SLC13A2,chr17:28473293-28497781,24488
99828811,100114513,chr3,FILIP1L,chr3:99828811-100114513,285702
69901918,70243398,chr12,PRANCR,chr12:69901918-70243398,341480
129249606,129277773,chr3,COPG1,chr3:129249606-129277773,28167
123363868,123366113,chr12,SBNO1-AS1,chr12:123363868-123366113,2245
110934590,110959093,chr12,LINC01405,chr12:110934590-110959093,24503
29071122,29180398,chr17,MYO18A,chr17:29071122-29180398,109276
6460786,6466175,chr1,TNFRSF25,chr1:6460786-6466175,5389
111839758,111842902,chr12,MAPKAPK5-AS1,chr12:111839758-111842902,3144
149610668,149610774,chr2,RNU6-601P,chr2:149610668-149610774,106
149745648,149859191,chr2,LINC01931,chr2:149745648-149859191,113543
150169474,150356460,chr2,LINC01818,chr2:150169474-150356460,186986
150234892,150257007,chr2,LINC01817,chr2:150234892-150257007,22115
113471981,113480636,chr12,LHX5-AS1,chr12:113471981-113480636,8655
130151392,130182750,chr2,SMPD4,chr2:130151392-130182750,31358
129272146,129272243,chr3,MIR6826,chr3:129272146-129272243,97
129278828,129306186,chr3,HMCES,chr3:129278828-129306186,27358
132084275,132131639,chr12,EP400P1,chr12:132084275-132131639,47364
16661139,16690023,chr19,TMEM38A,chr19:16661139-16690023,28884
98485544,98503858,chr12,LINC02453,chr12:98485544-98503858,18314
9715860,9733299,chr12,CLECL1,chr12:9715860-9733299,17439
589881,617159,chr19,HCN2,chr19:589881-617159,27278
129314771,129316286,chr3,H1-10,chr3:129314771-129316286,1515
129315392,129326225,chr3,H1-10-AS1,chr3:129315392-129326225,10833
129323046,129325426,chr3,NUP210P3,chr3:129323046-129325426,2380
617221,633537,chr19,POLRMT,chr19:617221-633537,16316
129397210,129397348,chr3,SNORA7B,chr3:129397210-129397348,138
129401321,129428651,chr3,EFCAB12,chr3:129401321-129428651,27330
129430947,129440179,chr3,MBD4,chr3:129430947-129440179,9232
57930115,57936345,chr12,GIHCG,chr12:57930115-57936345,6230
639879,644373,chr19,FGF22,chr19:639879-644373,4494
647526,663233,chr19,RNF126,chr19:647526-663233,15707
129528639,129535344,chr3,RHO,chr3:129528639-129535344,6705
129543175,129551467,chr3,H1-8,chr3:129543175-129551467,8292
129555214,129606676,chr3,PLXND1,chr3:129555214-129606676,51462
676392,683392,chr19,FSTL3,chr19:676392-683392,7000
18108756,18179802,chr17,MYO15A,chr17:18108756-18179802,71046
11237450,11241943,chr19,ANGPTL8,chr19:11237450-11241943,4493
11296139,11326996,chr19,TSPAN16,chr19:11296139-11326996,30857
150293861,150308979,chr1,MRPS21,chr1:150293861-150308979,15118
11322068,11346270,chr19,RAB3D,chr19:11322068-11346270,24202
129591349,129591635,chr3,RN7SL752P,chr3:129591349-129591635,286
48222685,48248644,chr1,SLC5A9,chr1:48222685-48248644,25959
4229523,4237528,chr19,EBI3,chr19:4229523-4237528,8005
134485699,134587789,chr3,CEP63,chr3:134485699-134587789,102090
13795443,13832254,chr19,ZSWIM4,chr19:13795443-13832254,36811
4182689,4224814,chr19,ANKRD24,chr19:4182689-4224814,42125
23762944,23871162,chr19,RPSAP58,chr19:23762944-23871162,108218
47227998,47283451,chr3,KIF9,chr3:47227998-47283451,55453
211258377,211316385,chr1,RCOR3,chr1:211258377-211316385,58008
74549026,74557551,chr2,DOK1,chr2:74549026-74557551,8525
17555649,17583162,chr19,COLGALT1,chr19:17555649-17583162,27513
110211529,110245420,chr2,MTLN,chr2:110211529-110245420,33891
5277734,5278133,chr19,RPL32P34,chr19:5277734-5278133,399
64506865,64542461,chr17,CEP95,chr17:64506865-64542461,35596
5158495,5340812,chr19,PTPRS,chr19:5158495-5340812,182317
88170295,88186636,chr2,THNSL2,chr2:88170295-88186636,16341
6375148,6379058,chr19,PSPN,chr19:6375148-6379058,3910
109105951,109113857,chr1,C1orf194,chr1:109105951-109113857,7906
63773603,63819317,chr17,DDX42,chr17:63773603-63819317,45714
6413102,6424811,chr19,KHSRP,chr19:6413102-6424811,11709
76747685,77593319,chr2,LRRTM4,chr2:76747685-77593319,845634
150468195,150539011,chr2,RND3,chr2:150468195-150539011,70816
24899511,24965121,chr1,RUNX3,chr1:24899511-24965121,65610
151188099,151188223,chr3,RNA5SP145,chr3:151188099-151188223,124
151197832,151203216,chr3,GPR171,chr3:151197832-151203216,5384
11355386,11365698,chr19,PLPPR2,chr19:11355386-11365698,10312
151212117,151278542,chr3,P2RY14,chr3:151212117-151278542,66425
31296982,31364953,chr1,ZCCHC17,chr1:31296982-31364953,67971
151269440,151270129,chr3,SETP11,chr3:151269440-151270129,689
151294086,151316820,chr3,GPR87,chr3:151294086-151316820,22734
151326312,151329549,chr3,P2RY13,chr3:151326312-151329549,3237
151336843,151384753,chr3,P2RY12,chr3:151336843-151384753,47910
151475804,151476174,chr3,MRPL42P6,chr3:151475804-151476174,370
151565876,151565995,chr3,MIR5186,chr3:151565876-151565995,119
151425384,151461061,chr3,IGSF10,chr3:151425384-151461061,35677
58543299,58543578,chr19,RN7SL525P,chr19:58543299-58543578,279
58544064,58550722,chr19,TRIM28,chr19:58544064-58550722,6658
202773150,202871766,chr2,ICA1L,chr2:202773150-202871766,98616
46921726,46982010,chr3,CCDC12,chr3:46921726-46982010,60284
28954901,29006440,chr17,SEZ6,chr17:28954901-29006440,51539
129647792,129893711,chr3,TMCC1,chr3:129647792-129893711,245919
44241886,44332098,chr3,TOPAZ1,chr3:44241886-44332098,90212
44338119,44409451,chr3,TCAIM,chr3:44338119-44409451,71332
166839447,166856359,chr1,POGK,chr1:166839447-166856359,16912
58550285,58550376,chr19,MIR6807,chr19:58550285-58550376,91
58555712,58558954,chr19,UBE2M,chr19:58555712-58558954,3242
60041008,60078922,chr17,HEATR6,chr17:60041008-60078922,37914
32364633,32394731,chr1,BSDC1,chr1:32364633-32394731,30098
58551452,58555105,chr19,CHMP2A,chr19:58551452-58555105,3653
4502192,4518486,chr19,PLIN4,chr19:4502192-4518486,16294
47608196,47703277,chr19,BICRA,chr19:47608196-47703277,95081
202033855,202038441,chr2,FZD7,chr2:202033855-202038441,4586
43230851,43596038,chr2,THADA,chr2:43230851-43596038,365187
35935358,35946624,chr19,LRFN3,chr19:35935358-35946624,11266
44421127,44439946,chr3,C3orf86,chr3:44421127-44439946,18819
50962174,51120868,chr17,SPAG9,chr17:50962174-51120868,158694
35995188,35996312,chr19,SDHAF1,chr19:35995188-35996312,1124
36003307,36008813,chr19,SYNE4,chr19:36003307-36008813,5506
205336061,205357090,chr1,KLHDC8A,chr1:205336061-205357090,21029
129429607,129520510,chr3,IFT122,chr3:129429607-129520510,90903
42086110,42196585,chr19,POU2F2,chr19:42086110-42196585,110475
77888513,77943895,chr1,NEXN,chr1:77888513-77943895,55382
156243320,156248117,chr1,PAQR6,chr1:156243320-156248117,4797
185767847,185767904,chr3,MIR548AQ,chr3:185767847-185767904,57
185914558,185938103,chr3,TRA2B,chr3:185914558-185938103,23545
185959943,185980872,chr3,NMRAL2P,chr3:185959943-185980872,20929
71289769,71305853,chr3,FOXP1-AS1,chr3:71289769-71305853,16084
71541970,71542089,chr3,MIR1284,chr3:71541970-71542089,119
71570255,71574457,chr3,FOXP1-IT1,chr3:71570255-71574457,4202
69739456,69968336,chr3,MITF,chr3:69739456-69968336,228880
183636085,183928532,chr1,RGL1,chr1:183636085-183928532,292447
47896150,47928957,chr17,SP2,chr17:47896150-47928957,32807
43875357,43909711,chr17,MPP2,chr17:43875357-43909711,34354
102311529,102398777,chr2,IL18R1,chr2:102311529-102398777,87248
27369110,27374824,chr1,FCN3,chr1:27369110-27374824,5714
118942194,118994660,chr2,MARCO,chr2:118942194-118994660,52466
77944055,77979110,chr1,FUBP1,chr1:77944055-77979110,35055
36009120,36014239,chr19,ALKBH6,chr19:36009120-36014239,5119
206642487,206649365,chr2,FAM237A,chr2:206642487-206649365,6878
132147591,132257969,chr2,ANKRD30BL,chr2:132147591-132257969,110378
87002559,87021852,chr2,PLGLB1,chr2:87002559-87021852,19293
24789728,24793391,chr2,PTRHD1,chr2:24789728-24793391,3663
31865060,32011230,chr2,MEMO1,chr2:31865060-32011230,146170
11495544,11495622,chr19,MIR7974,chr19:11495544-11495622,78
11516047,11516330,chr19,RN7SL833P,chr19:11516047-11516330,283
119368779,119394130,chr1,HAO2,chr1:119368779-119394130,25351
96184859,96208827,chr2,STARD7,chr2:96184859-96208827,23968
11505929,11529172,chr19,ECSIT,chr19:11505929-11529172,23243
109750080,109764027,chr1,EPS8L3,chr1:109750080-109764027,13947
72129238,72147862,chr2,CYP26B1,chr2:72129238-72147862,18624
6840570,6866635,chr2,CMPK2,chr2:6840570-6866635,26065
158696892,158732489,chr3,RARRES1,chr3:158696892-158732489,35597
158732198,158829719,chr3,MFSD1,chr3:158732198-158829719,97521
7843083,7853512,chr1,UTS2,chr1:7843083-7853512,10429
110513802,110577222,chr2,RGPD6,chr2:110513802-110577222,63420
41386371,41397362,chr19,EXOSC5,chr19:41386371-41397362,10991
96721665,96823738,chr1,PTBP2,chr1:96721665-96823738,102073
7677088,7679829,chr19,MCEMP1,chr19:7677088-7679829,2741
7830218,7864976,chr19,EVI5L,chr19:7830218-7864976,34758
42824385,42843760,chr17,PSME3,chr17:42824385-42843760,19375
227610090,227648606,chr2,C2orf83,chr2:227610090-227648606,38516
63440770,63593721,chr1,ITGB3BP,chr1:63440770-63593721,152951
200830009,200830116,chr2,RNU6-31P,chr2:200830009-200830116,107
200844240,200845461,chr2,BICD1P1,chr2:200844240-200845461,1221
200849038,200849144,chr2,RNA5SP115,chr2:200849038-200849144,106
200870907,200889303,chr2,PPIL3,chr2:200870907-200889303,18396
7958573,8005659,chr19,ELAVL1,chr19:7958573-8005659,47086
158763431,158763753,chr3,RPL35AP9,chr3:158763431-158763753,322
158841093,158841960,chr3,GPR79,chr3:158841093-158841960,867
17601336,17688365,chr19,UNC13A,chr19:17601336-17688365,87029
158962928,159266307,chr3,IQCJ,chr3:158962928-159266307,303379
159282646,159282734,chr3,MIR3919,chr3:159282646-159282734,88
159765387,159768612,chr3,IQCJ-SCHIP1-AS1,chr3:159765387-159768612,3225
159808416,159808570,chr3,RNU2-31P,chr3:159808416-159808570,154
159839861,159897360,chr3,SCHIP1,chr3:159839861-159897360,57499
26051301,26068436,chr1,TRIM63,chr1:26051301-26068436,17135
110210314,110283100,chr1,KCNC4,chr1:110210314-110283100,72786
159988835,159996019,chr3,IL12A,chr3:159988835-159996019,7184
200881715,200881821,chr2,RNU6-312P,chr2:200881715-200881821,106
200899020,200899121,chr2,RNU6-762P,chr2:200899020-200899121,101
200908977,200963680,chr2,ORC2,chr2:200908977-200963680,54703
203626787,203744081,chr1,ATP2B4,chr1:203626787-203744081,117294
17719242,17734513,chr19,MAP1S,chr19:17719242-17734513,15271
160016024,160031423,chr3,LINC01100,chr3:160016024-160031423,15399
70954693,71583978,chr3,FOXP1,chr3:70954693-71583978,629285
16029157,16218185,chr17,NCOR1,chr17:16029157-16218185,189028
201063089,201064051,chr2,HNRNPA1P35,chr2:201063089-201064051,962
201066691,201067191,chr2,RPL23AP30,chr2:201066691-201067191,500
201079842,201079944,chr2,RNU6-1206P,chr2:201079842-201079944,102
201102089,201102957,chr2,RPL17P10,chr2:201102089-201102957,868
201137516,201140027,chr2,IMPDH1P10,chr2:201137516-201140027,2511
201140278,201157823,chr2,CFLAR-AS1,chr2:201140278-201157823,17545
201141904,201141966,chr2,RNU7-45P,chr2:201141904-201141966,62
201162484,201162680,chr2,RPL38P5,chr2:201162484-201162680,196
201182898,201229406,chr2,CASP10,chr2:201182898-201229406,46508
37489993,37514766,chr1,MEAF6,chr1:37489993-37514766,24773
17794828,17813576,chr19,B3GNT3,chr19:17794828-17813576,18748
17816512,17821574,chr19,INSL3,chr19:17816512-17821574,5062
17747718,17788568,chr19,FCHO1,chr19:17747718-17788568,40850
12773738,12777906,chr1,PRAMEF12,chr1:12773738-12777906,4168
26164101,26168963,chr1,C1orf232,chr1:26164101-26168963,4862
167430640,167518610,chr1,CD247,chr1:167430640-167518610,87970
160276807,160286348,chr1,PEX19,chr1:160276807-160286348,9541
201212283,201213081,chr2,MTND5P25,chr2:201212283-201213081,798
201213298,201214660,chr2,MTND4P23,chr2:201213298-201214660,1362
201214653,201214950,chr2,MTND4LP13,chr2:201214653-201214950,297
201071433,201085750,chr2,NDUFB3,chr2:201071433-201085750,14317
172464262,172466022,chr2,ITGA6-AS1,chr2:172464262-172466022,1760
43637260,43767987,chr2,PLEKHH2,chr2:43637260-43767987,130727
40072710,40097260,chr1,PPT1,chr1:40072710-40097260,24550
43772120,43772350,chr2,RN7SKP66,chr2:43772120-43772350,230
43774039,43810010,chr2,DYNC2LI1,chr2:43774039-43810010,35971
6467122,6520074,chr1,PLEKHG5,chr1:6467122-6520074,52952
43812472,43838865,chr2,ABCG5,chr2:43812472-43838865,26393
43831942,43882988,chr2,ABCG8,chr2:43831942-43882988,51046
43892690,43892796,chr2,RNU6-1048P,chr2:43892690-43892796,106
43904412,43904693,chr2,RN7SL455P,chr2:43904412-43904693,281
44154789,44154895,chr2,RNU6-566P,chr2:44154789-44154895,106
44166266,44166943,chr2,PDSS1P2,chr2:44166266-44166943,677
44167625,44168859,chr2,PPM1B-DT,chr2:44167625-44168859,1234
43675151,43676429,chr2,C1GALT1C1L,chr2:43675151-43676429,1278
202840331,202841781,chr2,KRT8P15,chr2:202840331-202841781,1450
202912214,202988263,chr2,CARF,chr2:202912214-202988263,76049
41189887,41190639,chr17,KRTAP9-1,chr17:41189887-41190639,752
82458180,82490537,chr17,NARF,chr17:82458180-82490537,32357
18282077,18282161,chr19,MIR3188,chr19:18282077-18282161,84
18333276,18333573,chr19,RN7SL513P,chr19:18333276-18333573,297
18374731,18389176,chr19,GDF15,chr19:18374731-18389176,14445
139005806,139360497,chr3,MRPS22,chr3:139005806-139360497,354691
18386562,18386634,chr19,MIR3189,chr19:18386562-18386634,72
18442663,18522116,chr19,ELL,chr19:18442663-18522116,79453
1633858,1645744,chr17,SCARF1,chr17:1633858-1645744,11886
202924609,202925904,chr2,KRT8P52,chr2:202924609-202925904,1295
203040108,203040899,chr2,RPL7P14,chr2:203040108-203040899,791
203074685,203075142,chr2,RPL23AP36,chr2:203074685-203075142,457
203190780,203191277,chr2,RPL12P16,chr2:203190780-203191277,497
37312837,37369365,chr19,ZNF875,chr19:37312837-37369365,56528
40019097,40061215,chr17,MED24,chr17:40019097-40061215,42118
43886224,43996226,chr2,LRPPRC,chr2:43886224-43996226,110002
178094104,178484147,chr1,RASAL2,chr1:178094104-178484147,390043
150265407,150296605,chr3,LINC01214,chr3:150265407-150296605,31198
150546678,150586016,chr3,EIF2A,chr3:150546678-150586016,39338
236483165,236484468,chr1,ENO1P1,chr1:236483165-236484468,1303
236518000,236552981,chr1,LGALS8,chr1:236518000-236552981,34981
52594060,52690504,chr19,ZNF83,chr19:52594060-52690504,96444
17951293,18000085,chr19,KCNN1,chr19:17951293-18000085,48792
37969404,37969480,chr3,MIR26A1,chr3:37969404-37969480,76
37988059,38007188,chr3,VILL,chr3:37988059-38007188,19129
57599885,57612722,chr19,ZNF530,chr19:57599885-57612722,12837
51804816,51890950,chr19,ZNF577,chr19:51804816-51890950,86134
131462212,131502983,chr3,MRPL3,chr3:131462212-131502983,40771
57977076,58003349,chr19,ZNF606,chr19:57977076-58003349,26273
131479097,131479233,chr3,SNORA58,chr3:131479097-131479233,136
36445119,36489902,chr19,ZNF566,chr19:36445119-36489902,44783
131526447,131527179,chr3,BCL2L12P1,chr3:131526447-131527179,732
131985855,131985931,chr3,MIR5704,chr3:131985855-131985931,76
132175402,132176711,chr3,PSMC2P1,chr3:132175402-132176711,1309
132243528,132244265,chr3,RPL7P16,chr3:132243528-132244265,737
131533555,132285410,chr3,CPNE4,chr3:131533555-132285410,751855
12014715,12035741,chr19,ZNF433,chr19:12014715-12035741,21026
85820435,85820612,chr2,RN7SKP83,chr2:85820435-85820612,177
85837120,85905199,chr2,ST3GAL5,chr2:85837120-85905199,68079
63745255,63776351,chr17,CCDC47,chr17:63745255-63776351,31096
43401496,43418597,chr19,TEX101,chr19:43401496-43418597,17101
43460787,43465608,chr19,LYPD3,chr19:43460787-43465608,4821
43447776,43448644,chr1,SZT2-AS1,chr1:43447776-43448644,868
43448539,43448611,chr1,MIR6735,chr1:43448539-43448611,72
43453927,43456995,chr1,HYI-AS1,chr1:43453927-43456995,3068
1401909,1407293,chr1,MRPL20,chr1:1401909-1407293,5384
63832081,63843065,chr17,SMARCD2,chr17:63832081-63843065,10984
43474954,43504935,chr19,PHLDB3,chr19:43474954-43504935,29981
1405460,1405752,chr1,RN7SL657P,chr1:1405460-1405752,292
1409096,1410618,chr1,MRPL20-DT,chr1:1409096-1410618,1522
1430539,1434573,chr1,LINC01770,chr1:1430539-1434573,4034
1434861,1442882,chr1,VWA1,chr1:1434861-1442882,8021
1449689,1470163,chr1,ATAD3C,chr1:1449689-1470163,20474
43506719,43527230,chr19,ETHE1,chr19:43506719-43527230,20511
103569553,103570674,chr1,ACTG1P4,chr1:103569553-103570674,1121
103713723,103719871,chr1,AMYP1,chr1:103713723-103719871,6148
229516582,229558707,chr1,ABCB10,chr1:229516582-229558707,42125
43525497,43536130,chr19,ZNF575,chr19:43525497-43536130,10633
108325520,108326814,chr3,HNRNPA1P17,chr3:108325520-108326814,1294
45221444,45247319,chr17,FMNL1,chr17:45221444-45247319,25875
184229585,184242329,chr3,VWA5B2,chr3:184229585-184242329,12744
47349315,47382704,chr19,DHX34,chr19:47349315-47382704,33389
229535064,229535189,chr1,RNU4-21P,chr1:229535064-229535189,125
229549905,229550022,chr1,RNA5SP78,chr1:229549905-229550022,117
229570532,229570796,chr1,HMGN2P19,chr1:229570532-229570796,264
229626247,229660200,chr1,URB2,chr1:229626247-229660200,33953
229705234,229705861,chr1,HMGB1P26,chr1:229705234-229705861,627
229593121,229626047,chr1,TAF5L,chr1:229593121-229626047,32926
19814029,19815283,chr1,RNF186,chr1:19814029-19815283,1254
19882395,19912945,chr1,OTUD3,chr1:19882395-19912945,30550
47403124,47419527,chr19,MEIS3,chr19:47403124-47419527,16403
108296490,108378285,chr3,HHLA2,chr3:108296490-108378285,81795
19920009,19923617,chr1,PLA2G2E,chr1:19920009-19923617,3608
19970969,19971269,chr1,RN7SL304P,chr1:19970969-19971269,300
19975431,19980416,chr1,PLA2G2A,chr1:19975431-19980416,4985
248323630,248324568,chr1,OR2M7,chr1:248323630-248324568,938
248348775,248349713,chr1,OR14C36,chr1:248348775-248349713,938
46532166,46543969,chr1,TMEM275,chr1:46532166-46543969,11803
46538611,46570255,chr1,MKNK1-AS1,chr1:46538611-46570255,31644
46545641,46551647,chr1,KNCN,chr1:46545641-46551647,6006
19334308,19378193,chr17,B9D1,chr17:19334308-19378193,43885
46557407,46616843,chr1,MKNK1,chr1:46557407-46616843,59436
49198428,49258106,chr3,IHO1,chr3:49198428-49258106,59678
108380368,108529322,chr3,MYH15,chr3:108380368-108529322,148954
47428017,47471893,chr19,SLC8A2,chr19:47428017-47471893,43876
82942149,83051809,chr17,B3GNTL1,chr17:82942149-83051809,109660
47475150,47484265,chr19,KPTN,chr19:47475150-47484265,9115
127598410,127622436,chr3,MCM2,chr3:127598410-127622436,24026
85889151,85891136,chr2,ST3GAL5-AS1,chr2:85889151-85891136,1985
86020216,86106155,chr2,POLR1A,chr2:86020216-86106155,85939
47484282,47501597,chr19,NAPA-AS1,chr19:47484282-47501597,17315
47487637,47515091,chr19,NAPA,chr19:47487637-47515091,27454
43933320,43937240,chr1,ARTN,chr1:43933320-43937240,3920
73163035,73163359,chr17,POLR3KP2,chr17:73163035-73163359,324
73165010,73176633,chr17,SSTR2,chr17:73165010-73176633,11623
73193055,73208507,chr17,COG1,chr17:73193055-73208507,15452
43946950,43968022,chr1,IPO13,chr1:43946950-43968022,21072
127629185,127672802,chr3,PODXL2,chr3:127629185-127672802,43617
43970000,43973369,chr1,DPH2,chr1:43970000-43973369,3369
127672935,127680926,chr3,ABTB1,chr3:127672935-127680926,7991
73232233,73248959,chr17,C17orf80,chr17:73232233-73248959,16726
47520690,47573148,chr19,ZNF541,chr19:47520690-47573148,52458
47581023,47581321,chr19,RN7SL322P,chr19:47581023-47581321,298
181457202,181538940,chr2,ITGA4,chr2:181457202-181538940,81738
38374550,38383824,chr19,PSMD8,chr19:38374550-38383824,9274
43974487,43978295,chr1,ATP6V0B,chr1:43974487-43978295,3808
73248449,73262352,chr17,CPSF4L,chr17:73248449-73262352,13903
73283624,73312005,chr17,CDC42EP4,chr17:73283624-73312005,28381
127915232,127987671,chr3,KBTBD12,chr3:127915232-127987671,72439
127963608,127963724,chr3,RNA5SP139,chr3:127963608-127963724,116
73207353,73236753,chr17,FAM104A,chr17:73207353-73236753,29400
128051641,128071683,chr3,SEC61A1,chr3:128051641-128071683,20042
38384267,38388082,chr19,GGN,chr19:38384267-38388082,3815
78696694,78696797,chr17,RNU6-638P,chr17:78696694-78696797,103
78845953,78846868,chr17,RPL9P29,chr17:78845953-78846868,915
78852977,78925387,chr17,TIMP2,chr17:78852977-78925387,72410
38388421,38399587,chr19,SPRED3,chr19:38388421-38399587,11166
128075073,128075249,chr3,RNU2-37P,chr3:128075073-128075249,176
128075810,128079056,chr3,RUVBL1-AS1,chr3:128075810-128079056,3246
127689062,128052190,chr3,MGLL,chr3:127689062-128052190,363128
43991359,43996528,chr1,CCDC24,chr1:43991359-43996528,5169
181694442,181694900,chr2,SAP18P2,chr2:181694442-181694900,458
181738606,181738715,chr2,RNU6ATAC19P,chr2:181738606-181738715,109
88364695,88365608,chr2,MRPL45P1,chr2:88364695-88365608,913
88383494,88383597,chr2,RNU6-1168P,chr2:88383494-88383597,103
88414898,88415004,chr2,RNU6-1007P,chr2:88414898-88415004,106
52749942,52786807,chr19,ZNF600,chr19:52749942-52786807,36865
88428078,88428615,chr2,RPL38P6,chr2:88428078-88428615,537
78870910,78903217,chr17,CEP295NL,chr17:78870910-78903217,32307
88446787,88452693,chr2,FOXI3,chr2:88446787-88452693,5906
88524649,88529585,chr2,TEX37,chr2:88524649-88529585,4936
78187358,78207702,chr17,AFMID,chr17:78187358-78207702,20344
52860851,52897693,chr19,ZNF320,chr19:52860851-52897693,36842
88691673,88750929,chr2,RPIA,chr2:88691673-88750929,59256
121631399,121660927,chr3,HCLS1,chr3:121631399-121660927,29528
88811186,88825207,chr2,MALLP2,chr2:88811186-88825207,14021
88812370,88812454,chr2,MIR4436A,chr2:88812370-88812454,84
88857161,88857683,chr2,IGKC,chr2:88857161-88857683,522
43991500,44031467,chr1,SLC6A9,chr1:43991500-44031467,39967
88860568,88860605,chr2,IGKJ5,chr2:88860568-88860605,37
88860886,88860922,chr2,IGKJ4,chr2:88860886-88860922,36
88861221,88861258,chr2,IGKJ3,chr2:88861221-88861258,37
88861525,88861563,chr2,IGKJ2,chr2:88861525-88861563,38
50152548,50163281,chr19,IZUMO2,chr19:50152548-50163281,10733
88861886,88861923,chr2,IGKJ1,chr2:88861886-88861923,37
88885397,88886153,chr2,IGKV4-1,chr2:88885397-88886153,756
69829660,69881384,chr2,GMCL1,chr2:69829660-69881384,51724
8630633,8681151,chr19,NFILZ,chr19:8630633-8681151,50518
45149744,45160982,chr19,NKPD1,chr19:45149744-45160982,11238
36377531,36388435,chr17,TBC1D3H,chr17:36377531-36388435,10904
50927079,50927571,chr19,PPIAP59,chr19:50927079-50927571,492
50943303,50953093,chr19,KLK5,chr19:50943303-50953093,9790
69873565,69873819,chr2,RPL23AP92,chr2:69873565-69873819,254
69893956,69905575,chr2,SNRNP27,chr2:69893956-69905575,11619
41307700,41309309,chr17,KRTAP16-1,chr17:41307700-41309309,1609
121653994,121654296,chr3,RN7SL172P,chr3:121653994-121654296,302
8390702,8397827,chr17,RNF222,chr17:8390702-8397827,7125
121655475,121655604,chr3,RNU4-62P,chr3:121655475-121655604,129
78146385,78166297,chr17,C17orf99,chr17:78146385-78166297,19912
121769761,121835079,chr3,IQCB1,chr3:121769761-121835079,65318
69897688,69942945,chr2,MXD1,chr2:69897688-69942945,45257
80260852,80398794,chr17,RNF213,chr17:80260852-80398794,137942
50958631,50969673,chr19,KLK6,chr19:50958631-50969673,11042
70075014,70075272,chr2,RN7SL470P,chr2:70075014-70075272,258
70087477,70089203,chr2,PCBP1,chr2:70087477-70089203,1726
70102551,70102862,chr2,MRPL36P1,chr2:70102551-70102862,311
121835183,121886526,chr3,EAF2,chr3:121835183-121886526,51343
70149885,70248615,chr2,C2orf42,chr2:70149885-70248615,98730
44103306,44104703,chr1,KRT8P47,chr1:44103306-44104703,1397
44117098,44117397,chr1,RN7SL479P,chr1:44117098-44117397,299
248473351,248474307,chr1,OR2T3,chr1:248473351-248474307,956
248488589,248491113,chr1,OR2T5,chr1:248488589-248491113,2524
248498308,248498649,chr1,OR2AS2P,chr1:248498308-248498649,341
121894401,121944188,chr3,SLC15A2,chr3:121894401-121944188,49787
50976468,50984099,chr19,KLK7,chr19:50976468-50984099,7631
248549444,248549762,chr1,OR2AS1P,chr1:248549444-248549762,318
248573801,248574757,chr1,OR2T34,chr1:248573801-248574757,956
248681322,248682328,chr1,OR14I1,chr1:248681322-248682328,1006
152613811,152614098,chr1,LCE3B,chr1:152613811-152614098,287
152622834,152623103,chr1,LCE3A,chr1:152622834-152623103,269
152644393,152644717,chr1,LCEP4,chr1:152644393-152644717,324
152656332,152656501,chr1,LCEP3,chr1:152656332-152656501,169
152663380,152664659,chr1,LCE2D,chr1:152663380-152664659,1279
152686123,152687397,chr1,LCE2B,chr1:152686123-152687397,1274
152698345,152699442,chr1,LCE2A,chr1:152698345-152699442,1097
13315581,13322598,chr1,PRAMEF15,chr1:13315581-13322598,7017
70209444,70248660,chr2,TIA1,chr2:70209444-70248660,39216
13341892,13347134,chr1,PRAMEF14,chr1:13341892-13347134,5242
39342421,39385710,chr19,SAMD4B,chr19:39342421-39385710,43289
13369067,13371900,chr1,PRAMEF19,chr1:13369067-13371900,2833
9800608,9822079,chr17,GSG1L2,chr17:9800608-9822079,21471
13389632,13392629,chr1,PRAMEF17,chr1:13389632-13392629,2997
21123364,21193265,chr17,DHRS7B,chr17:21123364-21193265,69901
13416351,13421328,chr1,PRAMEF20,chr1:13416351-13421328,4977
92029985,92063538,chr1,EPHX4,chr1:92029985-92063538,33553
6729914,6737580,chr19,GPR108,chr19:6729914-6737580,7666
92066306,92067839,chr1,LPCAT2BP,chr1:92066306-92067839,1533
92114803,92115796,chr1,GAPDHP46,chr1:92114803-92115796,993
121663199,121749755,chr3,GOLGB1,chr3:121663199-121749755,86556
92125301,92126462,chr1,PRKAR1AP1,chr1:92125301-92126462,1161
1598012,1600135,chr1,FNDC10,chr1:1598012-1600135,2123
1632163,1635263,chr1,MMP23B,chr1:1632163-1635263,3100
757097,782294,chr17,GLOD4,chr17:757097-782294,25197
1659529,1692795,chr1,SLC35E2B,chr1:1659529-1692795,33266
1699942,1701782,chr1,MMP23A,chr1:1699942-1701782,1840
70252918,70253005,chr2,MIR1285-2,chr2:70252918-70253005,87
70253855,70254010,chr2,RPL39P15,chr2:70253855-70254010,155
171374931,171375278,chr2,RPS26P20,chr2:171374931-171375278,347
1702379,1724357,chr1,CDK11A,chr1:1702379-1724357,21978
171434217,171485052,chr2,DCAF17,chr2:171434217-171485052,50835
7717744,7833742,chr17,DNAH2,chr17:7717744-7833742,115998
194394821,194399266,chr3,GP5,chr3:194394821-194399266,4445
123610049,123884332,chr3,MYLK,chr3:123610049-123884332,274283
51639478,51646825,chr19,SIGLEC14,chr19:51639478-51646825,7347
171491422,171491931,chr2,DAP3P2,chr2:171491422-171491931,509
171517270,171517716,chr2,RPS15P4,chr2:171517270-171517716,446
55759097,55763421,chr19,RFPL4A,chr19:55759097-55763421,4324
171522247,171558129,chr2,CYBRD1,chr2:171522247-171558129,35882
36111143,36113711,chr19,OVOL3,chr19:36111143-36113711,2568
35371068,35372962,chr19,GPR42,chr19:35371068-35372962,1894
1228287,1238027,chr19,CBARP,chr19:1228287-1238027,9740
61145068,61164828,chr2,C2orf74,chr2:61145068-61164828,19760
72645949,73092712,chr17,SLC39A11,chr17:72645949-73092712,446763
52904415,52923470,chr19,ZNF888,chr19:52904415-52923470,19055
54094668,54102692,chr19,OSCAR,chr19:54094668-54102692,8024
73828916,73873659,chr2,STAMBP,chr2:73828916-73873659,44743
7251416,7259940,chr17,ELP5,chr17:7251416-7259940,8524
133429269,133455776,chr3,BFSP2-AS1,chr3:133429269-133455776,26507
35224800,35228739,chr19,FAM187B,chr19:35224800-35228739,3939
38403093,38409088,chr19,FAM98C,chr19:38403093-38409088,5995
133573686,133590261,chr3,CDV3,chr3:133573686-133590261,16575
11131520,11155807,chr19,SPC24,chr19:11131520-11155807,24287
133598175,133662380,chr3,TOPBP1,chr3:133598175-133662380,64205
1751232,1780457,chr1,NADK,chr1:1751232-1780457,29225
8747524,8758559,chr17,SPDYE4,chr17:8747524-8758559,11035
50882096,50896398,chr19,KLKP1,chr19:50882096-50896398,14302
50906351,50911395,chr19,KLK4,chr19:50906351-50911395,5044
78787381,78841441,chr17,USP36,chr17:78787381-78841441,54060
50996007,51002711,chr19,KLK8,chr19:50996007-51002711,6704
48306842,48333661,chr3,SPINK8,chr3:48306842-48333661,26819
1785285,1891117,chr1,GNB1,chr1:1785285-1891117,105832
158095905,158106420,chr3,SHOX2,chr3:158095905-158106420,10515
193274789,193378820,chr3,ATP13A5,chr3:193274789-193378820,104031
78597239,79767998,chr3,ROBO1,chr3:78597239-79767998,1170759
39679374,39686373,chr19,LGALS17A,chr19:39679374-39686373,6999
54444807,54449430,chr19,LENG8-AS1,chr19:54444807-54449430,4623
36682636,36687468,chr19,LINC01534,chr19:36682636-36687468,4832
1917590,1919279,chr1,TMEM52,chr1:1917590-1919279,1689
43901866,43927767,chr19,ZNF45-AS1,chr19:43901866-43927767,25901
51592448,51594377,chr19,LINC01530,chr19:51592448-51594377,1929
158254424,158258269,chr1,CD1A,chr1:158254424-158258269,3845
158266753,158267320,chr1,HMGN1P5,chr1:158266753-158267320,567
158289923,158294774,chr1,CD1C,chr1:158289923-158294774,4851
58362569,58367620,chr19,ZNF497-AS1,chr19:58362569-58367620,5051
782755,786092,chr19,LINC01836,chr19:782755-786092,3337
42821774,42826878,chr19,PSG8-AS1,chr19:42821774-42826878,5104
158327951,158331531,chr1,CD1B,chr1:158327951-158331531,3580
34576728,34577797,chr19,SCGB1B2P,chr19:34576728-34577797,1069
35809482,35864615,chr17,TAF15,chr17:35809482-35864615,55133
41449520,41501255,chr19,PCAT19,chr19:41449520-41501255,51735
63819299,63848636,chr3,C3orf49,chr3:63819299-63848636,29337
158353696,158357553,chr1,CD1E,chr1:158353696-158357553,3857
98166696,98169774,chr3,OR5H15,chr3:98166696-98169774,3078
178272932,178844429,chr3,KCNMB2,chr3:178272932-178844429,571497
8980591,9363053,chr3,SRGAP3,chr3:8980591-9363053,382462
29287011,29525752,chr19,VSTM2B-DT,chr19:29287011-29525752,238741
7101322,7115700,chr17,ASGR2,chr17:7101322-7115700,14378
40924219,40950676,chr19,CYP2B7P,chr19:40924219-40950676,26457
43847148,43863639,chr17,CD300LG,chr17:43847148-43863639,16491
158398522,158399466,chr1,OR10T2,chr1:158398522-158399466,944
16174680,16231992,chr3,GALNT15,chr3:16174680-16231992,57312
158445068,158446014,chr1,OR10T1P,chr1:158445068-158446014,946
158454198,158455273,chr1,EI24P2,chr1:158454198-158455273,1075
158491219,158492160,chr1,OR10R3P,chr1:158491219-158492160,941
158514785,158515925,chr1,OR10R1P,chr1:158514785-158515925,1140
158523672,158525838,chr1,HSP90AA3P,chr1:158523672-158525838,2166
93345907,93369493,chr1,DR1,chr1:93345907-93369493,23586
19757366,19776423,chr19,LINC00663,chr19:19757366-19776423,19057
43952733,44004469,chr17,PYY,chr17:43952733-44004469,51736
93488333,93488452,chr1,RNA5SP53,chr1:93488333-93488452,119
206684905,206734281,chr1,MAPKAPK2,chr1:206684905-206734281,49376
9689924,9700776,chr19,ZNF812P,chr19:9689924-9700776,10852
63573242,63573345,chr17,RNU6-288P,chr17:63573242-63573345,103
38671703,38674957,chr17,EPOP,chr17:38671703-38674957,3254
38702262,38702331,chr17,MIR4734,chr17:38702262-38702331,69
9538689,9539734,chr19,ZNF426-DT,chr19:9538689-9539734,1045
38705273,38729795,chr17,MLLT6,chr17:38705273-38729795,24522
55006193,55048086,chr19,GP6-AS1,chr19:55006193-55048086,41893
183015218,183116075,chr3,MCCC1,chr3:183015218-183116075,100857
206767602,206774541,chr1,IL10,chr1:206767602-206774541,6939
38719691,38719748,chr17,MIR4726,chr17:38719691-38719748,57
38730341,38735605,chr17,CISD3,chr17:38730341-38735605,5264
38731802,38731920,chr17,RNA5SP440,chr17:38731802-38731920,118
10037803,10074145,chr19,C3P1,chr19:10037803-10074145,36342
38733898,38749817,chr17,PCGF2,chr17:38733898-38749817,15919
206897443,206904139,chr1,IL24,chr1:206897443-206904139,6696
15846262,15864924,chr19,CLEC4OP,chr19:15846262-15864924,18662
28883430,28970874,chr19,LINC00906,chr19:28883430-28970874,87444
5978355,6020363,chr19,RANBP3-DT,chr19:5978355-6020363,42008
206903317,206923247,chr1,FCMR,chr1:206903317-206923247,19930
38752741,38764225,chr17,PSMB3,chr17:38752741-38764225,11484
35785697,35797935,chr19,LINC01529,chr19:35785697-35797935,12238
157526767,157628864,chr2,ACVR1C,chr2:157526767-157628864,102097
38755279,38755400,chr17,RNU6-866P,chr17:38755279-38755400,121
38765691,38800126,chr17,PIP4K2B,chr17:38765691-38800126,34435
19776586,19836193,chr19,ZNF56P,chr19:19776586-19836193,59607
206928522,206946466,chr1,PIGR,chr1:206928522-206946466,17944
58559125,58574797,chr19,MZF1-AS1,chr19:58559125-58574797,15672
38800441,38825355,chr17,CWC25,chr17:38800441-38825355,24914
41535183,41536904,chr19,LINC01480,chr19:41535183-41536904,1721
27681072,27794005,chr19,LINC00662,chr19:27681072-27794005,112933
206957965,206970625,chr1,FCAMR,chr1:206957965-206970625,12660
157736251,157876330,chr2,ACVR1,chr2:157736251-157876330,140079
113716458,113746300,chr3,NAA50,chr3:113716458-113746300,29842
38825838,38825892,chr17,MIR4727,chr17:38825838-38825892,54
38835086,38841438,chr17,C17orf98,chr17:38835086-38841438,6352
63523334,63548977,chr17,KCNH6,chr17:63523334-63548977,25643
207018522,207032756,chr1,C1orf116,chr1:207018522-207032756,14234
9703826,9729908,chr3,CPNE9,chr3:9703826-9729908,26082
107056674,107067636,chr1,PRMT6,chr1:107056674-107067636,10962
107505203,107505448,chr1,NDUFA4P1,chr1:107505203-107505448,245
26280086,26281522,chr1,SH3BGRL3,chr1:26280086-26281522,1436
26317958,26320523,chr1,CD52,chr1:26317958-26320523,2565
26361634,26374522,chr1,ZNF683,chr1:26361634-26374522,12888
32687086,32691764,chr19,NUDT19-DT,chr19:32687086-32691764,4678
46660364,46678991,chr19,DACT3-AS1,chr19:46660364-46678991,18627
63550222,63594286,chr17,DCAF7,chr17:63550222-63594286,44064
36573070,36594712,chr19,ZNF529-AS1,chr19:36573070-36594712,21642
195274745,195443044,chr3,ACAP2,chr3:195274745-195443044,168299
35540738,35546029,chr19,TMEM147-AS1,chr19:35540738-35546029,5291
31576485,31587686,chr1,TINAGL1,chr1:31576485-31587686,11201
42397114,42652355,chr19,LIPE-AS1,chr19:42397114-42652355,255241
8374372,8390685,chr19,RAB11B-AS1,chr19:8374372-8390685,16313
56545566,56567441,chr19,ZNF470-DT,chr19:56545566-56567441,21875
63600882,63608365,chr17,TACO1,chr17:63600882-63608365,7483
17488990,17511889,chr19,PGLS-DT,chr19:17488990-17511889,22899
31629866,31644896,chr1,PEF1,chr1:31629866-31644896,15030
35667948,35673304,chr19,UPK1A-AS1,chr19:35667948-35673304,5356
51949122,51981367,chr19,ZNF350-AS1,chr19:51949122-51981367,32245
44431705,44477670,chr3,ZNF445,chr3:44431705-44477670,45965
44883986,44884274,chr17,RN7SL405P,chr17:44883986-44884274,288
44934618,44934681,chr17,MIR6783,chr17:44934618-44934681,63
45114367,45114433,chr17,MIR6784,chr17:45114367-45114433,66
47694161,47712052,chr17,TBKBP1,chr17:47694161-47712052,17891
50333796,50344773,chr19,NAPSB,chr19:50333796-50344773,10977
31644049,31660162,chr1,PEF1-AS1,chr1:31644049-31660162,16113
42600655,42648735,chr3,NKTR,chr3:42600655-42648735,48080
46480788,46601200,chr19,PPP5D1P,chr19:46480788-46601200,120412
44191805,44200113,chr17,ATXN7L3,chr17:44191805-44200113,8308
37497159,37507122,chr19,ZNF793-AS1,chr19:37497159-37507122,9963
52150104,52150419,chr1,RN7SL788P,chr1:52150104-52150419,315
44926799,44931386,chr19,APOC1P1,chr19:44926799-44931386,4587
52179848,52180553,chr1,PDCL3P6,chr1:52179848-52180553,705
52252062,52252773,chr1,DNAJC19P7,chr1:52252062-52252773,711
52253621,52254176,chr1,ANAPC10P1,chr1:52253621-52254176,555
52368677,52369244,chr1,PLA2G12AP1,chr1:52368677-52369244,567
52372829,52404423,chr1,ORC1,chr1:52372829-52404423,31594
36259540,36331770,chr19,LINC00665,chr19:36259540-36331770,72230
157912772,157912885,chr2,RNU6-436P,chr2:157912772-157912885,113
176092721,176095944,chr2,HOXD13,chr2:176092721-176095944,3223
176099795,176102489,chr2,HOXD12,chr2:176099795-176102489,2694
176104216,176109754,chr2,HOXD11,chr2:176104216-176109754,5538
176108790,176119937,chr2,HOXD10,chr2:176108790-176119937,11147
20340262,20424978,chr19,ZNF826P,chr19:20340262-20424978,84716
45160700,45170040,chr17,HEXIM2,chr17:45160700-45170040,9340
176121611,176137098,chr2,HOXD-AS2,chr2:176121611-176137098,15487
150602875,150630436,chr3,SELENOT,chr3:150602875-150630436,27561
176122719,176124937,chr2,HOXD9,chr2:176122719-176124937,2218
37251867,37265547,chr19,LINC01535,chr19:37251867-37265547,13680
176129694,176132695,chr2,HOXD8,chr2:176129694-176132695,3001
161541759,161550737,chr1,FCGR3A,chr1:161541759-161550737,8978
7041621,7044092,chr17,SLC16A11,chr17:7041621-7044092,2471
176150303,176150412,chr2,MIR10B,chr2:176150303-176150412,109
176151550,176153226,chr2,HOXD4,chr2:176151550-176153226,1676
176164051,176188958,chr2,HAGLR,chr2:176164051-176188958,24907
23399097,23416075,chr19,LINC01224,chr19:23399097-23416075,16978
225982702,225999343,chr1,SDE2,chr1:225982702-225999343,16641
45023338,45061131,chr17,DCAKD,chr17:45023338-45061131,37793
51167328,51173524,chr19,SIGLEC17P,chr19:51167328-51173524,6196
226045561,226061898,chr1,H3-3A-DT,chr1:226045561-226061898,16337
226061851,226072019,chr1,H3-3A,chr1:226061851-226072019,10168
141487027,141615344,chr3,RASA2,chr3:141487027-141615344,128317
58257270,58278826,chr19,ZNF8-DT,chr19:58257270-58278826,21556
176188668,176190907,chr2,HOXD1,chr2:176188668-176190907,2239
176188843,176188901,chr2,MIR7704,chr2:176188843-176188901,58
176242111,176242993,chr2,RPSAP25,chr2:176242111-176242993,882
50797687,50804929,chr19,C19orf48,chr19:50797687-50804929,7242
176136612,176173102,chr2,HOXD3,chr2:176136612-176173102,36490
99337371,99401326,chr2,EIF5B,chr2:99337371-99401326,63955
112990984,113015060,chr3,GTPBP8,chr3:112990984-113015060,24076
226083590,226090465,chr1,LINC01703,chr1:226083590-226090465,6875
226144679,226186741,chr1,ACBD3,chr1:226144679-226186741,42062
562360,572228,chr19,BSG-AS1,chr19:562360-572228,9868
226148003,226155071,chr1,ACBD3-AS1,chr1:226148003-226155071,7068
226223618,226227060,chr1,MIXL1,chr1:226223618-226227060,3442
224175756,224193441,chr1,DEGS1,chr1:224175756-224193441,17685
171600404,171810950,chr3,PLD1,chr3:171600404-171810950,210546
52388842,52397791,chr19,ZNF528-AS1,chr19:52388842-52397791,8949
22615552,22623977,chr19,LINC01785,chr19:22615552-22623977,8425
224227334,224330189,chr1,NVL,chr1:224227334-224330189,102855
75587800,75626849,chr17,MYO15B,chr17:75587800-75626849,39049
4769031,4785077,chr19,MIR7-3HG,chr19:4769031-4785077,16046
99545419,100192428,chr2,AFF3,chr2:99545419-100192428,647009
68004247,68545621,chr3,TAFA1,chr3:68004247-68545621,541374
53884417,53891885,chr3,SELENOK,chr3:53884417-53891885,7468
56477250,56504362,chr19,ZNF667-AS1,chr19:56477250-56504362,27112
47413681,47477126,chr3,SCAP,chr3:47413681-47477126,63445
75909574,75941140,chr17,FBF1,chr17:75909574-75941140,31566
100271875,100322501,chr2,LONRF2,chr2:100271875-100322501,50626
100370255,100370545,chr2,CYCSP7,chr2:100370255-100370545,290
100391860,100417668,chr2,CHST10,chr2:100391860-100417668,25808
48467798,48504826,chr3,SHISA5,chr3:48467798-48504826,37028
35464249,35537678,chr17,SLFN12L,chr17:35464249-35537678,73429
62944215,62944312,chr17,MIR633,chr17:62944215-62944312,97
62950831,62951188,chr17,TRMT112P3,chr17:62950831-62951188,357
63182166,63182817,chr17,DNAJB6P8,chr17:63182166-63182817,651
49838300,49848069,chr17,TAC4,chr17:49838300-49848069,9769
224257004,224257141,chr1,MIR320B2,chr1:224257004-224257141,137
224305380,224305483,chr1,RNU6-1008P,chr1:224305380-224305483,103
224356858,224379459,chr1,CNIH4,chr1:224356858-224379459,22601
100425348,100426107,chr2,RALBP1P2,chr2:100425348-100426107,759
217978707,217993747,chr2,TNS1-AS1,chr2:217978707-217993747,15040
219249710,219277902,chr2,TUBA4A,chr2:219249710-219277902,28192
28363506,28365199,chr17,SEBOX,chr17:28363506-28365199,1693
7481446,7483496,chr17,SLC35G6,chr17:7481446-7483496,2050
14651762,14672659,chr3,CCDC174,chr3:14651762-14672659,20897
224398227,224398311,chr1,MIR4742,chr1:224398227-224398311,84
224574434,224575389,chr1,AKR1B1P1,chr1:224574434-224575389,955
224608130,224616220,chr1,CNIH3-AS2,chr1:224608130-224616220,8090
20008865,20319026,chr17,SPECC1,chr17:20008865-20319026,310161
224661173,224661886,chr1,DNAJB6P6,chr1:224661173-224661886,713
39491636,39529869,chr1,BMP8A,chr1:39491636-39529869,38233
219279342,219286898,chr2,DNAJB2,chr2:219279342-219286898,7556
39514956,39516490,chr1,OXCT2P1,chr1:39514956-39516490,1534
39565052,39573860,chr1,PABPC4-AS1,chr1:39565052-39573860,8808
39567374,39567508,chr1,SNORA55,chr1:39567374-39567508,134
39623435,39639643,chr1,HEYL,chr1:39623435-39639643,16208
39678648,39691485,chr1,HPCAL4,chr1:39678648-39691485,12837
195720884,195741123,chr3,MUC20,chr3:195720884-195741123,20239
39723566,39723627,chr1,RNU7-121P,chr1:39723566-39723627,61
52410660,52423641,chr3,PHF7,chr3:52410660-52423641,12981
39560709,39576790,chr1,PABPC4,chr1:39560709-39576790,16081
76000855,76005999,chr17,CDK3,chr17:76000855-76005999,5144
82050691,82057470,chr17,GPS1,chr17:82050691-82057470,6779
189661385,189670831,chr2,ASNSD1,chr2:189661385-189670831,9446
226318015,226318693,chr1,YBX1P9,chr1:226318015-226318693,678
49007062,49015953,chr3,WDR6,chr3:49007062-49015953,8891
226438564,226439344,chr1,RPS3AP7,chr1:226438564-226439344,780
226445937,226446292,chr1,RN7SKP165,chr1:226445937-226446292,355
189661452,189666437,chr2,ASDURF,chr2:189661452-189666437,4985
226493188,226493489,chr1,CDKN2AIPNLP1,chr1:226493188-226493489,301
150492345,150492410,chr1,MIR6878,chr1:150492345-150492410,65
150508062,150513789,chr1,ECM1,chr1:150508062-150513789,5727
189746660,189763227,chr2,OSGEPL1,chr2:189746660-189763227,16567
189762704,189765556,chr2,OSGEPL1-AS1,chr2:189762704-189765556,2852
189770267,189784364,chr2,ORMDL1,chr2:189770267-189784364,14097
150515757,150518032,chr1,FALEC,chr1:150515757-150518032,2275
150548562,150557724,chr1,ADAMTSL4-AS2,chr1:150548562-150557724,9162
150551929,150552014,chr1,MIR4257,chr1:150551929-150552014,85
150566562,150566860,chr1,RN7SL473P,chr1:150566562-150566860,298
150568971,150569269,chr1,RN7SL600P,chr1:150568971-150569269,298
53224712,53256052,chr3,TKT,chr3:53224712-53256052,31340
150600851,150629612,chr1,ENSA,chr1:150600851-150629612,28761
189674290,189761193,chr2,ANKAR,chr2:189674290-189761193,86903
135656477,135656579,chr2,RNU6-512P,chr2:135656477-135656579,102
135665397,135665478,chr2,MIR128-1,chr2:135665397-135665478,81
135741734,135785056,chr2,UBXN4,chr2:135741734-135785056,43322
150646230,150697154,chr1,GOLPH3L,chr1:150646230-150697154,50924
135787850,135837184,chr2,LCT,chr2:135787850-135837184,49334
150698060,150720895,chr1,HORMAD1,chr1:150698060-150720895,22835
51971426,51981196,chr3,ABHD14A,chr3:51971426-51981196,9770
135820191,135823087,chr2,LCT-AS1,chr2:135820191-135823087,2896
135531455,135725270,chr2,R3HDM1,chr2:135531455-135725270,193815
126524155,126543291,chr3,CHST13,chr3:126524155-126543291,19136
108549864,108589644,chr3,CIP2A,chr3:108549864-108589644,39780
74367458,74372600,chr17,GPR142,chr17:74367458-74372600,5142
43216941,43305397,chr17,CCDC200,chr17:43216941-43305397,88456
3144628,3179727,chr3,CRBN,chr3:3144628-3179727,35099
150701866,150701972,chr1,RNU6-1042P,chr1:150701866-150701972,106
150800473,150801031,chr1,UBE2D3P3,chr1:150800473-150801031,558
150560202,150562115,chr1,ADAMTSL4-AS1,chr1:150560202-150562115,1913
150560895,150579738,chr1,MCL1,chr1:150560895-150579738,18843
27456448,27626438,chr17,KSR1,chr17:27456448-27626438,169990
228006998,228061271,chr1,WNT3A,chr1:228006998-228061271,54273
228073909,228076550,chr1,LINC02809,chr1:228073909-228076550,2641
228082660,228099212,chr1,ARF1,chr1:228082660-228099212,16552
49108046,49120938,chr3,USP19,chr3:49108046-49120938,12892
82239023,82273700,chr17,CSNK1D,chr17:82239023-82273700,34677
228097263,228097341,chr1,MIR3620,chr1:228097263-228097341,78
228100726,228105411,chr1,C1orf35,chr1:228100726-228105411,4685
228106679,228109312,chr1,MRPL55,chr1:228106679-228109312,2633
240045077,240047027,chr2,OR6B3,chr2:240045077-240047027,1950
226731312,226799820,chr2,IRS1,chr2:226731312-226799820,68508
226835581,226999215,chr2,RHBDD1,chr2:226835581-226999215,163634
78674048,78782297,chr17,CYTH1,chr17:78674048-78782297,108249
227164624,227314792,chr2,COL4A3,chr2:227164624-227314792,150168
73805754,73902960,chr3,LINC02005,chr3:73805754-73902960,97206
73999805,74005609,chr3,LINC02047,chr3:73999805-74005609,5804
74135959,74136892,chr3,AKR1B1P2,chr3:74135959-74136892,933
74262568,74614659,chr3,CNTN3,chr3:74262568-74614659,352091
75084155,75085237,chr3,NIPA2P2,chr3:75084155-75085237,1082
75182754,75183048,chr3,RN7SL294P,chr3:75182754-75183048,294
75214476,75214549,chr3,MIR4444-2,chr3:75214476-75214549,73
75214631,75215636,chr3,HNRNPA3P6,chr3:75214631-75215636,1005
75328549,75339071,chr3,MYLKP1,chr3:75328549-75339071,10522
227221052,227325711,chr2,MFF-DT,chr2:227221052-227325711,104659
130345516,130484844,chr3,COL6A5,chr3:130345516-130484844,139328
19215615,19336715,chr17,EPN2,chr17:19215615-19336715,121100
227325151,227357836,chr2,MFF,chr2:227325151-227357836,32685
156825481,157046129,chr3,LEKR1,chr3:156825481-157046129,220648
96814581,97761532,chr3,EPHA6,chr3:96814581-97761532,946951
228114997,228115473,chr1,CIAO2AP2,chr1:228114997-228115473,476
228149930,228159826,chr1,GJC2,chr1:228149930-228159826,9896
228164086,228165512,chr1,IBA57-DT,chr1:228164086-228165512,1426
228165804,228182257,chr1,IBA57,chr1:228165804-228182257,16453
228203503,228213664,chr1,OBSCN-AS1,chr1:228203503-228213664,10161
228393673,228406835,chr1,TRIM11,chr1:228393673-228406835,13162
119579268,119589945,chr3,ADPRH,chr3:119579268-119589945,10677
228397048,228397109,chr1,MIR6742,chr1:228397048-228397109,61
228407935,228416861,chr1,TRIM17,chr1:228407935-228416861,8926
14947583,15053600,chr3,NR2C2,chr3:14947583-15053600,106017
35192520,35194393,chr17,SLC35G3,chr17:35192520-35194393,1873
42980565,42995142,chr17,RUNDC1,chr17:42980565-42995142,14577
29929200,30108452,chr17,EFCAB5,chr17:29929200-30108452,179252
228449163,228449621,chr1,RPL23AP15,chr1:228449163-228449621,458
228462074,228462152,chr1,MIR4666A,chr1:228462074-228462152,78
228510425,228512305,chr1,BTNL10,chr1:228510425-228512305,1880
228555793,228555901,chr1,RNA5SP19,chr1:228555793-228555901,108
228558296,228558339,chr1,RNA5SP162,chr1:228558296-228558339,43
42658335,42676758,chr1,PPIH,chr1:42658335-42676758,18423
227362038,227381995,chr2,TM4SF20,chr2:227362038-227381995,19957
227387683,227387949,chr2,SCYGR1,chr2:227387683-227387949,266
227472132,227472187,chr2,MIR5703,chr2:227472132-227472187,55
227472152,227561217,chr2,AGFG1,chr2:227472152-227561217,89065
57293699,57544344,chr3,DNAH12,chr3:57293699-57544344,250645
68101874,68161227,chr17,LINC00674,chr17:68101874-68161227,59353
22090743,22205156,chr17,UBBP4,chr17:22090743-22205156,114413
50050349,50055746,chr17,PICART1,chr17:50050349-50055746,5397
69961568,69994845,chr17,LINC01497,chr17:69961568-69994845,33277
37243191,37366879,chr3,GOLGA4,chr3:37243191-37366879,123688
44175968,44186723,chr17,ASB16-AS1,chr17:44175968-44186723,10755
25733753,25878487,chr2,ASXL2,chr2:25733753-25878487,144734
58324472,58415766,chr17,TSPOAP1-AS1,chr17:58324472-58415766,91294
78360417,78373911,chr17,SOCS3-DT,chr17:78360417-78373911,13494
39027277,39053215,chr17,LRRC37A11P,chr17:39027277-39053215,25938
25809925,25810656,chr2,TPM3P7,chr2:25809925-25810656,731
25822469,25822950,chr2,PTGES3P2,chr2:25822469-25822950,481
43338741,43389226,chr17,LINC00910,chr17:43338741-43389226,50485
25886964,25887206,chr2,NDUFB4P4,chr2:25886964-25887206,242
25926598,25982749,chr2,KIF3C,chr2:25926598-25982749,56151
42682418,42703805,chr1,YBX1,chr1:42682418-42703805,21387
20836447,20896157,chr17,CCDC144NL,chr17:20836447-20896157,59710
40717234,40721932,chr17,KRT223P,chr17:40717234-40721932,4698
45506741,45584705,chr17,LRRC37A4P,chr17:45506741-45584705,77964
42733093,42740254,chr1,CLDN19,chr1:42733093-42740254,7161
25994794,25995081,chr2,UQCRHP2,chr2:25994794-25995081,287
26028208,26028612,chr2,TRMT112P6,chr2:26028208-26028612,404
52794768,52809009,chr3,ITIH3,chr3:52794768-52809009,14241
81303771,81309252,chr17,LINC00482,chr17:81303771-81309252,5481
26034084,26137454,chr2,RAB10,chr2:26034084-26137454,103370
42746335,42767084,chr1,P3H1,chr1:42746335-42767084,20749
6853861,6954107,chr17,ALOX12P2,chr17:6853861-6954107,100246
26042675,26042781,chr2,RNU6-942P,chr2:26042675-26042781,106
26101317,26102136,chr2,RPS2P15,chr2:26101317-26102136,819
26140263,26141264,chr2,EMP2P1,chr2:26140263-26141264,1001
26149204,26150731,chr2,SMARCE1P6,chr2:26149204-26150731,1527
26162056,26162554,chr2,PPIL1P1,chr2:26162056-26162554,498
26173088,26189663,chr2,GAREM2,chr2:26173088-26189663,16575
231198546,231376848,chr2,ARMC9,chr2:231198546-231376848,178302
60079309,60088713,chr17,HEATR6-DT,chr17:60079309-60088713,9404
184361710,184368596,chr3,POLR2H,chr3:184361710-184368596,6886
43938257,43938963,chr17,LINC01976,chr17:43938257-43938963,706
18537800,18625653,chr17,CCDC144B,chr17:18537800-18625653,87853
24356999,24416934,chr1,STPG1,chr1:24356999-24416934,59935
44198537,44216565,chr17,ATXN7L3-AS1,chr17:44198537-44216565,18028
50171428,50181200,chr17,H1-9P,chr17:50171428-50181200,9772
32685145,32773875,chr3,CNOT10,chr3:32685145-32773875,88730
24415802,24472976,chr1,NIPAL3,chr1:24415802-24472976,57174
72290091,72640472,chr17,LINC00511,chr17:72290091-72640472,350381
24496254,24535400,chr1,RCAN3AS,chr1:24496254-24535400,39146
24502351,24541040,chr1,RCAN3,chr1:24502351-24541040,38689
49683947,49689501,chr3,MST1,chr3:49683947-49689501,5554
24538802,24556024,chr1,NCMAP-DT,chr1:24538802-24556024,17222
24556087,24609328,chr1,NCMAP,chr1:24556087-24609328,53241
58776845,58784048,chr1,JUN,chr1:58776845-58784048,7203
155335268,155563162,chr1,ASH1L,chr1:155335268-155563162,227894
47450568,47492492,chr17,MRPL45P2,chr17:47450568-47492492,41924
191267168,191330526,chr3,UTS2B,chr3:191267168-191330526,63358
13755574,14069495,chr17,COX10-AS1,chr17:13755574-14069495,313921
66133610,66388116,chr3,SLC25A26,chr3:66133610-66388116,254506
21428263,21574517,chr17,LINC02693,chr17:21428263-21574517,146254
61393455,61411555,chr17,TBX2-AS1,chr17:61393455-61411555,18100
49230853,49318011,chr17,FLJ40194,chr17:49230853-49318011,87158
224385146,224437033,chr1,WDR26,chr1:224385146-224437033,51887
60083562,60091885,chr17,WFDC21P,chr17:60083562-60091885,8323
39406716,39412542,chr3,RPSA,chr3:39406716-39412542,5826
79919310,79925999,chr17,LINC01978,chr17:79919310-79925999,6689
48045141,48048107,chr17,NFE2L1-DT,chr17:48045141-48048107,2966
1516877,1518101,chr17,PITPNA-AS1,chr17:1516877-1518101,1224
64779259,64837207,chr17,PLEKHM1P1,chr17:64779259-64837207,57948
39408389,39408539,chr3,SNORA6,chr3:39408389-39408539,150
39643638,39644705,chr3,NFU1P1,chr3:39643638-39644705,1067
39467198,39529479,chr3,MOBP,chr3:39467198-39529479,62281
47891219,47895837,chr17,SP2-DT,chr17:47891219-47895837,4618
1711447,1717174,chr17,MIR22HG,chr17:1711447-1717174,5727
25160853,25168903,chr2,POMC,chr2:25160853-25168903,8050
32179675,32198285,chr1,TXLNA,chr1:32179675-32198285,18610
151085286,151437072,chr3,MED12L,chr3:151085286-151437072,351786
5192007,5248182,chr17,ZNF594-DT,chr17:5192007-5248182,56175
25204313,25209202,chr2,LINC01381,chr2:25204313-25209202,4889
227002714,227164453,chr2,COL4A4,chr2:227002714-227164453,161739
20868433,21002276,chr17,CCDC144NL-AS1,chr17:20868433-21002276,133843
32205671,32208682,chr1,IQCC,chr1:32205671-32208682,3011
32214472,32222359,chr1,TMEM234,chr1:32214472-32222359,7887
47897330,47941410,chr17,SP2-AS1,chr17:47897330-47941410,44080
241809065,241817413,chr2,NEU4,chr2:241809065-241817413,8348
46193568,46197842,chr17,KANSL1-AS1,chr17:46193568-46197842,4274
8220624,8224043,chr17,LINC00324,chr17:8220624-8224043,3419
64145958,64146476,chr17,SNHG25,chr17:64145958-64146476,518
32247222,32248856,chr1,FAM167B,chr1:32247222-32248856,1634
40819106,40836270,chr17,KRT10-AS1,chr17:40819106-40836270,17164
47016428,47164113,chr3,SETD2,chr3:47016428-47164113,147685
32251239,32286165,chr1,LCK,chr1:32251239-32286165,34926
76557733,76565357,chr17,SNHG16,chr17:76557733-76565357,7624
82037872,82039380,chr17,DCXR-DT,chr17:82037872-82039380,1508
47603860,47649449,chr17,KPNB1-DT,chr17:47603860-47649449,45589
241849884,241858894,chr2,PDCD1,chr2:241849884-241858894,9010
18697998,18736118,chr17,TRIM16L,chr17:18697998-18736118,38120
241869600,241873823,chr2,RTP5,chr2:241869600-241873823,4223
241893988,241902551,chr2,FAM240C,chr2:241893988-241902551,8563
241970683,241977276,chr2,LINC01238,chr2:241970683-241977276,6593
242047695,242084233,chr2,LINC01880,chr2:242047695-242084233,36538
242119856,242120053,chr2,CICP10,chr2:242119856-242120053,197
242122287,242122469,chr2,SEPTIN14P2,chr2:242122287-242122469,182
242175181,242175634,chr2,RPL23AP88,chr2:242175181-242175634,453
237510931,237510988,chr2,MIR6811,chr2:237510931-237510988,57
237324003,237414328,chr2,COL6A3,chr2:237324003-237414328,90325
57071814,57085041,chr17,AKAP1-DT,chr17:57071814-57085041,13227
60526272,60550798,chr17,APPBP2-DT,chr17:60526272-60550798,24526
184053047,184060673,chr3,HTR3C,chr3:184053047-184060673,7626
79018131,79027673,chr17,C1QTNF1-AS1,chr17:79018131-79027673,9542
331205,333488,chr17,RPH3AL-AS1,chr17:331205-333488,2283
184076779,184084219,chr3,HTR3C2P,chr3:184076779-184084219,7440
184095118,184105178,chr3,HTR3E-AS1,chr3:184095118-184105178,10060
45799390,45895680,chr17,MAPT-AS1,chr17:45799390-45895680,96290
184097064,184106995,chr3,HTR3E,chr3:184097064-184106995,9931
6875232,7012530,chr17,ALOX12-AS1,chr17:6875232-7012530,137298
32292083,32333635,chr1,HDAC1,chr1:32292083-32333635,41552
30709299,30790908,chr17,SUZ12P1,chr17:30709299-30790908,81609
5111468,5115004,chr17,ZNF232-AS1,chr17:5111468-5115004,3536
35568050,35574900,chr17,SNHG30,chr17:35568050-35574900,6850
64966550,64975617,chr17,AMZ2P1,chr17:64966550-64975617,9067
32333839,32336233,chr1,MARCKSL1,chr1:32333839-32336233,2394
184115352,184117898,chr3,HSP90AA5P,chr3:184115352-184117898,2546
184134019,184135238,chr3,EIF2B5-DT,chr3:184134019-184135238,1219
32351521,32364312,chr1,TSSK3,chr1:32351521-32364312,12791
184186095,184194012,chr3,ABCF3,chr3:184186095-184194012,7917
110362851,110391082,chr1,SLC16A4,chr1:110362851-110391082,28231
16438767,16478678,chr17,SNHG29,chr17:16438767-16478678,39911
156404250,156456763,chr1,MIR9-1HG,chr1:156404250-156456763,52513
9397615,9479240,chr3,SETD5,chr3:9397615-9479240,81625
219418377,219426735,chr2,DES,chr2:219418377-219426735,8358
32221077,32245397,chr1,EIF3I,chr1:32221077-32245397,24320
165194993,165392310,chr2,SCN2A,chr2:165194993-165392310,197317
62966235,63427703,chr17,TANC2,chr17:62966235-63427703,461468
110401249,110407942,chr1,LAMTOR5,chr1:110401249-110407942,6693
183884924,183888449,chr3,RPSAP31,chr3:183884924-183888449,3525
183886800,183886885,chr3,MIR4448,chr3:183886800-183886885,85
183895900,183910936,chr3,CYP2AB1P,chr3:183895900-183910936,15036
183919934,184017939,chr3,ABCC5,chr3:183919934-184017939,98005
28736621,28769775,chr1,YTHDF2,chr1:28736621-28769775,33154
47509290,47570985,chr2,KCNK12,chr2:47509290-47570985,61695
47527008,47535199,chr2,MSH2-OT1,chr2:47527008-47535199,8191
47989625,47990526,chr2,VN1R18P,chr2:47989625-47990526,901
29119429,29123903,chr1,TMEM200B,chr1:29119429-29123903,4474
47789316,47906498,chr2,FBXO11,chr2:47789316-47906498,117182
29192657,29230942,chr1,MECR,chr1:29192657-29230942,38285
220786913,220819659,chr1,MTARC1,chr1:220786913-220819659,32746
220825620,220826063,chr1,RNU6ATAC35P,chr1:220825620-220826063,443
220829255,220832429,chr1,LINC01352,chr1:220829255-220832429,3174
220832763,220880140,chr1,HLX-AS1,chr1:220832763-220880140,47377
220879431,220885059,chr1,HLX,chr1:220879431-220885059,5628
220467954,220468808,chr1,PRELID3BP1,chr1:220467954-220468808,854
220485104,220487558,chr1,LINC02779,chr1:220485104-220487558,2454
220528136,220664461,chr1,MARK1,chr1:220528136-220664461,136325
184006338,184011419,chr3,ABCC5-AS1,chr3:184006338-184011419,5081
184026369,184027756,chr3,EEF1A1P8,chr3:184026369-184027756,1387
184031544,184039369,chr3,HTR3D,chr3:184031544-184039369,7825
127472234,127472415,chr2,RNU4-48P,chr2:127472234-127472415,181
88556741,88691518,chr2,EIF2AK3,chr2:88556741-88691518,134777
184155377,184173614,chr3,DVL3,chr3:184155377-184173614,18237
184174689,184184214,chr3,AP2M1,chr3:184174689-184184214,9525
220571739,220572035,chr1,RN7SL464P,chr1:220571739-220572035,296
220625740,220628056,chr1,HDAC1P2,chr1:220625740-220628056,2316
220690363,220699153,chr1,C1orf115,chr1:220690363-220699153,8790
173791548,173791887,chr1,RN7SKP160,chr1:173791548-173791887,339
173824653,173858808,chr1,DARS2,chr1:173824653-173858808,34155
181535041,181680665,chr2,CERKL,chr2:181535041-181680665,145624
173862473,173863941,chr1,GAS5-AS1,chr1:173862473-173863941,1468
173868082,173903549,chr1,ZBTB37,chr1:173868082-173903549,35467
173921070,173921200,chr1,RNA5SP67,chr1:173921070-173921200,130
173931084,174022357,chr1,RC3H1,chr1:173931084-174022357,91273
169764520,169765060,chr3,TERC,chr3:169764520-169765060,540
169764610,169765047,chr3,Telomerase-vert,chr3:169764610-169765047,437
169766921,169769561,chr3,ACTRT3,chr3:169766921-169769561,2640
169773396,169789716,chr3,MYNN,chr3:169773396-169789716,16320
169793003,169812986,chr3,LRRC34,chr3:169793003-169812986,19983
173969318,173969436,chr1,RNA5SP68,chr1:173969318-173969436,118
174009267,174016206,chr1,RC3H1-IT1,chr1:174009267-174016206,6939
174090136,174090474,chr1,RPL30P1,chr1:174090136-174090474,338
111648291,111649544,chr1,KRT18P57,chr1:111648291-111649544,1253
111650431,111650537,chr1,RNU6-151P,chr1:111650431-111650537,106
111680630,111755824,chr1,INKA2,chr1:111680630-111755824,75194
111739579,111747798,chr1,INKA2-AS1,chr1:111739579-111747798,8219
111853762,111856905,chr1,KCND3-IT1,chr1:111853762-111856905,3143
111909336,111910931,chr1,KCND3-AS1,chr1:111909336-111910931,1595
111989770,111998842,chr1,LINC01750,chr1:111989770-111998842,9072
111770662,111989668,chr1,KCND3,chr1:111770662-111989668,219006
169839172,169869935,chr3,LRRC31,chr3:169839172-169869935,30763
181668295,181680827,chr2,NEUROD1,chr2:181668295-181680827,12532
219498865,219513898,chr2,GMPPA,chr2:219498865-219513898,15033
205976740,206003461,chr1,RAB7B,chr1:205976740-206003461,26721
169902980,169904260,chr3,KRT18P43,chr3:169902980-169904260,1280
169911572,169939175,chr3,SAMD7,chr3:169911572-169939175,27603
226668897,226676345,chr1,ITPKB-AS1,chr1:226668897-226676345,7448
226781501,226781744,chr1,RPS27P5,chr1:226781501-226781744,243
160995211,161021343,chr1,F11R,chr1:160995211-161021343,26132
169966635,169998373,chr3,SEC62,chr3:169966635-169998373,31738
169978536,169985715,chr3,SEC62-AS1,chr3:169978536-169985715,7179
170037995,170085392,chr3,GPR160,chr3:170037995-170085392,47397
161034834,161035006,chr1,GLRX5P2,chr1:161034834-161035006,172
161037631,161038977,chr1,TSTD1,chr1:161037631-161038977,1346
170057301,170057429,chr3,RNU4-38P,chr3:170057301-170057429,128
170062244,170062951,chr3,KMT5AP3,chr3:170062244-170062951,707
169812870,169837773,chr3,LRRIQ4,chr3:169812870-169837773,24903
161039251,161045977,chr1,USF1,chr1:161039251-161045977,6726
51662693,51704323,chr3,TEX264,chr3:51662693-51704323,41630
173880850,173965373,chr2,SP3,chr2:173880850-173965373,84523
51694465,51694582,chr3,RNA5SP132,chr3:51694465-51694582,117
51707068,51718613,chr3,GRM2,chr3:51707068-51718613,11545
51778561,51779241,chr3,IQCF6,chr3:51778561-51779241,680
161046946,161069970,chr1,ARHGAP30,chr1:161046946-161069970,23024
51826883,51830856,chr3,IQCF3,chr3:51826883-51830856,3973
241227264,241317061,chr2,HDLBP,chr2:241227264-241317061,89797
196935402,196942594,chr3,NCBP2,chr3:196935402-196942594,7192
196939877,196942534,chr3,NCBP2-AS1,chr3:196939877-196942534,2657
196942674,196943543,chr3,NCBP2AS2,chr3:196942674-196943543,869
196946356,196969060,chr3,PIGZ,chr3:196946356-196969060,22704
161070998,161089558,chr1,NECTIN4,chr1:161070998-161089558,18560
196980590,197029817,chr3,MELTF,chr3:196980590-197029817,49227
161084465,161087571,chr1,NECTIN4-AS1,chr1:161084465-161087571,3106
161098361,161100346,chr1,KLHDC9,chr1:161098361-161100346,1985
161100556,161118055,chr1,PFDN2,chr1:161100556-161118055,17499
161118086,161125445,chr1,NIT1,chr1:161118086-161125445,7359
196986676,196987558,chr3,RPSAP69,chr3:196986676-196987558,882
72371825,72446621,chr3,RYBP,chr3:72371825-72446621,74796
150408298,150466422,chr3,TSC22D2,chr3:150408298-150466422,58124
130517177,130677044,chr3,COL6A6,chr3:130517177-130677044,159867
161120974,161132688,chr1,DEDD,chr1:161120974-161132688,11714
42809483,42942792,chr3,KRBOX1,chr3:42809483-42942792,133309
206008535,206023909,chr1,CTSE,chr1:206008535-206023909,15374
42906142,42919334,chr3,ZNF662,chr3:42906142-42919334,13192
42934252,42936785,chr3,KRBOX1-AS1,chr3:42934252-42936785,2533
43286512,43424764,chr3,SNRK,chr3:43286512-43424764,138252
226940286,226987544,chr1,COQ8A,chr1:226940286-226987544,47258
43314951,43315255,chr3,RN7SL517P,chr3:43314951-43315255,304
43346923,43352152,chr3,SNRK-AS1,chr3:43346923-43352152,5229
42979087,43067898,chr3,GASK1A,chr3:42979087-43067898,88811
43079229,43106085,chr3,POMGNT2,chr3:43079229-43106085,26856
11137093,11263557,chr3,HRH1,chr3:11137093-11263557,126464
11234256,11234582,chr3,CHCHD4P4,chr3:11234256-11234582,326
38958275,38958925,chr1,EIF1P2,chr1:38958275-38958925,650
11272309,11557665,chr3,ATG7,chr3:11272309-11557665,285356
38991276,39006059,chr1,AKIRIN1,chr1:38991276-39006059,14783
39026318,39034636,chr1,NDUFS5,chr1:39026318-39034636,8318
39120940,39121043,chr1,RNU6-608P,chr1:39120940-39121043,103
39154164,39154296,chr1,RNA5SP44,chr1:39154164-39154296,132
39304294,39304898,chr1,HSPE1P8,chr1:39304294-39304898,604
110947190,110963965,chr1,LRIF1,chr1:110947190-110963965,16775
212999691,213152427,chr2,IKZF2,chr2:212999691-213152427,152736
111007700,111015530,chr1,CCNT2P1,chr1:111007700-111015530,7830
111041834,111041925,chr1,RNA5SP54,chr1:111041834-111041925,91
111185969,111204535,chr1,DENND2D,chr1:111185969-111204535,18566
11556069,11771350,chr3,VGLL4,chr3:11556069-11771350,215281
111200771,111243440,chr1,CHI3L2,chr1:111200771-111243440,42669
208359714,208854503,chr2,PTH2R,chr2:208359714-208854503,494789
233729042,233773300,chr2,UGT1A3,chr2:233729042-233773300,44258
111250254,111256715,chr1,CHIAP1,chr1:111250254-111256715,6461
12716910,12742734,chr2,TRIB2,chr2:12716910-12742734,25824
111280059,111286116,chr1,CHIAP2,chr1:111280059-111286116,6057
233617633,233773300,chr2,UGT1A8,chr2:233617633-233773300,155667
111117163,111140203,chr1,DRAM2,chr1:111117163-111140203,23040
233712907,233773300,chr2,UGT1A5,chr2:233712907-233773300,60393
12582101,12664201,chr3,RAF1,chr3:12582101-12664201,82100
154325525,154351304,chr1,ATP8B2,chr1:154325525-154351304,25779
240029491,240030429,chr2,OR6B2,chr2:240029491-240030429,938
96122818,96138502,chr2,ASTL,chr2:96122818-96138502,15684
233681901,233773300,chr2,UGT1A7,chr2:233681901-233773300,91399
154338743,154338802,chr1,RNU7-57P,chr1:154338743-154338802,59
154378207,154379089,chr1,RPSAP17,chr1:154378207-154379089,882
154402328,154406564,chr1,IL6R-AS1,chr1:154402328-154406564,4236
154405193,154469450,chr1,IL6R,chr1:154405193-154469450,64257
131360492,131364168,chr2,RAB6D,chr2:131360492-131364168,3676
71453561,71686763,chr2,DYSF,chr2:71453561-71686763,233202
154414369,154415137,chr1,PSMD8P1,chr1:154414369-154415137,768
154469772,154502412,chr1,SHE,chr1:154469772-154502412,32640
20161253,20186518,chr1,PLA2G2C,chr1:20161253-20186518,25265
20186096,20196050,chr1,UBXN10,chr1:20186096-20196050,9954
20243095,20244664,chr1,LINC01757,chr1:20243095-20244664,1569
161314381,161363206,chr1,SDHC,chr1:161314381-161363206,48825
150809713,150876708,chr1,ARNT,chr1:150809713-150876708,66995
150812591,150812698,chr1,RNU6-1309P,chr1:150812591-150812698,107
150881236,150881683,chr1,RPS27AP6,chr1:150881236-150881683,447
150903896,150904213,chr1,CYCSP51,chr1:150903896-150904213,317
24494087,24681711,chr3,THRB-AS1,chr3:24494087-24681711,187624
226360210,226408154,chr1,PARP1,chr1:226360210-226408154,47944
24555834,24556459,chr3,EIF3KP2,chr3:24555834-24556459,625
25020166,25020463,chr3,RN7SL216P,chr3:25020166-25020463,297
25025007,25025126,chr3,RNA5SP125,chr3:25025007-25025126,119
25324174,25324659,chr3,CFL1P7,chr3:25324174-25324659,485
25352284,25352392,chr3,RNA5SP126,chr3:25352284-25352392,108
25441164,25441502,chr3,H3P10,chr3:25441164-25441502,338
24687887,25597932,chr3,RARB,chr3:24687887-25597932,910045
161197104,161214723,chr1,NDUFS2,chr1:161197104-161214723,17619
101779202,101828231,chr3,NXPE3,chr3:101779202-101828231,49029
101827991,101861022,chr3,NFKBIZ,chr3:101827991-101861022,33031
101940859,101997926,chr3,LINC02085,chr3:101940859-101997926,57067
101561868,101566446,chr3,TRMT10C,chr3:101561868-101566446,4578
101648889,101677135,chr3,ZBTB11,chr3:101648889-101677135,28246
180983697,180989774,chr3,DNAJC19,chr3:180983697-180989774,6077
181231737,181231843,chr3,RNU6-4P,chr3:181231737-181231843,106
181242345,181242901,chr3,FAUP2,chr3:181242345-181242901,556
194402672,194498364,chr3,ATP13A3,chr3:194402672-194498364,95692
49790732,49799873,chr3,CDHR4,chr3:49790732-49799873,9141
159276503,159277111,chr1,MPTX1,chr1:159276503-159277111,608
159279041,159280001,chr1,OR10J2P,chr1:159279041-159280001,960
159351093,159352026,chr1,OR10J7P,chr1:159351093-159352026,933
49803261,49805030,chr3,INKA1,chr3:49803261-49805030,1769
159366161,159367089,chr1,OR10J8P,chr1:159366161-159367089,928
49805209,49813953,chr3,UBA7,chr3:49805209-49813953,8744
159405423,159406409,chr1,OR10J9P,chr1:159405423-159406409,986
45510914,45542732,chr1,PRDX1,chr1:45510914-45542732,31818
45530927,45532139,chr1,HMGB1P48,chr1:45530927-45532139,1212
49806137,49806245,chr3,MIR5193,chr3:49806137-49806245,108
45583846,45618904,chr1,NASP,chr1:45583846-45618904,35058
49828601,49856574,chr3,TRAIP,chr3:49828601-49856574,27973
49857988,49869935,chr3,CAMKV,chr3:49857988-49869935,11947
49863375,49863660,chr3,RN7SL217P,chr3:49863375-49863660,285
49873347,49877305,chr3,ACTL11P,chr3:49873347-49877305,3958
49887002,49903873,chr3,MST1R,chr3:49887002-49903873,16871
45620044,45624057,chr1,CCDC17,chr1:45620044-45624057,4013
49907160,49930173,chr3,MON1A,chr3:49907160-49930173,23013
45627304,45688113,chr1,GPBP1L1,chr1:45627304-45688113,60809
49940007,50100045,chr3,RBM6,chr3:49940007-50100045,160038
45645816,45646197,chr1,RPS15AP10,chr1:45645816-45646197,381
45688181,45694436,chr1,TMEM69,chr1:45688181-45694436,6255
153959099,153968184,chr1,SLC39A1,chr1:153959099-153968184,9085
207496147,207641765,chr1,CR1,chr1:207496147-207641765,145618
88966262,88966767,chr2,IGKV1-6,chr2:88966262-88966767,505
88978468,88979081,chr2,IGKV3-7,chr2:88978468-88979081,613
88992409,88992931,chr2,IGKV1-8,chr2:88992409-88992931,522
89009982,89010515,chr2,IGKV1-9,chr2:89009982-89010515,533
89019992,89020686,chr2,IGKV2-10,chr2:89019992-89020686,694
89027171,89027731,chr2,IGKV3-11,chr2:89027171-89027731,560
89040224,89040745,chr2,IGKV1-12,chr2:89040224-89040745,521
89045995,89046466,chr2,IGKV1-13,chr2:89045995-89046466,471
89078010,89078784,chr2,IGKV2-14,chr2:89078010-89078784,774
89085177,89085787,chr2,IGKV3-15,chr2:89085177-89085787,610
89099859,89100361,chr2,IGKV1-16,chr2:89099859-89100361,502
89117342,89117844,chr2,IGKV1-17,chr2:89117342-89117844,502
89128724,89129483,chr2,IGKV2-18,chr2:89128724-89129483,759
89134975,89135257,chr2,IGKV2-19,chr2:89134975-89135257,282
89142574,89143160,chr2,IGKV3-20,chr2:89142574-89143160,586
89159751,89160366,chr2,IGKV6-21,chr2:89159751-89160366,615
89170775,89171212,chr2,IGKV1-22,chr2:89170775-89171212,437
89172022,89172553,chr2,IGKV2-23,chr2:89172022-89172553,531
89176328,89177160,chr2,IGKV2-24,chr2:89176328-89177160,832
89192500,89192752,chr2,IGKV3-25,chr2:89192500-89192752,252
89196096,89196829,chr2,IGKV2-26,chr2:89196096-89196829,733
89213423,89213928,chr2,IGKV1-27,chr2:89213423-89213928,505
89221698,89222461,chr2,IGKV2-28,chr2:89221698-89222461,763
89234174,89234912,chr2,IGKV2-29,chr2:89234174-89234912,738
89244781,89245596,chr2,IGKV2-30,chr2:89244781-89245596,815
89252211,89252736,chr2,IGKV3-31,chr2:89252211-89252736,525
89253571,89254015,chr2,IGKV1-32,chr2:89253571-89254015,444
89268001,89268506,chr2,IGKV1-33,chr2:89268001-89268506,505
89275298,89275787,chr2,IGKV3-34,chr2:89275298-89275787,489
89286689,89286973,chr2,IGKV1-35,chr2:89286689-89286973,284
89295233,89295455,chr2,IGKV2-36,chr2:89295233-89295455,222
89297264,89297785,chr2,IGKV1-37,chr2:89297264-89297785,521
89309898,89310144,chr2,IGKV2-38,chr2:89309898-89310144,246
89319625,89320146,chr2,IGKV1-39,chr2:89319625-89320146,521
89330116,89330429,chr2,IGKV2-40,chr2:89330116-89330429,313
89851791,89852493,chr2,IGKV2D-40,chr2:89851791-89852493,702
89862482,89862981,chr2,IGKV1D-39,chr2:89862482-89862981,499
89872463,89872702,chr2,IGKV2D-38,chr2:89872463-89872702,239
89884740,89885216,chr2,IGKV1D-37,chr2:89884740-89885216,476
50088919,50119021,chr3,RBM5,chr3:50088919-50119021,30102
228139962,228148984,chr1,GUK1,chr1:228139962-228148984,9022
89887022,89887247,chr2,IGKV2D-36,chr2:89887022-89887247,225
89895502,89895772,chr2,IGKV1D-35,chr2:89895502-89895772,270
89906757,89907246,chr2,IGKV3D-34,chr2:89906757-89907246,489
89913982,89914545,chr2,IGKV1D-33,chr2:89913982-89914545,563
89928422,89928867,chr2,IGKV1D-32,chr2:89928422-89928867,445
89929701,89930202,chr2,IGKV3D-31,chr2:89929701-89930202,501
89936859,89937679,chr2,IGKV2D-30,chr2:89936859-89937679,820
89947512,89948269,chr2,IGKV2D-29,chr2:89947512-89948269,757
89959979,89960748,chr2,IGKV2D-28,chr2:89959979-89960748,769
89968867,89969335,chr2,IGKV1D-27,chr2:89968867-89969335,468
89985922,89986702,chr2,IGKV2D-26,chr2:89985922-89986702,780
89989987,89990221,chr2,IGKV3D-25,chr2:89989987-89990221,234
90004797,90005629,chr2,IGKV2D-24,chr2:90004797-90005629,832
90009402,90009927,chr2,IGKV2D-23,chr2:90009402-90009927,525
90010741,90011184,chr2,IGKV1D-22,chr2:90010741-90011184,443
90021567,90022185,chr2,IGKV6D-21,chr2:90021567-90022185,618
90038848,90039479,chr2,IGKV3D-20,chr2:90038848-90039479,631
90046796,90047057,chr2,IGKV2D-19,chr2:90046796-90047057,261
90052581,90053372,chr2,IGKV2D-18,chr2:90052581-90053372,791
90069662,90070238,chr2,IGKV6D-41,chr2:90069662-90070238,576
90082635,90083291,chr2,IGKV1D-17,chr2:90082635-90083291,656
90100236,90100738,chr2,IGKV1D-16,chr2:90100236-90100738,502
90114838,90115402,chr2,IGKV3D-15,chr2:90114838-90115402,564
90121786,90122564,chr2,IGKV2D-14,chr2:90121786-90122564,778
90154073,90154574,chr2,IGKV1D-13,chr2:90154073-90154574,501
90159840,90160335,chr2,IGKV1D-12,chr2:90159840-90160335,495
90172802,90173414,chr2,IGKV3D-11,chr2:90172802-90173414,612
90179889,90180587,chr2,IGKV2D-10,chr2:90179889-90180587,698
90190193,90190681,chr2,IGKV1D-42,chr2:90190193-90190681,488
90209873,90210529,chr2,IGKV1D-43,chr2:90209873-90210529,656
90220727,90221384,chr2,IGKV1D-8,chr2:90220727-90221384,657
90234812,90235370,chr2,IGKV3D-7,chr2:90234812-90235370,558
90315366,90315836,chr2,IGKV1OR2-118,chr2:90315366-90315836,470
74557883,74648338,chr2,M1AP,chr2:74557883-74648338,90455
124025287,124921219,chr2,CNTNAP5,chr2:124025287-124921219,895932
50099603,50100988,chr3,RBM5-AS1,chr3:50099603-50100988,1385
50116022,50156085,chr3,SEMA3F-AS1,chr3:50116022-50156085,40063
122055362,122121139,chr3,CD86,chr3:122055362-122121139,65777
203014608,203226378,chr2,NBEAL1,chr2:203014608-203226378,211770
122183668,122291629,chr3,CASR,chr3:122183668-122291629,107961
171315746,171434802,chr2,METTL8,chr2:171315746-171434802,119056
122317609,122318741,chr3,HNRNPA1P23,chr3:122317609-122318741,1132
122325248,122341969,chr3,CSTA,chr3:122325248-122341969,16721
122359591,122383231,chr3,MIX23,chr3:122359591-122383231,23640
122384161,122412334,chr3,FAM162A,chr3:122384161-122412334,28173
181954241,182131398,chr2,PPP1R1C,chr2:181954241-182131398,177157
122411846,122416062,chr3,WDR5B,chr3:122411846-122416062,4216
122421902,122514945,chr3,KPNA1,chr3:122421902-122514945,93043
69960089,69961631,chr2,ASPRV1,chr2:69960089-69961631,1542
108239968,108265351,chr2,SULT1C3,chr2:108239968-108265351,25383
112911165,112918882,chr2,IL37,chr2:112911165-112918882,7717
127298668,127388465,chr2,MAP3K2,chr2:127298668-127388465,89797
122527924,122564577,chr3,PARP9,chr3:122527924-122564577,36653
113627229,113643396,chr2,RABL2A,chr2:113627229-113643396,16167
67407810,67430415,chr1,SERBP1,chr1:67407810-67430415,22605
122564338,122575203,chr3,DTX3L,chr3:122564338-122575203,10865
122577628,122639047,chr3,PARP15,chr3:122577628-122639047,61419
122660613,122662438,chr3,EIF4BP8,chr3:122660613-122662438,1825
10037552,10037655,chr3,RNU6-670P,chr3:10037552-10037655,103
9962682,10011202,chr3,EMC3,chr3:9962682-10011202,48520
218034960,218090581,chr2,RUFY4,chr2:218034960-218090581,55621
151340640,151347326,chr1,RFX5,chr1:151340640-151347326,6686
133784023,133825772,chr3,SRPRB,chr3:133784023-133825772,41749
24491254,24770702,chr2,NCOA1,chr2:24491254-24770702,279448
98657802,98660570,chr3,WWP1P1,chr3:98657802-98660570,2768
98706236,98732757,chr3,ST3GAL6-AS1,chr3:98706236-98732757,26521
98782188,98783193,chr3,PDLIM1P4,chr3:98782188-98783193,1005
98795941,98901695,chr3,DCBLD2,chr3:98795941-98901695,105754
98804978,98805084,chr3,RNU6-26P,chr3:98804978-98805084,106
98908459,98908564,chr3,RNU6-1263P,chr3:98908459-98908564,105
98732236,98821201,chr3,ST3GAL6,chr3:98732236-98821201,88965
143938068,144332568,chr2,GTDC1,chr2:143938068-144332568,394500
66924895,66988619,chr1,MIER1,chr1:66924895-66988619,63724
45742675,45742970,chr3,RN7SL145P,chr3:45742675-45742970,295
45917903,45995824,chr3,FYCO1,chr3:45917903-45995824,77921
9919051,9919153,chr3,RNU6-882P,chr3:9919051-9919153,102
9808086,9855138,chr3,TTLL3,chr3:9808086-9855138,47052
209424047,209734118,chr2,MAP2,chr2:209424047-209734118,310071
8318114,8344167,chr1,SLC45A1,chr1:8318114-8344167,26053
20664014,20718017,chr1,KIF17,chr1:20664014-20718017,54003
247099962,247104372,chr1,ZNF669,chr1:247099962-247104372,4410
179839967,179877803,chr1,TOR1AIP2,chr1:179839967-179877803,37836
101686827,101713301,chr3,PDCL3P4,chr3:101686827-101713301,26474
27214816,27215018,chr3,MICOS10P3,chr3:27214816-27215018,202
27265580,27265683,chr3,RNU6-342P,chr3:27265580-27265683,103
27462506,27462816,chr3,RPS20P15,chr3:27462506-27462816,310
27513871,27514032,chr3,RNU1-96P,chr3:27513871-27514032,161
27106484,27369460,chr3,NEK10,chr3:27106484-27369460,262976
193012250,193060080,chr1,UCHL5,chr1:193012250-193060080,47830
74414176,74421619,chr2,C2orf81,chr2:74414176-74421619,7443
200973718,201071671,chr2,FAM126B,chr2:200973718-201071671,97953
138608606,138633376,chr3,FAIM,chr3:138608606-138633376,24770
65353525,66038918,chr3,MAGI1,chr3:65353525-66038918,685393
127418427,127429242,chr2,PROC,chr2:127418427-127429242,10815
127423537,127423618,chr2,MIR4783,chr2:127423537-127423618,81
127436207,127526886,chr2,IWS1,chr2:127436207-127526886,90679
127638381,127681786,chr2,LIMS2,chr2:127638381-127681786,43405
3772749,3775982,chr1,SMIM1,chr1:3772749-3775982,3233
112815709,112846864,chr3,CD200R1L,chr3:112815709-112846864,31155
32936445,32964809,chr1,RNF19B,chr1:32936445-32964809,28364
8619386,8745040,chr3,SSUH2,chr3:8619386-8745040,125654
28668778,28719353,chr1,GMEB1,chr1:28668778-28719353,50575
52345723,52366205,chr1,CC2D1B,chr1:52345723-52366205,20482
11790442,11846919,chr3,TAMM41,chr3:11790442-11846919,56477
123968521,123992178,chr3,ROPN1,chr3:123968521-123992178,23657
56994778,58546734,chr1,DAB1,chr1:56994778-58546734,1551956
27372721,27484420,chr3,SLC4A7,chr3:27372721-27484420,111699
89524829,89597861,chr1,LRRC8B,chr1:89524829-89597861,73032
92080305,92184725,chr1,BTBD8,chr1:92080305-92184725,104420
203795623,203854999,chr1,ZC3H11A,chr1:203795623-203854999,59376
127645864,127652639,chr2,GPR17,chr2:127645864-127652639,6775
73385758,73625166,chr2,ALMS1,chr2:73385758-73625166,239408
239048168,239401654,chr2,HDAC4,chr2:239048168-239401654,353486
192636138,192660311,chr1,RGS13,chr1:192636138-192660311,24173
40040233,40072649,chr1,CAP1,chr1:40040233-40072649,32416
165984641,166149214,chr2,SCN1A,chr2:165984641-166149214,164573
6264269,6393767,chr1,ACOT7,chr1:6264269-6393767,129498
179882042,179920077,chr1,TOR1AIP1,chr1:179882042-179920077,38035
219496131,219498287,chr2,SPEGNB,chr2:219496131-219498287,2156
8603082,8603359,chr2,SNRPEP5,chr2:8603082-8603359,277
8678845,8684461,chr2,ID2,chr2:8678845-8684461,5616
8852690,9003709,chr2,MBOAT2,chr2:8852690-9003709,151019
53916574,53945699,chr1,HSPB11,chr1:53916574-53945699,29125
9018293,9018899,chr2,HMGB1P25,chr2:9018293-9018899,606
223052190,223198399,chr2,KCNE4,chr2:223052190-223198399,146209
8721081,8837630,chr2,KIDINS220,chr2:8721081-8837630,116549
1216909,1232067,chr1,SDF4,chr1:1216909-1232067,15158
22710839,22921500,chr1,EPHB2,chr1:22710839-22921500,210661
58717365,59050084,chr3,CFAP20DC,chr3:58717365-59050084,332719
128909866,129002690,chr3,CFAP92,chr3:128909866-129002690,92824
165724293,165827755,chr1,TMCO1,chr1:165724293-165827755,103462
36712421,36764553,chr3,DCLK3,chr3:36712421-36764553,52132
46370946,46376206,chr3,CCR5,chr3:46370946-46376206,5260
4303332,4317265,chr3,SETMAR,chr3:4303332-4317265,13933
158962235,159897629,chr3,IQCJ-SCHIP1,chr3:158962235-159897629,935394
21440128,21485005,chr1,NBPF3,chr1:21440128-21485005,44877
109326144,109337546,chr3,DPPA4,chr3:109326144-109337546,11402
1635225,1659012,chr1,CDK11B,chr1:1635225-1659012,23787
49412212,49416476,chr3,TCTA,chr3:49412212-49416476,4264
149964904,150050788,chr3,PFN2,chr3:149964904-150050788,85884
128462437,128466968,chr3,DNAJB8,chr3:128462437-128466968,4531
179236691,179267002,chr3,KCNMB3,chr3:179236691-179267002,30311
129382922,129399655,chr3,RPL32P3,chr3:129382922-129399655,16733
32277904,32316594,chr2,YIPF4,chr2:32277904-32316594,38690
75624275,75670156,chr3,RPL23AP49,chr3:75624275-75670156,45881
32357023,32618878,chr2,BIRC6,chr2:32357023-32618878,261855
194296191,194322871,chr3,LINC00887,chr3:194296191-194322871,26680
126180012,126210169,chr3,ALDH1L1-AS2,chr3:126180012-126210169,30157
107220744,107348464,chr3,DUBR,chr3:107220744-107348464,127720
64684909,65053439,chr3,ADAMTS9-AS2,chr3:64684909-65053439,368530
190120944,190150162,chr3,P3H2-AS1,chr3:190120944-190150162,29218
32377631,32379599,chr2,BIRC6-AS1,chr2:32377631-32379599,1968
32532153,32532246,chr2,MIR558,chr2:32532153-32532246,93
32557273,32574818,chr2,BIRC6-AS2,chr2:32557273-32574818,17545
32628032,32821051,chr2,TTC27,chr2:32628032-32821051,193019
133661968,133754576,chr3,INHCAP,chr3:133661968-133754576,92608
32635255,32635331,chr2,MIR4765,chr2:32635255-32635331,76
150703486,150723005,chr3,ERICH6-AS1,chr3:150703486-150723005,19519
198053522,198080737,chr3,ANKRD18DP,chr3:198053522-198080737,27215
233210051,233295674,chr2,ATG16L1,chr2:233210051-233295674,85623
196142525,196160893,chr3,LINC00885,chr3:196142525-196160893,18368
193841868,193844024,chr3,LINC02038,chr3:193841868-193844024,2156
125916609,125930056,chr3,FAM86JP,chr3:125916609-125930056,13447
44556987,44685665,chr3,ZKSCAN7-AS1,chr3:44556987-44685665,128678
110888384,111071553,chr3,NECTIN3-AS1,chr3:110888384-111071553,183169
125928689,125990580,chr3,ALG1L,chr3:125928689-125990580,61891
47164186,47246601,chr3,KIF9-AS1,chr3:47164186-47246601,82415
151770416,151784901,chr3,AADACP1,chr3:151770416-151784901,14485
54542257,54639192,chr1,ACOT11,chr1:54542257-54639192,96935
194247617,194260720,chr3,LINC02037,chr3:194247617-194260720,13103
131361845,131365122,chr3,NUDT16L2P,chr3:131361845-131365122,3277
167864773,167924011,chr3,LRRC77P,chr3:167864773-167924011,59238
45550543,45570049,chr1,AKR1A1,chr1:45550543-45570049,19506
75413292,75435125,chr3,FAM86DP,chr3:75413292-75435125,21833
196225779,196609225,chr1,KCNT2,chr1:196225779-196609225,383446
194487140,194521156,chr3,LINC00884,chr3:194487140-194521156,34016
233275727,233276002,chr2,SCARNA5,chr2:233275727-233276002,275
233288676,233288940,chr2,SCARNA6,chr2:233288676-233288940,264
233307816,233347055,chr2,SAG,chr2:233307816-233347055,39239
152245262,152269565,chr3,MBNL1-AS1,chr3:152245262-152269565,24303
40313802,40453329,chr3,ENTPD3-AS1,chr3:40313802-40453329,139527
37693655,37861802,chr3,ITGA9-AS1,chr3:37693655-37861802,168147
233354494,233472104,chr2,DGKD,chr2:233354494-233472104,117610
75672254,75742048,chr3,LINC00960,chr3:75672254-75742048,69794
136835345,136862618,chr3,NCK1-DT,chr3:136835345-136862618,27273
196999460,197004744,chr3,MELTF-AS1,chr3:196999460-197004744,5284
40061110,40309698,chr3,EIF1B-AS1,chr3:40061110-40309698,248588
42770600,42773722,chr3,LINC02158,chr3:42770600-42773722,3122
46364391,46407083,chr3,CCR5AS,chr3:46364391-46407083,42692
196631498,196632700,chr3,LINC01063,chr3:196631498-196632700,1202
157543246,157677749,chr3,SLC66A1L,chr3:157543246-157677749,134503
129893811,129918578,chr3,TMCC1-DT,chr3:129893811-129918578,24767
150794880,150809577,chr1,CTSK,chr1:150794880-150809577,14697
156671859,156674446,chr3,TIPARP-AS1,chr3:156671859-156674446,2587
50266631,50267541,chr3,SEMA3B-AS1,chr3:50266631-50267541,910
122416200,122443180,chr3,WDR5B-DT,chr3:122416200-122443180,26980
183447608,183456017,chr3,LINC00888,chr3:183447608-183456017,8409
9986885,10006990,chr3,EMC3-AS1,chr3:9986885-10006990,20105
233475520,233566782,chr2,USP40,chr2:233475520-233566782,91262
28887091,29120046,chr1,EPB41,chr1:28887091-29120046,232955
9349689,9398579,chr3,THUMPD3-AS1,chr3:9349689-9398579,48890
10014237,10026395,chr3,CIDECP1,chr3:10014237-10026395,12158
180989762,181836880,chr3,SOX2-OT,chr3:180989762-181836880,847118
151485336,151734487,chr2,NEB,chr2:151485336-151734487,249151
4490317,4493201,chr3,ITPR1-DT,chr3:4490317-4493201,2884
71943592,72279503,chr3,LINC00877,chr3:71943592-72279503,335911
80993822,81105182,chr3,LINC02027,chr3:80993822-81105182,111360
14920347,14948424,chr3,FGD5-AS1,chr3:14920347-14948424,28077
123585300,123644568,chr3,MYLK-AS1,chr3:123585300-123644568,59268
165206929,165846519,chr3,LINC01322,chr3:165206929-165846519,639590
157089634,157135557,chr3,LINC00881,chr3:157089634-157135557,45923
130097782,130111506,chr3,FAM86HP,chr3:130097782-130111506,13724
154024401,154121347,chr3,ARHGEF26-AS1,chr3:154024401-154121347,96946
139389761,139782699,chr3,COPB2-DT,chr3:139389761-139782699,392938
194583991,194590260,chr3,TMEM44-AS1,chr3:194583991-194590260,6269
161324913,161326219,chr3,EEF1GP4,chr3:161324913-161326219,1306
161328924,161330238,chr3,PSMC1P7,chr3:161328924-161330238,1314
161344798,161372880,chr3,SPTSSB,chr3:161344798-161372880,28082
161426427,161448242,chr3,LINC02067,chr3:161426427-161448242,21815
161429127,161429597,chr3,RPL23AP42,chr3:161429127-161429597,470
161496808,161503942,chr3,OTOL1,chr3:161496808-161503942,7134
74461057,74465410,chr2,MOGS,chr2:74461057-74465410,4353
101991960,102028544,chr2,IL1R2,chr2:101991960-102028544,36584
202874261,203014798,chr2,WDR12,chr2:202874261-203014798,140537
33838523,33840140,chr1,HSPD1P14,chr1:33838523-33840140,1617
33860475,33864791,chr1,HMGB4,chr1:33860475-33864791,4316
33868953,33893726,chr1,CSMD2-AS1,chr1:33868953-33893726,24773
202179297,202179971,chr2,PSMA2P3,chr2:202179297-202179971,674
202201384,202201886,chr2,DAZAP2P1,chr2:202201384-202201886,502
202206182,202238599,chr2,SUMO1,chr2:202206182-202238599,32417
33007940,33080996,chr1,AK2,chr1:33007940-33080996,73056
202231696,202231849,chr2,RPL39P14,chr2:202231696-202231849,153
202265736,202303661,chr2,NOP58,chr2:202265736-202303661,37925
33081104,33123492,chr1,AZIN2,chr1:33081104-33123492,42388
202276431,202276518,chr2,SNORD70,chr2:202276431-202276518,87
202278108,202278192,chr2,SNORD70B,chr2:202278108-202278192,84
202291332,202291421,chr2,SNORD11B,chr2:202291332-202291421,89
202293051,202293134,chr2,SNORD11,chr2:202293051-202293134,83
202333439,202333728,chr2,RN7SL753P,chr2:202333439-202333728,289
202336024,202336727,chr2,PIMREGP1,chr2:202336024-202336727,703
202357076,202357417,chr2,RN7SL40P,chr2:202357076-202357417,341
202376327,202567751,chr2,BMPR2,chr2:202376327-202567751,191424
33145399,33182059,chr1,TRIM62,chr1:33145399-33182059,36660
227598424,227599094,chr1,FAM133FP,chr1:227598424-227599094,670
202505012,202505343,chr2,H3P8,chr2:202505012-202505343,331
202520401,202520989,chr2,RPL13AP12,chr2:202520401-202520989,588
227696892,227706699,chr1,ZNF847P,chr1:227696892-227706699,9807
227743831,227747191,chr1,SNAP47-AS1,chr1:227743831-227747191,3360
202614214,202614704,chr2,MTCO1P17,chr2:202614214-202614704,490
227815693,227846470,chr1,PRSS38,chr1:227815693-227846470,30777
202614853,202615529,chr2,MTCO2P17,chr2:202614853-202615529,676
202615769,202616440,chr2,MTATP6P17,chr2:202615769-202616440,671
202616700,202617212,chr2,MTCO3P17,chr2:202616700-202617212,512
202617284,202617627,chr2,MTND3P17,chr2:202617284-202617627,343
150730079,150765957,chr1,CTSS,chr1:150730079-150765957,35878
202617695,202617987,chr2,MTND4LP17,chr2:202617695-202617987,292
202617983,202618881,chr2,MTND4P30,chr2:202617983-202618881,898
202619185,202619896,chr2,MTCO1P54,chr2:202619185-202619896,711
202634969,202769757,chr2,FAM117B,chr2:202634969-202769757,134788
54747103,54750473,chr2,EML6-AS1,chr2:54747103-54750473,3370
54850289,54850352,chr2,RNU7-81P,chr2:54850289-54850352,63
38763534,38765221,chr2,TTC39DP,chr2:38763534-38765221,1687
27582969,27623217,chr2,ZNF512,chr2:27582969-27623217,40248
226231149,226309869,chr1,LIN9,chr1:226231149-226309869,78720
27625638,27629012,chr2,CCDC121,chr2:27625638-27629012,3374
27628247,27651511,chr2,GPN1,chr2:27628247-27651511,23264
13029339,13032130,chr1,PRAMEF28P,chr1:13029339-13032130,2791
13049476,13056575,chr1,PRAMEF27,chr1:13049476-13056575,7099
13068677,13077884,chr1,PRAMEF25,chr1:13068677-13077884,9207
13095179,13097971,chr1,PRAMEF34P,chr1:13095179-13097971,2792
27650809,27663840,chr2,SUPT7L,chr2:27650809-27663840,13031
13104403,13105689,chr1,PRAMEF35P,chr1:13104403-13105689,1286
13115488,13116854,chr1,HNRNPCL2,chr1:13115488-13116854,1366
13128818,13131615,chr1,PRAMEF36P,chr1:13128818-13131615,2797
13163914,13165631,chr1,HNRNPCL4,chr1:13163914-13165631,1717
88979456,88992960,chr1,RBMXL1,chr1:88979456-88992960,13504
89006679,89022894,chr1,GBP3,chr1:89006679-89022894,16215
27663471,27694976,chr2,SLC4A1AP,chr2:27663471-27694976,31505
27537386,27582720,chr2,C2orf16,chr2:27537386-27582720,45334
89051882,89065360,chr1,GBP1,chr1:89051882-89065360,13478
112645939,112663825,chr2,SLC20A1,chr2:112645939-112663825,17886
89104285,89104767,chr1,PTGES3P1,chr1:89104285-89104767,482
89106132,89150456,chr1,GBP2,chr1:89106132-89150456,44324
96004563,96004850,chr2,RN7SL210P,chr2:96004563-96004850,287
96112876,96116571,chr2,ADRA2B,chr2:96112876-96116571,3695
96021946,96039451,chr2,GPAT2,chr2:96021946-96039451,17505
89131742,89176009,chr1,GBP7,chr1:89131742-89176009,44267
89181144,89198942,chr1,GBP4,chr1:89181144-89198942,17798
27534035,27604431,chr1,AHDC1,chr1:27534035-27604431,70396
27612064,27635185,chr1,FGR,chr1:27612064-27635185,23121
39175646,39243957,chr2,CDKL4,chr2:39175646-39243957,68311
39249266,39437301,chr2,MAP4K3,chr2:39249266-39437301,188035
27660328,27666279,chr1,LINC02574,chr1:27660328-27666279,5951
27666064,27672212,chr1,IFI6,chr1:27666064-27672212,6148
13060769,13062878,chr1,HNRNPCL3,chr1:13060769-13062878,2109
78619902,78646145,chr1,IFI44L,chr1:78619902-78646145,26243
109494052,109502932,chr1,CYB561D1,chr1:109494052-109502932,8880
109504178,109509738,chr1,AMIGO1,chr1:109504178-109509738,5560
109548615,109600195,chr1,GNAI3,chr1:109548615-109600195,51580
240691866,240698483,chr2,AQP12A,chr2:240691866-240698483,6617
158456952,158682879,chr2,PKP4,chr2:158456952-158682879,225927
109591534,109591640,chr1,RNU6V,chr1:109591534-109591640,106
109598893,109598967,chr1,MIR197,chr1:109598893-109598967,74
109651370,109652099,chr1,RPL7P8,chr1:109651370-109652099,729
109603091,109619929,chr1,GNAT2,chr1:109603091-109619929,16838
186671791,186680922,chr1,PTGS2,chr1:186671791-186680922,9131
186680622,186683165,chr1,PACERR,chr1:186680622-186683165,2543
85318481,85578363,chr1,DDAH1,chr1:85318481-85578363,259882
86143932,86195472,chr2,IMMT,chr2:86143932-86195472,51540
112911847,112957593,chr1,SLC16A1,chr1:112911847-112957593,45746
112923423,112924337,chr1,AKR7A2P1,chr1:112923423-112924337,914
115285904,115338770,chr1,NGF,chr1:115285904-115338770,52866
916865,921016,chr1,LINC02593,chr1:916865-921016,4151
944203,959309,chr1,NOC2L,chr1:944203-959309,15106
966482,975865,chr1,PLEKHN1,chr1:966482-975865,9383
975204,982093,chr1,PERM1,chr1:975204-982093,6889
998962,1000172,chr1,HES4,chr1:998962-1000172,1210
1001138,1014540,chr1,ISG15,chr1:1001138-1014540,13402
1020120,1056118,chr1,AGRN,chr1:1020120-1056118,35998
11179759,11348330,chr2,ROCK2,chr2:11179759-11348330,168571
65227788,65271253,chr2,ACTR2,chr2:65227788-65271253,43465
200853009,200864691,chr2,CLK1,chr2:200853009-200864691,11682
54132968,54153770,chr1,CDCP2,chr1:54132968-54153770,20802
54184041,54225464,chr1,MRPL37,chr1:54184041-54225464,41423
54236440,54239063,chr1,SSBP3-AS1,chr1:54236440-54239063,2623
54516412,54517259,chr1,LINC02784,chr1:54516412-54517259,847
54536796,54537758,chr1,HNRNPA1P63,chr1:54536796-54537758,962
54225433,54413479,chr1,SSBP3,chr1:54225433-54413479,188046
230712842,230821075,chr2,CAB39,chr2:230712842-230821075,108233
166888480,167259753,chr2,XIRP2,chr2:166888480-167259753,371273
173903800,173917327,chr1,SERPINC1,chr1:173903800-173917327,13527
230592660,230595583,chr1,LINC01737,chr1:230592660-230595583,2923
230642481,230693982,chr1,COG2,chr1:230642481-230693982,51501
175072250,175168382,chr2,ATF2,chr2:175072250-175168382,96132
230747384,230802003,chr1,CAPN9,chr1:230747384-230802003,54619
230820250,230820358,chr1,RNA5SP79,chr1:230820250-230820358,108
230837119,230869589,chr1,C1orf198,chr1:230837119-230869589,32470
230894141,230894427,chr1,RN7SL837P,chr1:230894141-230894427,286
230690776,230745576,chr1,AGT,chr1:230690776-230745576,54800
78649796,78664078,chr1,IFI44,chr1:78649796-78664078,14282
154502219,154548147,chr1,TDRD10,chr1:154502219-154548147,45928
154548577,154559028,chr1,UBE2Q1,chr1:154548577-154559028,10451
154553609,154555017,chr1,UBE2Q1-AS1,chr1:154553609-154555017,1408
154567778,154580013,chr1,CHRNB2,chr1:154567778-154580013,12235
154581695,154628013,chr1,ADAR,chr1:154581695-154628013,46318
200889327,200903938,chr2,NIF3L1,chr2:200889327-200903938,14611
47695530,47810063,chr2,MSH6,chr2:47695530-47810063,114533
203238977,203306026,chr2,CYP20A1,chr2:203238977-203306026,67049
46632737,46673867,chr1,ATPAF1,chr1:46632737-46673867,41130
46665910,46666375,chr1,NENFP1,chr1:46665910-46666375,465
46668855,46673594,chr1,TEX38,chr1:46668855-46673594,4739
185738804,185833290,chr2,FSIP2,chr2:185738804-185833290,94486
46674036,46692098,chr1,EFCAB14-AS1,chr1:46674036-46692098,18062
46674659,46719146,chr1,EFCAB14,chr1:46674659-46719146,44487
54972187,55112621,chr2,RTN4,chr2:54972187-55112621,140434
226870184,226927726,chr1,PSEN2,chr1:226870184-226927726,57542
161706972,161714352,chr1,FCRLA,chr1:161706972-161714352,7380
161721563,161728143,chr1,FCRLB,chr1:161721563-161728143,6580
161735808,161736102,chr1,RN7SL466P,chr1:161735808-161736102,294
161749758,161757238,chr1,DUSP12,chr1:161749758-161757238,7480
211326615,211374946,chr1,TRAF5,chr1:211326615-211374946,48331
132671788,133568463,chr2,NCKAP5,chr2:132671788-133568463,896675
211417025,211417934,chr1,SNX25P1,chr1:211417025-211417934,909
211442274,211442806,chr1,ARPC3P2,chr1:211442274-211442806,532
211571568,211579161,chr1,SLC30A1,chr1:211571568-211579161,7593
211639440,211654627,chr1,LINC01693,chr1:211639440-211654627,15187
186694060,186765959,chr2,FAM171B,chr2:186694060-186765959,71899
211660189,211661277,chr1,FDPSP8,chr1:211660189-211661277,1088
211476522,211492162,chr1,RD3,chr1:211476522-211492162,15640
241584405,241637158,chr2,THAP4,chr2:241584405-241637158,52753
161766298,161977574,chr1,ATF6,chr1:161766298-161977574,211276
131209536,131265278,chr2,POTEE,chr2:131209536-131265278,55742
64524305,64593005,chr2,AFTPH,chr2:64524305-64593005,68700
75724431,75787575,chr1,ACADM,chr1:75724431-75787575,63144
189784085,189877629,chr2,PMS1,chr2:189784085-189877629,93544
75743423,75744776,chr1,DLSTP1,chr1:75743423-75744776,1353
75786197,75795086,chr1,RABGGTB,chr1:75786197-75795086,8889
27364352,27370338,chr2,EIF2B4,chr2:27364352-27370338,5986
75787072,75787150,chr1,SNORD45C,chr1:75787072-75787150,78
75787889,75787972,chr1,SNORD45A,chr1:75787889-75787972,83
75789477,75789548,chr1,SNORD45B,chr1:75789477-75789548,71
75796882,75913242,chr1,MSH4,chr1:75796882-75913242,116360
197504748,197775696,chr1,DENND1B,chr1:197504748-197775696,270948
97113153,97264521,chr2,ANKRD36,chr2:97113153-97264521,151368
197688760,197690627,chr1,EEF1A1P32,chr1:197688760-197690627,1867
197746751,197747451,chr1,FAM204BP,chr1:197746751-197747451,700
197268204,197478455,chr1,CRB1,chr1:197268204-197478455,210251
24202864,24360536,chr2,ITSN2,chr2:24202864-24360536,157672
43337818,43354466,chr1,MPL,chr1:43337818-43354466,16648
43358981,43363203,chr1,CDC20,chr1:43358981-43363203,4222
43363398,43368074,chr1,ELOVL1,chr1:43363398-43368074,4676
201116154,201176687,chr2,CFLAR,chr2:201116154-201176687,60533
43364648,43364715,chr1,MIR6734,chr1:43364648-43364715,67
43383917,43389808,chr1,MED8,chr1:43383917-43389808,5891
43385113,43389155,chr1,MED8-AS1,chr1:43385113-43389155,4042
109616104,109632051,chr1,AMPD2,chr1:109616104-109632051,15947
160272151,160493807,chr2,RBMS1,chr2:160272151-160493807,221656
197084121,197146694,chr1,ASPM,chr1:197084121-197146694,62573
159318979,159616569,chr2,BAZ2B,chr2:159318979-159616569,297590
243267257,243268119,chr1,FCF1P7,chr1:243267257-243268119,862
243346176,243346255,chr1,MIR4677,chr1:243346176-243346255,79
243624666,243625056,chr1,FABP7P1,chr1:243624666-243625056,390
243793205,243794400,chr1,AKT3-IT1,chr1:243793205-243794400,1195
243488233,243851079,chr1,AKT3,chr1:243488233-243851079,362846
118088452,118110997,chr2,INSIG2,chr2:118088452-118110997,22545
136765545,137677718,chr2,THSD7B,chr2:136765545-137677718,912173
201233443,201287711,chr2,CASP8,chr2:201233443-201287711,54268
3889125,3900293,chr1,C1orf174,chr1:3889125-3900293,11168
162371407,162838767,chr2,KCNH7,chr2:162371407-162838767,467360
156525405,156572604,chr1,IQGAP3,chr1:156525405-156572604,47199
26308547,26395885,chr2,SELENOI,chr2:26308547-26395885,87338
113437691,113496204,chr2,CBWD2,chr2:113437691-113496204,58513
156591756,156609507,chr1,NAXE,chr1:156591756-156609507,17751
156594301,156601496,chr1,GPATCH4,chr1:156594301-156601496,7195
156619331,156625725,chr1,HAPLN2,chr1:156619331-156625725,6394
119366924,119372550,chr2,DBI,chr2:119366924-119372550,5626
156637783,156641004,chr1,BCAN-AS1,chr1:156637783-156641004,3221
156641390,156659532,chr1,BCAN,chr1:156641390-156659532,18142
213284389,214410501,chr2,SPAG16,chr2:213284389-214410501,1126112
156668763,156677407,chr1,NES,chr1:156668763-156677407,8644
156699606,156705816,chr1,CRABP2,chr1:156699606-156705816,6210
156721891,156728766,chr1,ISG20L2,chr1:156721891-156728766,6875
210477682,210679107,chr2,CPS1,chr2:210477682-210679107,201425
156728442,156736960,chr1,METTL25B,chr1:156728442-156736960,8518
156737303,156741590,chr1,MRPL24,chr1:156737303-156741590,4287
156742109,156766925,chr1,HDGF,chr1:156742109-156766925,24816
156750610,156800815,chr1,PRCC,chr1:156750610-156800815,50205
156806243,156816848,chr1,SH2D2A,chr1:156806243-156816848,10605
51059837,51059905,chr1,MIR4421,chr1:51059837-51059905,68
51060018,51060103,chr1,MIR6500,chr1:51060018-51060103,85
51157788,51158471,chr1,CFL1P2,chr1:51157788-51158471,683
51195095,51235096,chr1,LINC01562,chr1:51195095-51235096,40001
51236273,51273447,chr1,RNF11,chr1:51236273-51273447,37174
51329654,51335324,chr1,TTC39A-AS1,chr1:51329654-51335324,5670
51354263,51519266,chr1,EPS15,chr1:51354263-51519266,165003
51382308,51382414,chr1,RNU6-877P,chr1:51382308-51382414,106
51538625,51538729,chr1,RNU6-1281P,chr1:51538625-51538729,104
722092,724903,chr1,CICP3,chr1:722092-724903,2811
758233,758336,chr1,RNU6-1199P,chr1:758233-758336,103
778747,810065,chr1,LINC01409,chr1:778747-810065,31318
817371,819837,chr1,FAM87B,chr1:817371-819837,2466
826206,827522,chr1,LINC00115,chr1:826206-827522,1316
868071,876903,chr1,FAM41C,chr1:868071-876903,8832
873292,874349,chr1,TUBB8P11,chr1:873292-874349,1057
1070967,1074306,chr1,RNF223,chr1:1070967-1074306,3339
1081818,1116361,chr1,C1orf159,chr1:1081818-1116361,34543
1137017,1144056,chr1,LINC01342,chr1:1137017-1144056,7039
1167104,1167198,chr1,MIR200B,chr1:1167104-1167198,94
1167863,1167952,chr1,MIR200A,chr1:1167863-1167952,89
1169005,1169087,chr1,MIR429,chr1:1169005-1169087,82
1173056,1179555,chr1,TTLL10-AS1,chr1:1173056-1179555,6499
51287258,51345116,chr1,TTC39A,chr1:51287258-51345116,57858
73233420,73253021,chr2,CCT7,chr2:73233420-73253021,19601
232606057,232682776,chr2,EFHD1,chr2:232606057-232682776,76719
130459455,130509707,chr2,POTEI,chr2:130459455-130509707,50252
111898607,112029561,chr2,MERTK,chr2:111898607-112029561,130954
91829774,91830066,chr1,RN7SL653P,chr1:91829774-91830066,292
923923,944575,chr1,SAMD11,chr1:923923-944575,20652
100038095,100083377,chr1,MFSD14A,chr1:100038095-100083377,45282
100083563,100132955,chr1,SASS6,chr1:100083563-100132955,49392
48314637,48379295,chr2,FOXN2,chr2:48314637-48379295,64658
100148448,100178273,chr1,LRRC39,chr1:100148448-100178273,29825
47160084,47176921,chr2,CALM2,chr2:47160084-47176921,16837
100186919,100249834,chr1,DBT,chr1:100186919-100249834,62915
100196816,100197051,chr1,RPL23AP90,chr1:100196816-100197051,235
100213293,100213670,chr1,BRI3P1,chr1:100213293-100213670,377
100266216,100292769,chr1,RTCA,chr1:100266216-100292769,26553
100281241,100281308,chr1,MIR553,chr1:100281241-100281308,67
91949343,92014426,chr1,BRDT,chr1:91949343-92014426,65083
26692722,26733420,chr2,KCNK3,chr2:26692722-26733420,40698
49918503,51225575,chr2,NRXN1,chr2:49918503-51225575,1307072
32013868,32060850,chr1,KHDRBS1,chr1:32013868-32060850,46982
32072031,32102866,chr1,TMEM39B,chr1:32072031-32102866,30835
27325849,27357034,chr2,GTF3C2,chr2:27325849-27357034,31185
32086949,32087007,chr1,MIR5585,chr1:32086949-32087007,58
32108056,32176563,chr1,KPNA6,chr1:32108056-32176563,68507
32200595,32205453,chr1,CCDC28B,chr1:32200595-32205453,4858
55287842,55419895,chr2,CCDC88A,chr2:55287842-55419895,132053
111599655,111608723,chr1,LINC01160,chr1:111599655-111608723,9068
111754832,111775602,chr1,DDX20,chr1:111754832-111775602,20770
92832013,92841924,chr1,RPL5,chr1:92832013-92841924,9911
92832737,92961522,chr1,DIPK1A,chr1:92832737-92961522,128785
92837289,92837383,chr1,SNORD21,chr1:92837289-92837383,94
92840719,92840851,chr1,SNORA66,chr1:92840719-92840851,132
92969604,92969710,chr1,RNU6-970P,chr1:92969604-92969710,106
92974827,92975114,chr1,RN7SL692P,chr1:92974827-92975114,287
93010257,93010351,chr1,RNU6-210P,chr1:93010257-93010351,94
93026252,93026542,chr1,RN7SKP123,chr1:93026252-93026542,290
93079235,93139079,chr1,MTF2,chr1:93079235-93139079,59844
20719731,20732837,chr1,SH2D5,chr1:20719731-20732837,13106
20841241,20841302,chr1,RNU7-200P,chr1:20841241-20841302,61
20988314,20988432,chr1,MIR1256,chr1:20988314-20988432,118
21003550,21003934,chr1,RPS15AP6,chr1:21003550-21003934,384
21161475,21162081,chr1,HSPE1P27,chr1:21161475-21162081,606
21217247,21345572,chr1,ECE1,chr1:21217247-21345572,128325
21293290,21299874,chr1,ECE1-AS1,chr1:21293290-21299874,6584
223220819,223364233,chr1,SUSD4,chr1:223220819-223364233,143414
223373822,223373956,chr1,RNU4-57P,chr1:223373822-223373956,134
223393415,223395465,chr1,CCDC185,chr1:223393415-223395465,2050
232832017,232832187,chr1,RNU1-74P,chr1:232832017-232832187,170
74026015,74198187,chr1,LRRIQ3,chr1:74026015-74198187,172172
74235387,74544428,chr1,TNNI3K,chr1:74235387-74544428,309041
74469376,74512611,chr1,LRRC53,chr1:74469376-74512611,43235
74568117,74673792,chr1,ERICH3,chr1:74568117-74673792,105675
74577430,74626098,chr1,ERICH3-AS1,chr1:74577430-74626098,48668
74705482,74733408,chr1,CRYZ,chr1:74705482-74733408,27926
74733152,74766678,chr1,TYW3,chr1:74733152-74766678,33526
74198235,74544393,chr1,FPGT-TNNI3K,chr1:74198235-74544393,346158
13555001,13555694,chr1,BRWD1P1,chr1:13555001-13555694,693
13623184,13623284,chr1,RNA5SP41,chr1:13623184-13623284,100
228610268,228610386,chr1,RNA5S1,chr1:228610268-228610386,118
228612509,228612627,chr1,RNA5S2,chr1:228612509-228612627,118
228614750,228614868,chr1,RNA5S3,chr1:228614750-228614868,118
228616991,228617109,chr1,RNA5S4,chr1:228616991-228617109,118
228619232,228619350,chr1,RNA5S5,chr1:228619232-228619350,118
228621447,228621565,chr1,RNA5S6,chr1:228621447-228621565,118
228623667,228623785,chr1,RNA5S7,chr1:228623667-228623785,118
228625909,228626027,chr1,RNA5S8,chr1:228625909-228626027,118
228628148,228628266,chr1,RNA5S9,chr1:228628148-228628266,118
228630390,228630508,chr1,RNA5S10,chr1:228630390-228630508,118
228632631,228632749,chr1,RNA5S11,chr1:228632631-228632749,118
228634871,228634989,chr1,RNA5S12,chr1:228634871-228634989,118
228637096,228637214,chr1,RNA5S13,chr1:228637096-228637214,118
228639337,228639455,chr1,RNA5S14,chr1:228639337-228639455,118
228641568,228641686,chr1,RNA5S15,chr1:228641568-228641686,118
228643809,228643927,chr1,RNA5S16,chr1:228643809-228643927,118
228646040,228646158,chr1,RNA5S17,chr1:228646040-228646158,118
228647912,228648032,chr1,RNA5SP18,chr1:228647912-228648032,120
228650241,228651379,chr1,DUSP5P1,chr1:228650241-228651379,1138
228208044,228378876,chr1,OBSCN,chr1:228208044-228378876,170832
162170684,162245151,chr2,FAP,chr2:162170684-162245151,74467
224470150,224585397,chr2,CUL3,chr2:224470150-224585397,115247
1631887,1744852,chr2,PXDN,chr2:1631887-1744852,112965
2319232,2327110,chr2,MYT1L-AS1,chr2:2319232-2327110,7878
1789113,2331664,chr2,MYT1L,chr2:1789113-2331664,542551
149636766,149636929,chr1,RNVU1-30,chr1:149636766-149636929,163
149675205,149677740,chr1,FAM91A2P,chr1:149675205-149677740,2535
149676851,149747818,chr1,PDE4DIPP7,chr1:149676851-149747818,70967
149700151,149700296,chr1,RNU1-68P,chr1:149700151-149700296,145
149813225,149813693,chr1,H3C13,chr1:149813225-149813693,468
149842875,149846486,chr1,H2BC19P,chr1:149842875-149846486,3611
149844498,149850937,chr1,H2BC20P,chr1:149844498-149850937,6439
149886918,149887411,chr1,H2AC20,chr1:149886918-149887411,493
149887469,149887965,chr1,H2AC21,chr1:149887469-149887965,496
149887890,149900798,chr1,BOLA1,chr1:149887890-149900798,12908
149903318,149917844,chr1,SV2A,chr1:149903318-149917844,14526
149923317,149927803,chr1,SF3B4,chr1:149923317-149927803,4486
149782671,149791675,chr1,FCGR1A,chr1:149782671-149791675,9004
172885947,172886258,chr1,AIMP1P2,chr1:172885947-172886258,311
200863808,200864152,chr1,RPL34P6,chr1:200863808-200864152,344
200872981,200874178,chr1,GPR25,chr1:200872981-200874178,1197
200891048,200915742,chr1,INAVA,chr1:200891048-200915742,24694
200917460,200966668,chr1,MROH3P,chr1:200917460-200966668,49208
200933345,200933447,chr1,RNU6-704P,chr1:200933345-200933447,102
200969390,201023714,chr1,KIF21B,chr1:200969390-201023714,54324
201134772,201171574,chr1,TMEM9,chr1:201134772-201171574,36802
201190824,201228952,chr1,IGFN1,chr1:201190824-201228952,38128
201039512,201112451,chr1,CACNA1S,chr1:201039512-201112451,72939
112721020,112742879,chr2,NT5DC4,chr2:112721020-112742879,21859
178521183,178779963,chr2,TTN-AS1,chr2:178521183-178779963,258780
84244334,84244577,chr1,NEDD8P1,chr1:84244334-84244577,243
84298366,84389957,chr1,SAMD13,chr1:84298366-84389957,91591
84363706,84397831,chr1,UOX,chr1:84363706-84397831,34125
204707320,204707430,chr1,RNA5SP75,chr1:204707320-204707430,110
205083129,205084460,chr1,TMEM81,chr1:205083129-205084460,1331
178831371,178831449,chr2,RNU7-104P,chr2:178831371-178831449,78
236795260,236921278,chr1,MTR,chr1:236795260-236921278,126018
38962206,39124345,chr2,SOS1,chr2:38962206-39124345,162139
225741275,225741380,chr1,RNU6-1304P,chr1:225741275-225741380,105
225777813,225790468,chr1,SRP9,chr1:225777813-225790468,12655
225845536,225882380,chr1,TMEM63A,chr1:225845536-225882380,36844
225886282,225911382,chr1,LEFTY1,chr1:225886282-225911382,25100
225922080,225922142,chr1,MIR6741,chr1:225922080-225922142,62
225936598,225941383,chr1,LEFTY2,chr1:225936598-225941383,4785
178525989,178830802,chr2,TTN,chr2:178525989-178830802,304813
225964179,225964428,chr1,NDUFA3P3,chr1:225964179-225964428,249
225810124,225845563,chr1,EPHX1,chr1:225810124-225845563,35439
11012344,11030528,chr1,TARDBP,chr1:11012344-11030528,18184
11026523,11047239,chr1,MASP2,chr1:11026523-11047239,20716
11054584,11060020,chr1,SRM,chr1:11054584-11060020,5436
11066618,11099869,chr1,EXOSC10,chr1:11066618-11099869,33251
11143898,11149537,chr1,MTOR-AS1,chr1:11143898-11149537,5639
11152350,11152452,chr1,RNU6-537P,chr1:11152350-11152452,102
25222276,25232502,chr1,SYF2,chr1:25222276-25232502,10226
25242249,25338213,chr1,RSRP1,chr1:25242249-25338213,95964
25272393,25330445,chr1,RHD,chr1:25272393-25330445,58052
25294164,25294643,chr1,SDHDP6,chr1:25294164-25294643,479
25338317,25362361,chr1,TMEM50A,chr1:25338317-25362361,24044
127535683,127637729,chr2,MYO7B,chr2:127535683-127637729,102046
25430858,25500209,chr1,MACO1,chr1:25430858-25500209,69351
184051651,184123978,chr1,TSEN15,chr1:184051651-184123978,72327
156920632,156933094,chr1,LRRC71,chr1:156920632-156933094,12462
87755960,87825796,chr2,RGPD2,chr2:87755960-87825796,69836
156936131,156936244,chr1,MIR765,chr1:156936131-156936244,113
156985755,156986049,chr1,RN7SL612P,chr1:156985755-156986049,294
156815640,156881850,chr1,NTRK1,chr1:156815640-156881850,66210
176077472,176083962,chr2,EVX2,chr2:176077472-176083962,6490
38875976,38929072,chr2,MORN2,chr2:38875976-38929072,53096
240479422,240569209,chr2,ANKMY1,chr2:240479422-240569209,89787
240014348,240475187,chr1,FMN2,chr1:240014348-240475187,460839
240489573,240612155,chr1,GREM2,chr1:240489573-240612155,122582
240653367,240653477,chr1,RNU5F-8P,chr1:240653367-240653477,110
32775237,32817380,chr1,YARS1,chr1:32775237-32817380,42143
23303771,23344336,chr1,HNRNPR,chr1:23303771-23344336,40565
26308173,26346817,chr2,ADGRF3,chr2:26308173-26346817,38644
233636448,233773300,chr2,UGT1A10,chr2:233636448-233773300,136852
150549369,150560937,chr1,ADAMTSL4,chr1:150549369-150560937,11568
197453493,197475310,chr2,COQ10B,chr2:197453493-197475310,21817
36696690,36814794,chr2,VIT,chr2:36696690-36814794,118104
31906421,31944856,chr1,PTP4A2,chr1:31906421-31944856,38435
61888724,62147247,chr2,COMMD1,chr2:61888724-62147247,258523
178829757,179050137,chr2,CCDC141,chr2:178829757-179050137,220380
26321698,26360080,chr1,CRYBG2,chr1:26321698-26360080,38382
236193459,236264409,chr2,ASB18,chr2:236193459-236264409,70950
219514170,219538772,chr2,ASIC4,chr2:219514170-219538772,24602
93448118,93554661,chr1,FNBP1L,chr1:93448118-93554661,106543
37167820,37196598,chr2,SULT6B1,chr2:37167820-37196598,28778
25227855,25342590,chr2,DNMT3A,chr2:25227855-25342590,114735
52142089,52348671,chr1,ZFYVE9,chr1:52142089-52348671,206582
13583465,13617957,chr1,PDPN,chr1:13583465-13617957,34492
19682240,19799945,chr1,TMCO4,chr1:19682240-19799945,117705
43450989,43453989,chr1,HYI,chr1:43450989-43453989,3000
237485428,237555322,chr2,MLPH,chr2:237485428-237555322,69894
31727117,31764893,chr1,ADGRB2,chr1:31727117-31764893,37776
237563165,237563270,chr2,RNU6-1140P,chr2:237563165-237563270,105
237566574,237567175,chr2,PRLH,chr2:237566574-237567175,601
237574322,237601614,chr2,RAB17,chr2:237574322-237601614,27292
107140007,107484923,chr1,NTNG1,chr1:107140007-107484923,344916
26970637,27027219,chr2,MAPRE3,chr2:26970637-27027219,56582
155659443,155689000,chr1,YY1AP1,chr1:155659443-155689000,29557
26984776,27014612,chr2,MAPRE3-AS1,chr2:26984776-27014612,29836
27032910,27041694,chr2,TMEM214,chr2:27032910-27041694,8784
27042364,27070622,chr2,AGBL5,chr2:27042364-27070622,28258
27049683,27050264,chr2,AGBL5-AS1,chr2:27049683-27050264,581
27061038,27061815,chr2,AGBL5-IT1,chr2:27061038-27061815,777
27070472,27071654,chr2,OST4,chr2:27070472-27071654,1182
27078615,27086403,chr2,EMILIN1,chr2:27078615-27086403,7788
27086747,27100762,chr2,KHK,chr2:27086747-27100762,14015
27098889,27119128,chr2,CGREF1,chr2:27098889-27119128,20239
27123789,27130812,chr2,ABHD1,chr2:27123789-27130812,7023
27130756,27134666,chr2,PREB,chr2:27130756-27134666,3910
27136848,27139410,chr2,PRR30,chr2:27136848-27139410,2562
27149004,27156974,chr2,TCF23,chr2:27149004-27156974,7970
27199587,27212958,chr2,SLC5A6,chr2:27199587-27212958,13371
1418420,1421769,chr1,ANKRD65,chr1:1418420-1421769,3349
227728200,227781826,chr1,SNAP47,chr1:227728200-227781826,53626
43978943,43991170,chr1,B4GALT2,chr1:43978943-43991170,12227
161983192,162023869,chr1,OLFML2B,chr1:161983192-162023869,40677
156579723,156587719,chr1,TTC24,chr1:156579723-156587719,7996
206865623,206869223,chr1,IL20,chr1:206865623-206869223,3600
27217369,27243943,chr2,CAD,chr2:27217369-27243943,26574
12644085,12667076,chr1,AADACL4,chr1:12644085-12667076,22991
84398484,84415018,chr1,DNASE2B,chr1:84398484-84415018,16534
248030070,248042305,chr1,OR2L2,chr1:248030070-248042305,12235
248046836,248063407,chr1,OR2L3,chr1:248046836-248063407,16571
248231417,248244679,chr1,OR2M4,chr1:248231417-248244679,13262
27322145,27336400,chr1,TMEM222,chr1:27322145-27336400,14255
37793847,37801137,chr1,MANEAL,chr1:37793847-37801137,7290
2555639,2565382,chr1,TNFRSF14,chr1:2555639-2565382,9743
27253684,27275817,chr2,SLC30A3,chr2:27253684-27275817,22133
27275433,27281499,chr2,DNAJC5G,chr2:27275433-27281499,6066
27282429,27307439,chr2,TRIM54,chr2:27282429-27307439,25010
13171848,13179459,chr1,PRAMEF9,chr1:13171848-13179459,7611
27307400,27308445,chr2,UCN,chr2:27307400-27308445,1045
450740,451678,chr1,OR4F29,chr1:450740-451678,938
207043849,207052980,chr1,YOD1,chr1:207043849-207052980,9131
27309492,27325680,chr2,MPV17,chr2:27309492-27325680,16188
248636356,248645278,chr1,OR2T35,chr1:248636356-248645278,8922
158418210,158426237,chr1,OR10K2,chr1:158418210-158426237,8027
234604269,234610178,chr1,IRF2BP2,chr1:234604269-234610178,5909
110338506,110346681,chr1,RBM15,chr1:110338506-110346681,8175
227730425,227735411,chr1,JMJD4,chr1:227730425-227735411,4986
18480930,18485974,chr1,KLHDC7A,chr1:18480930-18485974,5044
155208695,155213824,chr1,MTX1,chr1:155208695-155213824,5129
202133404,202144743,chr1,ARL8A,chr1:202133404-202144743,11339
202122886,202133592,chr1,GPR37L1,chr1:202122886-202133592,10706
151612006,151699091,chr1,SNX27,chr1:151612006-151699091,87085
165957188,166390771,chr2,SCN1A-AS1,chr2:165957188-166390771,433583
166195185,166376001,chr2,SCN9A,chr2:166195185-166376001,180816
151629324,151629430,chr1,RNU6-1062P,chr1:151629324-151629430,106
151700058,151716803,chr1,CELF3,chr1:151700058-151716803,16745
27212041,27217178,chr2,ATRAID,chr2:27212041-27217178,5137
151710433,151729805,chr1,RIIAD1,chr1:151710433-151729805,19372
151747597,151747700,chr1,RNU6-662P,chr1:151747597-151747700,103
86213993,86338083,chr2,REEP1,chr2:86213993-86338083,124090
151759647,151763496,chr1,MRPL9,chr1:151759647-151763496,3849
151762899,151771334,chr1,OAZ3,chr1:151762899-151771334,8435
201620184,201643570,chr2,TMEM237,chr2:201620184-201643570,23386
151800264,151805419,chr1,LINGO4,chr1:151800264-151805419,5155
151806071,151831845,chr1,RORC,chr1:151806071-151831845,25774
152717647,152762396,chr2,ARL6IP6,chr2:152717647-152762396,44749
151837819,151840557,chr1,C2CD4D,chr1:151837819-151840557,2738
151841877,151850385,chr1,C2CD4D-AS1,chr1:151841877-151850385,8508
151847101,151853712,chr1,THEM5,chr1:151847101-151853712,6611
151870866,151909637,chr1,THEM4,chr1:151870866-151909637,38771
97322137,97322423,chr2,IGKV1OR2-9,chr2:97322137-97322423,286
97331533,97331843,chr2,IGKV2OR2-10,chr2:97331533-97331843,310
97335671,97335974,chr2,IGKV2OR2-7D,chr2:97335671-97335974,303
97348899,97349179,chr2,IGKV3OR2-5,chr2:97348899-97349179,280
151949523,151950912,chr1,KRT8P28,chr1:151949523-151950912,1389
97355059,97355335,chr2,IGKV1OR2-6,chr2:97355059-97355335,276
97372532,97372835,chr2,IGKV2OR2-7,chr2:97372532-97372835,303
151982915,151993859,chr1,S100A10,chr1:151982915-151993859,10944
97376674,97376973,chr2,IGKV2OR2-8,chr2:97376674-97376973,299
97386082,97386368,chr2,IGKV1OR2-11,chr2:97386082-97386368,286
152018662,152022508,chr1,NBPF18P,chr1:152018662-152022508,3846
47250139,47314892,chr1,STIL,chr1:47250139-47314892,64753
97636780,97637803,chr2,UBTFL6,chr2:97636780-97637803,1023
97646062,97648383,chr2,COX5B,chr2:97646062-97648383,2321
97655939,97664044,chr2,ACTR1B,chr2:97655939-97664044,8105
97664217,97703066,chr2,C2orf92,chr2:97664217-97703066,38849
97664591,97664731,chr2,RNU4-8P,chr2:97664591-97664731,140
97713576,97739862,chr2,ZAP70,chr2:97713576-97739862,26286
97492663,97589877,chr2,ANKRD36B,chr2:97492663-97589877,97214
95789654,95800166,chr2,GPAT2P1,chr2:95789654-95800166,10512
152719522,152720470,chr1,C1orf68,chr1:152719522-152720470,948
95807052,95835003,chr2,LINC00342,chr2:95807052-95835003,27951
152737518,152737868,chr1,LCEP2,chr1:152737518-152737868,350
152744299,152744606,chr1,LCEP1,chr1:152744299-152744606,307
152759561,152762052,chr1,KPRP,chr1:152759561-152762052,2491
152775140,152777024,chr1,LCE1F,chr1:152775140-152777024,1884
152786214,152788426,chr1,LCE1E,chr1:152786214-152788426,2212
152796721,152798181,chr1,LCE1D,chr1:152796721-152798181,1460
35557473,35567274,chr1,NCDN,chr1:35557473-35567274,9801
144364364,144521057,chr2,ZEB2,chr2:144364364-144521057,156693
35573314,35595328,chr1,TFAP2E,chr1:35573314-35595328,22014
103655760,103664554,chr1,AMY1A,chr1:103655760-103664554,8794
103687415,103696454,chr1,AMY1B,chr1:103687415-103696454,9039
103745323,103758726,chr1,AMY1C,chr1:103745323-103758726,13403
45326895,45328710,chr1,HPDL,chr1:45326895-45328710,1815
248013660,248024276,chr1,OR2L5,chr1:248013660-248024276,10616
25616791,25786206,chr1,MAN1C1,chr1:25616791-25786206,169415
25800193,25818221,chr1,SELENON,chr1:25800193-25818221,18028
116111399,116138149,chr1,MAB21L3,chr1:116111399-116138149,26750
204828651,205022822,chr1,NFASC,chr1:204828651-205022822,194171
95836919,95991831,chr2,ANKRD36C,chr2:95836919-95991831,154912
134838616,134902034,chr2,ACMSD,chr2:134838616-134902034,63418
134857820,134857873,chr2,MIR5590,chr2:134857820-134857873,53
134918235,134959342,chr2,CCNT2,chr2:134918235-134959342,41107
134964485,135047468,chr2,MAP3K19,chr2:134964485-135047468,82983
205042937,205078289,chr1,CNTN2,chr1:205042937-205078289,35352
135052289,135176667,chr2,RAB3GAP1,chr2:135052289-135176667,124378
135136628,135136755,chr2,SNORA40B,chr2:135136628-135136755,127
29060976,29074523,chr2,PCARE,chr2:29060976-29074523,13547
132304806,132326855,chr2,ZNF806,chr2:132304806-132326855,22049
112138385,112188218,chr2,FBLN7,chr2:112138385-112188218,49833
112211529,112255136,chr2,ZC3H8,chr2:112211529-112255136,43607
109466546,109482134,chr1,SYPL2,chr1:109466546-109482134,15588
112275597,112340063,chr2,ZC3H6,chr2:112275597-112340063,64466
229321011,229343294,chr1,CCSAP,chr1:229321011-229343294,22283
112286057,112286422,chr2,NDUFB4P6,chr2:112286057-112286422,365
166403573,166611482,chr2,SCN7A,chr2:166403573-166611482,207909
229383128,229383188,chr1,RNU6-180P,chr1:229383128-229383188,60
229410500,229410767,chr1,RN7SKP276,chr1:229410500-229410767,267
229430365,229434104,chr1,ACTA1,chr1:229430365-229434104,3739
40477290,40496343,chr1,ZFP69,chr1:40477290-40496343,19053
40531573,40548167,chr1,ZNF684,chr1:40531573-40548167,16594
204545475,205620162,chr2,PARD3B,chr2:204545475-205620162,1074687
28481362,28481480,chr1,RNU6ATAC27P,chr1:28481362-28481480,118
28505980,28510892,chr1,SNHG3,chr1:28505980-28510892,4912
28507366,28507571,chr1,SNORA73A,chr1:28507366-28507571,205
28508559,28508762,chr1,SNORA73B,chr1:28508559-28508762,203
28526318,28527227,chr1,PRDX3P2,chr1:28526318-28527227,909
28553085,28578545,chr1,TRNAU1AP,chr1:28553085-28578545,25460
28578749,28578822,chr1,SNORD99,chr1:28578749-28578822,73
28579764,28579893,chr1,SNORA61,chr1:28579764-28579893,129
28580381,28580512,chr1,SNORA44,chr1:28580381-28580512,131
28580920,28581054,chr1,SNORA16A,chr1:28580920-28581054,134
28592200,28595449,chr1,RAB42,chr1:28592200-28595449,3249
28643228,28648581,chr1,LINC01715,chr1:28643228-28648581,5353
28648600,28648733,chr1,RNU11,chr1:28648600-28648733,133
103553815,103579534,chr1,AMY2B,chr1:103553815-103579534,25719
103617427,103625780,chr1,AMY2A,chr1:103617427-103625780,8353
206114817,206159509,chr2,NDUFS1,chr2:206114817-206159509,44692
205504596,205532793,chr1,CDK18,chr1:205504596-205532793,28197
204198163,204213988,chr1,GOLT1A,chr1:204198163-204213988,15825
204218853,204377665,chr1,PLEKHA6,chr1:204218853-204377665,158812
204368431,204369719,chr1,LINC00628,chr1:204368431-204369719,1288
204562413,204562521,chr1,RNA5SP74,chr1:204562413-204562521,108
35032172,35115859,chr1,ZMYM1,chr1:35032172-35115859,83687
206116110,206116500,chr2,GCSHP3,chr2:206116110-206116500,390
206159585,206162928,chr2,EEF1B2,chr2:206159585-206162928,3343
206161841,206161929,chr2,snoZ196,chr2:206161841-206161929,88
206161878,206161957,chr2,SNORD51,chr2:206161878-206161957,79
206162228,206162359,chr2,SNORA41,chr2:206162228-206162359,131
35053468,35059271,chr1,RPL12P45,chr1:35053468-35059271,5803
206175316,206218047,chr2,CMKLR2,chr2:206175316-206218047,42731
35122022,35122484,chr1,EFCAB14P1,chr1:35122022-35122484,462
35176378,35193145,chr1,SFPQ,chr1:35176378-35193145,16767
206203543,206265326,chr2,GPR1-AS,chr2:206203543-206265326,61783
206221315,206221634,chr2,RN7SKP200,chr2:206221315-206221634,319
206236236,206236871,chr2,ATP5POP1,chr2:206236236-206236871,635
206259628,206259918,chr2,HMGN1P6,chr2:206259628-206259918,290
206260066,206260214,chr2,RN7SKP260,chr2:206260066-206260214,148
206274663,206314427,chr2,ZDBF2,chr2:206274663-206314427,39764
206410087,206410909,chr2,ACER2P1,chr2:206410087-206410909,822
206419292,206420238,chr2,HNRNPA1P51,chr2:206419292-206420238,946
200586014,200677064,chr2,AOX1,chr2:200586014-200677064,91050
35292196,35292498,chr1,RN7SL503P,chr1:35292196-35292498,302
92217915,92245813,chr1,C1orf146,chr1:92217915-92245813,27898
92229018,92229435,chr1,ACTBP12,chr1:92229018-92229435,417
92246402,92298987,chr1,GLMN,chr1:92246402-92298987,52585
200678233,200734109,chr2,AOX3P,chr2:200678233-200734109,55876
92299059,92402056,chr1,RPAP2,chr1:92299059-92402056,102997
200695723,200748040,chr2,AOX3P-AOX2P,chr2:200695723-200748040,52317
200738608,200794239,chr2,AOX2P,chr2:200738608-200794239,55631
92402389,92402685,chr1,RN7SL824P,chr1:92402389-92402685,296
92473043,92486925,chr1,GFI1,chr1:92473043-92486925,13882
200775584,200775750,chr2,RNU1-133P,chr2:200775584-200775750,166
200780495,200812170,chr2,BZW1-AS1,chr2:200780495-200812170,31675
200810594,200827338,chr2,BZW1,chr2:200810594-200827338,16744
92647048,92647630,chr1,HMGB3P9,chr1:92647048-92647630,582
92700819,92700934,chr1,RNU4-59P,chr1:92700819-92700934,115
92749175,92749330,chr1,H3P3,chr1:92749175-92749330,155
92755794,92756956,chr1,CCNJP2,chr1:92755794-92756956,1162
158578919,158579899,chr1,OR10X1,chr1:158578919-158579899,980
248649838,248655528,chr1,OR2T27,chr1:248649838-248655528,5690
158694539,158695509,chr1,OR6K1P,chr1:158694539-158695509,970
158716327,158720720,chr1,OR6K3,chr1:158716327-158720720,4393
158724113,158725067,chr1,OR6K4P,chr1:158724113-158725067,954
158742146,158743415,chr1,OR6K5P,chr1:158742146-158743415,1269
158796014,158796213,chr1,OR2AQ1P,chr1:158796014-158796213,199
158808399,158809335,chr1,OR10AA1P,chr1:158808399-158809335,936
158831351,158849506,chr1,MNDA,chr1:158831351-158849506,18155
159313720,159314659,chr1,OR10J3,chr1:159313720-159314659,939
247814660,247824119,chr1,OR14A16,chr1:247814660-247824119,9459
247827486,247828502,chr1,HSD17B7P1,chr1:247827486-247828502,1016
247833349,247834288,chr1,OR6R1P,chr1:247833349-247834288,939
247840928,247841896,chr1,OR11L1,chr1:247840928-247841896,968
247857187,247880138,chr1,TRIM58,chr1:247857187-247880138,22951
247895587,247896531,chr1,OR2W3,chr1:247895587-247896531,944
247924889,247935339,chr1,OR2AJ1,chr1:247924889-247935339,10450
247936061,247937513,chr1,CLK3P2,chr1:247936061-247937513,1452
247938973,247939659,chr1,OR2X1P,chr1:247938973-247939659,686
247948858,247949796,chr1,OR2L8,chr1:247948858-247949796,938
45329163,45340893,chr1,MUTYH,chr1:45329163-45340893,11730
29097705,29199777,chr2,CLIP4,chr2:29097705-29199777,102072
218162841,218166962,chr2,CXCR1,chr2:218162841-218166962,4121
218200434,218201388,chr2,HMGB1P9,chr2:218200434-218201388,954
218217141,218254356,chr2,ARPC2,chr2:218217141-218254356,37215
218259496,218263861,chr2,GPBAR1,chr2:218259496-218263861,4365
218264129,218270178,chr2,AAMP,chr2:218264129-218270178,6049
158544550,158554405,chr1,OR6Y1,chr1:158544550-158554405,9855
33466249,33468954,chr1,TLR12P,chr1:33466249-33468954,2705
33472645,33501643,chr1,ZSCAN20,chr1:33472645-33501643,28998
248375746,248391811,chr1,OR2T6,chr1:248375746-248391811,16065
248121932,248122882,chr1,OR2M1P,chr1:248121932-248122882,950
248145148,248146086,chr1,OR2M5,chr1:248145148-248146086,938
248174821,248181067,chr1,OR2M2,chr1:248174821-248181067,6246
171392229,171392790,chr1,GM2AP2,chr1:171392229-171392790,561
171444699,171444963,chr1,CYCSP53,chr1:171444699-171444963,264
171635417,171652688,chr1,MYOC,chr1:171635417-171652688,17271
2019329,2030758,chr1,GABRD,chr1:2019329-2030758,11429
218274197,218292586,chr2,TMBIM1,chr2:218274197-218292586,18389
15941869,15976132,chr1,ZBTB17,chr1:15941869-15976132,34263
15989871,15994751,chr1,TBC1D3P6,chr1:15989871-15994751,4880
16004236,16008807,chr1,SRARP,chr1:16004236-16008807,4571
16014028,16019594,chr1,HSPB7,chr1:16014028-16019594,5566
16018875,16034050,chr1,CLCNKA,chr1:16018875-16034050,15175
218280125,218280188,chr2,MIR6513,chr2:218280125-218280188,63
218326889,218357966,chr2,CATIP-AS2,chr2:218326889-218357966,31077
218341911,218341980,chr2,MIR6810,chr2:218341911-218341980,69
218354075,218354572,chr2,RPL19P5,chr2:218354075-218354572,497
218366665,218367835,chr2,CATIP-AS1,chr2:218366665-218367835,1170
218382029,218396894,chr2,SLC11A1,chr2:218382029-218396894,14865
16057769,16073651,chr1,FAM131C,chr1:16057769-16073651,15882
196819731,196832189,chr1,CFHR1,chr1:196819731-196832189,12458
247920252,247923152,chr1,OR2T8,chr1:247920252-247923152,2900
15226373,15227549,chr1,ZBTB2P1,chr1:15226373-15227549,1176
15326680,15343876,chr1,FHAD1-AS1,chr1:15326680-15343876,17196
15409888,15430339,chr1,EFHD2,chr1:15409888-15430339,20451
15438442,15449242,chr1,CTRC,chr1:15438442-15449242,10800
218398256,218405941,chr2,CTDSP1,chr2:218398256-218405941,7685
247711436,247716646,chr1,OR6F1,chr1:247711436-247716646,5210
247722957,247724043,chr1,OR14A2,chr1:247722957-247724043,1086
247738615,247739559,chr1,OR14K1,chr1:247738615-247739559,944
247770169,247779524,chr1,OR9H1P,chr1:247770169-247779524,9355
158461574,158470857,chr1,OR10K1,chr1:158461574-158470857,9283
248290139,248303424,chr1,OR2T12,chr1:248290139-248303424,13285
248269917,248277976,chr1,OR2T33,chr1:248269917-248277976,8059
32539427,32605941,chr1,ZBTB8A,chr1:32539427-32605941,66514
218402646,218402722,chr2,MIR26B,chr2:218402646-218402722,76
218419121,218453295,chr2,VIL1,chr2:218419121-218453295,34174
32600172,32650903,chr1,ZBTB8OS,chr1:32600172-32650903,50731
114697627,114697924,chr1,RN7SL432P,chr1:114697627-114697924,297
114704469,114716771,chr1,NRAS,chr1:114704469-114716771,12302
114727720,114727824,chr1,RNY1P13,chr1:114727720-114727824,104
114769479,114780685,chr1,SIKE1,chr1:114769479-114780685,11206
218269651,218346793,chr2,PNKD,chr2:218269651-218346793,77142
158754720,158755891,chr1,OR6K6,chr1:158754720-158755891,1171
248556912,248562772,chr1,OR2T29,chr1:248556912-248562772,5860
11869,14409,chr1,DDX11L1,chr1:11869-14409,2540
14404,29570,chr1,WASH7P,chr1:14404-29570,15166
17369,17436,chr1,MIR6859-1,chr1:17369-17436,67
29554,31109,chr1,MIR1302-2HG,chr1:29554-31109,1555
30366,30503,chr1,MIR1302-2,chr1:30366-30503,137
34554,36081,chr1,FAM138A,chr1:34554-36081,1527
52473,53312,chr1,OR4G4P,chr1:52473-53312,839
57598,64116,chr1,OR4G11P,chr1:57598-64116,6518
65419,71585,chr1,OR4F5,chr1:65419-71585,6166
131025,134836,chr1,CICP27,chr1:131025-134836,3811
157784,157887,chr1,RNU6-1100P,chr1:157784-157887,103
248508073,248527337,chr1,OR2G6,chr1:248508073-248527337,19264
236664141,236764631,chr1,ACTN2,chr1:236664141-236764631,100490
218356857,218368099,chr2,CATIP,chr2:218356857-218368099,11242
167293001,167874045,chr2,B3GALT1,chr2:167293001-167874045,581044
167631480,167631541,chr2,RNU7-148P,chr2:167631480-167631541,61
167713663,167716065,chr2,CTAGE14P,chr2:167713663-167716065,2402
167814757,167941180,chr2,B3GALT1-AS1,chr2:167814757-167941180,126423
85262144,85262267,chr2,SNRPEP11,chr2:85262144-85262267,123
85318027,85328251,chr2,TGOLN2,chr2:85318027-85328251,10224
85341281,85341838,chr2,PEBP1P2,chr2:85341281-85341838,557
85341955,85354531,chr2,RETSAT,chr2:85341955-85354531,12576
85354394,85391752,chr2,ELMOD3,chr2:85354394-85391752,37358
248445512,248455725,chr1,OR2T2,chr1:248445512-248455725,10213
247670812,247679739,chr1,OR13G1,chr1:247670812-247679739,8927
247754846,247760556,chr1,OR1C1,chr1:247754846-247760556,5710
248197265,248212925,chr1,OR2M3,chr1:248197265-248212925,15660
248590487,248597700,chr1,OR2T10,chr1:248590487-248597700,7213
158747814,158772195,chr1,OR6N1,chr1:158747814-158772195,24381
248623557,248635091,chr1,OR2T11,chr1:248623557-248635091,11534
158605268,158612514,chr1,OR10Z1,chr1:158605268-158612514,7246
158610704,158686715,chr1,SPTA1,chr1:158610704-158686715,76011
158472220,158480936,chr1,OR10R2,chr1:158472220-158480936,8716
70706441,70786468,chr1,LINC01788,chr1:70706441-70786468,80027
71048855,71067184,chr1,ZRANB2-AS1,chr1:71048855-71067184,18329
71063291,71081289,chr1,ZRANB2,chr1:71063291-71081289,17998
71067631,71067716,chr1,MIR186,chr1:71067631-71067716,85
71081324,71489976,chr1,ZRANB2-AS2,chr1:71081324-71489976,408652
150960583,150975003,chr1,CERS2,chr1:150960583-150975003,14420
85394753,85418432,chr2,CAPG,chr2:85394753-85418432,23679
150982249,150995634,chr1,ANXA9,chr1:150982249-150995634,13385
151008420,151035713,chr1,PRUNE1,chr1:151008420-151035713,27293
151022746,151022852,chr1,RNU6-884P,chr1:151022746-151022852,106
151036321,151047720,chr1,BNIPL,chr1:151036321-151047720,11399
85490930,85491780,chr2,RPSAP22,chr2:85490930-85491780,850
85537462,85538666,chr2,PARTICL,chr2:85537462-85538666,1204
151047751,151051986,chr1,C1orf56,chr1:151047751-151051986,4235
85539168,85545281,chr2,MAT2A,chr2:85539168-85545281,6113
151050971,151070325,chr1,CDC42SE1,chr1:151050971-151070325,19354
151060397,151069544,chr1,MLLT11,chr1:151060397-151069544,9147
85561562,85582031,chr2,VAMP8,chr2:85561562-85582031,20469
181088700,181092900,chr1,IER5,chr1:181088700-181092900,4200
156193932,156212796,chr1,SLC25A44,chr1:156193932-156212796,18864
85584431,85593406,chr2,VAMP5,chr2:85584431-85593406,8975
241497511,241519799,chr1,FH,chr1:241497511-241519799,22288
85595725,85597708,chr2,RNF181,chr2:85595725-85597708,1983
241532134,241595642,chr1,KMO,chr1:241532134-241595642,63508
85598547,85603196,chr2,TMEM150A,chr2:85598547-85603196,4649
85602856,85649283,chr2,USP39,chr2:85602856-85649283,46427
241590102,241677376,chr1,OPN3,chr1:241590102-241677376,87274
241628851,241640369,chr1,CHML,chr1:241628851-241640369,11518
10210570,10381603,chr1,KIF1B,chr1:10210570-10381603,171033
85605254,85612066,chr2,C2orf68,chr2:85605254-85612066,6812
85657314,85668741,chr2,SFTPB,chr2:85657314-85668741,11427
85685175,85698852,chr2,GNLY,chr2:85685175-85698852,13677
85686053,85687047,chr2,GPR160P1,chr2:85686053-85687047,994
164894354,164955525,chr2,SLC38A11,chr2:164894354-164955525,61171
85418714,85437029,chr2,SH2D6,chr2:85418714-85437029,18315
232550474,232550573,chr2,MIR5001,chr2:232550474-232550573,99
232649849,232650136,chr2,RN7SL359P,chr2:232649849-232650136,287
232782665,232782766,chr2,RNU6-107P,chr2:232782665-232782766,101
232550659,232583644,chr2,EIF4E2,chr2:232550659-232583644,32985
1512162,1534685,chr1,ATAD3A,chr1:1512162-1534685,22523
53570374,53570480,chr2,RNU6-997P,chr2:53570374-53570480,106
53767804,53775196,chr2,CHAC2,chr2:53767804-53775196,7392
53849122,53849205,chr2,MIR3682,chr2:53849122-53849205,83
53852912,53859967,chr2,GPR75,chr2:53852912-53859967,7055
53864069,53970993,chr2,PSME4,chr2:53864069-53970993,106924
1534778,1540624,chr1,TMEM240,chr1:1534778-1540624,5846
1541673,1574863,chr1,SSU72,chr1:1541673-1574863,33190
1615454,1630605,chr1,MIB2,chr1:1615454-1630605,15151
53787009,53833038,chr2,ERLEC1,chr2:53787009-53833038,46029
33418516,33418564,chr2,MIR4430,chr2:33418516-33418564,48
33436324,33564750,chr2,RASGRP3,chr2:33436324-33564750,128426
147541501,147626216,chr1,BCL9,chr1:147541501-147626216,84715
33532744,33599347,chr2,FAM98A,chr2:33532744-33599347,66603
241847967,241895148,chr1,EXO1,chr1:241847967-241895148,47181
33602041,33602286,chr2,ATP6V0E1P3,chr2:33602041-33602286,245
33636502,33637425,chr2,HNRNPA1P61,chr2:33636502-33637425,923
33722721,33728207,chr2,MYADML,chr2:33722721-33728207,5486
108449107,108509415,chr2,GCC2,chr2:108449107-108509415,60308
241916123,241916543,chr1,RPL23AP20,chr1:241916123-241916543,420
108507515,108534196,chr2,GCC2-AS1,chr2:108507515-108534196,26681
241957767,241959062,chr1,BECN2,chr1:241957767-241959062,1295
241993185,241993682,chr1,CFL1P4,chr1:241993185-241993682,497
108534355,108687246,chr2,LIMS1,chr2:108534355-108687246,152891
241995490,241999098,chr1,MAP1LC3C,chr1:241995490-241999098,3608
242057085,242060242,chr1,TUBB8P6,chr1:242057085-242060242,3157
241652278,241802777,chr1,WDR64,chr1:241652278-241802777,150499
66628440,66628517,chr1,MIR3117,chr1:66628440-66628517,77
66752459,66779047,chr1,DYNLT5,chr1:66752459-66779047,26588
66812885,66924856,chr1,DNAI4,chr1:66812885-66924856,111971
108676795,108678601,chr2,LIMS1-AS1,chr2:108676795-108678601,1806
108712262,108712900,chr2,RPL10P5,chr2:108712262-108712900,638
108719482,108785809,chr2,RANBP2,chr2:108719482-108785809,66327
66533267,66751139,chr1,SGIP1,chr1:66533267-66751139,217872
85368282,85368580,chr2,RN7SL113P,chr2:85368282-85368580,298
85442495,85442791,chr2,RN7SL251P,chr2:85442495-85442791,296
85567662,85567960,chr2,RN7SL126P,chr2:85567662-85567960,298
85728194,85728337,chr2,RNU1-38P,chr2:85728194-85728337,143
85783600,85783677,chr2,MIR6071,chr2:85783600-85783677,77
85544720,85561532,chr2,GGCX,chr2:85544720-85561532,16812
23385179,23708611,chr2,KLHL29,chr2:23385179-23708611,323432
169064789,169096167,chr2,DHRS9,chr2:169064789-169096167,31378
164653624,164843679,chr2,COBLL1,chr2:164653624-164843679,190055
224717504,224730662,chr1,CNIH3-AS1,chr1:224717504-224730662,13158
224766324,224779335,chr1,LINC02813,chr1:224766324-224779335,13011
225401502,225428925,chr1,LBR,chr1:225401502-225428925,27423
224896262,225399292,chr1,DNAH14,chr1:224896262-225399292,503030
217799588,218033982,chr2,TNS1,chr2:217799588-218033982,234394
32209089,32216192,chr1,DCDC2B,chr1:32209089-32216192,7103
206635536,206684419,chr1,DYRK3,chr1:206635536-206684419,48883
173039202,173050941,chr1,TNFSF18,chr1:173039202-173050941,11739
47333790,47378839,chr1,CMPK1,chr1:47333790-47378839,45049
232805416,232809929,chr1,MAP10,chr1:232805416-232809929,4513
75128434,75161533,chr1,LHX8,chr1:75128434-75161533,33099
99264292,99309590,chr1,PLPPR4,chr1:99264292-99309590,45298
39651229,39672107,chr1,NT5C1A,chr1:39651229-39672107,20878
231162058,231221565,chr1,TRIM67,chr1:231162058-231221565,59507
74198238,74234086,chr1,FPGT,chr1:74198238-74234086,35848
148748774,148752415,chr1,NUDT4B,chr1:148748774-148752415,3641
54806063,54842252,chr1,LEXM,chr1:54806063-54842252,36189
150363091,150476566,chr1,RPRD2,chr1:150363091-150476566,113475
149475045,149556361,chr1,NBPF19,chr1:149475045-149556361,81316
1425871,1430255,chr1,TMEM88B,chr1:1425871-1430255,4384
46340789,46365152,chr1,NSUN4,chr1:46340789-46365152,24363
248361665,248362627,chr1,OR2T4,chr1:248361665-248362627,962
66797740,66801276,chr1,INSL5,chr1:66797740-66801276,3536
247121975,247172020,chr1,ZNF124,chr1:247121975-247172020,50045
158560606,158570580,chr1,OR6P1,chr1:158560606-158570580,9974
108222464,108244081,chr1,NBPF4,chr1:108222464-108244081,21617
102418689,102452565,chr2,IL18RAP,chr2:102418689-102452565,33876
143955287,143971986,chr1,FAM72C,chr1:143955287-143971986,16699
151291797,151327715,chr1,PI4KB,chr1:151291797-151327715,35918
178463664,178478600,chr2,FKBP7,chr2:178463664-178478600,14936
172427354,172506459,chr2,ITGA6,chr2:172427354-172506459,79105
9002973,9026423,chr1,SLC2A7,chr1:9002973-9026423,23450
158699678,158700652,chr1,OR6K2,chr1:158699678-158700652,974
152708160,152709434,chr1,LCE4A,chr1:152708160-152709434,1274
156082573,156140081,chr1,LMNA,chr1:156082573-156140081,57508
240906330,240993311,chr2,CROCC2,chr2:240906330-240993311,86981
131104847,131353709,chr2,PLEKHB2,chr2:131104847-131353709,248862
99242246,99255666,chr2,LYG2,chr2:99242246-99255666,13420
219538954,219543809,chr2,CHPF,chr2:219538954-219543809,4855
10056473,10080944,chr2,CYS1,chr2:10056473-10080944,24471
54723499,54972025,chr2,EML6,chr2:54723499-54972025,248526
17510579,17518440,chr2,RAD51AP2,chr2:17510579-17518440,7861
106801600,106887108,chr2,ST6GAL2,chr2:106801600-106887108,85508
199760544,199851192,chr2,FTCDNL1,chr2:199760544-199851192,90648
241188509,241225976,chr2,ANO7,chr2:241188509-241225976,37467
110445883,110473075,chr2,LIMS4,chr2:110445883-110473075,27192
233775679,233833423,chr2,MROH2A,chr2:233775679-233833423,57744
109898428,109925625,chr2,LIMS3,chr2:109898428-109925625,27197
16460948,16468481,chr1,LINC01772,chr1:16460948-16468481,7533
16467436,16499257,chr1,CROCCP3,chr1:16467436-16499257,31821
199955317,200008540,chr2,MAIP1,chr2:199955317-200008540,53223
240605430,240633159,chr2,GPR35,chr2:240605430-240633159,27729
16514122,16514285,chr1,RNU1-1,chr1:16514122-16514285,163
16533886,16535649,chr1,LINC01783,chr1:16533886-16535649,1763
16534081,16534224,chr1,RNU1-6P,chr1:16534081-16534224,143
16548651,16552531,chr1,PDE4DIPP8,chr1:16548651-16552531,3880
25377198,25673647,chr2,DTNB,chr2:25377198-25673647,296449
16618253,16657232,chr1,CROCCP2,chr1:16618253-16657232,38979
16645622,16650289,chr1,MST1P2,chr1:16645622-16650289,4667
16666785,16666948,chr1,RNU1-3,chr1:16666785-16666948,163
3021467,3022903,chr1,ACTRT2,chr1:3021467-3022903,1436
3127975,3128035,chr1,MIR4251,chr1:3127975-3128035,60
21812265,21825225,chr1,LDLRAD2,chr1:21812265-21825225,12960
21822244,21937310,chr1,HSPG2,chr1:21822244-21937310,115066
21977022,21998642,chr1,CELA3B,chr1:21977022-21998642,21620
21987481,21987777,chr1,RN7SL386P,chr1:21987481-21987777,296
21987816,21987919,chr1,RNU6-1022P,chr1:21987816-21987919,103
22001657,22012542,chr1,CELA3A,chr1:22001657-22012542,10885
22010650,22010946,chr1,RN7SL186P,chr1:22010650-22010946,296
22010985,22011088,chr1,RNU6-776P,chr1:22010985-22011088,103
22023990,22026048,chr1,LINC01635,chr1:22023990-22026048,2058
22024558,22031223,chr1,LINC00339,chr1:22024558-22031223,6665
22025511,22101360,chr1,CDC42,chr1:22025511-22101360,75849
22028317,22052927,chr1,CDC42-AS1,chr1:22028317-22052927,24610
22059197,22064199,chr1,CDC42-IT1,chr1:22059197-22064199,5002
22068340,22068827,chr1,MPHOSPH6P1,chr1:22068340-22068827,487
22117313,22143969,chr1,WNT4,chr1:22117313-22143969,26656
22266239,22266300,chr1,MIR4418,chr1:22266239-22266300,61
206053173,206102449,chr1,RHEX,chr1:206053173-206102449,49276
206106936,206117699,chr1,AVPR1B,chr1:206106936-206117699,10763
206160887,206161276,chr1,RPL22P4,chr1:206160887-206161276,389
206186179,206204414,chr1,FAM72A,chr1:206186179-206204414,18235
112584240,112589275,chr2,CHCHD5,chr2:112584240-112589275,5035
162073256,162078036,chr2,DPP4-DT,chr2:162073256-162078036,4780
206203346,206464436,chr1,SRGAP2,chr1:206203346-206464436,261090
200711535,200735203,chr2,LINC01792,chr2:200711535-200735203,23668
100603752,100611542,chr2,LINC01849,chr2:100603752-100611542,7790
176177717,176179009,chr2,HAGLROS,chr2:176177717-176179009,1292
45164816,45323397,chr2,LINC01121,chr2:45164816-45323397,158581
106382114,106393811,chr2,PLGLA,chr2:106382114-106393811,11697
88627539,88631821,chr2,EIF2AK3-DT,chr2:88627539-88631821,4282
135985124,136022593,chr2,DARS1-AS1,chr2:135985124-136022593,37469
215718043,215720944,chr2,LINC01614,chr2:215718043-215720944,2901
15918350,15942249,chr2,MYCNOS,chr2:15918350-15942249,23899
107529292,107556499,chr2,LINC01886,chr2:107529292-107556499,27207
206470476,206496889,chr1,IKBKE,chr1:206470476-206496889,26413
8666636,8681864,chr2,ID2-AS1,chr2:8666636-8681864,15228
28384409,28394680,chr2,FLJ31356,chr2:28384409-28394680,10271
7988683,8488284,chr2,LINC00299,chr2:7988683-8488284,499601
73947322,73982164,chr2,DGUOK-AS1,chr2:73947322-73982164,34842
60336446,60439828,chr2,MIR4432HG,chr2:60336446-60439828,103382
149587196,150047447,chr2,MMADHC-DT,chr2:149587196-150047447,460251
206474803,206474864,chr1,MIR6769B,chr1:206474803-206474864,61
206491116,206497728,chr1,C1orf147,chr1:206491116-206497728,6612
206507531,206589448,chr1,RASSF5,chr1:206507531-206589448,81917
104430130,104532747,chr2,LINC01102,chr2:104430130-104532747,102617
206571292,206612465,chr1,EIF2D,chr1:206571292-206612465,41173
58427799,59063766,chr2,LINC01122,chr2:58427799-59063766,635967
16685621,16686055,chr1,EIF1AXP1,chr1:16685621-16686055,434
16687339,16720157,chr1,ESPNP,chr1:16687339-16720157,32818
16740273,16972964,chr1,CROCC,chr1:16740273-16972964,232691
231508420,231514396,chr2,LINC00471,chr2:231508420-231514396,5976
131492813,131521573,chr2,SMPD4BP,chr2:131492813-131521573,28760
161244720,161249095,chr2,LINC01806,chr2:161244720-161249095,4375
43027823,43040662,chr2,LINC01819,chr2:43027823-43040662,12839
70124034,70132897,chr2,LINC01816,chr2:70124034-70132897,8863
127388178,127406228,chr2,MAP3K2-DT,chr2:127388178-127406228,18050
103874236,104101537,chr2,LINC01965,chr2:103874236-104101537,227301
16740280,16750968,chr1,CROCCP4,chr1:16740280-16750968,10688
16740516,16740679,chr1,RNU1-4,chr1:16740516-16740679,163
16754910,16770237,chr1,MST1L,chr1:16754910-16770237,15327
212950520,212992037,chr1,VASH2,chr1:212950520-212992037,41517
222318275,222352989,chr2,CT75,chr2:222318275-222352989,34714
10448654,10457693,chr2,ODC1-DT,chr2:10448654-10457693,9039
19902025,19902577,chr2,TTC32-DT,chr2:19902025-19902577,552
207166120,207248668,chr2,MYOSLID,chr2:207166120-207248668,82548
43092530,43132482,chr2,LINC02580,chr2:43092530-43132482,39952
54169651,54200036,chr1,CYB5RL,chr1:54169651-54200036,30385
104936239,105038496,chr2,MRPS9-AS2,chr2:104936239-105038496,102257
74502552,74505091,chr2,LBX2-AS1,chr2:74502552-74505091,2539
46816697,46859009,chr2,LINC01119,chr2:46816697-46859009,42312
248436359,248444316,chr1,OR2T7,chr1:248436359-248444316,7957
109483479,109492804,chr1,ATXN7L2,chr1:109483479-109492804,9325
8461703,8592903,chr2,LINC01814,chr2:8461703-8592903,131200
173799550,173824883,chr1,CENPL,chr1:173799550-173824883,25333
113526836,113542738,chr2,PGM5P4-AS1,chr2:113526836-113542738,15902
113583593,113599081,chr2,WASH2P,chr2:113583593-113599081,15488
247297412,247331867,chr1,ZNF496,chr1:247297412-247331867,34455
44921077,44939199,chr2,LINC01833,chr2:44921077-44939199,18122
5932543,6003510,chr2,SILC1,chr2:5932543-6003510,70967
174159410,174995308,chr1,RABGAP1L,chr1:174159410-174995308,835898
38073447,38231651,chr2,CYP1B1-AS1,chr2:38073447-38231651,158204
94193659,94208408,chr2,BMS1P23,chr2:94193659-94208408,14749
27705786,27716738,chr2,LINC01460,chr2:27705786-27716738,10952
91587019,91659989,chr2,LSP1P4,chr2:91587019-91659989,72970
98761098,98775361,chr2,LINC02611,chr2:98761098-98775361,14263
65030720,65053017,chr2,LINC02576,chr2:65030720-65053017,22297
88765807,88806612,chr2,ANKRD36BP2,chr2:88765807-88806612,40805
118132128,118222250,chr2,THORLNC,chr2:118132128-118222250,90122
61471188,61484130,chr2,USP34-DT,chr2:61471188-61484130,12942
194344190,194576578,chr2,LINC01821,chr2:194344190-194576578,232388
114673090,114695618,chr1,AMPD1,chr1:114673090-114695618,22528
64203623,64267368,chr1,UBE2U,chr1:64203623-64267368,63745
178413635,178440243,chr2,CHROMR,chr2:178413635-178440243,26608
168079542,168137667,chr1,GPR161,chr1:168079542-168137667,58125
241881363,242078722,chr2,LINC01237,chr2:241881363-242078722,197359
117001750,117036552,chr1,CD101,chr1:117001750-117036552,34802
69960104,70103220,chr2,PCBP1-AS1,chr2:69960104-70103220,143116
7784291,7845177,chr1,PER3,chr1:7784291-7845177,60886
152804832,152806651,chr1,LCE1C,chr1:152804832-152806651,1819
143894544,143905977,chr1,H3-2,chr1:143894544-143905977,11433
182789293,182830384,chr1,NPL,chr1:182789293-182830384,41091
28505943,28539300,chr1,RCC1,chr1:28505943-28539300,33357
153297116,153312952,chr1,PGLYRP3,chr1:153297116-153312952,15836
67092165,67231853,chr1,C1orf141,chr1:67092165-67231853,139688
37681570,37692249,chr1,C1orf109,chr1:37681570-37692249,10679
23191895,23217502,chr1,HTR1D,chr1:23191895-23217502,25607
152399577,152399769,chr1,HMGN3P1,chr1:152399577-152399769,192
152409243,152414263,chr1,CRNN,chr1:152409243-152414263,5020
152510803,152512177,chr1,LCE5A,chr1:152510803-152512177,1374
152514482,152516008,chr1,CRCT1,chr1:152514482-152516008,1526
152565654,152566780,chr1,LCE3E,chr1:152565654-152566780,1126
152579381,152580516,chr1,LCE3D,chr1:152579381-152580516,1135
36084094,36088275,chr1,TEKT2,chr1:36084094-36088275,4181
36088892,36093932,chr1,ADPRS,chr1:36088892-36093932,5040
36095239,36125222,chr1,COL8A2,chr1:36095239-36125222,29983
36136570,36156053,chr1,TRAPPC3,chr1:36136570-36156053,19483
36155579,36180849,chr1,MAP7D1,chr1:36155579-36180849,25270
949257,951502,chr2,SNTG2-AS1,chr2:949257-951502,2245
113831049,113891020,chr2,ACTR3-AS1,chr2:113831049-113891020,59971
20052114,20054501,chr2,LAPTM4A-DT,chr2:20052114-20054501,2387
7725710,7731575,chr2,LINC01871,chr2:7725710-7731575,5865
104865407,104872653,chr2,LINC01159,chr2:104865407-104872653,7246
235505553,235507566,chr2,AGAP1-IT1,chr2:235505553-235507566,2013
199457697,199476935,chr2,SATB2-AS1,chr2:199457697-199476935,19238
242088633,242175997,chr2,LINC01881,chr2:242088633-242175997,87364
36191915,36192170,chr1,RN7SL131P,chr1:36191915-36192170,255
36241898,36242156,chr1,UBE2V2P4,chr1:36241898-36242156,258
33256492,33300719,chr1,ZNF362,chr1:33256492-33300719,44227
64901840,65056226,chr2,LINC02245,chr2:64901840-65056226,154386
33306766,33321098,chr1,A3GALT2,chr1:33306766-33321098,14332
121649320,121728563,chr2,NIFK-AS1,chr2:121649320-121728563,79243
33332393,33332492,chr1,MIR3605,chr1:33332393-33332492,99
33336566,33336864,chr1,RN7SKP16,chr1:33336566-33336864,298
33350352,33363245,chr1,PHC2-AS1,chr1:33350352-33363245,12893
1724838,1745992,chr1,SLC35E2A,chr1:1724838-1745992,21154
153500463,153500764,chr1,RN7SL44P,chr1:153500463-153500764,301
153534599,153536244,chr1,S100A6,chr1:153534599-153536244,1645
87454781,87636740,chr2,CYTOR,chr2:87454781-87636740,181959
153543613,153550136,chr1,S100A4,chr1:153543613-153550136,6523
153547329,153549258,chr1,S100A3,chr1:153547329-153549258,1929
153561108,153567890,chr1,S100A2,chr1:153561108-153567890,6782
208255214,208256181,chr2,IDH1-AS1,chr2:208255214-208256181,967
74148007,74151952,chr2,BOLA3-AS1,chr2:74148007-74151952,3945
187712816,188384365,chr2,LINC01090,chr2:187712816-188384365,671549
153606886,153613145,chr1,S100A16,chr1:153606886-153613145,6259
96010526,96023398,chr2,FAHD2CP,chr2:96010526-96023398,12872
153614255,153616986,chr1,S100A14,chr1:153614255-153616986,2731
153618787,153631360,chr1,S100A13,chr1:153618787-153631360,12573
153627926,153632039,chr1,S100A1,chr1:153627926-153632039,4113
153633982,153646306,chr1,CHTOP,chr1:153633982-153646306,12324
153658703,153661852,chr1,SNAPIN,chr1:153658703-153661852,3149
199608062,199750341,chr2,LINC01877,chr2:199608062-199750341,142279
36306368,36329340,chr1,SH3D21,chr1:36306368-36329340,22972
191846534,192044525,chr2,CAVIN2-AS1,chr2:191846534-192044525,197991
36339624,36385924,chr1,STK40,chr1:36339624-36385924,46300
216479030,216498770,chr2,RPL37A-DT,chr2:216479030-216498770,19740
239401436,239402394,chr2,HDAC4-AS1,chr2:239401436-239402394,958
3558439,3564842,chr2,RNASEH1-AS1,chr2:3558439-3564842,6403
10844224,10885152,chr2,LINC01954,chr2:10844224-10885152,40928
208108154,208112652,chr2,CRYGEP,chr2:208108154-208112652,4498
238224552,238231711,chr2,LINC02610,chr2:238224552-238231711,7159
36391238,36397908,chr1,LSM10,chr1:36391238-36397908,6670
36402721,36402859,chr1,RNU4-27P,chr1:36402721-36402859,138
36415827,36450451,chr1,OSCP1,chr1:36415827-36450451,34624
96208389,96243353,chr2,STARD7-AS1,chr2:96208389-96243353,34964
30346623,30361010,chr2,LINC01936,chr2:30346623-30361010,14387
24971390,25039716,chr2,DNAJC27-AS1,chr2:24971390-25039716,68326
197197936,197199276,chr2,ANKRD44-AS1,chr2:197197936-197199276,1340
44940153,44941916,chr2,SIX3-AS1,chr2:44940153-44941916,1763
207662375,207679116,chr2,LINC01857,chr2:207662375-207679116,16741
39436530,39665343,chr2,MAP4K3-DT,chr2:39436530-39665343,228813
36418450,36418578,chr1,SNORA63C,chr1:36418450-36418578,128
36455718,36464384,chr1,MRPS15,chr1:36455718-36464384,8666
36466043,36483278,chr1,CSF3R,chr1:36466043-36483278,17235
129893985,129934322,chr2,PLAC9P1,chr2:129893985-129934322,40337
115126622,115161384,chr2,DPP10-AS1,chr2:115126622-115161384,34762
104764932,104853183,chr2,PANTR1,chr2:104764932-104853183,88251
36322030,36324154,chr1,EVA1B,chr1:36322030-36324154,2124
160257716,160271880,chr2,LINC02478,chr2:160257716-160271880,14164
33323623,33431095,chr1,PHC2,chr1:33323623-33431095,107472
177653419,177723289,chr2,PDE11A-AS1,chr2:177653419-177723289,69870
177997273,177998770,chr2,API5P2,chr2:177997273-177998770,1497
178017993,178018465,chr2,SDHDP5,chr2:178017993-178018465,472
178038902,178039004,chr2,RNU6-629P,chr2:178038902-178039004,102
178092503,178104470,chr2,CYCTP,chr2:178092503-178104470,11967
178112424,178139011,chr2,RBM45,chr2:178112424-178139011,26587
178142548,178142651,chr2,RNU5E-9P,chr2:178142548-178142651,103
177623244,178108339,chr2,PDE11A,chr2:177623244-178108339,485095
201113943,201127184,chr1,ASCL5,chr1:201113943-201127184,13241
180906651,180909166,chr1,LINC02816,chr1:180906651-180909166,2515
180912897,180951614,chr1,KIAA1614,chr1:180912897-180951614,38717
180949699,180954887,chr1,KIAA1614-AS1,chr1:180949699-180954887,5188
180972712,181023121,chr1,STX6,chr1:180972712-181023121,50409
181174484,181182208,chr1,LINC01732,chr1:181174484-181182208,7724
181033374,181061938,chr1,MR1,chr1:181033374-181061938,28564
93149742,93180516,chr1,TMED5,chr1:93149742-93180516,30774
93262186,93346025,chr1,CCDC18-AS1,chr1:93262186-93346025,83839
101696850,101894690,chr2,MAP4K4,chr2:101696850-101894690,197840
93179919,93278730,chr1,CCDC18,chr1:93179919-93278730,98811
42784991,42816619,chr1,TMEM269,chr1:42784991-42816619,31628
101962053,101987167,chr2,LINC01127,chr2:101962053-101987167,25114
42807052,42817397,chr1,SVBP,chr1:42807052-42817397,10345
170531819,170553834,chr1,GORAB,chr1:170531819-170553834,22015
22953043,22965338,chr1,LACTBL1,chr1:22953043-22965338,12295
23044305,23044372,chr1,MIR3115,chr1:23044305-23044372,67
23162704,23162810,chr1,RNU6-514P,chr1:23162704-23162810,106
23163953,23164053,chr1,RNU6-135P,chr1:23163953-23164053,100
23019443,23083689,chr1,KDM1A,chr1:23019443-23083689,64246
152811971,152813108,chr1,LCE1B,chr1:152811971-152813108,1137
152827473,152828097,chr1,LCE1A,chr1:152827473-152828097,624
152842856,152843983,chr1,LCE6A,chr1:152842856-152843983,1127
152878322,152885047,chr1,SMCP,chr1:152878322-152885047,6725
152908546,152911886,chr1,IVL,chr1:152908546-152911886,3340
152930040,152949210,chr1,LINC01527,chr1:152930040-152949210,19170
152947154,152949258,chr1,SPRR5,chr1:152947154-152949258,2104
152970648,152972574,chr1,SPRR4,chr1:152970648-152972574,1926
152985231,152985500,chr1,SPRR1A,chr1:152985231-152985500,269
153001747,153003856,chr1,SPRR3,chr1:153001747-153003856,2109
153031203,153032900,chr1,SPRR1B,chr1:153031203-153032900,1697
153039732,153041931,chr1,SPRR2D,chr1:153039732-153041931,2199
153056120,153057512,chr1,SPRR2A,chr1:153056120-153057512,1392
153070226,153071611,chr1,SPRR2B,chr1:153070226-153071611,1385
153093135,153106184,chr1,SPRR2E,chr1:153093135-153106184,13049
153112121,153113516,chr1,SPRR2F,chr1:153112121-153113516,1395
153140491,153140709,chr1,SPRR2C,chr1:153140491-153140709,218
153149582,153150890,chr1,SPRR2G,chr1:153149582-153150890,1308
159171609,159203313,chr1,CADM3,chr1:159171609-159203313,31704
159178473,159178559,chr1,RNA5SP60,chr1:159178473-159178559,86
159194325,159207973,chr1,CADM3-AS1,chr1:159194325-159207973,13648
159203307,159206500,chr1,ACKR1,chr1:159203307-159206500,3193
159432204,159433138,chr1,OR10J4,chr1:159432204-159433138,934
159437845,159443078,chr1,OR10J1,chr1:159437845-159443078,5233
159466321,159483376,chr1,LINC02819,chr1:159466321-159483376,17055
159289714,159308224,chr1,FCER1A,chr1:159289714-159308224,18510
24056035,24112135,chr1,MYOM3,chr1:24056035-24112135,56100
24066774,24083565,chr1,MYOM3-AS1,chr1:24066774-24083565,16791
24119771,24143140,chr1,IL22RA1,chr1:24119771-24143140,23369
24154168,24187959,chr1,IFNLR1,chr1:24154168-24187959,33791
24200240,24211693,chr1,LINC02800,chr1:24200240-24211693,11453
24307556,24321901,chr1,GRHL3-AS1,chr1:24307556-24321901,14345
202007945,202017183,chr1,ELF3,chr1:202007945-202017183,9238
202096759,202096978,chr1,CRIP1P3,chr1:202096759-202096978,219
202168051,202189455,chr1,PTPRVP,chr1:202168051-202189455,21404
202193799,202319781,chr1,LGR6,chr1:202193799-202319781,125982
202331657,202341980,chr1,UBE2T,chr1:202331657-202341980,10323
202147013,202161588,chr1,PTPN7,chr1:202147013-202161588,14575
232397965,232630571,chr1,SIPA1L2,chr1:232397965-232630571,232606
29147743,29181900,chr1,SRSF4,chr1:29147743-29181900,34157
170935526,171064765,chr1,MROH9,chr1:170935526-171064765,129239
171090901,171117819,chr1,FMO3,chr1:171090901-171117819,26918
171101728,171101806,chr1,MIR1295A,chr1:171101728-171101806,78
171101739,171101798,chr1,MIR1295B,chr1:171101739-171101798,59
171137740,171161568,chr1,FMO6P,chr1:171137740-171161568,23828
171185249,171212686,chr1,FMO2,chr1:171185249-171212686,27437
156893698,156916429,chr1,PEAR1,chr1:156893698-156916429,22731
156934840,157045742,chr1,ARHGEF11,chr1:156934840-157045742,110902
157059232,157060762,chr1,SMU1P1,chr1:157059232-157060762,1530
157073257,157074703,chr1,KRT8P45,chr1:157073257-157074703,1446
157092043,157112412,chr1,ETV3L,chr1:157092043-157112412,20369
157121191,157138474,chr1,ETV3,chr1:157121191-157138474,17283
157128362,157128671,chr1,CYCSP52,chr1:157128362-157128671,309
227393554,227431035,chr1,LINC01641,chr1:227393554-227431035,37481
227410617,227411319,chr1,NUCKS1P1,chr1:227410617-227411319,702
227434064,227434346,chr1,BTF3P9,chr1:227434064-227434346,282
34112949,34113063,chr1,RNA5SP42,chr1:34112949-34113063,114
34166883,34219131,chr1,C1orf94,chr1:34166883-34219131,52248
33513998,34165842,chr1,CSMD2,chr1:33513998-34165842,651844
92508696,92792404,chr1,EVI5,chr1:92508696-92792404,283708
154924740,154936719,chr1,PMVK,chr1:154924740-154936719,11979
154944076,154956123,chr1,PBXIP1,chr1:154944076-154956123,12047
154957026,154963853,chr1,PYGO2,chr1:154957026-154963853,6827
154962298,154974395,chr1,SHC1,chr1:154962298-154974395,12097
154974653,154979251,chr1,CKS1B,chr1:154974653-154979251,4598
154975693,154975783,chr1,MIR4258,chr1:154975693-154975783,90
154983338,154993111,chr1,FLAD1,chr1:154983338-154993111,9773
155002630,155018523,chr1,ZBTB7B,chr1:155002630-155018523,15893
155018520,155033781,chr1,DCST2,chr1:155018520-155033781,15261
155033824,155050930,chr1,DCST1,chr1:155033824-155050930,17106
155045191,155046118,chr1,DCST1-AS1,chr1:155045191-155046118,927
155050566,155062775,chr1,ADAM15,chr1:155050566-155062775,12209
149928651,149936879,chr1,MTMR11,chr1:149928651-149936879,8228
149937812,150010726,chr1,OTUD7B,chr1:149937812-150010726,72914
144627192,144642372,chr1,LINC01632,chr1:144627192-144642372,15180
144701050,144701159,chr1,RNA5SP59,chr1:144701050-144701159,109
145095974,145112696,chr1,FAM72D,chr1:145095974-145112696,16722
145164099,145216058,chr1,LINC01145,chr1:145164099-145216058,51959
145169519,145169664,chr1,RNU1-153P,chr1:145169519-145169664,145
145866560,145885866,chr1,ANKRD35,chr1:145866560-145885866,19306
145891208,145910111,chr1,ITGA10,chr1:145891208-145910111,18903
145911350,145918717,chr1,PEX11B,chr1:145911350-145918717,7367
145919013,145925341,chr1,GNRHR2,chr1:145919013-145925341,6328
145926590,145959179,chr1,LIX1L-AS1,chr1:145926590-145959179,32589
145933423,145958017,chr1,LIX1L,chr1:145933423-145958017,24594
145959441,145964575,chr1,ANKRD34A,chr1:145959441-145964575,5134
145964690,145978848,chr1,POLR3GL,chr1:145964690-145978848,14158
145992435,145996579,chr1,TXNIP,chr1:145992435-145996579,4144
146017468,146036746,chr1,HJV,chr1:146017468-146036746,19278
146052081,146052244,chr1,RNVU1-6,chr1:146052081-146052244,163
146064711,146229000,chr1,NBPF10,chr1:146064711-146229000,164289
146288596,146288696,chr1,RNU6-1071P,chr1:146288596-146288696,100
146298170,146298715,chr1,NUDT4P2,chr1:146298170-146298715,545
23010834,23019100,chr1,TEX46,chr1:23010834-23019100,8266
48344209,48344315,chr1,RNU6-723P,chr1:48344209-48344315,106
48447936,48448042,chr1,RNU4-61P,chr1:48447936-48448042,106
48532854,50023954,chr1,AGBL4,chr1:48532854-50023954,1491100
48727519,48776969,chr1,BEND5,chr1:48727519-48776969,49450
49257411,49269285,chr1,AGBL4-AS1,chr1:49257411-49269285,11874
49374201,49472085,chr1,AGBL4-IT1,chr1:49374201-49472085,97884
49841821,49846400,chr1,ZNF859P,chr1:49841821-49846400,4579
50017092,50017503,chr1,MTND2P29,chr1:50017092-50017503,411
51102221,51148086,chr1,C1orf185,chr1:51102221-51148086,45865
63774017,64181498,chr1,ROR1,chr1:63774017-64181498,407481
63843196,63843685,chr1,CFL1P3,chr1:63843196-63843685,489
171670517,171670939,chr1,PFN1P1,chr1:171670517-171670939,422
171683128,171684438,chr1,RPL4P3,chr1:171683128-171684438,1310
171700160,171742074,chr1,VAMP4,chr1:171700160-171742074,41914
144265217,144265326,chr1,RNA5SP529,chr1:144265217-144265326,109
144274892,144277993,chr1,DRD5P2,chr1:144274892-144277993,3101
144412576,144412740,chr1,RNVU1-15,chr1:144412576-144412740,164
144442606,144443004,chr1,PFN1P6,chr1:144442606-144443004,398
144523860,144524021,chr1,RNVU1-26,chr1:144523860-144524021,161
144551779,144551943,chr1,RNVU1-2A,chr1:144551779-144551943,164
144560666,144560829,chr1,RNVU1-28,chr1:144560666-144560829,163
1921951,2003837,chr1,CFAP74,chr1:1921951-2003837,81886
149162783,149162944,chr1,RNVU1-24,chr1:149162783-149162944,161
149390621,149471833,chr1,NOTCH2NLC,chr1:149390621-149471833,81212
178677749,178677834,chr1,MIR4424,chr1:178677749-178677834,85
178724306,178726285,chr1,RALGPS2-AS1,chr1:178724306-178726285,1979
178725165,178921842,chr1,RALGPS2,chr1:178725165-178921842,196677
178746683,178747754,chr1,PTPN2P1,chr1:178746683-178747754,1071
178849535,178871077,chr1,ANGPTL1,chr1:178849535-178871077,21542
15236521,15400283,chr1,FHAD1,chr1:15236521-15400283,163762
20806292,21177285,chr1,EIF4G3,chr1:20806292-21177285,370993
144887265,145095528,chr1,SRGAP2B,chr1:144887265-145095528,208263
226631690,226739323,chr1,ITPKB,chr1:226631690-226739323,107633
152032506,152047907,chr1,S100A11,chr1:152032506-152047907,15401
152077952,152078211,chr1,SPTLC1P4,chr1:152077952-152078211,259
152084141,152089064,chr1,TCHHL1,chr1:152084141-152089064,4923
152124016,152196699,chr1,PUDPP2,chr1:152124016-152196699,72683
152153595,152159228,chr1,RPTN,chr1:152153595-152159228,5633
152212076,152224193,chr1,HRNR,chr1:152212076-152224193,12117
23084030,23177808,chr1,LUZP1,chr1:23084030-23177808,93778
144421390,144461676,chr1,NBPF15,chr1:144421390-144461676,40286
145281116,145281279,chr1,RNVU1-14,chr1:145281116-145281279,163
145289900,145405567,chr1,NBPF20,chr1:145289900-145405567,115667
145407772,145408173,chr1,PFN1P3,chr1:145407772-145408173,401
150996549,151008376,chr1,MINDY1,chr1:150996549-151008376,11827
26787054,26800659,chr1,PIGV,chr1:26787054-26800659,13605
26814822,26815112,chr1,RN7SL165P,chr1:26814822-26815112,290
26826688,26857604,chr1,ZDHHC18,chr1:26826688-26857604,30916
26863149,26864456,chr1,SFN,chr1:26863149-26864456,1307
26876132,26890283,chr1,GPN2,chr1:26876132-26890283,14151
26890488,26900467,chr1,GPATCH3,chr1:26890488-26900467,9979
26900238,26946871,chr1,NUDC,chr1:26900238-26946871,46633
26911489,26913975,chr1,NR0B2,chr1:26911489-26913975,2486
26980165,26980975,chr1,RPL12P13,chr1:26980165-26980975,810
26983628,26984024,chr1,RPL32P6,chr1:26983628-26984024,396
26985897,26986340,chr1,OSTCP2,chr1:26985897-26986340,443
26993692,27000886,chr1,TRNP1,chr1:26993692-27000886,7194
27005020,27012850,chr1,TENT5B,chr1:27005020-27012850,7830
26190561,26202968,chr1,CATSPER4,chr1:26190561-26202968,12407
26234200,26278808,chr1,CEP85,chr1:26234200-26278808,44608
26410817,26429728,chr1,LIN28A,chr1:26410817-26429728,18911
26432282,26471306,chr1,DHDDS,chr1:26432282-26471306,39024
26462756,26468014,chr1,DHDDS-AS1,chr1:26462756-26468014,5258
26472440,26476642,chr1,HMGN2,chr1:26472440-26476642,4202
26281328,26318363,chr1,UBXN11,chr1:26281328-26318363,37035
204396492,204411887,chr1,PPP1R15B,chr1:204396492-204411887,15395
53413149,53440020,chr1,SLC25A3P1,chr1:53413149-53440020,26871
53459399,53467488,chr1,DMRTB1,chr1:53459399-53467488,8089
53506237,53739164,chr1,GLIS1,chr1:53506237-53739164,232927
53688749,53688812,chr1,RNU7-95P,chr1:53688749-53688812,63
53765478,53838463,chr1,NDC1,chr1:53765478-53838463,72985
240767636,241357374,chr1,RGS7,chr1:240767636-241357374,589738
149054027,149103561,chr1,NBPF9,chr1:149054027-149103561,49534
23870515,23913362,chr1,CNR2,chr1:23870515-23913362,42847
23901471,23902737,chr1,BTBD6P1,chr1:23901471-23902737,1266
23929070,23929147,chr1,MIR378F,chr1:23929070-23929147,77
23949016,23949383,chr1,H3P1,chr1:23949016-23949383,367
23956839,23963462,chr1,PNRC2,chr1:23956839-23963462,6623
23964347,23980927,chr1,SRSF10,chr1:23964347-23980927,16580
24199558,24364482,chr1,GRHL3,chr1:24199558-24364482,164924
171781660,171814023,chr1,METTL13,chr1:171781660-171814023,32363
171817887,172418466,chr1,DNM3,chr1:171817887-172418466,600579
171864187,171864687,chr1,DNM3-IT1,chr1:171864187-171864687,500
172138397,172144840,chr1,DNM3OS,chr1:172138397-172144840,6443
172138798,172138907,chr1,MIR214,chr1:172138798-172138907,109
172138808,172138888,chr1,MIR3120,chr1:172138808-172138888,80
172144535,172144644,chr1,MIR199A2,chr1:172144535-172144644,109
172366540,172366646,chr1,RNU6-157P,chr1:172366540-172366646,106
172370189,172444086,chr1,PIGC,chr1:172370189-172444086,73897
172420685,172468831,chr1,C1orf105,chr1:172420685-172468831,48146
244943910,244944216,chr1,RN7SKP55,chr1:244943910-244944216,306
244954858,244954963,chr1,RNU6-947P,chr1:244954858-244954963,105
245023015,245023118,chr1,RNU6-1089P,chr1:245023015-245023118,103
245043928,245044032,chr1,RNU6-999P,chr1:245043928-245044032,104
245133927,245134090,chr1,RNU1-132P,chr1:245133927-245134090,163
245206444,245234501,chr1,KIF26B-AS1,chr1:245206444-245234501,28057
245282831,245283089,chr1,DNAJC19P8,chr1:245282831-245283089,258
244969682,245127164,chr1,EFCAB2,chr1:244969682-245127164,157482
228424845,228425360,chr1,H3-4,chr1:228424845-228425360,515
228464213,228464594,chr1,H2BU2P,chr1:228464213-228464594,381
92074533,92075411,chr1,SETSIP,chr1:92074533-92075411,878
93992834,94121148,chr1,ABCA4,chr1:93992834-94121148,128314
204516379,204558120,chr1,MDM4,chr1:204516379-204558120,41741
26693236,26782104,chr1,ARID1A,chr1:26693236-26782104,88868
108970214,109042113,chr1,WDR47,chr1:108970214-109042113,71899
16562319,16613562,chr1,NBPF1,chr1:16562319-16613562,51243
225919877,225924340,chr1,PYCR2,chr1:225919877-225924340,4463
160608106,160647044,chr1,SLAMF1,chr1:160608106-160647044,38938
51789191,51878805,chr1,NRDC,chr1:51789191-51878805,89614
1311585,1324687,chr1,INTS11,chr1:1311585-1324687,13102
21596221,21669357,chr1,RAP1GAP,chr1:21596221-21669357,73136
109733932,109741038,chr1,GSTM3,chr1:109733932-109741038,7106
50437028,50960267,chr1,FAF1,chr1:50437028-50960267,523239
207321532,207386804,chr1,CD55,chr1:207321532-207386804,65272
171485530,171593511,chr1,PRRC2C,chr1:171485530-171593511,107981
6424776,6461367,chr1,ESPN,chr1:6424776-6461367,36591
196888014,196918713,chr1,CFHR4,chr1:196888014-196918713,30699
155247205,155255483,chr1,FAM189B,chr1:155247205-155255483,8278
147242654,147295765,chr1,CHD1L,chr1:147242654-147295765,53111
46261196,46303616,chr1,LRRC41,chr1:46261196-46303616,42420
46757838,46819413,chr1,CYP4B1,chr1:46757838-46819413,61575
159927039,159945613,chr1,IGSF9,chr1:159927039-159945613,18574
113761832,113812476,chr1,RSBN1,chr1:113761832-113812476,50644
24631716,24673281,chr1,SRRM1,chr1:24631716-24673281,41565
150487414,150507602,chr1,TARS2,chr1:150487414-150507602,20188
111139627,111185104,chr1,CEPT1,chr1:111139627-111185104,45477
151770107,151791416,chr1,TDRKH,chr1:151770107-151791416,21309
1335276,1349418,chr1,DVL1,chr1:1335276-1349418,14142
46929177,46941484,chr1,CYP4A11,chr1:46929177-46941484,12307
148102047,148152322,chr1,NBPF11,chr1:148102047-148152322,50275
84078062,84238498,chr1,PRKACB,chr1:84078062-84238498,160436
146938744,146996202,chr1,NBPF12,chr1:146938744-146996202,57458
119911553,120100779,chr1,NOTCH2,chr1:119911553-120100779,189226
158999968,159055155,chr1,IFI16,chr1:158999968-159055155,55187
219608010,219613145,chr1,ZC3H11B,chr1:219608010-219613145,5135
61742477,62178675,chr1,PATJ,chr1:61742477-62178675,436198
196774813,196795407,chr1,CFHR3,chr1:196774813-196795407,20594
235661041,235883640,chr1,LYST,chr1:235661041-235883640,222599
155946851,156007070,chr1,ARHGEF2,chr1:155946851-156007070,60219
11845709,11848345,chr1,NPPA,chr1:11845709-11848345,2636
204190341,204196491,chr1,KISS1,chr1:204190341-204196491,6150
175067833,175148075,chr1,TNN,chr1:175067833-175148075,80242
45786987,46036122,chr1,MAST2,chr1:45786987-46036122,249135
56645314,56715335,chr1,PRKAA2,chr1:56645314-56715335,70021
156147366,156177752,chr1,SEMA4A,chr1:156147366-156177752,30386
23428563,23484568,chr1,ASAP3,chr1:23428563-23484568,56005
1385711,1399335,chr1,CCNL2,chr1:1385711-1399335,13624
26949562,26960468,chr1,KDF1,chr1:26949562-26960468,10906
109656099,109674836,chr1,GSTM4,chr1:109656099-109674836,18737
117143587,117210960,chr1,VTCN1,chr1:117143587-117210960,67373
151540305,151583583,chr1,TUFT1,chr1:151540305-151583583,43278
181317690,181808084,chr1,CACNA1E,chr1:181317690-181808084,490394
90915298,91022272,chr1,ZNF644,chr1:90915298-91022272,106974
47137435,47149727,chr1,CYP4A22,chr1:47137435-47149727,12292
960584,965719,chr1,KLHL17,chr1:960584-965719,5135
155173787,155184971,chr1,TRIM46,chr1:155173787-155184971,11184
214603195,214664571,chr1,CENPF,chr1:214603195-214664571,61376
156463727,156500779,chr1,MEF2D,chr1:156463727-156500779,37052
9651731,9729114,chr1,PIK3CD,chr1:9651731-9729114,77383
53891239,53911086,chr1,DIO1,chr1:53891239-53911086,19847
155185824,155192916,chr1,MUC1,chr1:155185824-155192916,7092
28812170,28871267,chr1,OPRD1,chr1:28812170-28871267,59097
68049360,68049745,chr1,ARL5AP3,chr1:68049360-68049745,385
68098473,68233120,chr1,WLS,chr1:68098473-68233120,134647
68161761,68163090,chr1,CTBP2P8,chr1:68161761-68163090,1329
68183518,68183610,chr1,MIR1262,chr1:68183518-68183610,92
68242474,68243055,chr1,RPS7P4,chr1:68242474-68243055,581
89256189,89272860,chr1,GBP5,chr1:89256189-89272860,16671
68045886,68051717,chr1,DIRAS3,chr1:68045886-68051717,5831
23743448,23762059,chr1,ELOA,chr1:23743448-23762059,18611
23801885,23838620,chr1,HMGCL,chr1:23801885-23838620,36735
23845077,23868290,chr1,FUCA1,chr1:23845077-23868290,23213
31617686,31632518,chr1,HCRTR1,chr1:31617686-31632518,14832
31652263,31704319,chr1,COL16A1,chr1:31652263-31704319,52056
171600621,171638799,chr1,MYOCOS,chr1:171600621-171638799,38178
165662216,165698562,chr1,ALDH9A1,chr1:165662216-165698562,36346
247449118,247458105,chr1,OR2B11,chr1:247449118-247458105,8987
685716,686654,chr1,OR4F16,chr1:685716-686654,938
158774222,158781204,chr1,OR6N2,chr1:158774222-158781204,6982
149852608,149853125,chr1,H3C15,chr1:149852608-149853125,517
149782689,149812373,chr1,H2BC18,chr1:149782689-149812373,29684
149854045,149861159,chr1,H4C15,chr1:149854045-149861159,7114
149851061,149851594,chr1,H2AC19,chr1:149851061-149851594,533
108450282,108471920,chr1,NBPF6,chr1:108450282-108471920,21638
167935783,168075843,chr1,DCAF6,chr1:167935783-168075843,140060
13148907,13156009,chr1,PRAMEF26,chr1:13148907-13156009,7102
149842218,149842750,chr1,H2AC18,chr1:149842218-149842750,532
149884459,149886682,chr1,H2BC21,chr1:149884459-149886682,2223
149832657,149839767,chr1,H4C14,chr1:149832657-149839767,7110
15659713,15662033,chr1,RSC1A1,chr1:15659713-15662033,2320
225486829,225653142,chr1,ENAH,chr1:225486829-225653142,166313
100133150,100150496,chr1,TRMT13,chr1:100133150-100150496,17346
149840687,149841208,chr1,H3C14,chr1:149840687-149841208,521
248403048,248408020,chr1,OR2T1,chr1:248403048-248408020,4972
177923956,177984303,chr1,SEC16B,chr1:177923956-177984303,60347
206770764,206842981,chr1,IL19,chr1:206770764-206842981,72217
179743291,179816198,chr1,FAM163A,chr1:179743291-179816198,72907
152675279,152676569,chr1,LCE2C,chr1:152675279-152676569,1290
247524677,247536440,chr1,OR2C3,chr1:247524677-247536440,11763
16387117,16437424,chr1,SPATA21,chr1:16387117-16437424,50307
200738893,200860704,chr1,CAMSAP2,chr1:200738893-200860704,121811
81426456,81427605,chr1,HNRNPA3P14,chr1:81426456-81427605,1149
81501794,81503468,chr1,ARID3BP1,chr1:81501794-81503468,1674
81557121,81557832,chr1,MED28P8,chr1:81557121-81557832,711
81721693,81723068,chr1,ST13P20,chr1:81721693-81723068,1375
81306147,81993932,chr1,ADGRL2,chr1:81306147-81993932,687785
16040252,16057311,chr1,CLCNKB,chr1:16040252-16057311,17059
20290875,20359518,chr1,VWA5B1,chr1:20290875-20359518,68643
152600234,152601086,chr1,LCE3C,chr1:152600234-152601086,852
40783787,40840452,chr1,KCNQ4,chr1:40783787-40840452,56665
40804846,40805141,chr1,RN7SL326P,chr1:40804846-40805141,295
40861054,40862363,chr1,CITED4,chr1:40861054-40862363,1309
40942251,40942515,chr1,UBE2V1P8,chr1:40942251-40942515,264
40979688,41012565,chr1,CTPS1,chr1:40979688-41012565,32877
41014590,41043890,chr1,SLFNL1-AS1,chr1:41014590-41043890,29300
41015589,41023237,chr1,SLFNL1,chr1:41015589-41023237,7648
41098638,41099136,chr1,RPL23AP17,chr1:41098638-41099136,498
216503246,217137755,chr1,ESRRG,chr1:216503246-217137755,634509
201283452,201332993,chr1,PKP1,chr1:201283452-201332993,49541
201359008,201377764,chr1,TNNT2,chr1:201359008-201377764,18756
201380833,201399915,chr1,LAD1,chr1:201380833-201399915,19082
201403768,201429866,chr1,TNNI1,chr1:201403768-201429866,26098
201464278,201469237,chr1,PHLDA3,chr1:201464278-201469237,4959
201483530,201509456,chr1,CSRP1,chr1:201483530-201509456,25926
201518703,201584367,chr1,RPS10P7,chr1:201518703-201584367,65664
201688259,201829559,chr1,IPO9-AS1,chr1:201688259-201829559,141300
201719508,201719627,chr1,MIR5191,chr1:201719508-201719627,119
201733406,201733505,chr1,RNU6-501P,chr1:201733406-201733505,99
201808611,201808702,chr1,MIR1231,chr1:201808611-201808702,91
201829149,201884291,chr1,IPO9,chr1:201829149-201884291,55142
201863373,201863447,chr1,MIR6739,chr1:201863373-201863447,74
201888680,201892587,chr1,SHISA4,chr1:201888680-201892587,3907
201539127,201826969,chr1,NAV1,chr1:201539127-201826969,287842
70852353,71047816,chr1,PTGER3,chr1:70852353-71047816,195463
145824088,145844402,chr1,POLR3C,chr1:145824088-145844402,20314
145845630,145848954,chr1,NUDT17,chr1:145845630-145848954,3324
145848522,145859836,chr1,PIAS3,chr1:145848522-145859836,11314
145850587,145850645,chr1,MIR6736,chr1:145850587-145850645,58
145921556,145927678,chr1,RBM8A,chr1:145921556-145927678,6122
112619805,112671616,chr1,CAPZA1,chr1:112619805-112671616,51811
112625906,112626224,chr1,MRPL53P1,chr1:112625906-112626224,318
112634719,112634784,chr1,RNU7-70P,chr1:112634719-112634784,65
112701127,112707434,chr1,RHOC,chr1:112701127-112707434,6307
112715672,112717796,chr1,PPM1J-DT,chr1:112715672-112717796,2124
112718905,112727235,chr1,TAFA3,chr1:112718905-112727235,8330
112748095,112748475,chr1,NUTF2P4,chr1:112748095-112748475,380
112673141,112700756,chr1,MOV10,chr1:112673141-112700756,27615
146146203,146229041,chr1,NOTCH2NLA,chr1:146146203-146229041,82838
120723912,120793882,chr1,NOTCH2NLR,chr1:120723912-120793882,69970
120723949,120842110,chr1,NBPF26,chr1:120723949-120842110,118161
120850819,120850985,chr1,RNVU1-19,chr1:120850819-120850985,166
28587829,28648291,chr1,TAF12,chr1:28587829-28648291,60462
149345661,149357612,chr1,SEC22B2P,chr1:149345661-149357612,11951
41375004,41375669,chr1,FOXO6-AS1,chr1:41375004-41375669,665
109062496,109076012,chr1,TAF13,chr1:109062496-109076012,13516
219968600,220046530,chr1,EPRS1,chr1:219968600-220046530,77930
220057482,220090462,chr1,BPNT1,chr1:220057482-220090462,32980
220094132,220148041,chr1,IARS2,chr1:220094132-220148041,53909
220117853,220117962,chr1,MIR215,chr1:220117853-220117962,109
220118157,220118241,chr1,MIR194-1,chr1:220118157-220118241,84
220143964,220144351,chr1,RPS15AP12,chr1:220143964-220144351,387
220148293,220272529,chr1,RAB3GAP2,chr1:220148293-220272529,124236
220200538,220200619,chr1,MIR664A,chr1:220200538-220200619,81
220200546,220200676,chr1,SNORA36B,chr1:220200546-220200676,130
220207618,220208282,chr1,SNX2P1,chr1:220207618-220208282,664
220253570,220254536,chr1,MORF4L1P1,chr1:220253570-220254536,966
220266706,220267917,chr1,AURKAP1,chr1:220266706-220267917,1211
220313945,220315565,chr1,XRCC6P3,chr1:220313945-220315565,1620
226989865,227318492,chr1,CDC42BPA,chr1:226989865-227318492,328627
162777730,162778014,chr1,RN7SL861P,chr1:162777730-162778014,284
162790702,162812823,chr1,HSD17B7,chr1:162790702-162812823,22121
163068775,163076802,chr1,RGS4,chr1:163068775-163076802,8027
39081316,39487177,chr1,MACF1,chr1:39081316-39487177,405861
162824458,162868761,chr1,CCDC190,chr1:162824458-162868761,44303
46040140,46133036,chr1,PIK3R3,chr1:46040140-46133036,92896
46043661,46176488,chr1,P3R3URF-PIK3R3,chr1:46043661-46176488,132827
46175073,46185962,chr1,TSPAN1,chr1:46175073-46185962,10889
46175486,46176488,chr1,P3R3URF,chr1:46175486-46176488,1002
46203334,46221256,chr1,LURAP1,chr1:46203334-46221256,17922
46246461,46278480,chr1,RAD54L,chr1:46246461-46278480,32019
46188683,46220305,chr1,POMGNT1,chr1:46188683-46220305,31622
169367970,169396540,chr1,BLZF1,chr1:169367970-169396540,28570
169394870,169460669,chr1,CCDC181,chr1:169394870-169460669,65799
169463909,169485944,chr1,SLC19A2,chr1:169463909-169485944,22035
169511951,169586588,chr1,F5,chr1:169511951-169586588,74637
99646113,99694541,chr1,PALMD,chr1:99646113-99694541,48428
99698242,99699178,chr1,HMGB3P10,chr1:99698242-99699178,936
226548764,226609230,chr1,STUM,chr1:226548764-226609230,60466
161581339,161605662,chr1,FCGR2C,chr1:161581339-161605662,24323
155749659,155859400,chr1,GON4L,chr1:155749659-155859400,109741
237042184,237833988,chr1,RYR2,chr1:237042184-237833988,791804
237120807,237121109,chr1,RN7SKP195,chr1:237120807-237121109,302
237471119,237471191,chr1,MIR4428,chr1:237471119-237471191,72
237877864,237890922,chr1,ZP4,chr1:237877864-237890922,13058
120913184,121009291,chr1,LINC00623,chr1:120913184-121009291,96107
120942600,120942763,chr1,RNVU1-4,chr1:120942600-120942763,163
120985692,121052167,chr1,PDE4DIPP4,chr1:120985692-121052167,66475
120889771,120890530,chr1,PPIAL4A,chr1:120889771-120890530,759
42456117,42473385,chr1,PPCS,chr1:42456117-42473385,17268
42463221,42657190,chr1,CCDC30,chr1:42463221-42657190,193969
42491739,42492493,chr1,RPS3AP11,chr1:42491739-42492493,754
42500205,42500339,chr1,TMSB4XP1,chr1:42500205-42500339,134
42569033,42569139,chr1,RNU6-536P,chr1:42569033-42569139,106
149583848,149584607,chr1,PPIAL4C,chr1:149583848-149584607,759
145241415,145242174,chr1,PPIAL4D,chr1:145241415-145242174,759
144372875,144373634,chr1,PPIAL4E,chr1:144372875-144373634,759
144592893,144593652,chr1,PPIAL4F,chr1:144592893-144593652,759
148522601,148522765,chr1,RNVU1-27,chr1:148522601-148522765,164
148531385,148679742,chr1,NBPF14,chr1:148531385-148679742,148357
148607040,148679779,chr1,NOTCH2NLB,chr1:148607040-148679779,72739
148482548,148483302,chr1,PPIAL4G,chr1:148482548-148483302,754
146344006,146344765,chr1,PPIAL4H,chr1:146344006-146344765,759
114716913,114758676,chr1,CSDE1,chr1:114716913-114758676,41763
109539872,109548406,chr1,GPR61,chr1:109539872-109548406,8534
6590724,6614607,chr1,KLHL21,chr1:6590724-6614607,23883
6613731,6624030,chr1,PHF13,chr1:6613731-6624030,10299
6724637,6730012,chr1,LINC01672,chr1:6724637-6730012,5375
202891116,202928636,chr1,KLHL12,chr1:202891116-202928636,37520
202911812,202912729,chr1,HNRNPA1P59,chr1:202911812-202912729,917
202940826,202958572,chr1,ADIPOR1,chr1:202940826-202958572,17746
202961873,202967275,chr1,CYB5R1,chr1:202961873-202967275,5402
202986557,202988582,chr1,MGAT4FP,chr1:202986557-202988582,2025
203007374,203024848,chr1,TMEM183A,chr1:203007374-203024848,17474
203083129,203086012,chr1,MYOG,chr1:203083129-203086012,2883
203090654,203167405,chr1,ADORA1,chr1:203090654-203167405,76751
203167811,203175826,chr1,MYBPH,chr1:203167811-203175826,8015
203178931,203186704,chr1,CHI3L1,chr1:203178931-203186704,7773
19074510,19210266,chr1,UBR4,chr1:19074510-19210266,135756
19265982,19274194,chr1,AKR7L,chr1:19265982-19274194,8212
19251805,19260128,chr1,MRTO4,chr1:19251805-19260128,8323
19282573,19288770,chr1,AKR7A3,chr1:19282573-19288770,6197
19303965,19312144,chr1,AKR7A2,chr1:19303965-19312144,8179
19305076,19305182,chr1,RNU6-1099P,chr1:19305076-19305182,106
19312326,19329300,chr1,SLC66A1,chr1:19312326-19329300,16974
19424384,19424671,chr1,RN7SL277P,chr1:19424384-19424671,287
202796030,202797094,chr1,SLC25A39P1,chr1:202796030-202797094,1064
202820266,202827225,chr1,MGAT4EP,chr1:202820266-202827225,6959
202861754,202875241,chr1,ACTG1P25,chr1:202861754-202875241,13487
202878282,202889149,chr1,RABIF,chr1:202878282-202889149,10867
203212827,203273641,chr1,CHIT1,chr1:203212827-203273641,60814
203255743,203256475,chr1,NPM1P40,chr1:203255743-203256475,732
203026491,203078740,chr1,PPFIA4,chr1:203026491-203078740,52249
150926263,150964744,chr1,SETDB1,chr1:150926263-150964744,38481
169067264,169067364,chr1,RNA5SP66,chr1:169067264-169067364,100
6540854,6540964,chr1,RNU6-731P,chr1:6540854-6540964,110
6634168,6701924,chr1,DNAJC11,chr1:6634168-6701924,67756
13700188,13825079,chr1,PRDM2,chr1:13700188-13825079,124891
25362249,25430192,chr1,RHCE,chr1:25362249-25430192,67943
19215660,19251552,chr1,EMC1,chr1:19215660-19251552,35892
100989623,101026088,chr1,DPH5,chr1:100989623-101026088,36465
42767245,42779491,chr1,C1orf50,chr1:42767245-42779491,12246
47216290,47232225,chr1,TAL1,chr1:47216290-47232225,15935
184690237,184754907,chr1,EDEM3,chr1:184690237-184754907,64670
184821428,184821489,chr1,RNU7-13P,chr1:184821428-184821489,61
154993586,154994315,chr1,LENEP,chr1:154993586-154994315,729
183266602,183267285,chr1,RPS3AP8,chr1:183266602-183267285,683
183555562,183590876,chr1,NCF2,chr1:183555562-183590876,35314
183620846,183635783,chr1,ARPC5,chr1:183620846-183635783,14937
183646275,183653316,chr1,APOBEC4,chr1:183646275-183653316,7041
183472216,183598246,chr1,SMG7,chr1:183472216-183598246,126030
108815898,108963484,chr1,AKNAD1,chr1:108815898-108963484,147586
108881885,108963527,chr1,CLCC1,chr1:108881885-108963527,81642
168784012,168792886,chr1,LINC00626,chr1:168784012-168792886,8874
168898136,168898439,chr1,SUMO1P2,chr1:168898136-168898439,303
168903905,169087005,chr1,LINC00970,chr1:168903905-169087005,183100
168938467,168938923,chr1,RPL29P7,chr1:168938467-168938923,456
84479259,84498352,chr1,RPF1,chr1:84479259-84498352,19093
84498323,84506581,chr1,GNG5,chr1:84498323-84506581,8258
84506300,84566194,chr1,SPATA1,chr1:84506300-84566194,59894
84549611,84574480,chr1,CTBS,chr1:84549611-84574480,24869
84628230,84635020,chr1,LINC01555,chr1:84628230-84635020,6790
84643706,84690803,chr1,SSX2IP,chr1:84643706-84690803,47097
2050411,2185395,chr1,PRKCZ,chr1:2050411-2185395,134984
45694324,45750653,chr1,IPP,chr1:45694324-45750653,56329
65792514,66374579,chr1,PDE4B,chr1:65792514-66374579,582065
151399560,151401937,chr1,PSMB4,chr1:151399560-151401937,2377
151281618,151292176,chr1,ZNF687,chr1:151281618-151292176,10558
151169986,151176284,chr1,TMOD4,chr1:151169986-151176284,6298
40344850,40423326,chr1,SMAP2,chr1:40344850-40423326,78476
1915108,1917296,chr1,CALML6,chr1:1915108-1917296,2188
20740266,20787323,chr1,HP1BP3,chr1:20740266-20787323,47057
40508741,40516038,chr1,EXO5,chr1:40508741-40516038,7297
204422628,204494805,chr1,PIK3C2B,chr1:204422628-204494805,72177
151176304,151195321,chr1,VPS72,chr1:151176304-151195321,19017
151131685,151146631,chr1,SEMA6C,chr1:151131685-151146631,14946
111414319,111427735,chr1,OVGP1,chr1:111414319-111427735,13416
111437514,111438037,chr1,UBE2FP3,chr1:111437514-111438037,523
111439890,111449256,chr1,WDR77,chr1:111439890-111449256,9366
111448864,111462773,chr1,ATP5PB,chr1:111448864-111462773,13909
111473792,111478512,chr1,C1orf162,chr1:111473792-111478512,4720
111483348,111563962,chr1,TMIGD3,chr1:111483348-111563962,80614
111490317,111490423,chr1,RNU6-792P,chr1:111490317-111490423,106
111499429,111503633,chr1,ADORA3,chr1:111499429-111503633,4204
111542218,111716691,chr1,RAP1A,chr1:111542218-111716691,174473
41361922,41383590,chr1,FOXO6,chr1:41361922-41383590,21668
41466937,41467028,chr1,RNA5SP45,chr1:41466937-41467028,91
41478775,41484683,chr1,EDN2,chr1:41478775-41484683,5908
169105697,169310992,chr1,ATP1B1,chr1:169105697-169310992,205295
86862445,86914424,chr1,SELENOF,chr1:86862445-86914424,51979
86914635,87109982,chr1,HS2ST1,chr1:86914635-87109982,195347
87129765,87169198,chr1,LINC01140,chr1:87129765-87169198,39433
59733227,59733296,chr1,MIR4711,chr1:59733227-59733296,69
59814786,59876322,chr1,HOOK1,chr1:59814786-59876322,61536
59893308,59926773,chr1,CYP2J2,chr1:59893308-59926773,33465
59974757,59975054,chr1,RN7SL475P,chr1:59974757-59975054,297
228434777,228457873,chr1,H2AW,chr1:228434777-228457873,23096
228458103,228463104,chr1,H2BU1,chr1:228458103-228463104,5001
228487382,228499899,chr1,RNF187,chr1:228487382-228499899,12517
11736084,11754802,chr1,AGTRAP,chr1:11736084-11754802,18718
11777077,11779619,chr1,C1orf167-AS1,chr1:11777077-11779619,2542
11785723,11806455,chr1,MTHFR,chr1:11785723-11806455,20732
11761787,11789585,chr1,C1orf167,chr1:11761787-11789585,27798
222737202,222751004,chr1,FAM177B,chr1:222737202-222751004,13802
121167646,121185539,chr1,FAM72B,chr1:121167646-121185539,17893
75202129,75611114,chr1,SLC44A5,chr1:75202129-75611114,408985
32361270,32364278,chr1,FAM229A,chr1:32361270-32364278,3008
6624868,6635586,chr1,THAP3,chr1:6624868-6635586,10718
5990927,6101193,chr1,KCNAB2,chr1:5990927-6101193,110266
153537147,153541765,chr1,S100A5,chr1:153537147-153541765,4618
161663143,161678654,chr1,FCGR2B,chr1:161663143-161678654,15511
112709994,112715332,chr1,PPM1J,chr1:112709994-112715332,5338
152106317,152115444,chr1,TCHH,chr1:152106317-152115444,9127
156212993,156240042,chr1,PMF1,chr1:156212993-156240042,27049
40691648,40771603,chr1,NFYC,chr1:40691648-40771603,79955
1373730,1375207,chr1,AURKAIP1,chr1:1373730-1375207,1477
31790422,31816022,chr1,SPOCD1,chr1:31790422-31816022,25600
77779624,77879540,chr1,MIGA1,chr1:77779624-77879540,99916
46607719,46616811,chr1,MOB3C,chr1:46607719-46616811,9092
70205682,70253052,chr1,SRSF11,chr1:70205682-70253052,47370
116164209,116167494,chr1,LINC01779,chr1:116164209-116167494,3285
225447233,225465400,chr1,LINC02765,chr1:225447233-225465400,18167
80535755,80646801,chr1,LINC01781,chr1:80535755-80646801,111046
110286375,110339171,chr1,RBM15-AS1,chr1:110286375-110339171,52796
146052566,146061952,chr1,LINC01719,chr1:146052566-146061952,9386
121107175,121117294,chr1,H2BP1,chr1:121107175-121117294,10119
115099580,115102686,chr1,LINC01765,chr1:115099580-115102686,3106
187070700,187687674,chr1,LINC01036,chr1:187070700-187687674,616974
116378437,116421301,chr1,ATP1A1-AS1,chr1:116378437-116421301,42864
67832297,68202987,chr1,GNG12-AS1,chr1:67832297-68202987,370690
9182004,9196284,chr1,LNCTAM34A,chr1:9182004-9196284,14280
155562026,155563944,chr1,ASH1L-AS1,chr1:155562026-155563944,1918
177351560,177437880,chr1,LINC01645,chr1:177351560-177437880,86320
159958035,159984750,chr1,LINC01133,chr1:159958035-159984750,26715
15740048,15749896,chr1,SLC25A34-AS1,chr1:15740048-15749896,9848
3059611,3069088,chr1,PRDM16-DT,chr1:3059611-3069088,9477
183460874,183472896,chr1,SMG7-AS1,chr1:183460874-183472896,12022
173417793,173489407,chr1,PRDX6-AS1,chr1:173417793-173489407,71614
218976672,219173961,chr1,LYPLAL1-DT,chr1:218976672-219173961,197289
94247819,94411036,chr1,ARHGAP29-AS1,chr1:94247819-94411036,163217
94613814,94855426,chr1,SLC44A3-AS1,chr1:94613814-94855426,241612
30824217,30834864,chr1,LINC01778,chr1:30824217-30834864,10647
39522280,39559698,chr1,PPIEL,chr1:39522280-39559698,37418
121519112,121575702,chr1,EMBP1,chr1:121519112-121575702,56590
198777861,198937471,chr1,MIR181A1HG,chr1:198777861-198937471,159610
58933643,59240555,chr1,LINC01358,chr1:58933643-59240555,306912
203273221,203288804,chr1,LINC01353,chr1:203273221-203288804,15583
174022509,174023167,chr1,LINC02776,chr1:174022509-174023167,658
3900352,3917225,chr1,LINC01134,chr1:3900352-3917225,16873
223951394,223992625,chr1,GTF2IP20,chr1:223951394-223992625,41231
203298758,203305315,chr1,LINC01136,chr1:203298758-203305315,6557
9425094,9440564,chr1,LINC02606,chr1:9425094-9440564,15470
112176836,112360625,chr1,LINC02884,chr1:112176836-112360625,183789
200253419,200400705,chr1,LINC00862,chr1:200253419-200400705,147286
60515716,60640507,chr1,LINC01748,chr1:60515716-60640507,124791
67522299,67532612,chr1,LINC01702,chr1:67522299-67532612,10313
155194997,155205495,chr1,THBS3-AS1,chr1:155194997-155205495,10498
58784384,58901109,chr1,LINC01135,chr1:58784384-58901109,116725
26209741,26229844,chr1,ZPLD2P,chr1:26209741-26229844,20103
235064927,235074220,chr1,LINC01348,chr1:235064927-235074220,9293
12525738,12530462,chr1,LINC02766,chr1:12525738-12530462,4724
209428817,209432848,chr1,MIR205HG,chr1:209428817-209432848,4031
206634184,206635714,chr1,DYRK3-AS1,chr1:206634184-206635714,1530
20360579,20431234,chr1,LINC01141,chr1:20360579-20431234,70655
155213821,155227574,chr1,GBAP1,chr1:155213821-155227574,13753
144716062,144758298,chr1,LSP1P5,chr1:144716062-144758298,42236
110347116,110443817,chr1,LAMTOR5-AS1,chr1:110347116-110443817,96701
97933474,98049863,chr1,MIR137HG,chr1:97933474-98049863,116389
825138,859446,chr1,LINC01128,chr1:825138-859446,34308
89581291,89633003,chr1,LRRC8C-DT,chr1:89581291-89633003,51712
83575776,83861038,chr1,LINC01725,chr1:83575776-83861038,285262
37350934,37474432,chr1,LINC01137,chr1:37350934-37474432,123498
230002372,230007195,chr1,LINC01736,chr1:230002372-230007195,4823
94927361,94963616,chr1,CNN3-DT,chr1:94927361-94963616,36255
212180141,212285130,chr1,LINC02608,chr1:212180141-212285130,104989
32231656,32241710,chr1,MTMR9LP,chr1:32231656-32241710,10054
151279678,151281970,chr1,ZNF687-AS1,chr1:151279678-151281970,2292
90769086,90851669,chr1,LINC02609,chr1:90769086-90851669,82583
112820170,112850643,chr1,LINC01356,chr1:112820170-112850643,30473
9672405,9687573,chr1,PIK3CD-AS2,chr1:9672405-9687573,15168
202810850,202812473,chr1,PCAT6,chr1:202810850-202812473,1623
202851828,202861755,chr1,TUBA5P,chr1:202851828-202861755,9927
209661356,209724125,chr1,HSD11B1-AS1,chr1:209661356-209724125,62769
56414935,56417137,chr1,LINC01767,chr1:56414935-56417137,2202
108040263,108076020,chr1,LINC02785,chr1:108040263-108076020,35757
211382736,211435570,chr1,LINC00467,chr1:211382736-211435570,52834
151346938,151348027,chr1,RFX5-AS1,chr1:151346938-151348027,1089
28578538,28583132,chr1,SNHG12,chr1:28578538-28583132,4594
42959049,42996814,chr1,SLC2A1-AS1,chr1:42959049-42996814,37765
46432129,46482493,chr1,FAAHP1,chr1:46432129-46482493,50364
218344190,218346024,chr1,TGFB2-AS1,chr1:218344190-218346024,1834
11099430,11102100,chr1,EXOSC10-AS1,chr1:11099430-11102100,2670
70354786,70385339,chr1,HHLA3,chr1:70354786-70385339,30553
212852105,212858138,chr1,FLVCR1-DT,chr1:212852105-212858138,6033
100251528,100266179,chr1,RTCA-AS1,chr1:100251528-100266179,14651
16215907,16228027,chr1,ANO7L1,chr1:16215907-16228027,12120
43685123,43708138,chr1,KDM4A-AS1,chr1:43685123-43708138,23015
35569807,35577771,chr1,TFAP2E-AS1,chr1:35569807-35577771,7964
23368949,23371839,chr1,ZNF436-AS1,chr1:23368949-23371839,2890
149606209,149705716,chr1,LINC00869,chr1:149606209-149705716,99507
119140391,119275973,chr1,WARS2-AS1,chr1:119140391-119275973,135582
23581495,23640568,chr1,MDS2,chr1:23581495-23640568,59073
1399515,1402046,chr1,MRPL20-AS1,chr1:1399515-1402046,2531
165476833,165582155,chr1,LRRC52-AS1,chr1:165476833-165582155,105322
226656080,226675089,chr1,ITPKB-IT1,chr1:226656080-226675089,19009
151790804,151794403,chr1,TDRKH-AS1,chr1:151790804-151794403,3599
112849821,112877878,chr1,LINC01357,chr1:112849821-112877878,28057
19210355,19240704,chr1,EMC1-AS1,chr1:19210355-19240704,30349
63320878,63324441,chr1,FOXD3-AS1,chr1:63320878-63324441,3563
23706901,23778325,chr1,ELOA-AS1,chr1:23706901-23778325,71424
93591972,93605573,chr1,BCAR3-AS1,chr1:93591972-93605573,13601
173858559,173868882,chr1,GAS5,chr1:173858559-173868882,10323
234372807,234373662,chr1,COA6-AS1,chr1:234372807-234373662,855
150887136,150913292,chr1,CTXND2,chr1:150887136-150913292,26156
236142505,236221865,chr1,GPR137B,chr1:236142505-236221865,79360
236267780,236267958,chr1,RNU2-70P,chr1:236267780-236267958,178
236214681,236282019,chr1,ERO1B,chr1:236214681-236282019,67338
