start,end,chrom,gene_symbol,segment_id,length
648,1601,chrMT,MT-RNR1,chrMT:648-1601,953
1602,1670,chrMT,MT-TV,chrMT:1602-1670,68
1671,3229,chrMT,MT-RNR2,chrMT:1671-3229,1558
4402,4469,chrMT,MT-TM,chrMT:4402-4469,67
5587,5655,chrMT,MT-TA,chrMT:5587-5655,68
5761,5826,chrMT,MT-TC,chrMT:5761-5826,65
5904,7445,chrMT,MT-CO1,chrMT:5904-7445,1541
7586,8269,chrMT,MT-CO2,chrMT:7586-8269,683
8527,9207,chrMT,MT-ATP6,chrMT:8527-9207,680
9207,9990,chrMT,MT-CO3,chrMT:9207-9990,783
9991,10058,chrMT,MT-TG,chrMT:9991-10058,67
10405,10469,chrMT,MT-TR,chrMT:10405-10469,64
10760,12137,chrMT,MT-ND4,chrMT:10760-12137,1377
12138,12206,chrMT,MT-TH,chrMT:12138-12206,68
12207,12265,chrMT,MT-TS2,chrMT:12207-12265,58
12266,12336,chrMT,MT-TL2,chrMT:12266-12336,70
12337,14148,chrMT,MT-ND5,chrMT:12337-14148,1811
14149,14673,chrMT,MT-ND6,chrMT:14149-14673,524
14747,15887,chrMT,MT-CYB,chrMT:14747-15887,1140
15956,16023,chrMT,MT-TP,chrMT:15956-16023,67
5337745,5338964,chrY,EIF4A1P2,chrY:5337745-5338964,1219
11957208,11987386,chrY,MXRA5Y,chrY:11957208-11987386,30178
7341531,7341642,chrY,Y_RNA,chrY:7341531-7341642,111
14522573,14845654,chrY,NLGN4Y,chrY:14522573-14845654,323081
11981025,12030877,chr18,IMPA2,chr18:11981025-12030877,49852
9708275,9862551,chr18,RAB31,chr18:9708275-9862551,154276
9082601,9083101,chr21,SOWAHCP2,chr21:9082601-9083101,500
5750393,5864395,chr20,SHLD1,chr20:5750393-5864395,114002
5911510,5925353,chr20,CHGB,chr20:5911510-5925353,13843
18269116,18485879,chr21,TMPRSS15,chr21:18269116-18485879,216763
14819699,14918552,chr21,LINC02246,chr21:14819699-14918552,98853
12984694,12991173,chr18,CEP192-DT,chr18:12984694-12991173,6479
26655737,27190698,chr18,AQP4-AS1,chr18:26655737-27190698,534961
4120980,4187747,chr20,SMOX,chr20:4120980-4187747,66767
29004384,29019360,chr21,RWDD2B,chr21:29004384-29019360,14976
27420380,27421023,chr21,RPL10P1,chr21:27420380-27421023,643
9781910,9838011,chr21,LINC01667,chr21:9781910-9838011,56101
29077471,29175889,chr21,MAP3K7CL,chr21:29077471-29175889,98418
29748175,29764002,chr21,GRIK1-AS1,chr21:29748175-29764002,15827
25639258,25717562,chr21,JAM2,chr21:25639258-25717562,78304
2481817,2524702,chr20,ZNF343,chr20:2481817-2524702,42885
5928085,5929318,chr20,KANK1P1,chr20:5928085-5929318,1233
26466209,26573286,chr21,CYYR1,chr21:26466209-26573286,107077
28997613,28998033,chr21,RPL23P2,chr21:28997613-28998033,420
18383367,18467281,chr20,DZANK1,chr20:18383367-18467281,83914
45212995,45683688,chr18,SLC14A2,chr18:45212995-45683688,470693
18504633,18505066,chr20,RPS19P1,chr20:18504633-18505066,433
24469629,24666616,chr20,SYNDIG1,chr20:24469629-24666616,196987
22054074,22074654,chr20,LINC01432,chr20:22054074-22074654,20580
26016253,26091217,chr18,SS18,chr18:26016253-26091217,74964
5544439,5611006,chr20,GPCPD1,chr20:5544439-5611006,66567
24306939,24547942,chr21,LINC01684,chr21:24306939-24547942,241003
24949269,24959928,chr20,CST7,chr20:24949269-24959928,10659
36385392,36419015,chr21,CHAF1B,chr21:36385392-36419015,33623
14179097,14252140,chr18,ANKRD20A5P,chr18:14179097-14252140,73043
28116094,28228667,chr21,LINC01695,chr21:28116094-28228667,112573
17493905,17569220,chr20,BFSP1,chr20:17493905-17569220,75315
23994213,24015339,chr18,TTC39C-AS1,chr18:23994213-24015339,21126
14337423,14342524,chr18,CYP4F35P,chr18:14337423-14342524,5101
50375040,50394168,chr18,SKA1,chr18:50375040-50394168,19128
17178790,17258235,chr22,ADA2,chr22:17178790-17258235,79445
17570075,17609919,chr20,DSTN,chr20:17570075-17609919,39844
25734264,25735093,chr20,VN1R108P,chr20:25734264-25735093,829
20998409,21543329,chr21,NCAM2,chr21:20998409-21543329,544920
13237801,13239674,chr20,ISM1-AS1,chr20:13237801-13239674,1873
25880550,26171128,chr21,APP,chr21:25880550-26171128,290578
17036570,17060825,chr22,CECR7,chr22:17036570-17060825,24255
25985210,26086917,chr20,FAM182A,chr20:25985210-26086917,101707
17084954,17115694,chr22,IL17RA,chr22:17084954-17115694,30740
19179473,19291719,chr22,CLTCL1,chr22:19179473-19291719,112246
37951425,38121360,chr21,DSCR4,chr21:37951425-38121360,169935
33432485,33479974,chr21,TMEM50B,chr21:33432485-33479974,47489
32772100,32955437,chr21,C21orf62-AS1,chr21:32772100-32955437,183337
6511416,6590653,chr18,LINC01387,chr18:6511416-6590653,79237
31873020,32044633,chr21,HUNK,chr21:31873020-32044633,171613
18605815,18611919,chr22,RIMBP3,chr22:18605815-18611919,6104
17788974,17819386,chr21,C21orf91,chr21:17788974-17819386,30412
52340197,53535903,chr18,DCC,chr18:52340197-53535903,1195706
50560087,50731826,chr18,MAPK4,chr18:50560087-50731826,171739
45825675,45844094,chr18,SIGLEC15,chr18:45825675-45844094,18419
10637684,10673999,chr20,JAG1,chr20:10637684-10673999,36315
32790673,32813743,chr21,C21orf62,chr21:32790673-32813743,23070
3604340,3713649,chrX,PRKX,chrX:3604340-3713649,109309
38206156,38208644,chr21,DSCR10,chr21:38206156-38208644,2488
4852356,5010293,chr20,SLC23A2,chr20:4852356-5010293,157937
20946906,21111813,chr18,ROCK1,chr18:20946906-21111813,164907
10939388,10961338,chr22,FRG1FP,chr22:10939388-10961338,21950
1336616,1382689,chrX,IL3RA,chrX:1336616-1382689,46073
22900976,22901437,chr22,IGLC2,chr22:22900976-22901437,461
1462581,1537185,chrX,P2RY8,chrX:1462581-1537185,74604
12975110,12977227,chrX,TMSB4X,chrX:12975110-12977227,2117
23536881,23547797,chr22,PCAT14,chr22:23536881-23547797,10916
22887780,22896111,chr22,IGLL5,chr22:22887780-22896111,8331
1615059,1643081,chrX,ASMT,chrX:1615059-1643081,28022
22686726,22687271,chr22,IGLV3-25,chr22:22686726-22687271,545
22819010,22819756,chr22,IGLV3-9,chr22:22819010-22819756,746
22792491,22793007,chr22,IGLV2-11,chr22:22792491-22793007,516
29878636,29879363,chr20,DUX4L37,chr20:29878636-29879363,727
304529,318819,chrX,GTPBP6,chrX:304529-318819,14290
9786429,9949443,chrX,SHROOM2,chrX:9786429-9949443,163014
8528874,8732137,chrX,ANOS1,chrX:8528874-8732137,203263
1403139,1453762,chrX,ASMTL,chrX:1403139-1453762,50623
1187549,1212723,chrX,CRLF2,chrX:1187549-1212723,25174
54717860,54895516,chr18,RAB27B,chr18:54717860-54895516,177656
11111301,11123086,chrX,HCCS,chrX:11111301-11123086,11785
13389392,13638932,chr20,TASP1,chr20:13389392-13638932,249540
62325287,62391288,chr18,TNFRSF11A,chr18:62325287-62391288,66001
5840637,6228867,chrX,NLGN4X,chrX:5840637-6228867,388230
22547701,22559361,chr22,PRAME,chr22:22547701-22559361,11660
13035617,13044682,chrX,FAM9C,chrX:13035617-13044682,9065
56597209,56651600,chr18,TXNL1,chr18:56597209-56651600,54391
22880706,22881396,chr22,IGLV3-1,chr22:22880706-22881396,690
23752743,23754425,chr22,VPREB3,chr22:23752743-23754425,1682
36777447,36863538,chr20,SOGA1,chr20:36777447-36863538,86091
34627075,34657285,chrX,TMEM47,chrX:34627075-34657285,30210
50879080,50954257,chr18,ME2,chr18:50879080-50954257,75177
14244382,14244928,chrX,UBE2E4P,chrX:14244382-14244928,546
23638487,23717356,chr22,GUSBP11,chr22:23638487-23717356,78869
26103416,26114028,chr20,NCOR1P1,chr20:26103416-26114028,10612
45983536,46072272,chr18,PSTPIP2,chr18:45983536-46072272,88736
25673195,25696853,chr20,ZNF337,chr20:25673195-25696853,23658
37560480,37569405,chr22,CDC42EP1,chr22:37560480-37569405,8925
36460621,36576569,chr21,CLDN14,chr21:36460621-36576569,115948
19304593,19305625,chr13,MRPL3P1,chr13:19304593-19305625,1032
24420931,24512778,chr13,PARP4,chr13:24420931-24512778,91847
26672747,26780893,chr22,MIATNB,chr22:26672747-26780893,108146
46894624,47188844,chr20,EYA2,chr20:46894624-47188844,294220
31488688,31618588,chr22,SFI1,chr22:31488688-31618588,129900
46598604,46605208,chr21,S100B,chr21:46598604-46605208,6604
16786432,16844519,chrX,TXLNG,chrX:16786432-16844519,58087
18989307,19122637,chrX,ADGRG2,chrX:18989307-19122637,133330
24764169,24879921,chr13,RNF17,chr13:24764169-24879921,115752
46366050,46432985,chr20,ELMO2,chr20:46366050-46432985,66935
49822789,50195147,chr18,MYO5B,chr18:49822789-50195147,372358
8759077,8761335,chr21,LINC01666,chr21:8759077-8761335,2258
29194071,29630751,chr21,BACH1,chr21:29194071-29630751,436680
19267115,19268164,chr14,TOMM40P1,chr14:19267115-19268164,1049
19268853,19337730,chr14,DUXAP10,chr14:19268853-19337730,68877
28659104,28678959,chr13,POMP,chr13:28659104-28678959,19855
30202630,30307551,chr13,KATNAL1,chr13:30202630-30307551,104921
26809340,26836458,chr14,LINC02293,chr14:26809340-26836458,27118
26775495,26822107,chr14,LINC02294,chr14:26775495-26822107,46612
18253526,18270822,chr13,GGT4P,chr13:18253526-18270822,17296
19301704,19316914,chr14,BMS1P17,chr14:19301704-19316914,15210
46709649,46736347,chr20,SLC2A10,chr20:46709649-46736347,26698
40044817,40335808,chr22,TNRC6B,chr22:40044817-40335808,290991
49293394,49484297,chr20,KCNB1,chr20:49293394-49484297,190903
44745865,44752313,chr20,KCNK15,chr20:44745865-44752313,6448
38805183,38824955,chr21,ETS2,chr21:38805183-38824955,19772
30617693,30660770,chr13,USPL1,chr13:30617693-30660770,43077
49936336,49953885,chr20,RNF114,chr20:49936336-49953885,17549
30635781,30669016,chr22,SLC35E4,chr22:30635781-30669016,33235
36168217,36214588,chr13,SOHLH2,chr13:36168217-36214588,46371
47764954,47795302,chr14,LINC00648,chr14:47764954-47795302,30348
28722386,28724021,chr13,CYP51A1P2,chr13:28722386-28724021,1635
58459101,58515399,chr20,APCDD1L,chr20:58459101-58515399,56298
52857268,52952435,chr14,FERMT2,chr14:52857268-52952435,95167
46098112,46132848,chr21,COL6A2,chr21:46098112-46132848,34736
39787132,39788136,chrX,GAPDHP1,chrX:39787132-39788136,1004
29080390,29102761,chr20,FRG1DP,chr20:29080390-29102761,22371
22893692,22893818,chr22,IGLJ1,chr22:22893692-22893818,126
18239313,18354688,chrX,SCML2,chrX:18239313-18354688,115375
16946658,17153272,chrX,REPS2,chrX:16946658-17153272,206614
32043261,32113029,chr22,SLC5A1,chr22:32043261-32113029,69768
13038160,13067033,chr21,ANKRD30BP2,chr21:13038160-13067033,28873
48636165,48637135,chrX,VN1R110P,chrX:48636165-48637135,970
25452697,25585531,chr20,NINL,chr20:25452697-25585531,132834
12947133,12987536,chr18,SEH1L,chr18:12947133-12987536,40403
40648305,40735858,chrX,MED14,chrX:40648305-40735858,87553
30240453,30246759,chr22,LIF,chr22:30240453-30246759,6306
44910060,44959035,chr20,PABPC1L,chr20:44910060-44959035,48975
26598369,26806467,chr14,NOVA1-DT,chr14:26598369-26806467,208098
60016778,60017441,chr18,SINHCAFP2,chr18:60016778-60017441,663
28872191,28885371,chr21,N6AMT1,chr21:28872191-28885371,13180
59327823,59359265,chr18,LMAN1,chr18:59327823-59359265,31442
33543038,33577481,chr21,SON,chr21:33543038-33577481,34443
49699320,49792682,chr13,KPNA3,chr13:49699320-49792682,93362
45891087,46501903,chr14,LINC00871,chr14:45891087-46501903,610816
60643421,60658259,chr14,SIX1,chr14:60643421-60658259,14838
23334849,23404374,chrX,PTCHD1,chrX:23334849-23404374,69525
16719612,16765340,chrX,SYAP1,chrX:16719612-16765340,45728
64268081,64395452,chrX,MTMR8,chrX:64268081-64395452,127371
45687025,45752520,chr18,SLC14A1,chr18:45687025-45752520,65495
8208473,8208652,chr21,MIR3648-1,chr21:8208473-8208652,179
29180425,29180639,chr21,U3,chr21:29180425-29180639,214
43923792,43964488,chr22,PNPLA3,chr22:43923792-43964488,40696
35302566,35412031,chr20,UQCC1,chr20:35302566-35412031,109465
42009194,42055130,chr21,ZNF295-AS1,chr21:42009194-42055130,45936
49599994,49600572,chr14,RHOQP1,chr14:49599994-49600572,578
72204657,72239027,chrX,ERCC6L,chrX:72204657-72239027,34370
60396469,60515543,chr14,C14orf39,chr14:60396469-60515543,119074
54932961,54998534,chrX,PFKFB1,chrX:54932961-54998534,65573
41465783,41632185,chr18,KC6,chr18:41465783-41632185,166402
34787801,36004667,chr21,RUNX1,chr21:34787801-36004667,1216866
60709539,60724351,chr14,SIX4,chr14:60709539-60724351,14812
40863599,40863902,chr13,CYCSP34,chr13:40863599-40863902,303
37934298,38066444,chr13,LINC02334,chr13:37934298-38066444,132146
32496812,32497311,chr21,EXOSC3P1,chr21:32496812-32497311,499
26755200,26760786,chr13,GPR12,chr13:26755200-26760786,5586
25061924,25352190,chr18,ZNF521,chr18:25061924-25352190,290266
49853844,49890080,chr22,ZBED4,chr22:49853844-49890080,36236
26557683,26688948,chr13,WASF3,chr13:26557683-26688948,131265
46599251,46759118,chrX,SLC9A7,chrX:46599251-46759118,159867
59504539,59576812,chr14,CCDC175,chr14:59504539-59576812,72273
69775416,69797241,chr14,SLC10A1,chr14:69775416-69797241,21825
2071918,2242121,chr4,POLN,chr4:2071918-2242121,170203
14485228,14658821,chr21,SAMSN1,chr21:14485228-14658821,173593
60144119,60169856,chr14,DHRS7,chr14:60144119-60169856,25737
59267035,59274086,chr18,RAX,chr18:59267035-59274086,7051
15384799,15493564,chrX,PIR,chrX:15384799-15493564,108765
46296870,46330810,chr22,GTSE1,chr22:46296870-46330810,33940
652850,656213,chr4,PDE6B-AS1,chr4:652850-656213,3363
60639216,60642589,chr14,SALRNA1,chr14:60639216-60642589,3373
9771153,10054936,chr4,SLC2A9,chr4:9771153-10054936,283783
69569799,69574871,chr14,CCDC177,chr14:69569799-69574871,5072
61556273,61570653,chr14,LINC01303,chr14:61556273-61570653,14380
573880,576295,chr4,TMEM271,chr4:573880-576295,2415
5711201,5814305,chr4,EVC,chr4:5711201-5814305,103104
74421493,74533917,chrX,SLC16A2,chrX:74421493-74533917,112424
33358839,33401561,chr20,CDK5RAP1,chr20:33358839-33401561,42722
23197144,23437961,chr18,TMEM241,chr18:23197144-23437961,240817
56232356,56291531,chrX,KLF8,chrX:56232356-56291531,59175
70290104,70420886,chrX,KIF4A,chrX:70290104-70420886,130782
62699464,63102037,chr14,KCNH5,chr14:62699464-63102037,402573
44158740,44160076,chr21,LINC01678,chr21:44158740-44160076,1336
60971441,60981170,chr14,TRMT5,chr14:60971441-60981170,9729
77970637,77993731,chr18,LINC01029,chr18:77970637-77993731,23094
44966479,45080021,chr20,STK4,chr20:44966479-45080021,113542
9512905,9513874,chr4,OR7E83P,chr4:9512905-9513874,969
2418974,2462942,chr4,CFAP99,chr4:2418974-2462942,43968
52192159,52670578,chr20,LINC01524,chr20:52192159-52670578,478419
4859665,4863936,chr4,MSX1,chr4:4859665-4863936,4271
986997,1004564,chr4,IDUA,chr4:986997-1004564,17567
41798225,41879482,chr21,PRDM15,chr21:41798225-41879482,81257
33924227,34462774,chr14,EGLN3,chr14:33924227-34462774,538547
59936663,59940305,chr20,PPP1R3D,chr20:59936663-59940305,3642
5014586,5019458,chr4,CYTL1,chr4:5014586-5019458,4872
673580,682033,chr4,MYL5,chr4:673580-682033,8453
75278826,75282230,chr14,FOS,chr14:75278826-75282230,3404
44668547,44737681,chr22,PRR5,chr22:44668547-44737681,69134
39209116,39603528,chr13,LHFPL6,chr13:39209116-39603528,394412
73242651,73245979,chr14,PAPLN-AS1,chr14:73242651-73245979,3328
43300263,43300595,chr14,HNRNPUP1,chr14:43300263-43300595,332
6909242,7033118,chr4,TBC1D14,chr4:6909242-7033118,123876
74498183,74612378,chr14,LTBP2,chr14:74498183-74612378,114195
34546854,34560345,chr20,MAP1LC3A,chr20:34546854-34560345,13491
69831158,69961803,chr18,CD226,chr18:69831158-69961803,130645
75156388,75304885,chrX,UPRT,chrX:75156388-75304885,148497
43053191,43076943,chr21,CBS,chr21:43053191-43076943,23752
75427716,75474111,chr14,JDP2,chr14:75427716-75474111,46395
80669503,80809877,chrX,BRWD3,chrX:80669503-80809877,140374
2793071,2841098,chr4,SH3BP2,chr4:2793071-2841098,48027
92113246,92114461,chrX,EIF4A1P10,chrX:92113246-92114461,1215
54440704,54441315,chr13,RPL13AP25,chr13:54440704-54441315,611
33016423,33066143,chr13,KL,chr13:33016423-33066143,49720
75740831,75746911,chrX,TTC3P1,chrX:75740831-75746911,6080
86084716,86086339,chrX,STIP1P3,chrX:86084716-86086339,1623
95973328,95974315,chrX,KAT7P1,chrX:95973328-95974315,987
10074339,10116949,chr4,WDR1,chr4:10074339-10116949,42610
52842889,52848641,chr13,PCDH8,chr13:52842889-52848641,5752
85277396,85379717,chrX,POF1B,chrX:85277396-85379717,102321
87517409,87670050,chrX,KLHL4,chrX:87517409-87670050,152641
36034541,36079389,chr21,SETD4,chr21:36034541-36079389,44848
55074644,55075140,chr20,RPL12P4,chr20:55074644-55075140,496
72727749,72756198,chr13,BORA,chr13:72727749-72756198,28449
76427710,76431342,chrX,MAGEE1,chrX:76427710-76431342,3632
103356489,103358462,chrX,TCEAL9,chrX:103356489-103358462,1973
2462220,2625320,chr4,RNF4,chr4:2462220-2625320,163100
53949736,53958761,chr14,BMP4,chr14:53949736-53958761,9025
80014753,80031774,chrX,TBX22,chrX:80014753-80031774,17021
80571871,80574607,chrX,HK2P1,chrX:80571871-80574607,2736
5897373,6200555,chr4,C4orf50,chr4:5897373-6200555,303182
101009346,101052116,chrX,TRMT2B,chrX:101009346-101052116,42770
65279267,65281166,chr14,PTBP1P,chr14:65279267-65281166,1899
13333414,13338657,chr4,HSP90AB2P,chr4:13333414-13338657,5243
47232866,47248328,chrX,USP11,chrX:47232866-47248328,15462
40735400,40738701,chrX,MED14OS,chrX:40735400-40738701,3301
25645722,25646327,chrX,RANBP1P1,chrX:25645722-25646327,605
37453925,37623495,chr4,C4orf19,chr4:37453925-37623495,169570
55853648,55905086,chr4,EXOC1,chr4:55853648-55905086,51438
37903111,37945350,chr20,VSTM2L,chr20:37903111-37945350,42239
32268228,32279049,chr21,MIS18A,chr21:32268228-32279049,10821
32277863,32280988,chr21,MIS18A-AS1,chr21:32277863-32280988,3125
64047582,64049639,chr20,SOX18,chr20:64047582-64049639,2057
103075810,103093143,chrX,NXF3,chrX:103075810-103093143,17333
42777819,42779994,chr21,LINC01668,chr21:42777819-42779994,2175
25006230,25058980,chr20,ACSS1,chr20:25006230-25058980,52750
26576437,26756223,chr4,TBC1D19,chr4:26576437-26756223,179786
36187497,36272157,chr18,MOCOS,chr18:36187497-36272157,84660
73151241,73264480,chr18,LINC02864,chr18:73151241-73264480,113239
54475593,54651169,chr20,DOK5,chr20:54475593-54651169,175576
58515379,58619888,chr20,APCDD1L-DT,chr20:58515379-58619888,104509
108084207,108091549,chrX,PSMD10,chrX:108084207-108091549,7342
52051663,52204308,chr20,ZFP64,chr20:52051663-52204308,152645
43176994,43226598,chrX,PINCR,chrX:43176994-43226598,49604
65410592,65744121,chr14,FUT8,chr14:65410592-65744121,333529
3766348,3768526,chr4,ADRA2C,chr4:3766348-3768526,2178
1166932,1208962,chr4,SPON2,chr4:1166932-1208962,42030
48676596,48691427,chrX,WAS,chrX:48676596-48691427,14831
57168753,57266641,chr20,BMP7,chr20:57168753-57266641,97888
20251905,20620561,chr4,SLIT2,chr4:20251905-20620561,368656
70444835,70505490,chrX,DLG3,chrX:70444835-70505490,60655
45163925,45188017,chr22,NUP50,chr22:45163925-45188017,24092
52639915,52695900,chr14,ERO1A,chr14:52639915-52695900,55985
46454097,46457199,chrX,VEZTP1,chrX:46454097-46457199,3102
120210461,120212680,chrX,EEF1A1P30,chrX:120210461-120212680,2219
50309030,50327012,chr22,DENND6B,chr22:50309030-50327012,17982
69400888,69849087,chr18,DOK6,chr18:69400888-69849087,448199
120202061,120202748,chrX,SFR1P1,chrX:120202061-120202748,687
19533977,19887600,chrX,SH3KBP1,chrX:19533977-19887600,353623
45671798,45845307,chr22,ATXN10,chr22:45671798-45845307,173509
82692704,82693055,chr14,ENSAP2,chr14:82692704-82693055,351
38254000,38256093,chr14,CLEC14A,chr14:38254000-38256093,2093
71932429,72566530,chr14,RGS6,chr14:71932429-72566530,634101
23598926,23662911,chr18,ANKRD29,chr18:23598926-23662911,63985
39315707,39323218,chr21,BRWD1-AS1,chr21:39315707-39323218,7511
55420336,55427197,chr20,LINC01441,chr20:55420336-55427197,6861
45344063,45413619,chr22,SMC1B,chr22:45344063-45413619,69556
20728606,21948772,chr4,KCNIP4,chr4:20728606-21948772,1220166
34122470,34123290,chr20,RPS2P1,chr20:34122470-34123290,820
56629306,56639283,chr20,TFAP2C,chr20:56629306-56639283,9977
27977992,27981449,chrX,DCAF8L1,chrX:27977992-27981449,3457
75283503,75482169,chr13,TBC1D4,chr13:75283503-75482169,198666
126163499,126166289,chrX,DCAF12L2,chrX:126163499-126166289,2790
59430939,59697662,chr18,CCBE1,chr18:59430939-59697662,266723
119236245,119244466,chrX,PGRMC1,chrX:119236245-119244466,8221
40335333,40355217,chr4,CHRNA9,chr4:40335333-40355217,19884
64290385,64313132,chr20,LINC00266-1,chr20:64290385-64313132,22747
56647988,56681899,chr4,HOPX,chr4:56647988-56681899,33911
103252995,103255192,chrX,TCEAL8,chrX:103252995-103255192,2197
34756676,35002862,chr22,LINC02885,chr22:34756676-35002862,246186
46684410,46738252,chr22,CERK,chr22:46684410-46738252,53842
24179038,24179295,chr18,Metazoa_SRP,chr18:24179038-24179295,257
25747433,25863760,chr4,SEL1L3,chr4:25747433-25863760,116327
4792944,4885917,chr9,RCL1,chr9:4792944-4885917,92973
40010999,40847158,chr21,DSCAM,chr21:40010999-40847158,836159
56818298,56995827,chrX,SPIN3,chrX:56818298-56995827,177529
274190,689668,chr10,DIP2C,chr10:274190-689668,415478
51386957,51562831,chr20,NFATC2,chr20:51386957-51562831,175874
10439880,10457426,chr4,ZNF518B,chr4:10439880-10457426,17546
41167801,41282530,chr21,BACE2,chr21:41167801-41282530,114729
1249300,1288291,chr4,CTBP1-DT,chr4:1249300-1288291,38991
270675,305474,chr4,ZNF732,chr4:270675-305474,34799
41175231,41186788,chr21,PLAC4,chr21:41175231-41186788,11557
79360384,79367667,chrX,ITM2A,chrX:79360384-79367667,7283
38867677,38945739,chr4,FAM114A1,chr4:38867677-38945739,78062
3411608,3459978,chr18,TGIF1,chr18:3411608-3459978,48370
4542131,4787359,chr4,STX18-AS1,chr4:4542131-4787359,245228
42199689,42297244,chr21,ABCG1,chr21:42199689-42297244,97555
103376395,103378164,chrX,BEX3,chrX:103376395-103378164,1769
1177313,1737525,chr10,ADARB2,chr10:1177313-1737525,560212
22002903,22009305,chr9,CDKN2B,chr9:22002903-22009305,6402
36496128,36641939,chr4,LINC02505,chr4:36496128-36641939,145811
44492583,44498233,chr22,RTL6,chr22:44492583-44498233,5650
142202342,142205290,chrX,MAGEC2,chrX:142202342-142205290,2948
5881596,6008482,chr9,KIAA2026,chr9:5881596-6008482,126886
115718942,115719229,chrX,SUMO2P21,chrX:115718942-115719229,287
73212299,73214851,chrX,NAP1L2,chrX:73212299-73214851,2552
74405894,74426210,chr14,SYNDIG1L,chr14:74405894-74426210,20316
337814,384868,chr4,ZNF141,chr4:337814-384868,47054
73054976,73077541,chr13,KLF5,chr13:73054976-73077541,22565
13568738,13627725,chr4,BOD1L1,chr4:13568738-13627725,58987
4662294,4665258,chr9,PLPP6,chr9:4662294-4665258,2964
5510531,5571282,chr9,PDCD1LG2,chr9:5510531-5571282,60751
42371887,42396091,chr21,TMPRSS3,chr21:42371887-42396091,24204
79406293,79427317,chr13,RBM26-AS1,chr13:79406293-79427317,21024
11011748,11013096,chr9,AKAP8P1,chr9:11011748-11013096,1348
118346073,118449961,chrX,WDR44,chrX:118346073-118449961,103888
22446824,22455740,chr9,DMRTA1,chr9:22446824-22455740,8916
6350316,6352762,chr10,LINC02656,chr10:6350316-6352762,2446
94574054,94596242,chr13,TGDS,chr13:94574054-94596242,22188
33041765,33076674,chr9,SMU1,chr9:33041765-33076674,34909
13317428,13348298,chr10,SEPHS1,chr10:13317428-13348298,30870
28300346,28495145,chr13,FLT1,chr13:28300346-28495145,194799
13099449,13138308,chr10,OPTN,chr10:13099449-13138308,38859
42496008,42581440,chr21,SLC37A1,chr21:42496008-42581440,85432
3775996,3785281,chr10,KLF6,chr10:3775996-3785281,9285
15464066,15510995,chr9,PSIP1,chr9:15464066-15510995,46929
48885019,48906937,chr4,OCIAD2,chr4:48885019-48906937,21918
64073181,64079988,chr20,RGS19,chr20:64073181-64079988,6807
40423267,40630875,chr4,RBM47,chr4:40423267-40630875,207608
39223359,39244982,chr22,PDGFB,chr22:39223359-39244982,21623
64255695,64287821,chr20,PCMTD2,chr20:64255695-64287821,32126
64049836,64072347,chr20,TCEA2,chr20:64049836-64072347,22511
32886601,33025130,chr9,APTX,chr9:32886601-33025130,138529
51174550,51218333,chr18,MEX3C,chr18:51174550-51218333,43783
28772674,28789301,chr22,CCDC117,chr22:28772674-28789301,16627
37590800,37686376,chr4,RELL1,chr4:37590800-37686376,95576
38207904,38213067,chr14,SSTR1,chr14:38207904-38213067,5163
138614727,139222777,chrX,FGF13,chrX:138614727-139222777,608050
48135783,48269838,chr4,TEC,chr4:48135783-48269838,134055
55222185,55664787,chr18,TCF4,chr18:55222185-55664787,442602
137566127,137577691,chrX,ZIC3,chrX:137566127-137577691,11564
62463497,62475995,chr20,GATA5,chr20:62463497-62475995,12498
4963253,4983283,chr10,AKR1C1,chr10:4963253-4983283,20030
141838316,141897832,chrX,MAGEC3,chrX:141838316-141897832,59516
38219291,38273010,chr22,TMEM184B,chr22:38219291-38273010,53719
149774068,149776867,chrX,HSFX1,chrX:149774068-149776867,2799
149881141,149885835,chrX,MAGEA8,chrX:149881141-149885835,4694
43110750,43129712,chr22,BIK,chr22:43110750-43129712,18962
7703316,7749520,chr10,ITIH2,chr10:7703316-7749520,46204
124501,202303,chr4,ZNF718,chr4:124501-202303,77802
41256413,41268455,chr4,UCHL1,chr4:41256413-41268455,12042
15553043,16061663,chr9,CCDC171,chr9:15553043-16061663,508620
152166234,152451315,chrX,GABRA3,chrX:152166234-152451315,285081
6144934,6254644,chr10,PFKFB3,chr10:6144934-6254644,109710
104223584,104288069,chr14,LINC02691,chr14:104223584-104288069,64485
93333219,93707876,chr14,UNC79,chr14:93333219-93707876,374657
77697687,77764242,chr13,SLAIN1,chr13:77697687-77764242,66555
151563675,151676739,chrX,PASD1,chrX:151563675-151676739,113064
48490252,48494389,chr4,ZAR1,chr4:48490252-48494389,4137
131273506,131578899,chrX,IGSF1,chrX:131273506-131578899,305393
25624045,25689032,chr20,ZNF337-AS1,chr20:25624045-25689032,64987
17579066,17797124,chr9,SH3GL2,chr9:17579066-17797124,218058
36336396,36487548,chr9,RNF38,chr9:36336396-36487548,151152
33290512,33371157,chr9,NFX1,chr9:33290512-33371157,80645
6089034,6117457,chr10,RBM17,chr10:6089034-6117457,28423
34844720,34872856,chr20,GGT7,chr20:34844720-34872856,28136
63974116,63980008,chr20,SAMD10,chr20:63974116-63980008,5892
43414483,43427131,chr21,SIK1,chr21:43414483-43427131,12648
12896625,13099652,chr10,CCDC3,chr10:12896625-13099652,203027
43151547,43163242,chr22,TSPO,chr22:43151547-43163242,11695
26647986,26653454,chr10,FAM238B,chr10:26647986-26653454,5468
34466325,34466418,chr20,MIR644A,chr20:34466325-34466418,93
9493736,9498066,chr4,UNC93B7,chr4:9493736-9498066,4330
7750962,7787993,chr10,KIN,chr10:7750962-7787993,37031
153179284,153183880,chrX,MAGEA1,chrX:153179284-153183880,4596
45306840,45317824,chr20,RBPJL,chr20:45306840-45317824,10984
31122731,31134697,chr22,INPP5J,chr22:31122731-31134697,11966
47593999,47838106,chr4,CORIN,chr4:47593999-47838106,244107
5861616,5889906,chr10,ANKRD16,chr10:5861616-5889906,28290
141903894,141909374,chrX,MAGEC1,chrX:141903894-141909374,5480
154835788,155026940,chrX,F8,chrX:154835788-155026940,191152
11920022,12043170,chr10,UPF2,chr10:11920022-12043170,123148
44217014,44240966,chr21,ICOSLG,chr21:44217014-44240966,23952
148500617,149000663,chrX,AFF2,chrX:148500617-149000663,500046
58634772,58635738,chr20,LINC01711,chr20:58634772-58635738,966
58651253,58679526,chr20,STX16,chr20:58651253-58679526,28273
5943639,5978187,chr10,IL15RA,chr10:5943639-5978187,34548
44285838,44298648,chr21,AIRE,chr21:44285838-44298648,12810
49210422,49212294,chr13,OGFOD1P1,chr13:49210422-49212294,1872
103215108,103217246,chrX,BEX4,chrX:103215108-103217246,2138
39822863,39977956,chr4,PDS5A,chr4:39822863-39977956,155093
97953658,98024296,chr13,IPO5,chr13:97953658-98024296,70638
136213220,136256482,chrX,MAP7D3,chrX:136213220-136256482,43262
121047610,121050094,chrX,GLUD2,chrX:121047610-121050094,2484
134887632,134915257,chrX,MOSPD1,chrX:134887632-134915257,27625
106802673,106876150,chrX,TBC1D8B,chrX:106802673-106876150,73477
14878820,14904315,chr10,SUV39H2,chr10:14878820-14904315,25495
58689131,58719238,chr20,NPEPL1,chr20:58689131-58719238,30107
106813871,107000212,chrX,MORC4,chrX:106813871-107000212,186341
15097180,15139818,chr10,RPP38,chr10:15097180-15139818,42638
59665583,60163928,chr13,DIAPH3,chr13:59665583-60163928,498345
41092592,41180077,chr22,EP300,chr22:41092592-41180077,87485
52314305,52328598,chr14,PTGER2,chr14:52314305-52328598,14293
155197007,155239841,chrX,VBP1,chrX:155197007-155239841,42834
44768580,44801826,chr21,UBE2G2,chr21:44768580-44801826,33246
58818226,58818313,chr20,MIR298,chr20:58818226-58818313,87
115003975,115019977,chrX,IL13RA2,chrX:115003975-115019977,16002
31346777,31348719,chr22,LINC01521,chr22:31346777-31348719,1942
41207592,41228500,chr22,L3MBTL2-AS1,chr22:41207592-41228500,20908
40951347,40973309,chr22,RBX1,chr22:40951347-40973309,21962
25647261,25649232,chr22,YES1P1,chr22:25647261-25649232,1971
31134807,31140508,chr22,PLA2G3,chr22:31134807-31140508,5701
59019429,59026654,chr20,TUBB1,chr20:59019429-59026654,7225
99169287,99272197,chr14,BCL11B,chr14:99169287-99272197,102910
18659431,18681639,chr10,ARL5B,chr10:18659431-18681639,22208
72127110,72131901,chrX,RTL5,chrX:72127110-72131901,4791
16823966,17129811,chr10,CUBN,chr10:16823966-17129811,305845
77895481,77975529,chr13,EDNRB,chr13:77895481-77975529,80048
46039907,46044853,chr22,LINC00899,chr22:46039907-46044853,4946
44243665,44312951,chr22,SHISAL1,chr22:44243665-44312951,69286
93670930,93673578,chrX,NAP1L3,chrX:93670930-93673578,2648
150980509,150990771,chrX,HMGB3,chrX:150980509-150990771,10262
28883572,29057488,chr22,ZNRF3,chr22:28883572-29057488,173916
44989864,44994086,chr21,LINC00163,chr21:44989864-44994086,4222
75620434,75859870,chr13,LMO7,chr13:75620434-75859870,239436
118727133,118794535,chrX,IL13RA1,chrX:118727133-118794535,67402
17137336,17202054,chr10,TRDMT1,chr10:17137336-17202054,64718
45234308,45264548,chr21,LINC00334,chr21:45234308-45264548,30240
114584078,114910061,chrX,HTR2C,chrX:114584078-114910061,325983
16513734,16521879,chr10,C1QL3,chr10:16513734-16521879,8145
13546075,13547801,chr4,LINC01096,chr4:13546075-13547801,1726
90453571,90490763,chr14,LINC00642,chr14:90453571-90490763,37192
21383374,21389478,chr22,RIMBP3B,chr22:21383374-21389478,6104
103733195,103847575,chr14,PPP1R13B,chr14:103733195-103847575,114380
47483571,47484823,chrX,LINC01560,chrX:47483571-47484823,1252
41359607,41700044,chr4,LIMCH1,chr4:41359607-41700044,340437
15095385,15097319,chr10,RPP38-DT,chr10:15095385-15097319,1934
22922594,22923034,chr22,IGLC7,chr22:22922594-22923034,440
41205282,41231271,chr22,L3MBTL2,chr22:41205282-41231271,25989
74722495,74888094,chr9,TRPM6,chr9:74722495-74888094,165599
37469063,37486393,chr22,MFNG,chr22:37469063-37486393,17330
36876121,36894235,chr20,TLDC2,chr20:36876121-36894235,18114
44106590,44187188,chr20,JPH2,chr20:44106590-44187188,80598
32205115,32278382,chr22,SLC5A4-AS1,chr22:32205115-32278382,73267
40555667,40666641,chr13,FOXO1,chr13:40555667-40666641,110974
96256210,96268967,chr14,BDKRB1,chr14:96256210-96268967,12757
71533104,71575892,chrX,OGT,chrX:71533104-71575892,42788
93718298,93788485,chr14,PRIMA1,chr14:93718298-93788485,70187
7477045,7478320,chr9,RPL4P5,chr9:7477045-7478320,1275
16748358,16770062,chr20,OTOR,chr20:16748358-16770062,21704
18587942,18766644,chr20,DTD1,chr20:18587942-18766644,178702
46188141,46228824,chr21,LSS,chr21:46188141-46228824,40683
71615916,71618511,chrX,CXCR3,chrX:71615916-71618511,2595
26491225,26512505,chr22,TFIP11,chr22:26491225-26512505,21280
81689911,81691072,chr13,PTMAP5,chr13:81689911-81691072,1161
27672874,27746060,chr10,MKX,chr10:27672874-27746060,73186
42475480,42495337,chr10,LINC00839,chr10:42475480-42495337,19857
391752,411443,chr6,IRF4,chr6:391752-411443,19691
46229196,46259390,chr21,MCM3AP-AS1,chr21:46229196-46259390,30194
27775186,27999079,chr10,ODAD2,chr10:27775186-27999079,223893
55776727,55781722,chr18,LINC01415,chr18:55776727-55781722,4995
15513954,15719922,chr10,ITGA8,chr10:15513954-15719922,205968
26687621,26703638,chr18,PCAT18,chr18:26687621-26703638,16017
45073853,45226560,chr21,ADARB1,chr21:45073853-45226560,152707
37204237,37212477,chr22,SSTR3,chr22:37204237-37212477,8240
95650498,95679833,chr14,TCL6,chr14:95650498-95679833,29335
11537749,11583524,chr6,TMEM170B,chr6:11537749-11583524,45775
57435374,57491298,chr18,ONECUT2,chr18:57435374-57491298,55924
22133205,22147193,chr6,NBAT1,chr6:22133205-22147193,13988
65287914,65323015,chr9,CBWD4P,chr9:65287914-65323015,35101
104137150,104137898,chr14,KIF26A-DT,chr14:104137150-104137898,748
21485896,21521414,chr6,LINC00581,chr6:21485896-21521414,35518
32979560,32980403,chr9,TCEA1P4,chr9:32979560-32980403,843
24976419,24976982,chr6,PPIAP29,chr6:24976419-24976982,563
57646426,57803315,chr18,ATP8B1,chr18:57646426-57803315,156889
77716097,78031811,chr9,GNAQ,chr9:77716097-78031811,315714
34446688,34512214,chr21,KCNE1,chr21:34446688-34512214,65526
7726099,7881728,chr6,BMP6,chr6:7726099-7881728,155629
45981770,46005050,chr21,COL6A1,chr21:45981770-46005050,23280
58481247,58629091,chr18,ALPK2,chr18:58481247-58629091,147844
7881517,7910788,chr6,TXNDC5,chr6:7881517-7910788,29271
58671465,58754477,chr18,MALT1,chr18:58671465-58754477,83012
63102205,63104386,chr20,HAR1A,chr20:63102205-63104386,2181
33025935,33029196,chr21,OLIG2,chr21:33025935-33029196,3261
92703807,92748679,chr14,LGMN,chr14:92703807-92748679,44872
44997698,45000888,chr10,ZNF22-AS1,chr10:44997698-45000888,3190
63240784,63272694,chr20,NKAIN4,chr20:63240784-63272694,31910
24848614,24952606,chr10,PRTFDC1,chr10:24848614-24952606,103992
12698554,12814377,chr9,LURAP1L-AS1,chr9:12698554-12814377,115823
24417879,24442357,chr22,ADORA2A,chr22:24417879-24442357,24478
25648011,25678748,chr4,SLC34A2,chr4:25648011-25678748,30737
14897359,14954432,chr10,DCLRE1C,chr10:14897359-14954432,57073
24429206,24495074,chr22,ADORA2A-AS1,chr22:24429206-24495074,65868
83623049,83644130,chr9,IDNK,chr9:83623049-83644130,21081
24494107,24528390,chr22,UPB1,chr22:24494107-24528390,34283
99481169,99535044,chr14,CCNK,chr14:99481169-99535044,53875
82979590,83063177,chr9,RASEF,chr9:82979590-83063177,83587
75060573,75088217,chr9,NMRK1,chr9:75060573-75088217,27644
24585620,24593208,chr22,LRRC75B,chr22:24585620-24593208,7588
64914281,65024485,chr4,LINC02232,chr4:64914281-65024485,110204
37485948,37503697,chr9,POLR1E,chr9:37485948-37503697,17749
103822327,103832257,chrX,RAB9B,chrX:103822327-103832257,9930
85792790,85806683,chr13,SLITRK6,chr13:85792790-85806683,13893
45680184,45701184,chr13,LINC01055,chr13:45680184-45701184,21000
89005771,89178818,chr9,SHC3,chr9:89005771-89178818,173047
104937244,104978374,chr14,AHNAK2,chr14:104937244-104978374,41130
44173903,44448809,chr4,KCTD8,chr4:44173903-44448809,274906
76691980,76863307,chr9,PCA3,chr9:76691980-76863307,171327
77963940,77964511,chr4,HMGB1P44,chr4:77963940-77964511,571
63343223,63378401,chr20,CHRNA4,chr20:63343223-63378401,35178
75940950,75990962,chr4,SDAD1,chr4:75940950-75990962,50012
46667821,46759257,chr18,ST8SIA5,chr18:46667821-46759257,91436
34513142,34615113,chr21,RCAN1,chr21:34513142-34615113,101971
86287733,86354454,chr9,TUT7,chr9:86287733-86354454,66721
18195297,18232024,chr13,FAM230C,chr13:18195297-18232024,36727
48489553,48850912,chr22,TAFA5,chr22:48489553-48850912,361359
29934101,29934286,chr6,HLA-U,chr6:29934101-29934286,185
23694746,24547848,chr10,KIAA1217,chr10:23694746-24547848,853102
13357830,13487662,chr6,GFOD1,chr6:13357830-13487662,129832
21759657,21867680,chr22,MAPK1,chr22:21759657-21867680,108023
29926459,29929232,chr6,HLA-K,chr6:29926459-29929232,2773
98972879,98973301,chr14,RPL3P4,chr14:98972879-98973301,422
101561351,101563452,chr14,DIO3,chr14:101561351-101563452,2101
106335082,106335613,chr14,IGHV3-30,chr14:106335082-106335613,531
91232532,91253925,chr14,GPR68,chr14:91232532-91253925,21393
63528001,63537376,chr20,PTK6,chr20:63528001-63537376,9375
105703995,105708665,chr14,IGHA1,chr14:105703995-105708665,4670
101730437,101732522,chr14,LINC00239,chr14:101730437-101732522,2085
10980759,11044305,chr6,ELOVL2,chr6:10980759-11044305,63546
90061994,90185853,chr14,KCNK13,chr14:90061994-90185853,123859
107788342,107835451,chr13,NALF1-IT1,chr13:107788342-107835451,47109
19422877,19536762,chr13,TPTE2,chr13:19422877-19536762,113885
6346465,6622771,chr6,LY86-AS1,chr6:6346465-6622771,276306
72351413,72365235,chr9,ZFAND5,chr9:72351413-72365235,13822
29925983,29926973,chr6,HCG4B,chr6:29925983-29926973,990
958887,986895,chr4,DGKQ,chr4:958887-986895,28008
12290361,12297194,chr6,EDN1,chr6:12290361-12297194,6833
29975112,29978410,chr6,HCG9,chr6:29975112-29978410,3298
58862600,58986480,chr18,ZNF532,chr18:58862600-58986480,123880
29970801,29972464,chr6,MICD,chr6:29970801-29972464,1663
85941146,86025462,chr9,NAA35,chr9:85941146-86025462,84316
46734827,46909245,chr4,COX7B2,chr4:46734827-46909245,174418
12867072,12890361,chrX,TLR7,chrX:12867072-12890361,23289
76435229,76783253,chr4,SHROOM3,chr4:76435229-76783253,348024
49477243,49487252,chr18,C18orf32,chr18:49477243-49487252,10009
44016700,44022063,chr4,LINC02475,chr4:44016700-44022063,5363
62856999,62898095,chr9,LERFS,chr9:62856999-62898095,41096
38664197,38701517,chr4,KLF3,chr4:38664197-38701517,37320
20534457,21232404,chr6,CDKAL1,chr6:20534457-21232404,697947
19837370,19842197,chr6,ID4,chr6:19837370-19842197,4827
17737449,17754988,chrX,SCML1,chrX:17737449-17754988,17539
25742144,26031045,chr22,MYO18B,chr22:25742144-26031045,288901
62860873,62864957,chr9,ADGRF5P1,chr9:62860873-62864957,4084
70217195,70217668,chr9,RPL24P8,chr9:70217195-70217668,473
109752695,109786583,chr13,IRS2,chr13:109752695-109786583,33888
114234887,114272723,chr13,CDC16,chr13:114234887-114272723,37836
91159573,91166272,chr9,LINC00484,chr9:91159573-91166272,6699
83242990,83538546,chr9,FRMD3,chr9:83242990-83538546,295556
31805398,31928876,chr10,ARHGAP12,chr10:31805398-31928876,123478
5542772,5709548,chr4,EVC2,chr4:5542772-5709548,166776
153334147,153360110,chrX,ZNF275,chrX:153334147-153360110,25963
74946583,74952912,chr9,C9orf40,chr9:74946583-74952912,6329
35226690,35276998,chr20,MMP24,chr20:35226690-35276998,50308
82352498,82374503,chr4,HNRNPD,chr4:82352498-82374503,22005
95433604,95579759,chr13,CLDN10,chr13:95433604-95579759,146155
30925130,30968774,chr22,MORC2,chr22:30925130-30968774,43644
58334979,58370751,chr10,UBE2D1,chr10:58334979-58370751,35772
97926791,97944856,chr9,HEMGN,chr9:97926791-97944856,18065
39745183,39802081,chr21,IGSF5,chr21:39745183-39802081,56898
114314482,114337626,chr13,CHAMP1,chr13:114314482-114337626,23144
82909973,83012926,chr4,LIN54,chr4:82909973-83012926,102953
83659968,83707958,chr9,UBQLN1,chr9:83659968-83707958,47990
6667865,7148158,chrX,PUDP,chrX:6667865-7148158,480293
44676927,44679717,chr18,SETBP1-DT,chr18:44676927-44679717,2790
2608328,2699994,chr11,KCNQ1OT1,chr11:2608328-2699994,91666
2129112,2141238,chr11,IGF2,chr11:2129112-2141238,12126
6444869,6468040,chr21,CBSL,chr21:6444869-6468040,23171
53459301,53701405,chr4,LNX1,chr4:53459301-53701405,242104
63743668,63832038,chr20,ZBTB46,chr20:63743668-63832038,88370
130171962,130184870,chrX,RAB33A,chrX:130171962-130184870,12908
110878540,110915069,chr13,ANKRD10,chr13:110878540-110915069,36529
19816239,20289856,chr10,PLXDC2,chr10:19816239-20289856,473617
33915534,33977703,chr21,LINC00649,chr21:33915534-33977703,62169
10886831,10979320,chr6,SYCP2L,chr6:10886831-10979320,92489
91409045,91423832,chr9,NFIL3,chr9:91409045-91423832,14787
98943179,99070792,chr9,COL15A1,chr9:98943179-99070792,127613
16590611,16817463,chr10,RSU1,chr10:16590611-16817463,226852
67558727,67607337,chr4,STAP1,chr4:67558727-67607337,48610
17611708,17633199,chr21,BTG3-AS1,chr21:17611708-17633199,21491
113158648,113172386,chr13,PROZ,chr13:113158648-113172386,13738
105694541,105776629,chr9,TMEM38B,chr9:105694541-105776629,82088
42380407,42432403,chr22,NFAM1,chr22:42380407-42432403,51996
61330717,61453030,chr9,CNTNAP3C,chr9:61330717-61453030,122313
30012803,30115494,chr10,JCAD,chr10:30012803-30115494,102691
38426327,38455199,chr22,KCNJ4,chr22:38426327-38455199,28872
2400488,2403878,chr11,TSSC4,chr11:2400488-2403878,3390
75397830,75401764,chr10,ZNF503,chr10:75397830-75401764,3934
30720415,31146805,chr4,PCDH7,chr4:30720415-31146805,426390
38818452,38844028,chr22,NPTXR,chr22:38818452-38844028,25576
22345445,22454224,chr10,SPAG6,chr10:22345445-22454224,108779
2140501,2148666,chr11,IGF2-AS,chr11:2140501-2148666,8165
2335135,2347685,chr11,RPL26P30,chr11:2335135-2347685,12550
2444684,2849105,chr11,KCNQ1,chr11:2444684-2849105,404421
9692495,9702954,chr4,FAM86MP,chr4:9692495-9702954,10459
109498325,110172512,chr9,PALM2AKAP2,chr9:109498325-110172512,674187
38982347,38992804,chr22,APOBEC3B,chr22:38982347-38992804,10457
9546791,9615240,chr18,PPP4R1,chr18:9546791-9615240,68449
45454585,45594906,chr10,MARCHF8,chr10:45454585-45594906,140321
78179185,78551355,chr10,LINC00595,chr10:78179185-78551355,372170
14236206,14362754,chr21,ABCC13,chr21:14236206-14362754,126548
6926404,7001004,chr11,ZNF215,chr11:6926404-7001004,74600
6320578,6563600,chr4,PPP2R2C,chr4:6320578-6563600,243022
68560337,68694487,chr10,TET1,chr10:68560337-68694487,134150
68705240,69009176,chr9,PIP5K1B,chr9:68705240-69009176,303936
10409340,10416446,chr6,TFAP2A-AS1,chr6:10409340-10416446,7106
32009015,32056425,chr10,KIF5B,chr10:32009015-32056425,47410
14904997,15082342,chr11,CALCB,chr11:14904997-15082342,177345
35406755,35483035,chr9,ATP8B5P,chr9:35406755-35483035,76280
39457012,39492194,chr22,MGAT3,chr22:39457012-39492194,35182
98731329,98796965,chr9,ANKS6,chr9:98731329-98796965,65636
15102584,15168693,chr10,NMT2,chr10:15102584-15168693,66109
52775193,52791668,chr14,GNPNAT1,chr14:52775193-52791668,16475
127087348,127122635,chr9,ANGPTL2,chr9:127087348-127122635,35287
15345596,15384413,chrX,VEGFD,chrX:15345596-15384413,38817
876554,896436,chr7,GET4,chr7:876554-896436,19882
68721012,68792377,chr10,CCAR1,chr10:68721012-68792377,71365
19117099,19176422,chr11,ZDHHC13,chr11:19117099-19176422,59323
44801883,44804717,chr21,LINC01424,chr21:44801883-44804717,2834
112750760,112881671,chr9,SNX30,chr9:112750760-112881671,130911
22547506,22552156,chr14,TRAC,chr14:22547506-22552156,4650
16129086,16148248,chr6,MYLIP,chr6:16129086-16148248,19162
153642492,153651326,chrX,DUSP9,chrX:153642492-153651326,8834
3208868,3223870,chr20,ITPA,chr20:3208868-3223870,15002
153669733,153689010,chrX,PNCK,chrX:153669733-153689010,19277
32829927,32858120,chr11,PRRG4,chr11:32829927-32858120,28193
76822557,76972901,chr18,ZNF236,chr18:76822557-76972901,150344
17777322,17779481,chr22,LINC00528,chr22:17777322-17779481,2159
1152071,1160759,chr7,ZFAND2A,chr7:1152071-1160759,8688
16613132,16758340,chr11,C11orf58,chr11:16613132-16758340,145208
90838903,90839037,chr4,TMSB4XP8,chr4:90838903-90839037,134
31829197,31953136,chr18,TRAPPC8,chr18:31829197-31953136,123939
75401519,75408982,chr10,ZNF503-AS2,chr10:75401519-75408982,7463
153724856,153744755,chrX,ABCD1,chrX:153724856-153744755,19899
56357227,56361273,chr10,ZWINT,chr10:56357227-56361273,4046
31819308,31834689,chr20,MYLK2,chr20:31819308-31834689,15381
22606022,22617854,chr15,GOLGA8IP,chr15:22606022-22617854,11832
192571,260772,chr7,FAM20C,chr7:192571-260772,68201
31664452,31723989,chr20,BCL2L1,chr20:31664452-31723989,59537
4682295,4771442,chr7,FOXK1,chr7:4682295-4771442,89147
30323104,30338223,chr11,ARL14EP,chr11:30323104-30338223,15119
75431624,76560168,chr10,LRMDA,chr10:75431624-76560168,1128544
21114723,21115197,chr20,RPL24P2,chr20:21114723-21115197,474
17788048,18013047,chr11,SERGEF,chr11:17788048-18013047,224999
21125983,21246622,chr20,KIZ,chr20:21125983-21246622,120639
7041899,7057952,chr4,TADA2B,chr4:7041899-7057952,16053
63465229,63466563,chr10,JMJD1C-AS1,chr10:63465229-63466563,1334
68715209,69055189,chr18,CCDC102B,chr18:68715209-69055189,339980
45000923,45005326,chr10,ZNF22,chr10:45000923-45005326,4403
99397024,99906605,chr9,STX17-DT,chr9:99397024-99906605,509581
70043848,70226972,chr9,MAMDC2,chr9:70043848-70226972,183124
153861514,153886173,chrX,L1CAM,chrX:153861514-153886173,24659
34438934,34472060,chr11,CAT,chr11:34438934-34472060,33126
107283137,107332192,chr9,RAD23B,chr9:107283137-107332192,49055
26866911,26949208,chr15,GABRA5,chr15:26866911-26949208,82297
9505180,9514998,chr20,LAMP5-AS1,chr20:9505180-9514998,9818
98069275,98119222,chr9,TRIM14,chr9:98069275-98119222,49947
9514358,9530524,chr20,LAMP5,chr20:9514358-9530524,16166
32583798,32606264,chr11,EIF3M,chr11:32583798-32606264,22466
36740775,36839444,chr6,CPNE5,chr6:36740775-36839444,98669
9460319,9528524,chr11,ZNF143,chr11:9460319-9528524,68205
1266280,1309328,chr20,SNPH,chr20:1266280-1309328,43048
126613928,126701032,chr9,LMX1B,chr9:126613928-126701032,87104
24978583,25420336,chr15,SNHG14,chr15:24978583-25420336,441753
87497228,87708634,chr9,DAPK1,chr9:87497228-87708634,211406
46576012,46679790,chr22,GRAMD4,chr22:46576012-46679790,103778
153907367,153934999,chrX,ARHGAP4,chrX:153907367-153934999,27632
45841721,45857405,chr20,ACOT8,chr20:45841721-45857405,15684
11183298,11382348,chr6,NEDD9,chr6:11183298-11382348,199050
2755705,3037741,chr17,RAP1GAP2,chr17:2755705-3037741,282036
77779723,77844145,chr13,EDNRB-AS1,chr13:77779723-77844145,64422
99948086,99950355,chr4,H2AZ1,chr4:99948086-99950355,2269
20156155,20160475,chr11,DBX1,chr11:20156155-20160475,4320
33256672,33357023,chr11,HIPK3,chr11:33256672-33357023,100351
9703754,9710812,chr4,ALG1L3P,chr4:9703754-9710812,7058
45857614,45879122,chr20,ZSWIM3,chr20:45857614-45879122,21508
77862830,77952785,chr4,MRPL1,chr4:77862830-77952785,89955
106041599,106316683,chr4,TBCK,chr4:106041599-106316683,275084
153929225,153935080,chrX,NAA10,chrX:153929225-153935080,5855
46008908,46016561,chr20,MMP9,chr20:46008908-46016561,7653
80407829,80437115,chr10,PRXL2A,chr10:80407829-80437115,29286
46013500,46022073,chr20,SLC12A5-AS1,chr20:46013500-46022073,8573
16777297,17014414,chr11,PLEKHA7,chr11:16777297-17014414,237117
129612225,129620776,chr9,C9orf50,chr9:129612225-129620776,8551
112894378,113099742,chr13,MCF2L,chr13:112894378-113099742,205364
3227417,3239559,chr20,SLC4A11,chr20:3227417-3239559,12142
153947557,153971818,chrX,HCFC1,chrX:153947557-153971818,24261
34051731,34102610,chr11,CAPRIN1,chr11:34051731-34102610,50879
8113184,8262687,chr7,ICA1,chr7:8113184-8262687,149503
107590276,107720234,chr4,PAPSS1,chr4:107590276-107720234,129958
101028727,101325135,chr9,PLPPR1,chr9:101028727-101325135,296408
153969325,153970087,chrX,HCFC1-AS1,chrX:153969325-153970087,762
23295652,23302859,chr14,PPP1R3E,chr14:23295652-23302859,7207
87504875,87553461,chr10,MINPP1,chr10:87504875-87553461,48586
43311963,43344529,chr11,API5,chr11:43311963-43344529,32566
58385345,58399220,chr10,TFAM,chr10:58385345-58399220,13875
7636518,7718607,chr7,RPA3,chr7:7636518-7718607,82089
142789,181650,chr17,DOC2B,chr17:142789-181650,38861
11820317,11821294,chr7,THRAP3P3,chr7:11820317-11821294,977
7958183,7969903,chr7,GLCCI1-DT,chr7:7958183-7969903,11720
91807179,91807439,chr10,SRP9P1,chr10:91807179-91807439,260
71212570,71302864,chr10,UNC5B,chr10:71212570-71302864,90294
6031376,6036552,chr7,ANKRD61,chr7:6031376-6036552,5176
3860315,3894891,chr17,CAMKK1,chr17:3860315-3894891,34576
43307134,43369647,chr6,ZNF318,chr6:43307134-43369647,62513
22727104,22744918,chr15,PDCD6IPP1,chr15:22727104-22744918,17814
76708853,76802426,chr4,SHROOM3-AS1,chr4:76708853-76802426,93573
91628442,91633071,chr10,PPP1R3C,chr10:91628442-91633071,4629
35618460,35620865,chr11,FJX1,chr11:35618460-35620865,2405
78033760,78056813,chr10,RPS24,chr10:78033760-78056813,23053
3896592,3916476,chr17,P2RX1,chr17:3896592-3916476,19884
71043214,71045470,chrX,SOCS5P4,chrX:71043214-71045470,2256
410325,431062,chr17,C17orf97,chr17:410325-431062,20737
74744759,74794523,chr4,BTC,chr4:74744759-74794523,49764
6451263,6556555,chr17,PITPNM3,chr17:6451263-6556555,105292
44809317,45377953,chr6,SUPT3H,chr6:44809317-45377953,568636
87341685,87357882,chr10,LINC00863,chr10:87341685-87357882,16197
59788747,59906556,chr10,CCDC6,chr10:59788747-59906556,117809
46476972,46657220,chr18,LOXHD1,chr18:46476972-46657220,180248
77790791,77926755,chr10,DLG5,chr10:77790791-77926755,135964
49430360,49463253,chr6,MMUT,chr6:49430360-49463253,32893
23559565,23568070,chr14,AP1G2,chr14:23559565-23568070,8505
13668668,13732346,chr11,FAR1,chr11:13668668-13732346,63678
74732856,74925472,chrX,NEXMIF,chrX:74732856-74925472,192616
19502672,19507229,chr11,NAV2-AS5,chr11:19502672-19507229,4557
76419850,76651203,chr9,GCNT1,chr9:76419850-76651203,231353
107628428,107651993,chrX,PRPS1,chrX:107628428-107651993,23565
67544021,67730619,chrX,AR,chrX:67544021-67730619,186598
93306429,93482334,chr10,MYOF,chr10:93306429-93482334,175905
75890644,76362975,chr9,PCSK5,chr9:75890644-76362975,472331
14117256,14136918,chr6,CD83,chr6:14117256-14136918,19662
113977783,114132623,chr13,RASA3,chr13:113977783-114132623,154840
38628005,39180499,chr15,LINC02694,chr15:38628005-39180499,552494
37257772,37332970,chr6,TBC1D22B,chr6:37257772-37332970,75198
41459717,41468692,chr22,PHF5A,chr22:41459717-41468692,8975
34978341,34988287,chr15,ZNF770,chr15:34978341-34988287,9946
38139595,38226897,chr15,LINC02895,chr15:38139595-38226897,87302
42782795,42834937,chr10,BMS1,chr10:42782795-42834937,52142
150231075,150232896,chrX,XRCC6P2,chrX:150231075-150232896,1821
6651762,6693202,chr17,C17orf100,chr17:6651762-6693202,41440
12570577,12660182,chr7,SCIN,chr7:12570577-12660182,89605
117083554,117085576,chr4,TRAM1L1,chr4:117083554-117085576,2022
37353979,37394734,chr6,RNF8,chr6:37353979-37394734,40755
41561010,41577741,chr22,CSDC2,chr22:41561010-41577741,16731
92689955,92695647,chr10,HHEX,chr10:92689955-92695647,5692
84328586,84518521,chr10,CCSER2,chr10:84328586-84518521,189935
23953734,23969279,chr14,DHRS4,chr14:23953734-23969279,15545
39581079,39599466,chr15,THBS1,chr15:39581079-39599466,18387
103675496,103688158,chrX,MORF4L2,chrX:103675496-103688158,12662
45328157,45664349,chr6,RUNX2,chr6:45328157-45664349,336192
5126879,5197887,chr20,CDS2,chr20:5126879-5197887,71008
129634604,129642169,chr9,ASB6,chr9:129634604-129642169,7565
34851782,34969742,chr15,AQR,chr15:34851782-34969742,117960
86944362,86947506,chr9,GAS1,chr9:86944362-86947506,3144
98120975,98192637,chr9,CORO2A,chr9:98120975-98192637,71662
104099214,104157009,chrX,SLC25A53,chrX:104099214-104157009,57795
5292388,5292831,chr20,UBE2D3P1,chr20:5292388-5292831,443
88273864,88584530,chr10,RNLS,chr10:88273864-88584530,310666
49174802,49186528,chrX,PRICKLE3,chrX:49174802-49186528,11726
92947523,93036236,chr9,FGD3,chr9:92947523-93036236,88713
24284188,24291862,chr7,NPY,chr7:24284188-24291862,7674
33721662,33746905,chr6,IP6K3,chr6:33721662-33746905,25243
30820207,31031937,chr10,ZNF438,chr10:30820207-31031937,211730
95709947,95714196,chr14,TCL1A,chr14:95709947-95714196,4249
1044546,1059261,chr7,GPR146,chr7:1044546-1059261,14715
78867551,78946440,chr6,IRAK1BP1,chr6:78867551-78946440,78889
13891229,13991425,chr7,ETV1,chr7:13891229-13991425,100196
96364608,96513926,chr10,TLL2,chr10:96364608-96513926,149318
7796500,7888380,chr9,DMAC1,chr9:7796500-7888380,91880
63133247,63155031,chr10,NRBF2,chr10:63133247-63155031,21784
280057,389320,chr12,KDM5A,chr12:280057-389320,109263
5078467,5096374,chr17,ZFP3,chr17:5078467-5096374,17907
94762681,94855547,chr10,CYP2C19,chr10:94762681-94855547,92866
42830337,42950827,chr9,ANKRD20A7P,chr9:42830337-42950827,120490
84965534,85011277,chr4,WDFY3-AS2,chr4:84965534-85011277,45743
104094260,104141419,chr9,SMC2,chr9:104094260-104141419,47159
9537370,9839076,chr20,PAK5,chr20:9537370-9839076,301706
49269793,49301461,chrX,PPP1R3F,chrX:49269793-49301461,31668
49220338,49222377,chr13,MLNR,chr13:49220338-49222377,2039
28995235,29195451,chr7,CPVL,chr7:28995235-29195451,200216
27506830,27698231,chr11,BDNF-AS,chr11:27506830-27698231,191401
91798426,91865475,chr10,TNKS2,chr10:91798426-91865475,67049
58985686,59008238,chr20,CTSZ,chr20:58985686-59008238,22552
4487735,4538508,chr12,C12orf4,chr12:4487735-4538508,50773
121035613,121073021,chr4,NDNF,chr4:121035613-121073021,37408
93058688,93085133,chr9,SUSD3,chr9:93058688-93085133,26445
13217498,13652755,chr18,LDLRAD4,chr18:13217498-13652755,435257
897900,955407,chr7,ADAP1,chr7:897900-955407,57507
106541673,106568137,chr13,ARGLU1,chr13:106541673-106568137,26464
77800109,77935014,chr14,ADCK1,chr14:77800109-77935014,134905
41028822,41124487,chr20,TOP1,chr20:41028822-41124487,95665
70856679,70957060,chr6,B3GAT2,chr6:70856679-70957060,100381
33851100,34224952,chr18,NOL4,chr18:33851100-34224952,373852
39104063,39115186,chr6,SAYSD1,chr6:39104063-39115186,11123
102885048,103019719,chr4,SLC9B1,chr4:102885048-103019719,134671
5032600,5052009,chr17,SLC52A1,chr17:5032600-5052009,19409
12791355,12824222,chrX,PRPS2,chrX:12791355-12824222,32867
50857891,50944483,chr14,PYGL,chr14:50857891-50944483,86592
27754875,28099315,chr15,OCA2,chr15:27754875-28099315,344440
96593315,96720514,chr10,PIK3AP1,chr10:96593315-96720514,127199
35668052,35699355,chr20,NFS1,chr20:35668052-35699355,31303
5392381,5630700,chr18,EPB41L3,chr18:5392381-5630700,238319
26438341,26567803,chr10,APBB1IP,chr10:26438341-26567803,129462
39934115,40035591,chr15,EIF2AK4,chr15:39934115-40035591,101476
77780337,77781876,chr10,IMPDH1P5,chr10:77780337-77781876,1539
121338987,121370304,chr9,STOM,chr9:121338987-121370304,31317
51615299,52087613,chr6,PKHD1,chr6:51615299-52087613,472314
74824927,75032624,chr10,KAT6B,chr10:74824927-75032624,207697
90801787,90898549,chr9,SYK,chr9:90801787-90898549,96762
2876258,2889524,chr12,RHNO1,chr12:2876258-2889524,13266
95099054,95426796,chr9,FANCC,chr9:95099054-95426796,327742
82818509,82901166,chr4,SEC31A,chr4:82818509-82901166,82657
212389,386254,chr17,RPH3AL,chr17:212389-386254,173865
42781550,42791549,chr13,FAM216B,chr13:42781550-42791549,9999
220621,262873,chr12,SLC6A13,chr12:220621-262873,42252
44219553,44234142,chr6,SLC29A1,chr6:44219553-44234142,14589
114346167,114346637,chr13,RPL23AP97,chr13:114346167-114346637,470
19969896,20016823,chr22,ARVCF,chr22:19969896-20016823,46927
75013769,75051532,chr14,MLH3,chr14:75013769-75051532,37763
88388430,88478694,chr9,SPIN1,chr9:88388430-88478694,90264
30103720,30131757,chr15,ULK4P3,chr15:30103720-30131757,28037
38252836,38357249,chr15,SPRED1,chr15:38252836-38357249,104413
31369840,31432835,chr11,DNAJC24,chr11:31369840-31432835,62995
133532164,133575519,chr9,ADAMTSL2,chr9:133532164-133575519,43355
32765544,33194714,chr15,FMN1,chr15:32765544-33194714,429170
94561442,94593118,chr14,SERPINA5,chr14:94561442-94593118,31676
38454127,38487710,chr15,FAM98B,chr15:38454127-38487710,33583
74148523,74160531,chr18,TIMM21,chr18:74148523-74160531,12008
99356131,99356228,chr13,MIR623,chr13:99356131-99356228,97
52576787,52643058,chr6,TRAM2-AS1,chr6:52576787-52643058,66271
78934419,79078254,chr6,PHIP,chr6:78934419-79078254,143835
22915651,22916523,chr13,NUS1P2,chr13:22915651-22916523,872
135462727,135480777,chr9,PPP1R26-AS1,chr9:135462727-135480777,18050
19020991,19117636,chr7,TWIST1,chr7:19020991-19117636,96645
30689105,30690272,chr9,RBMXP2,chr9:30689105-30690272,1167
25134692,25180356,chr7,C7orf31,chr7:25134692-25180356,45664
8681600,8783095,chr12,RIMKLB,chr12:8681600-8783095,101495
22646200,22824213,chr9,LINC01239,chr9:22646200-22824213,178013
24954986,24977850,chr15,SNURF,chr15:24954986-24977850,22864
134030305,134068535,chr9,BRD3,chr9:134030305-134068535,38230
48232612,48270357,chr13,ITM2B,chr13:48232612-48270357,37745
44825747,44884694,chr15,SORD2P,chr15:44825747-44884694,58947
83859656,83967423,chr6,CYB5R4,chr6:83859656-83967423,107767
133577081,133609389,chr9,FAM163B,chr9:133577081-133609389,32308
47778087,47848555,chr11,NUP160,chr11:47778087-47848555,70468
30424527,30478784,chr7,NOD1,chr7:30424527-30478784,54257
100473149,100577636,chr9,TMEFF1,chr9:100473149-100577636,104487
57314805,57646850,chr6,PRIM2,chr6:57314805-57646850,332045
6161776,6272644,chr7,CYTH3,chr7:6161776-6272644,110868
102854259,102864961,chr10,BORCS7,chr10:102854259-102864961,10702
107484852,107490482,chr9,KLF4,chr9:107484852-107490482,5630
40391591,40587364,chr6,LRFN2,chr6:40391591-40587364,195773
50015254,50020922,chr13,KCNRG,chr13:50015254-50020922,5668
92291167,92353964,chr10,MARCHF5,chr10:92291167-92353964,62797
20330702,20415754,chr7,ITGB8,chr7:20330702-20415754,85052
60850933,60855950,chr11,PTGDR2,chr11:60850933-60855950,5017
35662775,35818007,chr11,TRIM44,chr11:35662775-35818007,155232
50172089,50173181,chr13,ST13P4,chr13:50172089-50173181,1092
99104038,99154192,chr9,TGFBR1,chr9:99104038-99154192,50154
59574398,59615774,chr11,OSBP,chr11:59574398-59615774,41376
50909747,51024120,chr13,RNASEH2B,chr13:50909747-51024120,114373
10212458,10223128,chr12,GABARAPL1,chr12:10212458-10223128,10670
32580949,32761787,chr7,DPY19L1P1,chr7:32580949-32761787,180838
89568144,89638749,chr6,LYRM2,chr6:89568144-89638749,70605
69854131,70032366,chr14,SMOC1,chr14:69854131-70032366,178235
84033772,84090881,chr6,MRAP2,chr6:84033772-84090881,57109
83161150,83193936,chr6,PGM3,chr6:83161150-83193936,32786
73478484,73558947,chr14,HEATR4,chr14:73478484-73558947,80463
19449911,19479202,chr22,UFD1,chr22:19449911-19479202,29291
92826831,93059493,chr10,EXOC6,chr10:92826831-93059493,232662
51489100,51730727,chr14,FRMD6,chr14:51489100-51730727,241627
7968796,8094272,chr7,GLCCI1,chr7:7968796-8094272,125476
62123998,62153169,chr11,INCENP,chr11:62123998-62153169,29171
73237497,73274640,chr14,PAPLN,chr14:73237497-73274640,37143
63902451,63903245,chr10,RPL7AP50,chr10:63902451-63903245,794
10604193,10613609,chr12,MAGOHB,chr12:10604193-10613609,9416
125747345,125967377,chr9,PBX3,chr9:125747345-125967377,220032
36483769,36510272,chr11,TRAF6,chr11:36483769-36510272,26503
36296288,36465204,chr11,PRR5L,chr11:36296288-36465204,168916
103967140,104029233,chr10,SLK,chr10:103967140-104029233,62093
44288719,44415758,chr15,GOLM2,chr15:44288719-44415758,127039
22480439,22484840,chr15,HERC2P7,chr15:22480439-22484840,4401
135479079,135488893,chr9,PPP1R26,chr9:135479079-135488893,9814
19212642,19722926,chr20,SLC24A3,chr20:19212642-19722926,510284
100347233,100364826,chr10,SCD,chr10:100347233-100364826,17593
99737693,99942060,chr14,EML1,chr14:99737693-99942060,204367
40685848,40689236,chr20,MAFB,chr20:40685848-40689236,3388
48823741,48963919,chr15,SHC4,chr15:48823741-48963919,140178
15688830,15788411,chrX,CA5B,chrX:15688830-15788411,99581
4301372,4302698,chr17,MFSD1P1,chr17:4301372-4302698,1326
20999596,21043760,chr17,USP22,chr17:20999596-21043760,44164
118850688,119061247,chr4,SYNPO2,chr4:118850688-119061247,210559
105993463,106109939,chr6,PRDM1,chr6:105993463-106109939,116476
43112629,43566001,chr7,HECW1,chr7:43112629-43566001,453372
136107808,136109424,chr9,LINC02846,chr9:136107808-136109424,1616
98199011,98255649,chr9,TBC1D2,chr9:98199011-98255649,56638
95237572,95291012,chr10,PDLIM1,chr10:95237572-95291012,53440
45252239,45254564,chr20,SLPI,chr20:45252239-45254564,2325
17972813,18016889,chr17,DRC3,chr17:17972813-18016889,44076
118280038,118353003,chr4,PRSS12,chr4:118280038-118353003,72965
15211643,15371289,chr10,FAM171A1,chr10:15211643-15371289,159646
52361421,52407777,chr6,PAQR8,chr6:52361421-52407777,46356
19846138,19854896,chr22,RTL10,chr22:19846138-19854896,8758
27888838,27891033,chr11,HSP90AA2P,chr11:27888838-27891033,2195
52146814,52151119,chr6,LINCMD1,chr6:52146814-52151119,4305
56593004,56595681,chr4,GLDCP1,chr4:56593004-56595681,2677
40334775,40387590,chr6,TDRG1,chr6:40334775-40387590,52815
38010650,38065088,chr10,ZNF33A,chr10:38010650-38065088,54438
31509755,31790324,chr11,ELP4,chr11:31509755-31790324,280569
73695785,73828316,chr6,CD109,chr6:73695785-73828316,132531
115019575,115118257,chr9,TNC,chr9:115019575-115118257,98682
89786610,89787107,chr10,MTND5P42,chr10:89786610-89787107,497
23630115,23645639,chr14,DHRS2,chr14:23630115-23645639,15524
100273280,100286680,chr10,BLOC1S2,chr10:100273280-100286680,13400
33904308,34156427,chr7,BMPER,chr7:33904308-34156427,252119
45073146,45073541,chr10,RPS19P7,chr10:45073146-45073541,395
63276018,63309126,chr15,APH1B,chr15:63276018-63309126,33108
84421028,84556152,chr6,LINC01611,chr6:84421028-84556152,135124
41714534,41857733,chr11,LINC01499,chr11:41714534-41857733,143199
39329990,39725408,chr6,KIF6,chr6:39329990-39725408,395418
43870761,44195271,chr15,FRMD5,chr15:43870761-44195271,324510
45823214,45833745,chr20,TNNC2,chr20:45823214-45833745,10531
47275154,47582558,chr7,TNS3,chr7:47275154-47582558,307404
49038357,49038602,chr20,SNAP23P1,chr20:49038357-49038602,245
20321164,20403557,chr17,CCDC144CP,chr17:20321164-20403557,82393
36594353,36605600,chr6,SRSF3,chr6:36594353-36605600,11247
108650585,108667820,chr4,OSTC,chr4:108650585-108667820,17235
6390440,6394998,chr11,SMPD1,chr11:6390440-6394998,4558
10116777,10130258,chr12,CLEC7A,chr12:10116777-10130258,13481
104924713,104937761,chr14,PLD4,chr14:104924713-104937761,13048
46549580,46652830,chr6,CYP39A1,chr6:46549580-46652830,103250
53374149,53422728,chrX,SMC1A,chrX:53374149-53422728,48579
118722823,118838683,chr4,SEC24D,chr4:118722823-118838683,115860
33039417,33105943,chr11,TCP11L1,chr11:33039417-33105943,66526
11548030,11590369,chr12,LINC01252,chr12:11548030-11590369,42339
79307669,79313384,chr6,LCAL1,chr6:79307669-79313384,5715
12326056,12350242,chr12,MANSC1,chr12:12326056-12350242,24186
51695486,51699595,chr10,CSTF2T,chr10:51695486-51699595,4109
13044381,13142521,chr12,FAM234B,chr12:13044381-13142521,98140
91163012,91284337,chr10,PCGF5,chr10:91163012-91284337,121325
97222173,97292673,chr10,ARHGAP19,chr10:97222173-97292673,70500
8295986,8396803,chr12,LINC00937,chr12:8295986-8396803,100817
62663019,62666724,chr20,SLCO4A1-AS1,chr20:62663019-62666724,3705
62800627,62805587,chr20,OGFR-AS1,chr20:62800627-62805587,4960
135112905,135123779,chr4,LINC02485,chr4:135112905-135123779,10874
8227734,8231764,chr12,ALG1L10P,chr12:8227734-8231764,4030
127880893,127899224,chr4,PLK4,chr4:127880893-127899224,18331
45100100,45112047,chr7,TBRG4,chr7:45100100-45112047,11947
62816244,62841159,chr20,COL9A3,chr20:62816244-62841159,24915
40114203,41459773,chr11,LRRC4C,chr11:40114203-41459773,1345570
83739425,83829516,chr9,GKAP1,chr9:83739425-83829516,90091
61950063,61965515,chr11,BEST1,chr11:61950063-61965515,15452
48919853,48950965,chr18,SMAD7,chr18:48919853-48950965,31112
50082169,50906856,chr13,DLEU1,chr13:50082169-50906856,824687
119494397,119628804,chr4,PDE5A,chr4:119494397-119628804,134407
59781318,59781722,chr11,FABP5P7,chr11:59781318-59781722,404
38383704,38631420,chr7,AMPH,chr7:38383704-38631420,247716
129887187,130043194,chr9,FNBP1,chr9:129887187-130043194,156007
74597870,75065671,chr18,ZNF407,chr18:74597870-75065671,467801
62841005,62861822,chr20,TCFL5,chr20:62841005-62861822,20817
118297925,118342328,chr10,FAM204A,chr10:118297925-118342328,44403
24810024,24949101,chr12,BCAT1,chr12:24810024-24949101,139077
47608465,47629893,chr7,LINC01447,chr7:47608465-47629893,21428
120055623,120066858,chr4,MAD2L1,chr4:120055623-120066858,11235
65588377,65741931,chrX,MSN,chrX:65588377-65741931,153554
65141032,65234216,chr7,INTS4P1,chr7:65141032-65234216,93184
71254814,71301522,chrX,NONO,chrX:71254814-71301522,46708
24122065,24123814,chr13,IPO7P2,chr13:24122065-24123814,1749
3732685,3753111,chr20,HSPA12B,chr20:3732685-3753111,20426
101229577,101270148,chr10,LBX1-AS1,chr10:101229577-101270148,40571
32303699,32315363,chr13,ZAR1L,chr13:32303699-32315363,11664
124942123,124988189,chr10,ZRANB1,chr10:124942123-124988189,46066
66075800,66094697,chr7,ASL,chr7:66075800-66094697,18897
101023409,101348278,chr4,PPP3CA,chr4:101023409-101348278,324869
99659509,99711241,chr10,ENTPD7,chr10:99659509-99711241,51732
44427622,44529038,chr15,CTDSPL2,chr15:44427622-44529038,101416
121071429,121080476,chr4,NDNF-AS1,chr4:121071429-121080476,9047
124499940,124558445,chr4,LINC02516,chr4:124499940-124558445,58505
27243968,27325959,chr12,STK38L,chr12:27243968-27325959,81991
3888239,3888868,chr20,PANK2-AS1,chr20:3888239-3888868,629
99878336,99894428,chr4,LAMTOR3,chr4:99878336-99894428,16092
106969831,106975627,chr6,CD24,chr6:106969831-106975627,5796
119033670,119080823,chr10,EIF3A,chr10:119033670-119080823,47153
116681187,116741867,chr6,KPNA5,chr6:116681187-116741867,60680
49106068,49155661,chr15,COPS2,chr15:49106068-49155661,49593
12357078,12471233,chr12,BORCS5,chr12:12357078-12471233,114155
109366514,109382467,chr6,CD164,chr6:109366514-109382467,15953
51908218,51910621,chr13,CTAGE3P,chr13:51908218-51910621,2403
133636363,133659329,chr9,DBH,chr9:133636363-133659329,22966
16347142,16609259,chr12,MGST1,chr12:16347142-16609259,262117
25016612,25026664,chr10,THNSL1,chr10:25016612-25026664,10052
32728569,32753744,chr7,ZNRF2P1,chr7:32728569-32753744,25175
19089151,19089888,chr12,RPL7P6,chr12:19089151-19089888,737
55793540,55862755,chr7,SEPTIN14,chr7:55793540-55862755,69215
109375466,109498313,chr9,PTPN3,chr9:109375466-109498313,122847
128269237,128288829,chr4,PGRMC2,chr4:128269237-128288829,19592
26994112,26997087,chr11,FIBIN,chr11:26994112-26997087,2975
14522,32015,chr12,WASH8P,chr12:14522-32015,17493
66856647,66860475,chr11,LRFN4,chr11:66856647-66860475,3828
36572862,36677683,chr9,MELK,chr9:36572862-36677683,104821
90513573,90587072,chr6,MAP3K7,chr6:90513573-90587072,73499
19061912,19062669,chr17,SNORD3B-1,chr17:19061912-19062669,757
101845599,102056193,chr10,ARMH3,chr10:101845599-102056193,210594
33077188,33162371,chr11,CSTF3,chr11:33077188-33162371,85183
31937007,32001038,chr17,SUZ12,chr17:31937007-32001038,64031
50263713,50270767,chr22,MAPK11,chr22:50263713-50270767,7054
104323369,104327004,chr10,ITPRIP-AS1,chr10:104323369-104327004,3635
15620134,15882329,chr12,EPS8,chr12:15620134-15882329,262195
30558809,30577766,chrX,TASL,chrX:30558809-30577766,18957
93073475,93077885,chr10,CYP26A1,chr10:93073475-93077885,4410
24558087,24672677,chrX,PCYT1B,chrX:24558087-24672677,114590
34574123,34579369,chr17,TMEM132E-DT,chr17:34574123-34579369,5246
24693873,24996986,chrX,POLA1,chrX:24693873-24996986,303113
69745871,69746851,chr6,GAPDHP42,chr6:69745871-69746851,980
15999784,16045015,chr17,TTC19,chr17:15999784-16045015,45231
46035769,46124054,chr4,GABRG1,chr4:46035769-46124054,88285
134196333,134201789,chr4,PABPC4L,chr4:134196333-134201789,5456
86823468,86849384,chr4,SLC10A6,chr4:86823468-86849384,25916
20684560,20701216,chr14,RNASE4,chr14:20684560-20701216,16656
20781268,20782467,chr14,RNASE6,chr14:20781268-20782467,1199
127623271,127726737,chr4,INTU,chr4:127623271-127726737,103466
133654586,133657313,chr9,DBH-AS1,chr9:133654586-133657313,2727
68039025,68050895,chr11,TCIRG1,chr11:68039025-68050895,11870
36088256,36090169,chr17,CCL3,chr17:36088256-36090169,1913
3723903,3726699,chr17,HASPIN,chr17:3723903-3726699,2796
53794497,53924125,chr6,LRRC1,chr6:53794497-53924125,129628
68414064,68472121,chr10,DNA2,chr10:68414064-68472121,58057
50818723,50847619,chr6,TFAP2B,chr6:50818723-50847619,28896
69866556,70212468,chr6,COL19A1,chr6:69866556-70212468,345912
41952174,41958933,chr22,LINC00634,chr22:41952174-41958933,6759
73397114,73421482,chr4,ALB,chr4:73397114-73421482,24368
41998725,42058456,chr22,WBP2NL,chr22:41998725-42058456,59731
42000446,42001991,chr22,SLC25A5P1,chr22:42000446-42001991,1545
125781161,125932034,chr6,NCOA7,chr6:125781161-125932034,150873
30655489,30717266,chr10,SVIL2P,chr10:30655489-30717266,61777
42548828,42569994,chr15,HAUS2,chr15:42548828-42569994,21166
133761894,133992604,chr9,VAV2,chr9:133761894-133992604,230710
3791047,3873448,chr12,PARP11,chr12:3791047-3873448,82401
68930525,69062762,chr15,NOX5,chr15:68930525-69062762,132237
44258166,44265788,chr6,NFKBIE,chr6:44258166-44265788,7622
123216339,123637093,chr6,TRDN,chr6:123216339-123637093,420754
15200317,15562015,chr7,AGMO,chr7:15200317-15562015,361698
20684177,20698971,chr14,ANG,chr14:20684177-20698971,14794
136114581,136118875,chr9,TMEM250,chr9:136114581-136118875,4294
15107783,15348675,chr12,RERG,chr12:15107783-15348675,240892
28108248,28527041,chr11,METTL15,chr11:28108248-28527041,418793
35247025,35572669,chr10,CCNY,chr10:35247025-35572669,325644
27654893,27722058,chr11,BDNF,chr11:27654893-27722058,67165
15911302,16037381,chr12,DERA,chr12:15911302-16037381,126079
120258650,120311556,chrX,TMEM255A,chrX:120258650-120311556,52906
129612330,129771527,chr4,LINC02466,chr4:129612330-129771527,159197
35943981,36232136,chr11,LDLRAD3,chr11:35943981-36232136,288155
105244622,105439171,chr9,SLC44A1,chr9:105244622-105439171,194549
59806140,59810778,chr11,MRPL16,chr11:59806140-59810778,4638
119104086,119137984,chr10,DENND10,chr10:119104086-119137984,33898
150264435,151015727,chr4,LRBA,chr4:150264435-151015727,751292
111876051,111903990,chrX,TRPC5OS,chrX:111876051-111903990,27939
45192244,45240894,chr22,KIAA0930,chr22:45192244-45240894,48650
64841883,64868002,chr15,PLEKHO2,chr15:64841883-64868002,26119
75958097,75983011,chr14,TGFB3,chr14:75958097-75983011,24914
134025481,134034666,chr9,BRD3OS,chr9:134025481-134034666,9185
63321378,63381846,chr15,CA12,chr15:63321378-63381846,60468
24806169,24927578,chr22,SGSM1,chr22:24806169-24927578,121409
111299028,111483715,chr6,REV3L,chr6:111299028-111483715,184687
3077355,3286564,chr12,TSPAN9,chr12:3077355-3286564,209209
103120847,103123007,chr14,LINC00677,chr14:103120847-103123007,2160
103121476,103137439,chr14,TNFAIP2,chr14:103121476-103137439,15963
123135970,123139423,chr10,HMX3,chr10:123135970-123139423,3453
114821744,114899832,chr10,FHIP2A,chr10:114821744-114899832,78088
47079603,47236662,chr12,PCED1B,chr12:47079603-47236662,157059
47836902,48002561,chrX,ZNF81,chrX:47836902-48002561,165659
107825755,107931637,chrX,MID2,chrX:107825755-107931637,105882
33235552,33247621,chr15,TMCO5B,chr15:33235552-33247621,12069
34036681,34039872,chr17,TLK2P1,chr17:34036681-34039872,3191
46764761,46832408,chr12,SLC38A4,chr12:46764761-46832408,67647
32265832,32324659,chr17,RHBDL3,chr17:32265832-32324659,58827
65027439,65040572,chr11,SNX15,chr11:65027439-65040572,13133
2655726,2805017,chr18,SMCHD1,chr18:2655726-2805017,149291
38685346,38687037,chr7,FAM183BP,chr7:38685346-38687037,1691
116153791,116402321,chr9,PAPPA,chr9:116153791-116402321,248530
69072926,69095820,chr15,EWSAT1,chr15:69072926-69095820,22894
62253730,62270680,chr15,GOLGA2P11,chr15:62253730-62270680,16950
33162226,33922841,chr22,LARGE1,chr22:33162226-33922841,760615
65647823,65718688,chr7,INTS4P2,chr7:65647823-65718688,70865
33247820,33264720,chr9,BAG1,chr9:33247820-33264720,16900
121435595,121449727,chr6,GJA1,chr6:121435595-121449727,14132
63189560,63267776,chr15,RAB8B,chr15:63189560-63267776,78216
132445867,132513198,chr6,STX7,chr6:132445867-132513198,67331
27494418,27506769,chr11,LIN7C,chr11:27494418-27506769,12351
83955777,84492724,chr7,SEMA3A,chr7:83955777-84492724,536947
68121624,68130518,chr11,CHKA-DT,chr11:68121624-68130518,8894
15882387,15903478,chr12,STRAP,chr12:15882387-15903478,21091
46129989,46146688,chr6,ENPP4,chr6:46129989-46146688,16699
1268800,1310381,chrX,CSF2RA,chrX:1268800-1310381,41581
48183644,48185926,chr12,CCDC184,chr12:48183644-48185926,2282
47135498,47138370,chr12,IFITM3P6,chr12:47135498-47138370,2872
100578079,100588389,chr9,CAVIN4,chr9:100578079-100588389,10310
47709734,47725567,chr12,ENDOU,chr12:47709734-47725567,15833
85934737,85935663,chr11,SLC25A1P1,chr11:85934737-85935663,926
87329407,87330052,chr11,PSMA2P1,chr11:87329407-87330052,645
41955234,42087830,chr18,PIK3C3,chr18:41955234-42087830,132596
75576496,75630716,chr4,CDKL2,chr4:75576496-75630716,54220
98288109,98708935,chr9,GABBR2,chr9:98288109-98708935,420826
113105788,113120685,chr13,F7,chr13:113105788-113120685,14897
88725955,89111398,chr4,FAM13A,chr4:88725955-89111398,385443
55436056,55572988,chr7,VOPP1,chr7:55436056-55572988,136932
15112363,15114698,chr12,RERG-IT1,chr12:15112363-15114698,2335
41237440,41237557,chr9,RNA5SP530,chr9:41237440-41237557,117
44752558,44862788,chr22,ARHGAP8,chr22:44752558-44862788,110230
98868535,98948006,chr6,FBXL4,chr6:98868535-98948006,79471
100581079,100581379,chr9,RN7SKP87,chr9:100581079-100581379,300
27270830,27275192,chr13,RASL11A,chr13:27270830-27275192,4362
89326625,89352722,chr6,UBE2J1,chr6:89326625-89352722,26097
108848416,108974476,chr6,ARMC2,chr6:108848416-108974476,126060
127397138,127408424,chr9,SLC2A8,chr9:127397138-127408424,11286
2877223,2941138,chr12,TULP3,chr12:2877223-2941138,63915
50458436,50565405,chr7,DDC,chr7:50458436-50565405,106969
39097224,39104067,chr22,APOBEC3H,chr22:39097224-39104067,6843
46125920,46211871,chr13,LCP1,chr13:46125920-46211871,85951
7298744,7355359,chr8,FAM66B,chr8:7298744-7355359,56615
133149294,133208606,chr4,PCDH10,chr4:133149294-133208606,59312
48727435,48765790,chr12,TEX49,chr12:48727435-48765790,38355
152618628,152680012,chr4,TMEM154,chr4:152618628-152680012,61384
39755025,40106089,chr12,SLC2A13,chr12:39755025-40106089,351064
66842835,66846552,chr11,RCE1,chr11:66842835-66846552,3717
29500840,29784759,chr12,TMTC1,chr12:29500840-29784759,283919
45647689,45665622,chr11,CHST1,chr11:45647689-45665622,17933
40749925,40811184,chr4,NSUN7,chr4:40749925-40811184,61259
55681074,55713252,chr7,FKBP9P1,chr7:55681074-55713252,32178
36153254,36301538,chr7,EEPD1,chr7:36153254-36301538,148284
93130056,93148385,chr7,SAMD9L,chr7:93130056-93148385,18329
45777242,45851753,chr13,SIAH3,chr13:45777242-45851753,74511
112616703,112617880,chr6,PA2G4P5,chr6:112616703-112617880,1177
105096822,105137157,chr6,BVES,chr6:105096822-105137157,40335
140859807,141212877,chr4,RNF150,chr4:140859807-141212877,353070
12721906,12756073,chr8,LONRF1,chr8:12721906-12756073,34167
122849078,122879641,chr10,FAM24B,chr10:122849078-122879641,30563
118589997,118595648,chr10,PRLHR,chr10:118589997-118595648,5651
46211940,46277366,chr13,LRRC63,chr13:46211940-46277366,65426
127738317,127778710,chr9,SH2D3C,chr9:127738317-127778710,40393
102714538,102743492,chr10,SFXN2,chr10:102714538-102743492,28954
979073,993440,chr4,SLC26A1,chr4:979073-993440,14367
101053776,101416508,chr13,NALCN,chr13:101053776-101416508,362732
85957175,86069882,chr11,PICALM,chr11:85957175-86069882,112707
52051304,52097299,chr4,SPATA18,chr4:52051304-52097299,45995
113751262,113783429,chr10,PLEKHS1,chr10:113751262-113783429,32167
8317736,8386439,chr8,PRAG1,chr8:8317736-8386439,68703
116106921,116108430,chrX,API5P1,chrX:116106921-116108430,1509
25803298,25804526,chr12,TDGP1,chr12:25803298-25804526,1228
142147162,142224685,chr6,VTA1,chr6:142147162-142224685,77523
68277745,68295862,chr15,FEM1B,chr15:68277745-68295862,18117
40344344,40346151,chr6,LINC00951,chr6:40344344-40346151,1807
116100851,116249497,chr6,NT5DC1,chr6:116100851-116249497,148646
88824153,88881078,chr14,TTC8,chr14:88824153-88881078,56925
102743948,102834516,chr10,WBP1L,chr10:102743948-102834516,90568
125823546,125853695,chr10,BCCIP,chr10:125823546-125853695,30149
20034368,20056046,chr20,CRNKL1,chr20:20034368-20056046,21678
40056850,40158252,chr4,N4BP2,chr4:40056850-40158252,101402
94543840,94621421,chr11,PIWIL4,chr11:94543840-94621421,77581
56651343,57029811,chr18,WDR7,chr18:56651343-57029811,378468
20350578,20377251,chr22,USP41,chr22:20350578-20377251,26673
72836745,73142318,chr11,FCHSD2,chr11:72836745-73142318,305573
134327063,134328798,chr4,PES1P1,chr4:134327063-134328798,1735
154585133,154586816,chrX,CTAG1A,chrX:154585133-154586816,1683
36136536,36163913,chr9,GLIPR2,chr9:36136536-36163913,27377
3927309,4015558,chr20,RNF24,chr20:3927309-4015558,88249
129738949,129769536,chrX,XPNPEP2,chrX:129738949-129769536,30587
121989163,122254545,chr10,TACC2,chr10:121989163-122254545,265382
23966888,23972556,chr22,DDTL,chr22:23966888-23972556,5668
144646156,144745271,chr4,HHIP,chr4:144646156-144745271,99115
125986479,126203817,chr6,TRMT11,chr6:125986479-126203817,217338
692498,705808,chr16,FBXL16,chr16:692498-705808,13310
128128529,128130628,chr9,PTGES2-AS1,chr9:128128529-128130628,2099
4023917,4024444,chr20,FTLP3,chr20:4023917-4024444,527
78215293,78418348,chr11,GAB2,chr11:78215293-78418348,203055
110673856,110795819,chrX,CHRDL1,chrX:110673856-110795819,121963
100539203,100568220,chr7,AGFG2,chr7:100539203-100568220,29017
148078762,148444698,chr4,NR3C2,chr4:148078762-148444698,365936
92528773,92540481,chr7,RBM48,chr7:92528773-92540481,11708
92468380,92477986,chr7,ERVW-1,chr7:92468380-92477986,9606
32052197,32101856,chr20,HCK,chr20:32052197-32101856,49659
29073035,29168333,chr22,KREMEN1,chr22:29073035-29168333,95298
44467897,44468304,chr7,RPL32P18,chr7:44467897-44468304,407
90251204,90915052,chr11,DISC1FP1,chr11:90251204-90915052,663848
111245099,111270483,chrX,CAPN6,chrX:111245099-111270483,25384
128342153,128342770,chr9,TMSB4XP4,chr9:128342153-128342770,617
15417215,15766649,chr8,TUSC3,chr8:15417215-15766649,349434
56056590,56394094,chr6,COL21A1,chr6:56056590-56394094,337504
100644195,100675788,chrX,SRPX2,chrX:100644195-100675788,31593
54752250,54759974,chr7,SEC61G,chr7:54752250-54759974,7724
77589391,77610356,chr11,AQP11,chr11:77589391-77610356,20965
39603536,39609777,chr17,NEUROD2,chr17:39603536-39609777,6241
94973709,94999519,chr11,KDM4D,chr11:94973709-94999519,25810
32927910,32945106,chr17,TMEM98,chr17:32927910-32945106,17196
34957608,34982544,chr9,PHF24,chr9:34957608-34982544,24936
55595229,55636698,chr4,NMU,chr4:55595229-55636698,41469
92141298,92160114,chr9,LINC00475,chr9:92141298-92160114,18816
54842008,54902826,chr14,GCH1,chr14:54842008-54902826,60818
102765888,102773811,chr13,TEX30,chr13:102765888-102773811,7923
158201604,158255416,chr4,TMEM144,chr4:158201604-158255416,53812
90131515,90192894,chr11,NAALAD2,chr11:90131515-90192894,61379
120505920,120604074,chrX,CUL4B,chrX:120505920-120604074,98154
49900311,49932764,chr12,LINC02395,chr12:49900311-49932764,32453
34255218,34257203,chr17,CCL2,chr17:34255218-34257203,1985
29748309,29798492,chr8,LINC02099,chr8:29748309-29798492,50183
74202705,74336472,chr15,CCDC33,chr15:74202705-74336472,133767
100725705,100738224,chr14,DLK1,chr14:100725705-100738224,12519
25841725,26045413,chr8,EBF2,chr8:25841725-26045413,203688
102047437,102084554,chr11,CFAP300,chr11:102047437-102084554,37117
62183028,62203568,chr20,MTG2,chr20:62183028-62203568,20540
107176286,107177530,chr11,ASS1P13,chr11:107176286-107177530,1244
106051098,106077459,chr11,KBTBD3,chr11:106051098-106077459,26361
21242232,21526112,chr18,GREB1L,chr18:21242232-21526112,283880
100779410,100861031,chr14,MEG3,chr14:100779410-100861031,81621
134960378,135103056,chr6,HBS1L,chr6:134960378-135103056,142678
30628988,30695869,chr12,IPO8,chr12:30628988-30695869,66881
94493979,94499578,chr11,ANKRD49,chr11:94493979-94499578,5599
614746,738106,chr8,ERICH1,chr8:614746-738106,123360
113815630,113845744,chr13,GAS6-AS1,chr13:113815630-113845744,30114
113820549,113864076,chr13,GAS6,chr13:113820549-113864076,43527
50103982,50111313,chr12,GPD1,chr12:50103982-50111313,7331
153710160,153760024,chr4,RNF175,chr4:153710160-153760024,49864
52250466,52258867,chr12,KRT87P,chr12:52250466-52258867,8401
73051710,73305205,chr15,NEO1,chr15:73051710-73305205,253495
158270378,158278676,chr4,AIDAP2,chr4:158270378-158278676,8298
49791146,49828750,chr12,NCKAP5L,chr12:49791146-49828750,37604
30578318,30658236,chr8,GTF2E2,chr8:30578318-30658236,79918
155206529,155209027,chr4,NPY2R-AS1,chr4:155206529-155209027,2498
88695913,88697829,chr4,NAP1L5,chr4:88695913-88697829,1916
48053323,48095131,chr13,MED4,chr13:48053323-48095131,41808
53567071,53609907,chr20,ZNF217,chr20:53567071-53609907,42836
113550837,113589602,chr10,HABP2,chr10:113550837-113589602,38765
124664048,124712732,chr4,ANKRD50,chr4:124664048-124712732,48684
45888625,45891208,chr20,NEURL2,chr20:45888625-45891208,2583
125956770,125980244,chr6,HINT3,chr6:125956770-125980244,23474
48771128,48771827,chr13,PSME2P2,chr13:48771128-48771827,699
2088708,2135898,chr16,PKD1,chr16:2088708-2135898,47190
83834099,83921465,chr9,KIF27,chr9:83834099-83921465,87366
122458551,122514907,chr10,HTRA1,chr10:122458551-122514907,56356
130839347,131063322,chr6,EPB41L2,chr6:130839347-131063322,223975
50934867,50959140,chr20,DPM1,chr20:50934867-50959140,24273
100894770,101038859,chr14,MEG8,chr14:100894770-101038859,144089
83968083,83980616,chr9,HNRNPK,chr9:83968083-83980616,12533
128096659,128126423,chr10,MKI67,chr10:128096659-128126423,29764
13770939,13938638,chrX,GPM6B,chrX:13770939-13938638,167699
93188534,93226469,chr7,HEPACAM2,chr7:93188534-93226469,37935
44680173,45068510,chr18,SETBP1,chr18:44680173-45068510,388337
128809700,128875224,chr4,JADE1,chr4:128809700-128875224,65524
20144855,20183206,chr8,SLC18A1,chr8:20144855-20183206,38351
40219304,40284136,chr17,WIPF2,chr17:40219304-40284136,64832
110002631,110182734,chrX,TMEM164,chrX:110002631-110182734,180103
124748149,124791887,chr10,EEF1AKMT2,chr10:124748149-124791887,43738
93721513,93721865,chr11,SCARNA9,chr11:93721513-93721865,352
110358816,110456334,chrX,RTL9,chrX:110358816-110456334,97518
96518110,96587452,chr10,TM9SF3,chr10:96518110-96587452,69342
101066724,101066801,chr14,MIR656,chr14:101066724-101066801,77
101068283,101072937,chr14,MEG9,chr14:101068283-101072937,4654
29554808,29581327,chr22,NIPSNAP1,chr22:29554808-29581327,26519
36194869,36196758,chr17,CCL3L3,chr17:36194869-36196758,1889
35235475,35796550,chr8,UNC5D,chr8:35235475-35796550,561075
106489745,106535662,chr13,EFNB2,chr13:106489745-106535662,45917
2275881,2340746,chr16,ABCA3,chr16:2275881-2340746,64865
35658290,35661511,chr9,CCDC107,chr9:35658290-35661511,3221
93818232,93850618,chr11,VSTM5,chr11:93818232-93850618,32386
24078662,24115010,chr14,NRL,chr14:24078662-24115010,36348
93885396,93890753,chr7,TFPI2,chr7:93885396-93890753,5357
35658875,35675866,chr9,ARHGEF39,chr9:35658875-35675866,16991
24094053,24110598,chr14,PCK2,chr14:24094053-24110598,16545
32970376,32997877,chr17,SPACA3,chr17:32970376-32997877,27501
47661249,47706030,chr12,RPAP3,chr12:47661249-47706030,44781
68683779,68691175,chr11,GAL,chr11:68683779-68691175,7396
46118278,46129863,chr20,CD40,chr20:46118278-46129863,11585
78437431,78501453,chr15,IREB2,chr15:78437431-78501453,64022
35696948,35732195,chr9,TLN1,chr9:35696948-35732195,35247
24114195,24125242,chr14,DCAF11,chr14:24114195-24125242,11047
107790991,107928293,chr11,SLC35F2,chr11:107790991-107928293,137302
45729706,45908040,chr12,ARID2,chr12:45729706-45908040,178334
38078262,38124770,chr17,NPEPPSP1,chr17:38078262-38124770,46508
38351844,38405593,chr17,SOCS7,chr17:38351844-38405593,53749
75023586,75117462,chr15,PPCDC,chr15:75023586-75117462,93876
74173710,74176872,chr15,ISLR,chr15:74173710-74176872,3162
74350768,74364620,chr15,PPIAP46,chr15:74350768-74364620,13852
27596917,27614700,chr8,CLU,chr8:27596917-27614700,17783
174636920,174829247,chr4,GLRA3,chr4:174636920-174829247,192327
73319859,73368958,chr15,HCN4,chr15:73319859-73368958,49099
35749287,35758585,chr9,RGP1,chr9:35749287-35758585,9298
38646822,38907430,chr12,CPNE8,chr12:38646822-38907430,260608
2922662,2923202,chr16,RPL23AP86,chr16:2922662-2923202,540
174236658,174283667,chr4,FBXO8,chr4:174236658-174283667,47009
95578202,95644706,chr13,DZIP1,chr13:95578202-95644706,66504
98385801,98386584,chr7,RPS3AP26,chr7:98385801-98386584,783
84687351,84764598,chr6,TBX18,chr6:84687351-84764598,77247
49961872,49965682,chr12,AQP5,chr12:49961872-49965682,3810
102110447,102233424,chr11,YAP1,chr11:102110447-102233424,122977
157076125,157172090,chr4,GLRB,chr4:157076125-157172090,95965
41812680,41823213,chr17,FKBP10,chr17:41812680-41823213,10533
54556970,54571726,chr7,VSTM2A-OT1,chr7:54556970-54571726,14756
54058254,54122235,chr12,FLJ12825,chr12:54058254-54122235,63981
56511002,56512703,chr12,HSPD1P4,chr12:56511002-56512703,1701
30638580,30646064,chr8,SMIM18,chr8:30638580-30646064,7484
29336,38321,chr16,IL9RP3,chr16:29336-38321,8985
48105139,48146404,chr12,PFKM,chr12:48105139-48146404,41265
81699010,81770438,chr7,HGF,chr7:81699010-81770438,71428
127135426,127196591,chr10,INSYN2A,chr10:127135426-127196591,61165
636817,648474,chr16,MCRIP2,chr16:636817-648474,11657
35906202,35907136,chr9,HRCT1,chr9:35906202-35907136,934
35909490,35937153,chr9,SPAAR,chr9:35909490-35937153,27663
120851305,120909524,chr10,WDR11,chr10:120851305-120909524,58219
20341669,20622499,chr9,MLLT3,chr9:20341669-20622499,280830
29730956,29767011,chr22,ZMAT5,chr22:29730956-29767011,36055
136256627,136289851,chr6,BCLAF1,chr6:136256627-136289851,33224
525155,527407,chr16,LINC00235,chr16:525155-527407,2252
24143362,24147570,chr14,PSME2,chr14:24143362-24147570,4208
2253116,2268397,chr16,RNPS1,chr16:2253116-2268397,15281
143424753,143426013,chr4,RPSAP36,chr4:143424753-143426013,1260
119167720,119178812,chr10,PRDX3,chr10:119167720-119178812,11092
67785273,67792335,chr11,ALG1L8P,chr11:67785273-67792335,7062
137434364,137441816,chr9,ENTPD8,chr9:137434364-137441816,7452
169094259,169270956,chr4,SH3RF1,chr4:169094259-169270956,176697
57599794,57610104,chr7,NCOR1P3,chr7:57599794-57610104,10310
97435909,97446017,chr10,EXOSC1,chr10:97435909-97446017,10108
137459952,137550402,chr9,PNPLA7,chr9:137459952-137550402,90450
30131671,30144665,chr8,MBOAT4,chr8:30131671-30144665,12994
56005715,56007176,chr15,CNOT6LP1,chr15:56005715-56007176,1461
114294824,114404756,chr10,AFAP1L2,chr10:114294824-114404756,109932
24146683,24160660,chr14,RNF31,chr14:24146683-24160660,13977
103907189,104164379,chr11,PDGFD,chr11:103907189-104164379,257190
97851677,97872542,chr7,ASNS,chr7:97851677-97872542,20865
75604700,75635994,chr13,LMO7-AS1,chr13:75604700-75635994,31294
125725634,125752110,chr10,EDRF1-AS1,chr10:125725634-125752110,26476
19063346,19064136,chr17,SNORD3B-2,chr17:19063346-19064136,790
27633868,27676776,chr8,SCARA3,chr8:27633868-27676776,42908
16726814,16727524,chr9,BNC2-AS1,chr9:16726814-16727524,710
123008979,123058290,chr10,ACADSB,chr10:123008979-123058290,49311
12570350,12571130,chr8,RPS3AP34,chr8:12570350-12571130,780
841690,969090,chr9,DMRT1,chr9:841690-969090,127400
105532169,105567677,chr7,RINT1,chr7:105532169-105567677,35508
24161265,24166565,chr14,IRF9,chr14:24161265-24166565,5300
110644336,110839468,chr10,RBM20,chr10:110644336-110839468,195132
43527844,43579620,chr17,ETV4,chr17:43527844-43579620,51776
31751179,32428131,chr7,PDE1C,chr7:31751179-32428131,676952
153780591,153789083,chr4,SFRP2,chr4:153780591-153789083,8492
26748150,26867278,chr8,ADRA1A,chr8:26748150-26867278,119128
89236383,89307800,chr4,GPRIN3,chr4:89236383-89307800,71417
56467617,56503681,chr4,SRP72,chr4:56467617-56503681,36064
54016931,54056030,chr12,HOXC4,chr12:54016931-54056030,39099
120902393,120929173,chr9,TRAF1,chr9:120902393-120929173,26780
23678697,23682938,chr8,NKX3-1,chr8:23678697-23682938,4241
38530031,38605952,chr17,SRCIN1,chr17:38530031-38605952,75921
119364359,119526664,chr11,USP2-AS1,chr11:119364359-119526664,162305
68052859,68121444,chr11,CHKA,chr11:68052859-68121444,68585
39667981,39670475,chr17,PNMT,chr17:39667981-39670475,2494
1392794,1445440,chr5,SLC6A3,chr5:1392794-1445440,52646
98214624,98252232,chr7,TECPR1,chr7:98214624-98252232,37608
27022546,27066343,chr12,MED21,chr12:27022546-27066343,43797
117241093,117279430,chr10,SLC18A2,chr10:117241093-117279430,38337
74337759,74367646,chr15,CYP11A1,chr15:74337759-74367646,29887
2692874,2760108,chr20,EBF4,chr20:2692874-2760108,67234
121203159,121203435,chr9,RN7SL181P,chr9:121203159-121203435,276
25427847,25458476,chr8,KCTD9,chr8:25427847-25458476,30629
94743668,94757681,chr4,BMPR1B-DT,chr4:94743668-94757681,14013
101468349,101482199,chr9,TMEM246-AS1,chr9:101468349-101482199,13850
125219962,125302078,chr6,HDDC2,chr6:125219962-125302078,82116
101473170,101533537,chr9,PGAP4,chr9:101473170-101533537,60367
101533853,101563344,chr9,RNF20,chr9:101533853-101563344,29491
124801819,124836667,chr10,ABRAXAS2,chr10:124801819-124836667,34848
151396515,151409364,chrX,VMA21,chrX:151396515-151409364,12849
2794074,2800627,chr20,CPXM1,chr20:2794074-2800627,6553
74179466,74212267,chr15,STRA6,chr15:74179466-74212267,32801
2835314,2841190,chr20,PCED1A,chr20:2835314-2841190,5876
1317752,1345099,chr5,CLPTM1L,chr5:1317752-1345099,27347
106900164,106930861,chrX,CLDN2,chrX:106900164-106930861,30697
55753653,55875590,chr6,BMP5,chr6:55753653-55875590,121937
115030564,115126314,chr7,LINC01393,chr7:115030564-115126314,95750
101219769,101264502,chrX,DRP2,chrX:101219769-101264502,44733
68201349,68225810,chr12,IL26,chr12:68201349-68225810,24461
280450,283010,chr16,ARHGDIG,chr16:280450-283010,2560
36210924,36212878,chr17,CCL4L2,chr17:36210924-36212878,1954
23296897,23425328,chr8,LOXL2,chr8:23296897-23425328,128431
24209615,24213830,chr14,CHMP4A,chr14:24209615-24213830,4215
132296055,132401475,chr6,MOXD1,chr6:132296055-132401475,105420
29673922,29748109,chr8,LINC00589,chr8:29673922-29748109,74187
123666355,123697399,chr10,GPR26,chr10:123666355-123697399,31044
37289649,37317260,chr20,MANBAL,chr20:37289649-37317260,27611
115093365,115948999,chr10,ATRNL1,chr10:115093365-115948999,855634
25459199,25507911,chr8,CDCA2,chr8:25459199-25507911,48712
100508194,100881372,chr6,ASCC3,chr6:100508194-100881372,373178
52249300,52309163,chr12,KRT86,chr12:52249300-52309163,59863
30607003,30627271,chr22,TCN2,chr22:30607003-30627271,20268
604257,610309,chr20,TCF15,chr20:604257-610309,6052
73308276,73369388,chr11,ARHGEF17,chr11:73308276-73369388,61112
45886491,45887622,chr20,SPATA25,chr20:45886491-45887622,1131
163323962,163344832,chr4,NPY1R,chr4:163323962-163344832,20870
101832112,101857577,chrX,NXF5,chrX:101832112-101857577,25465
4787332,4788584,chr8,PAICSP4,chr8:4787332-4788584,1252
24216857,24232367,chr14,NEDD8,chr14:24216857-24232367,15510
163494442,163520539,chr4,TMA16,chr4:163494442-163520539,26097
97674909,97697340,chr9,XPA,chr9:97674909-97697340,22431
74748849,74842413,chr11,RNF169,chr11:74748849-74842413,93564
24239643,24242674,chr14,TINF2,chr14:24239643-24242674,3031
137447570,137459334,chr9,NSMF,chr9:137447570-137459334,11764
125784980,125823258,chr10,UROS,chr10:125784980-125823258,38278
94451857,94668227,chr4,PDLIM5,chr4:94451857-94668227,216370
64034344,64039962,chr20,C20orf204,chr20:64034344-64039962,5618
23879493,23879790,chr22,RN7SL268P,chr22:23879493-23879790,297
362835,397559,chr20,TRIB3,chr20:362835-397559,34724
67351436,67352039,chr12,MRPL40P1,chr12:67351436-67352039,603
7396138,7830081,chr5,ADCY2,chr5:7396138-7830081,433943
63538489,63547749,chr20,SRMS,chr20:63538489-63547749,9260
48508959,48520814,chrX,PORCN,chrX:48508959-48520814,11855
24181487,24189106,chr22,SUSD2,chr22:24181487-24189106,7619
24249114,24264432,chr14,TGM1,chr14:24249114-24264432,15318
8450701,8486930,chr5,MIR4458HG,chr5:8450701-8486930,36229
16616848,16617881,chr17,SRSF6P2,chr17:16616848-16617881,1033
20408311,20434286,chr17,USP32P3,chr17:20408311-20434286,25975
16067139,16180762,chr5,MARCHF11,chr5:16067139-16180762,113623
9463320,9741037,chrX,TBL1X,chrX:9463320-9741037,277717
38681957,38685421,chr22,TOMM22,chr22:38681957-38685421,3464
12945642,13031503,chr8,TRMT9B,chr8:12945642-13031503,85861
41825057,41836260,chr17,NT5C3B,chr17:41825057-41836260,11203
99966720,99976042,chr7,AZGP1,chr7:99966720-99976042,9322
64103802,64107565,chr20,NPBWR2,chr20:64103802-64107565,3763
13995369,16053197,chr20,MACROD2,chr20:13995369-16053197,2057828
57906039,57959148,chr12,ATP23,chr12:57906039-57959148,53109
79773563,79935460,chr12,PPP1R12A,chr12:79773563-79935460,161897
102396332,102470384,chr11,TMEM123,chr11:102396332-102470384,74052
123154402,123170467,chr10,BUB3,chr10:123154402-123170467,16065
1456480,1523962,chr5,LPCAT1,chr5:1456480-1523962,67482
49994513,50012659,chr22,IL17REL,chr22:49994513-50012659,18146
60951,71626,chr19,WASH5P,chr19:60951-71626,10675
18288283,18316996,chr20,ZNF133,chr20:18288283-18316996,28713
14728272,14854667,chr18,ANKRD30B,chr18:14728272-14854667,126395
4803203,4847288,chr16,GLYR1,chr16:4803203-4847288,44085
99408641,99419616,chr7,BUD31,chr7:99408641-99419616,10975
43014607,43025123,chr17,VAT1,chr17:43014607-43025123,10516
174283730,174333380,chr4,CEP44,chr4:174283730-174333380,49650
9914016,9960021,chr18,VAPA,chr18:9914016-9960021,46005
12574830,12804363,chr5,LINC01194,chr5:12574830-12804363,229533
9035033,9546075,chr5,SEMA5A,chr5:9035033-9546075,511042
86791059,86952910,chr11,PRSS23,chr11:86791059-86952910,161851
133657235,133660635,chr10,CLUHP5,chr10:133657235-133660635,3400
3162617,3173549,chr20,LZTS3,chr20:3162617-3173549,10932
101308270,101314800,chr7,EMSLR,chr7:101308270-101314800,6530
83877205,83882474,chr13,SLITRK1,chr13:83877205-83882474,5269
131573966,131628242,chr6,MED23,chr6:131573966-131628242,54276
9923920,9924021,chr18,RNA5SP450,chr18:9923920-9924021,101
116210506,116258783,chr7,TES,chr7:116210506-116258783,48277
10666483,11149569,chr18,PIEZO2,chr18:10666483-11149569,483086
183505058,183512429,chr4,ING2,chr4:183505058-183512429,7371
161383897,162164004,chr4,FSTL5,chr4:161383897-162164004,780107
125719515,125764143,chr10,EDRF1,chr10:125719515-125764143,44628
825097,832018,chr19,AZU1,chr19:825097-832018,6921
37683843,37951936,chr7,EPDR1,chr7:37683843-37951936,268093
11965210,11968068,chr16,TNFRSF17,chr16:11965210-11968068,2858
4510669,4538828,chr16,CDIP1,chr16:4510669-4538828,28159
19817391,19852083,chr8,INTS10,chr8:19817391-19852083,34692
128191655,128255248,chr9,DNM1,chr9:128191655-128255248,63593
1226044,1296421,chr20,RAD21L1,chr20:1226044-1296421,70377
71686082,71705047,chr12,TMEM19,chr12:71686082-71705047,18965
86945679,86955395,chr11,FZD4,chr11:86945679-86955395,9716
17101769,17470960,chr16,XYLT1,chr16:17101769-17470960,369191
122882683,122963862,chr11,JHY,chr11:122882683-122963862,81179
119207571,119459745,chr10,GRK5,chr10:119207571-119459745,252174
26291508,26372680,chr8,PPP2R2A,chr8:26291508-26372680,81172
171812254,173041559,chr4,GALNTL6,chr4:171812254-173041559,1229305
33490075,33650036,chr20,CBFA2T2,chr20:33490075-33650036,159961
80936414,81261210,chr12,ACSS3,chr12:80936414-81261210,324796
19175581,19178739,chr22,SLC25A1,chr22:19175581-19178739,3158
100463009,100483744,chr10,WNT8B,chr10:100463009-100483744,20735
122471917,122726373,chr6,PKIB,chr6:122471917-122726373,254456
47365496,47384293,chr10,ZNF488,chr10:47365496-47384293,18797
41717742,41734644,chr17,HAP1,chr17:41717742-41734644,16902
1026586,1039068,chr19,CNN2,chr19:1026586-1039068,12482
10275875,10307902,chr5,CMBL,chr5:10275875-10307902,32027
27809624,27838082,chr8,PBK,chr8:27809624-27838082,28458
33666943,33668525,chr20,ACTL10,chr20:33666943-33668525,1582
49858238,50182817,chr15,ATP8B4,chr15:49858238-50182817,324579
184088706,184221230,chr4,ENPP6,chr4:184088706-184221230,132524
58839718,58911192,chr20,GNAS,chr20:58839718-58911192,71474
81875194,82987179,chr10,NRG3,chr10:81875194-82987179,1111985
143513472,143514635,chr4,SMARCA5-AS1,chr4:143513472-143514635,1163
18178038,18205915,chr22,FAM230D,chr22:18178038-18205915,27877
7851186,7906025,chr5,MTRR,chr5:7851186-7906025,54839
184474802,184477304,chr4,IRF2-DT,chr4:184474802-184477304,2502
184365180,184382416,chr4,LINC02362,chr4:184365180-184382416,17236
40443450,40457725,chr17,IGFBP4,chr17:40443450-40457725,14275
2977538,2995179,chr19,TLE6,chr19:2977538-2995179,17641
147617386,147672044,chr4,TMEM184C,chr4:147617386-147672044,54658
19756703,19783593,chr22,TBX1,chr22:19756703-19783593,26890
25691959,26137685,chr16,HS3ST4,chr16:25691959-26137685,445726
42810134,42833350,chr17,BECN1,chr17:42810134-42833350,23216
708935,748329,chr19,PALM,chr19:708935-748329,39394
100232298,100267680,chr10,CWF19L1,chr10:100232298-100267680,35382
185445182,185471752,chr4,CCDC110,chr4:185445182-185471752,26570
59594875,59640239,chr15,GCNT3,chr15:59594875-59640239,45364
120111286,120185529,chr11,TRIM29,chr11:120111286-120185529,74243
46762506,46833154,chr17,WNT3,chr17:46762506-46833154,70648
113857345,113863475,chr6,MARCKS,chr6:113857345-113863475,6130
139135080,139180802,chr6,HECA,chr6:139135080-139180802,45722
63125872,63158021,chr15,RPS27L,chr15:63125872-63158021,32149
54324358,54357964,chr18,STARD6,chr18:54324358-54357964,33606
40894450,40903975,chr15,VPS18,chr15:40894450-40903975,9525
3172346,3180332,chr19,S1PR4,chr19:3172346-3180332,7986
12446512,12658107,chr18,SPIRE1,chr18:12446512-12658107,211595
105609994,105982092,chr11,GRIA4,chr11:105609994-105982092,372098
134917393,134950115,chr6,ALDH8A1,chr6:134917393-134950115,32722
35525176,35525763,chr8,LSM12P1,chr8:35525176-35525763,587
49082028,49082165,chrX,RNU4-52P,chrX:49082028-49082165,137
49113407,49123735,chrX,GPKOW,chrX:49113407-49123735,10328
79574979,79690964,chr12,PAWR,chr12:79574979-79690964,115985
19410496,19499113,chr16,TMC5,chr16:19410496-19499113,88617
144150517,144191939,chr6,STX11,chr6:144150517-144191939,41422
25174802,25602229,chr10,GPR158,chr10:25174802-25602229,427427
88609897,88963618,chr6,RNGTT,chr6:88609897-88963618,353721
62643994,62935150,chr12,PPM1H,chr12:62643994-62935150,291156
149781930,149787737,chrX,MAGEA9,chrX:149781930-149787737,5807
10564070,10657816,chr5,ANKRD33B,chr5:10564070-10657816,93746
35617844,35814611,chr5,SPEF2,chr5:35617844-35814611,196767
4304598,4323843,chr19,FSD1,chr19:4304598-4323843,19245
49866896,49904217,chr12,FAIM2,chr12:49866896-49904217,37321
135094985,135098712,chrX,SMIM10L2B,chrX:135094985-135098712,3727
166409364,166906451,chr6,RPS6KA2,chr6:166409364-166906451,497087
135156540,135171398,chrX,CT55,chrX:135156540-135171398,14858
110712736,110723339,chr13,ING1,chr13:110712736-110723339,10603
135421944,135428075,chrX,SMIM10L2A,chrX:135421944-135428075,6131
41216369,41263577,chr13,MTRF1,chr13:41216369-41263577,47208
23664262,23686397,chrX,PRDX4,chrX:23664262-23686397,22135
3725054,3880713,chr16,CREBBP,chr16:3725054-3880713,155659
24534551,24708542,chr18,LINC01915,chr18:24534551-24708542,173991
78593052,78621295,chr15,CHRNA3,chr15:78593052-78621295,28243
46978156,46979253,chr17,RPRML,chr17:46978156-46979253,1097
125747664,125761269,chr6,HEY2,chr6:125747664-125761269,13605
43125551,43153671,chr17,NBR2,chr17:43125551-43153671,28120
27629798,27649560,chr17,LGALS9,chr17:27629798-27649560,19762
152320544,152536092,chr4,FBXW7,chr4:152320544-152536092,215548
136949551,136955497,chr9,LCN12,chr9:136949551-136955497,5946
3593732,3598363,chr18,DLGAP1-AS1,chr18:3593732-3598363,4631
6462144,6463030,chr18,RPL6P27,chr18:6462144-6463030,886
41457550,41470871,chr13,RGCC,chr13:41457550-41470871,13321
136981904,136986410,chr9,LCNL1,chr9:136981904-136986410,4506
177309874,177362936,chr4,NEIL3,chr4:177309874-177362936,53062
136992422,136993984,chr9,PAXX,chr9:136992422-136993984,1562
58298504,58373887,chr14,ARID4A,chr14:58298504-58373887,75383
136994608,136996568,chr9,CLIC3,chr9:136994608-136996568,1960
3603000,3610103,chr18,DLGAP1-AS2,chr18:3603000-3610103,7103
137027464,137037957,chr9,LINC02908,chr9:137027464-137037957,10493
150599883,150843665,chr6,PLEKHG1,chr6:150599883-150843665,243782
137030174,137032088,chr9,FUT7,chr9:137030174-137032088,1914
18374521,18401940,chr16,PKD1P5,chr16:18374521-18401940,27419
137039463,137046179,chr9,NPDC1,chr9:137039463-137046179,6716
143422832,143450695,chr6,ADAT2,chr6:143422832-143450695,27863
28089673,28191156,chr8,ELP3,chr8:28089673-28191156,101483
137048107,137054061,chr9,ENTPD2,chr9:137048107-137054061,5954
143490424,143506406,chr6,VDAC1P8,chr6:143490424-143506406,15982
176683538,176792922,chr4,VEGFC,chr4:176683538-176792922,109384
11968508,11968743,chr16,UBL5P4,chr16:11968508-11968743,235
41189749,41201149,chr6,TREML2,chr6:41189749-41201149,11400
15104723,15131601,chr16,PKD1P6-NPIPP1,chr16:15104723-15131601,26878
160539254,160586817,chr4,LINC02477,chr4:160539254-160586817,47563
137062127,137070557,chr9,SAPCD2,chr9:137062127-137070557,8430
154886355,154888061,chrX,F8A1,chrX:154886355-154888061,1706
268301,275980,chr16,RGS11,chr16:268301-275980,7679
173168811,173323967,chr4,GALNT7,chr4:173168811-173323967,155156
62183035,62268844,chr10,RTKN2,chr10:62183035-62268844,85809
137077517,137084539,chr9,UAP1L1,chr9:137077517-137084539,7022
41306952,41510628,chr5,PLCXD3,chr5:41306952-41510628,203676
3379675,3485094,chr2,TRAPPC12,chr2:3379675-3485094,105419
137084946,137086817,chr9,MAN1B1-DT,chr9:137084946-137086817,1871
137110546,137115177,chr9,DPP7,chr9:137110546-137115177,4631
163110073,163166890,chr4,NAF1,chr4:163110073-163166890,56817
137139154,137168756,chr9,GRIN1,chr9:137139154-137168756,29602
109535781,109544698,chrX,NXT2,chrX:109535781-109544698,8917
109624244,109733403,chrX,ACSL4,chrX:109624244-109733403,109159
92140278,92145846,chr12,BTG1,chr12:92140278-92145846,5568
97434169,97469128,chr13,RAP2A,chr13:97434169-97469128,34959
69239569,69274358,chr12,CPSF6,chr12:69239569-69274358,34789
2895048,3126026,chr2,LINC01250,chr2:2895048-3126026,230978
100150094,100186033,chr10,ERLIN1,chr10:100150094-100186033,35939
32354350,32444740,chr5,ZFR,chr5:32354350-32444740,90390
6755447,6775647,chr17,XAF1,chr17:6755447-6775647,20200
3481242,3482409,chr2,TRAPPC12-AS1,chr2:3481242-3482409,1167
50763710,50821162,chr12,ATF1,chr12:50763710-50821162,57452
798041,800734,chr16,GNG13,chr16:798041-800734,2693
3658200,3702671,chr2,ALLC,chr2:3658200-3702671,44471
34109560,34815325,chr10,PARD3,chr10:34109560-34815325,705765
2511219,2702694,chr19,GNG7,chr19:2511219-2702694,191475
78863993,79452008,chr12,SYT1,chr12:78863993-79452008,588015
20187463,20192938,chr13,GJB2,chr13:20187463-20192938,5475
106045423,106325791,chr6,ATG5,chr6:106045423-106325791,280368
55625845,55773194,chr5,SLC38A9,chr5:55625845-55773194,147349
134986508,135147963,chr7,AGBL3,chr7:134986508-135147963,161455
3136033,3163749,chr19,GNA15,chr19:3136033-3163749,27716
47117703,47189422,chr17,CDC27,chr17:47117703-47189422,71719
3594832,3644644,chr2,COLEC11,chr2:3594832-3644644,49812
24219654,24245108,chr22,GGT5,chr22:24219654-24245108,25454
116287380,116508541,chr7,CAV2,chr7:116287380-116508541,221161
81946444,82443777,chr7,CACNA2D1,chr7:81946444-82443777,497333
70638073,70920738,chr12,PTPRR,chr12:70638073-70920738,282665
2828822,2882820,chrX,GYG2,chrX:2828822-2882820,53998
144004916,144008262,chr6,HYMAI,chr6:144004916-144008262,3346
25351418,25405377,chr22,LRP5L,chr22:25351418-25405377,53959
25437306,25437823,chr22,IGLVIVOR22-1,chr22:25437306-25437823,517
39021113,39033277,chr22,APOBEC3D,chr22:39021113-39033277,12164
116496899,116500630,chr11,LINC02151,chr11:116496899-116500630,3731
18077923,18105396,chr22,PEX26,chr22:18077923-18105396,27473
137170858,137172056,chr9,TMEM210,chr9:137170858-137172056,1198
123069872,123195248,chr11,CLMP,chr11:123069872-123195248,125376
40909497,40984643,chr5,C7,chr5:40909497-40984643,75146
100589402,100604206,chr7,PCOLCE-AS1,chr7:100589402-100604206,14804
20859007,20891214,chr22,SNAP29,chr22:20859007-20891214,32207
55879835,56014169,chr8,LYN,chr8:55879835-56014169,134334
3041471,3112727,chrX,ARSF,chrX:3041471-3112727,71256
137224635,137226315,chr9,CYSRT1,chr9:137224635-137226315,1680
55160167,55167297,chr5,GPX8,chr5:55160167-55167297,7130
20917407,20953747,chr22,CRKL,chr22:20917407-20953747,36340
137227502,137229640,chr9,RNF224,chr9:137227502-137229640,2138
137230757,137236555,chr9,SLC34A3,chr9:137230757-137236555,5798
137241287,137243707,chr9,TUBB4B,chr9:137241287-137243707,2420
78129748,78139650,chrX,TAF9B,chrX:78129748-78139650,9902
31860904,31901708,chr17,UTP6,chr17:31860904-31901708,40804
125442881,125592568,chr11,FEZ1,chr11:125442881-125592568,149687
43511058,43521811,chr5,C5orf34-AS1,chr5:43511058-43521811,10753
3688021,3688981,chr2,GAPDHP48,chr2:3688021-3688981,960
9488486,9556732,chr2,ADAM17,chr2:9488486-9556732,68246
137299631,137302271,chr9,NRARP,chr9:137299631-137302271,2640
138088505,138107419,chr6,PERP,chr6:138088505-138107419,18914
148747030,149076990,chr6,UST,chr6:148747030-149076990,329960
32106835,32383633,chr12,BICD1,chr12:32106835-32383633,276798
2934045,2968475,chrX,ARSL,chrX:2934045-2968475,34430
152779937,152918463,chr4,ARFIP1,chr4:152779937-152918463,138526
28020619,28108156,chr11,KIF18A,chr11:28020619-28108156,87537
48575507,48578350,chr17,HOXB4,chr17:48575507-48578350,2843
21008193,21014292,chr22,TUBA3FP,chr22:21008193-21014292,6099
39665349,39666554,chr17,TCAP,chr17:39665349-39666554,1205
21028718,21032840,chr22,SLC7A4,chr22:21028718-21032840,4122
53210567,53232980,chr12,RARG,chr12:53210567-53232980,22413
3575260,3580920,chr2,RPS7,chr2:3575260-3580920,5660
14922802,14952060,chr16,NPIPA1,chr16:14922802-14952060,29258
104579764,104590515,chr14,C14orf180,chr14:104579764-104590515,10751
82009177,82029955,chr7,CACNA2D1-AS1,chr7:82009177-82029955,20778
163413065,163413960,chr6,CAHM,chr6:163413065-163413960,895
118214669,118496171,chr7,ANKRD7,chr7:118214669-118496171,281502
151239967,151358559,chr6,AKAP12,chr6:151239967-151358559,118592
108023548,108130361,chr7,LAMB4,chr7:108023548-108130361,106813
20973036,21061586,chr13,LATS2,chr13:20973036-21061586,88550
80003887,80042527,chr6,TTK,chr6:80003887-80042527,38640
36140330,36166177,chr22,APOL3,chr22:36140330-36166177,25847
43571594,43603230,chr5,NNT-AS1,chr5:43571594-43603230,31636
24882279,24922889,chr13,CENPJ,chr13:24882279-24922889,40610
119623408,119729200,chr11,NECTIN1,chr11:119623408-119729200,105792
31639222,32855666,chr8,NRG1,chr8:31639222-32855666,1216444
147480917,147544954,chr4,EDNRA,chr4:147480917-147544954,64037
22814162,22916338,chr16,HS3ST2,chr16:22814162-22916338,102176
32689070,32791724,chr5,NPR3,chr5:32689070-32791724,102654
77324641,78213010,chr12,NAV3,chr12:77324641-78213010,888369
18983934,19063942,chr16,TMC7,chr16:18983934-19063942,80008
36189124,36204840,chr22,APOL4,chr22:36189124-36204840,15716
166733384,167234796,chr4,SPOCK3,chr4:166733384-167234796,501412
130404923,130428609,chr11,ADAMTS8,chr11:130404923-130428609,23686
6772708,6857366,chr19,VAV1,chr19:6772708-6857366,84658
22435598,22436818,chrX,METTL15P3,chrX:22435598-22436818,1220
53480626,53487134,chr5,FST,chr5:53480626-53487134,6508
101170496,101180293,chr7,NAT16,chr7:101170496-101180293,9797
34837549,34839278,chr5,TTC23L-AS1,chr5:34837549-34839278,1729
120273175,120750337,chr7,KCND2,chr7:120273175-120750337,477162
49210411,49223225,chr17,ABI3,chr17:49210411-49223225,12814
132444327,132449408,chr10,LINC02870,chr10:132444327-132449408,5081
30215563,30220089,chrX,MAGEB2,chrX:30215563-30220089,4526
151904431,151913968,chrX,MAGEA4-AS1,chrX:151904431-151913968,9537
151953124,151974680,chrX,GABRE,chrX:151953124-151974680,21556
143851375,143902198,chr7,TCAF1,chr7:143851375-143902198,50823
50834650,50842353,chr17,WFIKKN2,chr17:50834650-50842353,7703
119729583,119739623,chr11,NECTIN1-DT,chr11:119729583-119739623,10040
121292681,121313410,chr11,SC5D,chr11:121292681-121313410,20729
55392622,55421924,chr17,MMD,chr17:55392622-55421924,29302
68746125,68793964,chr12,SLC35E3,chr12:68746125-68793964,47839
107449652,107605255,chrX,FRMPD3,chrX:107449652-107605255,155603
52205392,52213583,chr12,LINC02874,chr12:52205392-52213583,8191
59619689,59696956,chr17,CLTC,chr17:59619689-59696956,77267
73820649,73852723,chrX,XIST,chrX:73820649-73852723,32074
3804024,3869038,chr19,ZFR2,chr19:3804024-3869038,65014
4628216,4656498,chr2,LINC01249,chr2:4628216-4656498,28282
14632700,14650814,chr2,LRATD1,chr2:14632700-14650814,18114
6887566,6940459,chr19,ADGRE1,chr19:6887566-6940459,52893
10690344,10692099,chr2,RN7SL832P,chr2:10690344-10692099,1755
87298772,87300447,chr6,HSPD1P10,chr6:87298772-87300447,1675
132814569,132817564,chr6,RPS12,chr6:132814569-132817564,2995
169986597,170033031,chr4,MFAP3L,chr4:169986597-170033031,46434
48543551,48551250,chr17,HOXB-AS1,chr17:48543551-48551250,7699
23951348,24178263,chr5,LINC02899,chr5:23951348-24178263,226915
102449837,102451543,chr10,C10orf95,chr10:102449837-102451543,1706
154387515,154510685,chr6,CNKSR3,chr6:154387515-154510685,123170
35951006,36001028,chr5,UGT3A1,chr5:35951006-36001028,50022
108934400,108950744,chr9,ABITRAM,chr9:108934400-108950744,16344
108942569,109013522,chr9,CTNNAL1,chr9:108942569-109013522,70953
104724229,104747325,chr14,ADSS1,chr14:104724229-104747325,23096
124865432,124881471,chr11,ROBO3,chr11:124865432-124881471,16039
19471296,20575873,chr5,CDH18,chr5:19471296-20575873,1104577
3094362,3123999,chr19,GNA11,chr19:3094362-3123999,29637
100483927,100494802,chr7,NYAP1,chr7:100483927-100494802,10875
110180141,110254275,chr6,CDC40,chr6:110180141-110254275,74134
90740823,90858039,chr10,HTR7,chr10:90740823-90858039,117216
130713016,130887675,chr9,ABL1,chr9:130713016-130887675,174659
58633967,58648321,chr14,DACT1,chr14:58633967-58648321,14354
90912096,90921087,chr10,ANKRD1,chr10:90912096-90921087,8991
34656328,34832612,chr5,RAI14,chr5:34656328-34832612,176284
185399537,185425979,chr4,UFSP2,chr4:185399537-185425979,26442
130664594,130682986,chr9,PRDM12,chr9:130664594-130682986,18392
98291650,98401090,chr7,BAIAP2L1,chr7:98291650-98401090,109440
154010496,154246867,chr6,OPRM1,chr6:154010496-154246867,236371
150692971,150765108,chrX,MTMR1,chrX:150692971-150765108,72137
3777970,3802129,chr19,MATK,chr19:3777970-3802129,24159
25257952,25261066,chr16,ZKSCAN2-DT,chr16:25257952-25261066,3114
52164115,52223813,chr12,LINC00592,chr12:52164115-52223813,59698
129175552,129178261,chr9,IER5L,chr9:129175552-129178261,2709
129321016,129324905,chr9,LINC02913,chr9:129321016-129324905,3889
11976734,12574287,chr16,SNX29,chr16:11976734-12574287,597553
82223681,82358805,chr12,CCDC59,chr12:82223681-82358805,135124
22297375,22335101,chr16,POLR3E,chr16:22297375-22335101,37726
50545899,50551023,chr22,KLHDC7B,chr22:50545899-50551023,5124
145110838,145180589,chr4,OTUD4,chr4:145110838-145180589,69751
35251070,35251829,chr13,PHBP13,chr13:35251070-35251829,759
35473789,35476689,chr13,MAB21L1,chr13:35473789-35476689,2900
16013928,16087201,chr2,GACAT3,chr2:16013928-16087201,73273
40890647,40891537,chrX,SDCBPP3,chrX:40890647-40891537,890
113102117,113111543,chr9,FAM225B,chr9:113102117-113111543,9426
41085445,41236579,chrX,USP9X,chrX:41085445-41236579,151134
50118254,50153734,chr20,PEDS1,chr20:50118254-50153734,35480
19351485,19358623,chr2,OSR1,chr2:19351485-19358623,7138
37695782,37700019,chr8,ZNF703,chr8:37695782-37700019,4237
4838341,4867694,chr19,PLIN3,chr19:4838341-4867694,29353
50184598,50191498,chr20,CEBPB-AS1,chr20:50184598-50191498,6900
32315086,32400268,chr13,BRCA2,chr13:32315086-32400268,85182
50292709,50315488,chr20,LINC01270,chr20:50292709-50315488,22779
50510321,50585241,chr20,PTPN1,chr20:50510321-50585241,74920
127940913,127941654,chr11,DNAJB6P1,chr11:127940913-127941654,741
101098188,101166126,chrX,CENPI,chrX:101098188-101166126,67938
128095758,128183671,chr11,LINC02725,chr11:128095758-128183671,87913
4608883,4615027,chr16,UBALD1,chr16:4608883-4615027,6144
122915566,122931512,chr9,ZBTB26,chr9:122915566-122931512,15946
47960185,47978160,chr8,MCM4,chr8:47960185-47978160,17975
67269358,67319953,chr12,CAND1,chr12:67269358-67319953,50595
156760454,156971799,chr4,PDGFC,chr4:156760454-156971799,211345
120354701,120355183,chr10,RPL21P16,chr10:120354701-120355183,482
120597949,120600124,chr10,LINC01561,chr10:120597949-120600124,2175
120457227,120592065,chr10,PLPP4,chr10:120457227-120592065,134838
122701668,122702922,chr7,RNF148,chr7:122701668-122702922,1254
50578959,50601455,chr22,CHKB,chr22:50578959-50601455,22496
21492658,21497260,chr10,MIR1915HG,chr10:21492658-21497260,4602
23298790,23311751,chr14,BCL2L2,chr14:23298790-23311751,12961
917287,921005,chr19,KISS1R,chr19:917287-921005,3718
130844191,130865561,chr11,LINC02551,chr11:130844191-130865561,21370
23306833,23326175,chr14,BCL2L2-PABPN1,chr14:23306833-23326175,19342
135662496,135693418,chr7,STMP1,chr7:135662496-135693418,30922
27402174,27452042,chr16,IL21R,chr16:27402174-27452042,49868
49827913,49841143,chr12,BCDIN3D-AS1,chr12:49827913-49841143,13230
68647666,68725842,chrX,STARD8,chrX:68647666-68725842,78176
2177180,2196605,chr16,CASKIN1,chr16:2177180-2196605,19425
11482341,11642788,chr2,GREB1,chr2:11482341-11642788,160447
47734363,47771040,chr12,RAPGEF3,chr12:47734363-47771040,36677
119651380,119677819,chr10,BAG3,chr10:119651380-119677819,26439
51354077,51454264,chr13,INTS6,chr13:51354077-51454264,100187
18791669,18801572,chr16,ARL6IP1,chr16:18791669-18801572,9903
154617609,154619282,chrX,CTAG1B,chrX:154617609-154619282,1673
154651972,154653579,chrX,CTAG2,chrX:154651972-154653579,1607
81175452,81221377,chr14,GTF2A1,chr14:81175452-81221377,45925
73995193,74121363,chr10,VCL,chr10:73995193-74121363,126170
112774503,112840831,chrX,AMOT,chrX:112774503-112840831,66328
78171249,78188626,chr11,KCTD21,chr11:78171249-78188626,17377
27313668,27364778,chr16,IL4R,chr16:27313668-27364778,51110
33547754,33567128,chr8,RNF122,chr8:33547754-33567128,19374
90200429,90223077,chr11,CHORDC1,chr11:90200429-90223077,22648
21750673,22853344,chr5,CDH12,chr5:21750673-22853344,1102671
19360056,19515508,chrX,MAP3K15,chrX:19360056-19515508,155452
100879753,100903722,chr14,RTL1,chr14:100879753-100903722,23969
4279266,4290722,chr19,SHD,chr19:4279266-4290722,11456
67386984,67412167,chr14,PLEK2,chr14:67386984-67412167,25183
38225218,38275558,chr8,DDHD2,chr8:38225218-38275558,50340
56815549,56896152,chr5,MAP3K1,chr5:56815549-56896152,80603
8806170,8832314,chr19,ZNF558,chr19:8806170-8832314,26144
37805229,37807432,chr22,H1-0,chr22:37805229-37807432,2203
125164687,125433389,chr11,PKNOX2,chr11:125164687-125433389,268702
165327667,165343164,chr4,MSMO1,chr4:165327667-165343164,15497
43486709,43515148,chr5,C5orf34,chr5:43486709-43515148,28439
32174471,32175272,chr5,GOLPH3-DT,chr5:32174471-32175272,801
34266041,34268649,chr16,BCLAF1P2,chr16:34266041-34268649,2608
166585604,166587594,chr6,RAMACL,chr6:166585604-166587594,1990
145757627,145938823,chr4,ZNF827,chr4:145757627-145938823,181196
54085132,54125992,chr12,FAM242C,chr12:54085132-54125992,40860
70654554,70763558,chr15,UACA,chr15:70654554-70763558,109004
2486414,2500976,chrX,ZBED1,chrX:2486414-2500976,14562
35169692,35170241,chr16,UBE2MP1,chr16:35169692-35170241,549
60751791,60844274,chr5,ELOVL7,chr5:60751791-60844274,92483
152750797,152759765,chr6,VIP,chr6:152750797-152759765,8968
21545666,21551461,chr22,RIMBP3C,chr22:21545666-21551461,5795
51452364,51554678,chr13,INTS6-AS1,chr13:51452364-51554678,102314
130070534,130135705,chr7,KLHDC10,chr7:130070534-130135705,65171
83363238,83649139,chr7,SEMA3E,chr7:83363238-83649139,285901
51454164,51461315,chr13,RPS4XP16,chr13:51454164-51461315,7151
154231742,154491799,chr4,DCHS2,chr4:154231742-154491799,260057
153355365,153413985,chr7,LINC01287,chr7:153355365-153413985,58620
136658856,136672678,chr9,EGFL7,chr9:136658856-136672678,13822
33706886,34738231,chr2,LINC01320,chr2:33706886-34738231,1031345
53103486,53124535,chr12,SOAT2,chr12:53103486-53124535,21049
151409176,151670503,chr4,FHIP1A,chr4:151409176-151670503,261327
129434432,129488399,chr7,STRIP2,chr7:129434432-129488399,53967
9067825,9504593,chr20,PLCB4,chr20:9067825-9504593,436768
96090107,96839562,chr13,HS6ST3,chr13:96090107-96839562,749455
27154824,27187953,chr10,MASTL,chr10:27154824-27187953,33129
56504635,56505072,chr5,RPL26P19,chr5:56504635-56505072,437
40530590,40897833,chr8,ZMAT4,chr8:40530590-40897833,367243
11199295,11262524,chr19,DOCK6,chr19:11199295-11262524,63229
99254732,99261744,chr13,GPR18,chr13:99254732-99261744,7012
60596912,60700190,chr5,DEPDC1B,chr5:60596912-60700190,103278
183444635,183449064,chr4,CDKN2AIP,chr4:183444635-183449064,4429
150361422,150514178,chrX,MAMLD1,chrX:150361422-150514178,152756
187746094,187748199,chr4,ADAM20P3,chr4:187746094-187748199,2105
39664982,39717963,chr2,TMEM178A,chr2:39664982-39717963,52981
74984505,75034558,chr8,CRISPLD1,chr8:74984505-75034558,50053
27246350,27259455,chr10,LRRC37A6P,chr10:27246350-27259455,13105
95162504,95549206,chr4,UNC5C,chr4:95162504-95549206,386702
93591573,93911265,chr7,GNGT1,chr7:93591573-93911265,319692
136712572,136724742,chr9,DIPK1B,chr9:136712572-136724742,12170
136738167,136743356,chr9,LCN10,chr9:136738167-136743356,5189
134331874,134378341,chr11,GLB1L2,chr11:134331874-134378341,46467
82358528,82479239,chr12,METTL25,chr12:82358528-82479239,120711
8621683,8649654,chr16,METTL22,chr16:8621683-8649654,27971
50719763,50831162,chr14,NIN,chr14:50719763-50831162,111399
96998038,97185959,chr10,SLIT1,chr10:96998038-97185959,187921
96194375,96269824,chr12,ELK3,chr12:96194375-96269824,75449
134378504,134412242,chr11,B3GAT1,chr11:134378504-134412242,33738
19992052,20012668,chr2,MATN3,chr2:19992052-20012668,20616
42795147,42798704,chr17,COA3,chr17:42795147-42798704,3557
136759634,136766255,chr9,LCN15,chr9:136759634-136766255,6621
100717526,101128641,chr12,ANO4,chr12:100717526-101128641,411115
49202791,49210574,chr17,GNGT2,chr17:49202791-49210574,7783
11833926,12702913,chr2,MIR3681HG,chr2:11833926-12702913,868987
33858576,33892076,chr11,LMO2,chr11:33858576-33892076,33500
51056598,51105276,chr15,TNFAIP8L3,chr15:51056598-51105276,48678
25161679,25172288,chr13,AMER2,chr13:25161679-25172288,10609
44564427,44620358,chr11,CD82,chr11:44564427-44620358,55931
42756818,42802439,chr5,CCDC152,chr5:42756818-42802439,45621
55307989,55425579,chr5,MTREX,chr5:55307989-55425579,117590
78666089,78719765,chr8,ZC2HC1A,chr8:78666089-78719765,53676
41909543,41915074,chr22,SHISA8,chr22:41909543-41915074,5531
124822386,124929983,chr7,POT1,chr7:124822386-124929983,107597
5412557,5459056,chr10,NET1,chr10:5412557-5459056,46499
136848724,136851027,chr9,PHPT1,chr9:136848724-136851027,2303
11814273,11835216,chr19,ZNF440,chr19:11814273-11835216,20943
136850943,136860799,chr9,MAMDC4,chr9:136850943-136860799,9856
30351873,30353518,chr8,TUBBP1,chr8:30351873-30353518,1645
30722771,30820542,chr2,CAPN13,chr2:30722771-30820542,97771
33094204,33129090,chr16,HERC2P8,chr16:33094204-33129090,34886
5638867,5666595,chr10,ASB13,chr10:5638867-5666595,27728
83637805,83720855,chr5,HAPLN1,chr5:83637805-83720855,83050
43879678,43892013,chr22,PNPLA5,chr22:43879678-43892013,12335
5684838,5763740,chr10,TASOR2,chr10:5684838-5763740,78902
27330827,27363234,chr11,CCDC34,chr11:27330827-27363234,32407
36281280,36388010,chr22,MYH9,chr22:36281280-36388010,106730
61057158,61501645,chr8,CLVS1,chr8:61057158-61501645,444487
76173629,76174183,chr5,RAP1BL,chr5:76173629-76174183,554
32946953,33399509,chr2,LTBP1,chr2:32946953-33399509,452556
136361903,136373681,chr9,CARD9,chr9:136361903-136373681,11778
83471618,83582303,chr5,VCAN,chr5:83471618-83582303,110685
5765223,5842132,chr10,GDI2,chr10:5765223-5842132,76909
4292232,4302431,chr19,TMIGD2,chr19:4292232-4302431,10199
136401922,136410614,chr9,ENTR1,chr9:136401922-136410614,8692
115920248,115943181,chr11,LINC02703,chr11:115920248-115943181,22933
153411472,153426481,chrX,ZFP92,chrX:153411472-153426481,15009
14621634,14622242,chr19,ITGB1P1,chr19:14621634-14622242,608
186286094,186500997,chr4,F11-AS1,chr4:186286094-186500997,214903
135881063,135893444,chrX,CT45A10,chrX:135881063-135893444,12381
80106647,80346270,chr6,BCKDHB,chr6:80106647-80346270,239623
109422190,109429167,chr11,C11orf87,chr11:109422190-109429167,6977
19856691,19886167,chr16,GPRC5B,chr16:19856691-19886167,29476
5594984,5632566,chr10,LASTR,chr10:5594984-5632566,37582
91779261,92623230,chrX,PCDH11X,chrX:91779261-92623230,843969
93496612,93529092,chr10,CEP55,chr10:93496612-93529092,32480
107743949,107761667,chr7,CBLL1,chr7:107743949-107761667,17718
56593699,56595611,chr17,NOG,chr17:56593699-56595611,1912
130144315,130365425,chr6,SAMD3,chr6:130144315-130365425,221110
50055968,50090481,chr17,ITGA3,chr17:50055968-50090481,34513
74445136,74455005,chr4,AREG,chr4:74445136-74455005,9869
135926760,135977359,chr7,MTPN,chr7:135926760-135977359,50599
95549129,95552457,chr4,UNC5C-AS1,chr4:95549129-95552457,3328
2134134,2134209,chr11,MIR483,chr11:2134134-2134209,75
37244743,37449463,chr4,NWD2,chr4:37244743-37449463,204720
35648446,35668404,chr22,APOL6,chr22:35648446-35668404,19958
112819147,112939875,chr7,BMT2,chr7:112819147-112939875,120728
74968189,74968292,chr11,RNU6-216P,chr11:74968189-74968292,103
76347904,76905444,chr15,SCAPER,chr15:76347904-76905444,557540
61500556,61714640,chr8,ASPH,chr8:61500556-61714640,214084
105974826,105974931,chr11,RNU6-277P,chr11:105974826-105974931,105
105447796,105552433,chr9,FSD1L,chr9:105447796-105552433,104637
32531633,32604079,chr5,SUB1,chr5:32531633-32604079,72446
87966441,87974753,chr9,CDK20,chr9:87966441-87974753,8312
14819245,14838575,chr10,CDNF,chr10:14819245-14838575,19330
110936759,110939784,chr13,PARP1P1,chr13:110936759-110939784,3025
14838306,14871741,chr10,HSPA14,chr10:14838306-14871741,33435
37826660,37862937,chr4,PGM2,chr4:37826660-37862937,36277
129834698,129881828,chr9,USP20,chr9:129834698-129881828,47130
139581770,139708227,chrX,MCF2,chrX:139581770-139708227,126457
56101573,56106476,chr7,CHCHD2,chr7:56101573-56106476,4903
46702282,46790407,chr16,MYLK3,chr16:46702282-46790407,88125
75434640,75525941,chr11,GDPD5,chr11:75434640-75525941,91301
155208636,155217078,chr4,NPY2R,chr4:155208636-155217078,8442
36253071,36267530,chr22,APOL1,chr22:36253071-36267530,14459
103302796,103351144,chr10,PCGF6,chr10:103302796-103351144,48348
35802869,35803280,chr16,HMGN2P41,chr16:35802869-35803280,411
114334156,114394405,chr9,AKNA,chr9:114334156-114394405,60249
48244300,48363122,chr16,LONP2,chr16:48244300-48363122,118822
103087185,103277605,chr10,NT5C2,chr10:103087185-103277605,190420
71343427,71420745,chr6,LINC00472,chr6:71343427-71420745,77318
190057902,190063005,chr4,CLUHP4,chr4:190057902-190063005,5103
93958191,93961540,chr10,PIPSL,chr10:93958191-93961540,3349
24935098,24946695,chr22,TMEM211,chr22:24935098-24946695,11597
20667144,20679243,chr2,GDF7,chr2:20667144-20679243,12099
67189393,67228550,chr14,FAM71D,chr14:67189393-67228550,39157
139726346,139945276,chrX,ATP11C,chrX:139726346-139945276,218930
25212564,25231870,chr22,CRYBB2,chr22:25212564-25231870,19306
15878023,15898077,chr19,CYP4F2,chr19:15878023-15898077,20054
67294371,67360265,chr14,ATP6V1D,chr14:67294371-67360265,65894
79631329,79703655,chr6,SH3BGRL2,chr6:79631329-79703655,72326
46884362,46931289,chr16,GPT2,chr16:46884362-46931289,46927
183653572,183653676,chr4,RNU6-479P,chr4:183653572-183653676,104
31639131,32110932,chr5,PDZD2,chr5:31639131-32110932,471801
124257606,124353307,chr9,NEK6,chr9:124257606-124353307,95701
189709539,189709714,chr4,RNU1-51P,chr4:189709539-189709714,175
47847233,47914667,chr4,NFXL1,chr4:47847233-47914667,67434
151912495,151925171,chrX,MAGEA4,chrX:151912495-151925171,12676
120236640,120319945,chr11,POU2F3,chr11:120236640-120319945,83305
681670,684528,chr16,JMJD8,chr16:681670-684528,2858
133300103,133415489,chrX,GPC4,chrX:133300103-133415489,115386
87318416,87412930,chr5,CCNH,chr5:87318416-87412930,94514
133670971,133671386,chrX,RPS24P19,chrX:133670971-133671386,415
100427143,100451734,chr9,MSANTD3,chr9:100427143-100451734,24591
49250438,49270477,chrX,FOXP3,chrX:49250438-49270477,20039
28392448,28417317,chr2,FOSL2,chr2:28392448-28417317,24869
14472466,14475354,chr19,PTGER1,chr19:14472466-14475354,2888
37120574,37358149,chr9,ZCCHC7,chr9:37120574-37358149,237575
47914142,48040173,chr4,NIPAL1,chr4:47914142-48040173,126031
31104772,31120069,chr22,SELENOM,chr22:31104772-31120069,15297
48066393,48134250,chr4,TXK,chr4:48066393-48134250,67857
46923075,46975524,chr17,GOSR2,chr17:46923075-46975524,52449
52590960,52659301,chr4,USP46,chr4:52590960-52659301,68341
134465,254637,chr10,ZMYND11,chr10:134465-254637,120172
53082367,53088540,chrX,TSPYL2,chrX:53082367-53088540,6173
64631621,64751005,chr2,SERTAD2,chr2:64631621-64751005,119384
66439088,66444221,chr2,MEIS1-AS2,chr2:66439088-66444221,5133
55865967,55924139,chr2,EFEMP1,chr2:55865967-55924139,58172
52722618,52751586,chr4,ERVMER34-1,chr4:52722618-52751586,28968
64449074,64451657,chr11,LINC02724,chr11:64449074-64451657,2583
80779343,80951776,chr15,CEMIP,chr15:80779343-80951776,172433
52989340,53094779,chr5,ITGA2,chr5:52989340-53094779,105439
164915565,164916983,chr4,TRIM60P14,chr4:164915565-164916983,1418
164943290,164943937,chr4,NACA3P,chr4:164943290-164943937,647
111316184,111344249,chr13,TEX29,chr13:111316184-111344249,28065
149262171,149297302,chr7,ZNF783,chr7:149262171-149297302,35131
60756253,60802086,chr2,PAPOLG,chr2:60756253-60802086,45833
40824535,40856639,chr22,ST13,chr22:40824535-40856639,32104
76880175,76886405,chr13,KCTD12,chr13:76880175-76886405,6230
70628744,70646824,chr4,ENAM,chr4:70628744-70646824,18080
139523685,139544985,chr7,CLEC2L,chr7:139523685-139544985,21300
70688532,70690551,chr4,UTP3,chr4:70688532-70690551,2019
150625375,150632648,chr7,GIMAP6,chr7:150625375-150632648,7273
141738334,141787922,chr7,SSBP1,chr7:141738334-141787922,49588
66696190,66703252,chr2,LINC01797,chr2:66696190-66703252,7062
149963943,149973715,chr6,ULBP1,chr6:149963943-149973715,9772
25111731,25178231,chr16,LCMT1,chr16:25111731-25178231,66500
107490106,107661306,chr6,SOBP,chr6:107490106-107661306,171200
26243170,26290465,chr2,HADHB,chr2:26243170-26290465,47295
43197280,43343372,chr22,SCUBE1,chr22:43197280-43343372,146092
46578591,46621379,chr16,SHCBP1,chr16:46578591-46621379,42788
39921042,39925880,chr15,GPR176-DT,chr15:39921042-39925880,4838
77042474,77327094,chr13,MYCBP2,chr13:77042474-77327094,284620
75407914,75566834,chr8,HNF4G,chr8:75407914-75566834,158920
52712325,52723623,chr4,DANCR,chr4:52712325-52723623,11298
68232003,68300035,chr9,CBWD3,chr9:68232003-68300035,68032
17292131,17310236,chr19,ABHD8,chr19:17292131-17310236,18105
160453428,160520269,chr6,LPAL2,chr6:160453428-160520269,66841
27787528,28063714,chr16,GSG1L,chr16:27787528-28063714,276186
51767993,51804163,chr13,DHRS12,chr13:51767993-51804163,36170
139561570,139777998,chr7,HIPK2,chr7:139561570-139777998,216428
52020706,52038299,chr4,SGCB,chr4:52020706-52038299,17593
77013751,77014028,chr8,HIGD1AP18,chr8:77013751-77014028,277
37812677,37840041,chr5,GDNF,chr5:37812677-37840041,27364
100028455,100142874,chr12,UHRF1BP1L,chr12:100028455-100142874,114419
157381133,157678157,chr6,ZDHHC14,chr6:157381133-157678157,297024
85214048,85220421,chr8,RBIS,chr8:85214048-85220421,6373
23856703,23886312,chr22,SLC2A11,chr22:23856703-23886312,29609
51553436,51647132,chr16,HNRNPA1P48,chr16:51553436-51647132,93696
112967484,112968824,chr13,MCF2L-AS1,chr13:112967484-112968824,1340
61202350,61203220,chr8,NPM1P6,chr8:61202350-61203220,870
130538954,130546900,chr7,COPG2IT1,chr7:130538954-130546900,7946
78835307,78840525,chr8,LINC02605,chr8:78835307-78840525,5218
80111651,80256048,chr5,SERINC5,chr5:80111651-80256048,144397
73420369,73747708,chr8,STAU2,chr8:73420369-73747708,327339
55389700,55506691,chr16,MMP2,chr16:55389700-55506691,116991
36876769,37066413,chr5,NIPBL,chr5:36876769-37066413,189644
130853720,130930682,chr7,LINC00513,chr7:130853720-130930682,76962
10172395,10308258,chr20,SNAP25,chr20:10172395-10308258,135863
98261384,98443858,chr4,RAP1GDS1,chr4:98261384-98443858,182474
51630313,52160017,chr17,CA10,chr17:51630313-52160017,529704
107044705,107161811,chr7,PRKAR2B,chr7:107044705-107161811,117106
64917553,64934475,chr11,PPP2R5B,chr11:64917553-64934475,16922
55846154,55956031,chr16,CES5A,chr16:55846154-55956031,109877
143060496,143341058,chr6,AIG1,chr6:143060496-143341058,280562
46557823,46684467,chr20,SLC13A3,chr20:46557823-46684467,126644
17351450,17377342,chr19,PLVAP,chr19:17351450-17377342,25892
5225464,5229395,chr11,HBB,chr11:5225464-5229395,3931
40686183,40695107,chr15,RAD51-AS1,chr15:40686183-40695107,8924
5232678,5243657,chr11,HBD,chr11:5232678-5243657,10979
136249973,136306901,chr9,CCDC187,chr9:136249973-136306901,56928
84980440,85139145,chr15,PDE8A,chr15:84980440-85139145,158705
43495073,43496454,chr5,EEF1A1P19,chr5:43495073-43496454,1381
56505209,56524959,chr4,ARL9,chr4:56505209-56524959,19750
17281645,17287646,chr19,ANKLE1,chr19:17281645-17287646,6001
33104082,33167356,chr9,B4GALT1,chr9:33104082-33167356,63274
81972023,82276857,chr5,ATG10,chr5:81972023-82276857,304834
63119559,63827843,chr2,WDPCP,chr2:63119559-63827843,708284
3308565,3346652,chrX,MXRA5,chrX:3308565-3346652,38087
3271544,3290158,chrX,LINC01546,chrX:3271544-3290158,18614
73686089,74133929,chr13,KLF12,chr13:73686089-74133929,447840
134549110,134579875,chr7,AKR1B15,chr7:134549110-134579875,30765
132743870,132763459,chr6,VNN2,chr6:132743870-132763459,19589
48653711,48711226,chr13,CYSLTR2,chr13:48653711-48711226,57515
61017225,61051990,chr2,PEX13,chr2:61017225-61051990,34765
96985713,96994730,chr13,OXGR1,chr13:96985713-96994730,9017
57471922,57487327,chr16,DOK4,chr16:57471922-57487327,15405
37582646,37592604,chr9,TOMM5,chr9:37582646-37592604,9958
37650954,37746904,chr9,FRMPD1,chr9:37650954-37746904,95950
78675743,78805523,chr8,IL7,chr8:78675743-78805523,129780
65665928,65723035,chr5,SGTB,chr5:65665928-65723035,57107
61824848,61854143,chr2,FAM161A,chr2:61824848-61854143,29295
32124716,32174319,chr5,GOLPH3,chr5:32124716-32174319,49603
7951263,8611924,chr3,LMCD1-AS1,chr3:7951263-8611924,660661
98213402,98214121,chr5,PSME2P1,chr5:98213402-98214121,719
79762371,79767857,chr8,HEY1,chr8:79762371-79767857,5486
58251440,58252525,chr2,EIF3FP3,chr2:58251440-58252525,1085
52377167,52416373,chr13,THSD1,chr13:52377167-52416373,39206
77784881,77786003,chr5,ACTBP2,chr5:77784881-77786003,1122
57758217,57863053,chr16,KIFC3,chr16:57758217-57863053,104836
39371675,39462300,chr5,DAB2,chr5:39371675-39462300,90625
52412602,52450634,chr13,VPS36,chr13:52412602-52450634,38032
72942036,73075619,chr2,SFXN5,chr2:72942036-73075619,133583
66114604,66154568,chr7,CRCP,chr7:66114604-66154568,39964
27869883,27992673,chr8,SCARA5,chr8:27869883-27992673,122790
3390780,3391752,chr11,OR7E12P,chr11:3390780-3391752,972
152826994,152830757,chrX,CETN2,chrX:152826994-152830757,3763
152830967,152869729,chrX,NSDHL,chrX:152830967-152869729,38762
152988824,152994116,chrX,PNMA5,chrX:152988824-152994116,5292
59171430,59208588,chr11,DTX4,chr11:59171430-59208588,37158
130013699,130141449,chr6,L3MBTL3,chr6:130013699-130141449,127750
64739891,64775589,chr15,RBPMS2,chr15:64739891-64775589,35698
52455429,52476628,chr13,CKAP2,chr13:52455429-52476628,21199
90791741,90959393,chr8,NECAB1,chr8:90791741-90959393,167652
3667965,3682246,chr20,ADAM33,chr20:3667965-3682246,14281
17323223,17334855,chr19,ANO8,chr19:17323223-17334855,11632
131009174,131094473,chr9,LAMC3,chr9:131009174-131094473,85299
94249253,94262350,chr8,GEM,chr8:94249253-94262350,13097
91101832,91219236,chr8,LRRC69,chr8:91101832-91219236,117404
70829130,70854157,chr15,LARP6,chr15:70829130-70854157,25027
52390515,52535701,chr17,LINC01982,chr17:52390515-52535701,145186
23983716,24027186,chrX,KLHL15,chrX:23983716-24027186,43470
10445310,10833654,chrX,MID1,chrX:10445310-10833654,388344
56451627,56481946,chr5,LINC01948,chr5:56451627-56481946,30319
53990624,54030823,chr12,HOXC6,chr12:53990624-54030823,40199
90958471,90985238,chr8,C8orf88,chr8:90958471-90985238,26767
173331376,173334432,chr4,HMGB2,chr4:173331376-173334432,3056
24076526,24169640,chr2,FAM228B,chr2:24076526-24169640,93114
85172077,85177062,chr8,E2F5-DT,chr8:85172077-85177062,4985
117907264,118317676,chr6,SLC35F1,chr6:117907264-118317676,410412
127866486,127877675,chr9,AK1,chr9:127866486-127877675,11189
139371807,139374648,chr6,CITED2,chr6:139371807-139374648,2841
17613678,17682295,chr20,RRBP1,chr20:17613678-17682295,68617
14675141,14773036,chr3,C3orf20,chr3:14675141-14773036,97895
97221434,97394120,chr13,MBNL2,chr13:97221434-97394120,172686
96039362,96093971,chr14,C14orf132,chr14:96039362-96093971,54609
76310712,76501837,chr14,ESRRB,chr14:76310712-76501837,191125
17841199,18021876,chr4,LCORL,chr4:17841199-18021876,180677
1612337,1677908,chr16,CRAMP1,chr16:1612337-1677908,65571
35852695,35879603,chr5,IL7R,chr5:35852695-35879603,26908
150568417,150673143,chrX,MTM1,chrX:150568417-150673143,104726
96204679,96244166,chr14,BDKRB2,chr14:96204679-96244166,39487
107660828,107717809,chr7,SLC26A4,chr7:107660828-107717809,56981
66964707,67033398,chr17,CACNG4,chr17:66964707-67033398,68691
15166914,15561334,chr2,NBAS,chr2:15166914-15561334,394420
68159218,68159893,chr5,EEF1B2P2,chr5:68159218-68159893,675
71828167,72118393,chr8,MSC-AS1,chr8:71828167-72118393,290226
64449106,64505213,chr14,ZBTB25,chr14:64449106-64505213,56107
139301505,139420033,chr4,NAA15,chr4:139301505-139420033,118528
71754863,71800286,chr12,RAB21,chr12:71754863-71800286,45423
31532638,31637616,chr3,STT3B,chr3:31532638-31637616,104978
99981784,99986765,chr13,ZIC2,chr13:99981784-99986765,4981
150766336,150898816,chrX,CD99L2,chrX:150766336-150898816,132480
96639577,96655317,chr9,PRXL2C,chr9:96639577-96655317,15740
99962964,99971767,chr13,ZIC5,chr13:99962964-99971767,8803
27916774,28059268,chr3,LINC01967,chr3:27916774-28059268,142494
20923222,20950697,chr19,ZNF85,chr19:20923222-20950697,27475
16802651,17090604,chr3,PLCL2,chr3:16802651-17090604,287953
117180628,117181095,chr9,RPL10P3,chr9:117180628-117181095,467
1692731,1712344,chr4,SLBP,chr4:1692731-1712344,19613
45293445,45308529,chr20,MATN4,chr20:45293445-45308529,15084
16141556,16141624,chr6,MIR4639,chr6:16141556-16141624,68
74748628,74769353,chr17,SLC9A3R1,chr17:74748628-74769353,20725
141704003,141738346,chr7,WEE2-AS1,chr7:141704003-141738346,34343
55547292,55618880,chr2,PPP4R3B,chr2:55547292-55618880,71588
53180704,53195142,chr12,ZNF740,chr12:53180704-53195142,14438
18940235,18947452,chr19,HOMER3-AS1,chr19:18940235-18947452,7217
67662945,67667265,chr16,ENKD1,chr16:67662945-67667265,4320
100473708,100564414,chr12,NR1H4,chr12:100473708-100564414,90706
48878134,48880173,chr15,EID1,chr15:48878134-48880173,2039
137227341,137343774,chr7,PTN,chr7:137227341-137343774,116433
17375200,17735994,chrX,NHS,chrX:17375200-17735994,360794
124030921,124033067,chr7,TMEM229A,chr7:124030921-124033067,2146
99606669,99909459,chr13,CLYBL,chr13:99606669-99909459,302790
61055399,61055964,chr16,RPS27AP16,chr16:61055399-61055964,565
89829894,89874436,chr6,CASP8AP2,chr6:89829894-89874436,44542
66720893,66751609,chr16,DYNC1LI2,chr16:66720893-66751609,30716
91954967,92103286,chr8,RUNX1T1,chr8:91954967-92103286,148319
77425970,77620611,chr5,WDR41,chr5:77425970-77620611,194641
61187463,61471087,chr2,USP34,chr2:61187463-61471087,283624
42796502,42858106,chr22,ARFGAP3,chr22:42796502-42858106,61604
83654088,84039842,chr15,ADAMTSL3,chr15:83654088-84039842,385754
52977948,52995304,chr6,GSTA4,chr6:52977948-52995304,17356
48607232,48633572,chr17,HOXB7,chr17:48607232-48633572,26340
48646923,48707346,chr17,LINC02086,chr17:48646923-48707346,60423
100156357,100173659,chr12,GOLGA2P5,chr12:100156357-100173659,17302
155297776,155310235,chr7,INSIG1,chr7:155297776-155310235,12459
106955719,106978778,chr12,TMEM263,chr12:106955719-106978778,23059
134460165,134520513,chrX,HPRT1,chrX:134460165-134520513,60348
52436417,52547802,chr16,TOX3,chr16:52436417-52547802,111385
76351797,76559809,chr12,OSBPL8,chr12:76351797-76559809,208012
152759749,152855378,chr7,ACTR3B,chr7:152759749-152855378,95629
35048756,35230487,chr5,PRLR,chr5:35048756-35230487,181731
67397322,67412089,chr2,ETAA1,chr2:67397322-67412089,14767
36676460,36687337,chr6,CDKN1A,chr6:36676460-36687337,10877
21082159,21125270,chr19,ZNF714,chr19:21082159-21125270,43111
43222402,43226606,chr2,ZFP36L2,chr2:43222402-43226606,4204
97960703,97973833,chr15,ARRDC4,chr15:97960703-97973833,13130
19870723,19871299,chr19,BNIP3P10,chr19:19870723-19871299,576
19538248,19546659,chr19,CILP2,chr19:19538248-19546659,8411
92420860,92422735,chr15,ENO1P2,chr15:92420860-92422735,1875
38724486,38729372,chr20,SLC32A1,chr20:38724486-38729372,4886
37052626,37183689,chr3,LRRFIP2,chr3:37052626-37183689,131063
19561707,19618693,chr19,PBX4,chr19:19561707-19618693,56986
5085341,5089487,chr6,PPP1R3G,chr6:5085341-5089487,4146
18683678,18782333,chr19,CRTC1,chr19:18683678-18782333,98655
21498133,21511342,chr14,METTL3,chr14:21498133-21511342,13209
128686535,128813267,chr11,FLI1,chr11:128686535-128813267,126732
134442356,134459284,chr7,AKR1B1,chr7:134442356-134459284,16928
84655129,84658563,chr15,NMB,chr15:84655129-84658563,3434
20221869,20222463,chr19,BNIP3P17,chr19:20221869-20222463,594
22052430,22091480,chr19,ZNF257,chr19:22052430-22091480,39050
69667046,69834978,chr8,SLCO5A1,chr8:69667046-69834978,167932
53776048,53819722,chr5,LINC02105,chr5:53776048-53819722,43674
149867697,149880610,chr7,ATP6V0E2-AS1,chr7:149867697-149880610,12913
111223653,111494886,chr5,CAMK4,chr5:111223653-111494886,271233
138460259,138589996,chr7,TRIM24,chr7:138460259-138589996,129737
108308519,108467531,chr11,C11orf65,chr11:108308519-108467531,159012
16549831,16572415,chr19,SLC35E1,chr19:16549831-16572415,22584
90001405,90053633,chr8,DECR1,chr8:90001405-90053633,52228
21705659,21718481,chr20,PAX1,chr20:21705659-21718481,12822
123396795,123403760,chr4,SPRY1,chr4:123396795-123403760,6965
84821650,84907008,chr2,TRABD2A,chr2:84821650-84907008,85358
117453817,117569858,chr6,DCBLD1,chr6:117453817-117569858,116041
50237563,50312229,chr14,L2HGDH,chr14:50237563-50312229,74666
56963350,56977606,chr4,NOA1,chr4:56963350-56977606,14256
54948015,54984762,chr12,TESPA1,chr12:54948015-54984762,36747
56977722,57031158,chr4,POLR2B,chr4:56977722-57031158,53436
114784652,114806039,chr9,TNFSF15,chr9:114784652-114806039,21387
78810487,78898139,chr15,MORF4L1,chr15:78810487-78898139,87652
114587706,114598915,chr9,ATP6V1G1,chr9:114587706-114598915,11209
61942605,62065278,chr17,MED13,chr17:61942605-62065278,122673
50326265,50416461,chr14,CDKL1,chr14:50326265-50416461,90196
75469302,75569722,chr2,EVA1A,chr2:75469302-75569722,100420
20134655,20217404,chr7,MACC1,chr7:20134655-20217404,82749
140177184,140179640,chr7,KDM7A-DT,chr7:140177184-140179640,2456
134527567,134541412,chr7,AKR1B10,chr7:134527567-134541412,13845
27715949,27722711,chr3,EOMES,chr3:27715949-27722711,6762
121839527,121863596,chr12,HPD,chr12:121839527-121863596,24069
15878047,15879571,chr3,IMPDH1P8,chr3:15878047-15879571,1524
67893254,67929676,chr16,PSKH1,chr16:67893254-67929676,36422
100385009,100464921,chr6,SIM1,chr6:100385009-100464921,79912
112074086,112085150,chr11,NKAPD1,chr11:112074086-112085150,11064
29054570,29290726,chr3,RBMS3-AS3,chr3:29054570-29290726,236156
32444379,32483319,chr17,PSMD11,chr17:32444379-32483319,38940
116687305,116701300,chr9,TRIM32,chr9:116687305-116701300,13995
139339457,139346328,chr7,FMC1,chr7:139339457-139346328,6871
67086446,67311439,chr2,LINC01828,chr2:67086446-67311439,224993
121667946,121696995,chr4,ANXA5,chr4:121667946-121696995,29049
20077994,20127076,chr19,ZNF90,chr19:20077994-20127076,49082
135889205,135913062,chrX,SAGE1,chrX:135889205-135913062,23857
34905260,34918989,chr5,RAD1,chr5:34905260-34918989,13729
129611720,129757082,chr7,NRF1,chr7:129611720-129757082,145362
61868085,61888671,chr2,CCT4,chr2:61868085-61888671,20586
45919131,45992120,chr12,SCAF11,chr12:45919131-45992120,72989
109462594,109483219,chr6,ZBTB24,chr6:109462594-109483219,20625
48595751,48604992,chr17,HOXB6,chr17:48595751-48604992,9241
15522807,15663058,chr6,DTNBP1,chr6:15522807-15663058,140251
112175510,112224699,chr11,BCO2,chr11:112175510-112224699,49189
27797552,27931579,chr3,LINC01980,chr3:27797552-27931579,134027
19404045,19720801,chr12,AEBP2,chr12:19404045-19720801,316756
14489107,14556075,chr3,GRIP2,chr3:14489107-14556075,66968
112226367,112269955,chr11,PTS,chr11:112226367-112269955,43588
121801318,121817021,chr4,EXOSC9,chr4:121801318-121817021,15703
3722614,3751713,chr6,PXDC1,chr6:3722614-3751713,29099
8501807,8574668,chr3,LMCD1,chr3:8501807-8574668,72861
32934396,33820863,chr14,NPAS3,chr14:32934396-33820863,886467
15640897,15662825,chr19,CYP4F3,chr19:15640897-15662825,21928
58588809,58749791,chr15,ADAM10,chr15:58588809-58749791,160982
98024851,98046469,chr8,RPL30,chr8:98024851-98046469,21618
55634061,55693863,chr2,PNPT1,chr2:55634061-55693863,59802
26622806,26717537,chr3,LRRC3B,chr3:26622806-26717537,94731
149126416,149183042,chr7,ZNF398,chr7:149126416-149183042,56626
55264960,55325187,chr17,HLF,chr17:55264960-55325187,60227
23203020,23591794,chr3,UBE2E2,chr3:23203020-23591794,388774
138594285,138701362,chr7,SVOPL,chr7:138594285-138701362,107077
121816444,121823883,chr4,CCNA2,chr4:121816444-121823883,7439
33613848,33614009,chr9,PRSS3P4,chr9:33613848-33614009,161
33624274,33625293,chr9,ANXA2P2,chr9:33624274-33625293,1019
78997564,79236038,chr5,DMGDH,chr5:78997564-79236038,238474
33676785,33688011,chr9,PTENP1-AS,chr9:33676785-33688011,11226
33817160,33920399,chr9,UBE2R2,chr9:33817160-33920399,103239
131110096,131496632,chr7,MKLN1,chr7:131110096-131496632,386536
76235055,76235623,chr16,RPL18P13,chr16:76235055-76235623,568
72112157,72176878,chr16,PMFBP1,chr16:72112157-72176878,64721
47345158,47387601,chr2,EPCAM,chr2:47345158-47387601,42443
87724051,87731469,chr9,CTSL,chr9:87724051-87731469,7418
93718542,94070898,chr15,LINC01579,chr15:93718542-94070898,352356
121874481,121952060,chr4,TRPC3,chr4:121874481-121952060,77579
49773283,49827873,chr22,BRD1,chr22:49773283-49827873,54590
83447228,83618743,chr15,SH3GL3,chr15:83447228-83618743,171515
27830573,28180795,chr7,JAZF1,chr7:27830573-28180795,350222
14737152,14910995,chr9,FREM1,chr9:14737152-14910995,173843
90993802,91040872,chr8,PIP4P2,chr8:90993802-91040872,47070
82031678,82034204,chr17,RAC3,chr17:82031678-82034204,2526
55424854,55534969,chr5,PLPP1,chr5:55424854-55534969,110115
54455950,54473602,chr12,GTSF1,chr12:54455950-54473602,17652
77788564,77980107,chr16,VAT1L,chr16:77788564-77980107,191543
96235427,96239149,chr8,UQCRB-AS1,chr8:96235427-96239149,3722
98769618,98773469,chr5,RGMB-AS1,chr5:98769618-98773469,3851
20175013,20177063,chr19,BNIP3P16,chr19:20175013-20177063,2050
45005182,45009452,chr2,SIX2,chr2:45005182-45009452,4270
15604381,15681679,chr4,FBXL5,chr4:15604381-15681679,77298
48458537,48470260,chrX,SLC38A5,chrX:48458537-48470260,11723
71130632,71150101,chr2,MPHOSPH10,chr2:71130632-71150101,19469
3023142,3023772,chr6,HTATSF1P2,chr6:3023142-3023772,630
3118374,3153578,chr6,BPHL,chr6:3118374-3153578,35204
26764284,26781231,chr2,SLC35F6,chr2:26764284-26781231,16947
102913000,102945111,chr7,LRRC17,chr7:102913000-102945111,32111
139777051,140020325,chr7,TBXAS1,chr7:139777051-140020325,243274
35210343,35214985,chr11,CD44-AS1,chr11:35210343-35214985,4642
76277278,76560757,chr16,CNTNAP4,chr16:76277278-76560757,283479
100062275,100067954,chr5,GUSBP7,chr5:100062275-100067954,5679
103576231,103587729,chrX,TCEAL4,chrX:103576231-103587729,11498
70258978,70354873,chr9,SMC5,chr9:70258978-70354873,95895
24424565,24495205,chr6,GPLD1,chr6:24424565-24495205,70640
35251205,35420063,chr11,SLC1A2,chr11:35251205-35420063,168858
100849831,100876836,chr15,GCAWKR,chr15:100849831-100876836,27005
90529344,91164437,chr5,ADGRV1,chr5:90529344-91164437,635093
27638483,27646483,chr19,ERVK-28,chr19:27638483-27646483,8000
96797304,96954846,chr14,VRK1,chr14:96797304-96954846,157542
24098425,24098980,chr19,BNIP3P40,chr19:24098425-24098980,555
50560715,50627474,chr17,CACNA1G,chr17:50560715-50627474,66759
43227210,43228855,chr2,LINC01126,chr2:43227210-43228855,1645
99098217,99135593,chr15,SYNM,chr15:99098217-99135593,37376
153785766,153794512,chrX,IDH3G,chrX:153785766-153794512,8746
42500553,42512562,chr22,SERHL,chr22:42500553-42512562,12009
159028175,159144867,chr7,VIPR2,chr7:159028175-159144867,116692
34942270,35673022,chr13,NBEA,chr13:34942270-35673022,730752
23390605,23402726,chr22,ZDHHC8P1,chr22:23390605-23402726,12121
23396446,23396516,chr7,SNORD65C,chr7:23396446-23396516,70
123960212,124422664,chrX,STAG2,chrX:123960212-124422664,462452
132410043,132573319,chr9,CFAP77,chr9:132410043-132573319,163276
135521438,135526540,chr9,LCN1,chr9:135521438-135526540,5102
42364387,42369284,chr22,LINC01315,chr22:42364387-42369284,4897
31149979,31349436,chr19,TSHZ3,chr19:31149979-31349436,199457
25448080,25520856,chr22,CRYBB2P1,chr22:25448080-25520856,72776
109690609,109878098,chr6,FIG4,chr6:109690609-109878098,187489
70655541,70681817,chr4,JCHAIN,chr4:70655541-70681817,26276
49495610,49528981,chr13,PHF11,chr13:49495610-49528981,33371
40538127,40546928,chr7,SUGCT-AS1,chr7:40538127-40546928,8801
67666814,67668757,chr16,C16orf86,chr16:67666814-67668757,1943
77047155,77076309,chr4,CCNI,chr4:77047155-77076309,29154
57447425,57461270,chr16,COQ9,chr16:57447425-57461270,13845
15564074,15584709,chr19,CYP4F23P,chr19:15564074-15584709,20635
106357748,106510198,chr12,POLR3B,chr12:106357748-106510198,152450
107470018,107475684,chr7,GPR22,chr7:107470018-107475684,5666
21102984,21122286,chr22,BCRP2,chr22:21102984-21122286,19302
33299934,33302534,chr19,CEBPA,chr19:33299934-33302534,2600
119006347,119070902,chr5,DMXL1-DT,chr5:119006347-119070902,64555
95620087,95622142,chr5,GPR150,chr5:95620087-95622142,2055
85177154,85217158,chr8,E2F5,chr8:85177154-85217158,40004
55148112,55191608,chr14,DLGAP5,chr14:55148112-55191608,43496
40135005,40860763,chr7,SUGCT,chr7:40135005-40860763,725758
29555629,29633976,chr6,GABBR1,chr6:29555629-29633976,78347
1092658,1404217,chr3,CNTN6,chr3:1092658-1404217,311559
124743885,124765792,chr7,GPR37,chr7:124743885-124765792,21907
80826074,80892682,chr16,ARLNC1,chr16:80826074-80892682,66608
26512529,26514568,chr22,TFIP11-DT,chr22:26512529-26514568,2039
34560542,34698790,chr20,PIGU,chr20:34560542-34698790,138248
55298644,55299231,chr14,CHMP4BP1,chr14:55298644-55299231,587
76858709,76879023,chr12,CSRP2,chr12:76858709-76879023,20314
39498755,39528311,chr4,UGDH,chr4:39498755-39528311,29556
21140514,21149084,chr13,SAP18,chr13:21140514-21149084,8570
5121239,5144546,chr7,ZNF890P,chr7:5121239-5144546,23307
2163929,2171815,chr11,TH,chr11:2163929-2171815,7886
86566829,86569728,chr16,FOXC2,chr16:86566829-86569728,2899
97572185,97875650,chr15,LINC00923,chr15:97572185-97875650,303465
126360132,126496494,chr5,GRAMD2B,chr5:126360132-126496494,136362
92471654,92501117,chr15,C15orf32,chr15:92471654-92501117,29463
39808914,40260321,chr3,MYRIP,chr3:39808914-40260321,451407
84971093,85059472,chr2,KCMF1,chr2:84971093-85059472,88379
39452587,39458931,chr4,RPL9,chr4:39452587-39458931,6344
21153595,21176552,chr13,SKA3,chr13:21153595-21176552,22957
98648539,98964530,chr15,IGF1R,chr15:98648539-98964530,315991
97775057,97853013,chr8,LAPTM4B,chr8:97775057-97853013,77956
106674019,107018476,chr11,GUCY1A2,chr11:106674019-107018476,344457
21372571,21459370,chr13,ZDHHC20,chr13:21372571-21459370,86799
85169525,85676204,chr16,GSE1,chr16:85169525-85676204,506679
106237881,106304279,chr12,CKAP4,chr12:106237881-106304279,66398
84905656,84906671,chr2,TMSB10,chr2:84905656-84906671,1015
87824942,87825143,chr2,MTATP8P2,chr2:87824942-87825143,201
92770637,92929331,chr12,EEA1,chr12:92770637-92929331,158694
89575469,89631056,chr15,TICRR,chr15:89575469-89631056,55587
54051334,54051760,chr2,HMGB1P31,chr2:54051334-54051760,426
86815339,86861924,chr2,CD8B,chr2:86815339-86861924,46585
85990007,86594625,chr4,MAPK10,chr4:85990007-86594625,604618
35401513,35404749,chr14,NFKBIA,chr14:35401513-35404749,3236
34928432,34956027,chr20,GSS,chr20:34928432-34956027,27595
86603398,86623866,chr2,RNF103,chr2:86603398-86623866,20468
35430260,35430631,chr14,DNAJC8P1,chr14:35430260-35430631,371
16313574,16514026,chr3,RFTN1,chr3:16313574-16514026,200452
58771192,58861900,chr15,MINDY2,chr15:58771192-58861900,90708
11841423,11961887,chr11,USP47,chr11:11841423-11961887,120464
75646783,75690851,chr2,MRPL19,chr2:75646783-75690851,44068
132311285,132370170,chr5,MIR3936HG,chr5:132311285-132370170,58885
96325938,96340263,chr15,NR2F2,chr15:96325938-96340263,14325
102197585,102402596,chr12,HELLPAR,chr12:102197585-102402596,205011
2295628,2303049,chr11,C11orf21,chr11:2295628-2303049,7421
77021248,77065569,chr12,E2F7,chr12:77021248-77065569,44321
6770001,7741533,chr3,GRM7,chr3:6770001-7741533,971532
98426958,98432853,chr8,KCNS2,chr8:98426958-98432853,5895
24265538,24271611,chr14,RABGGTA,chr14:24265538-24271611,6073
123470054,123533719,chr12,RILPL1,chr12:123470054-123533719,63665
77322017,77474635,chr11,PAK1,chr11:77322017-77474635,152618
41931599,41933909,chr2,LINC01914,chr2:41931599-41933909,2310
100159244,100168617,chr7,GAL3ST4,chr7:100159244-100168617,9373
151694607,151705924,chrX,PRRG3,chrX:151694607-151705924,11317
34915677,34925996,chr5,BRIX1,chr5:34915677-34925996,10319
38906451,38909592,chr12,CPNE8-AS1,chr12:38906451-38909592,3141
108129288,108250537,chr12,WSCD2,chr12:108129288-108250537,121249
49187815,49200218,chrX,SYP,chrX:49187815-49200218,12403
32091074,32105722,chr11,RCN1,chr11:32091074-32105722,14648
57487959,57495366,chr20,HMGB1P1,chr20:57487959-57495366,7407
104064531,104106524,chr12,HCFC2,chr12:104064531-104106524,41993
137617500,137736089,chr5,KLHL3,chr5:137617500-137736089,118589
96489571,96875555,chr12,CFAP54,chr12:96489571-96875555,385984
155997696,156010817,chrX,IL9R,chrX:155997696-156010817,13121
68530090,68576072,chr16,ZFP90,chr16:68530090-68576072,45982
96335766,96377091,chr2,NCAPH,chr2:96335766-96377091,41325
10743324,10747663,chr6,TMEM14B-DT,chr6:10743324-10747663,4339
64084232,64338112,chr14,ESR2,chr14:64084232-64338112,253880
18858906,19049358,chr9,SAXO1,chr9:18858906-19049358,190452
39141855,39154562,chr3,CSRNP1,chr3:39141855-39154562,12707
87859751,88256768,chr15,NTRK3,chr15:87859751-88256768,397017
17906563,18910950,chr9,ADAMTSL1,chr9:17906563-18910950,1004387
44712643,44723831,chr3,ZNF502,chr3:44712643-44723831,11188
43213130,43786972,chr13,ENOX1,chr13:43213130-43786972,573842
35073835,35079942,chr9,FANCG,chr9:35073835-35079942,6107
14348451,14352568,chr3,LINC01267,chr3:14348451-14352568,4117
87406246,87493024,chr16,ZCCHC14,chr16:87406246-87493024,86778
102073103,102120120,chr12,NUP37,chr12:102073103-102120120,47017
135033280,135358219,chr5,PITX1-AS1,chr5:135033280-135358219,324939
88696499,88706408,chr16,RNF166,chr16:88696499-88706408,9909
34610486,34612104,chr9,RPP25L,chr9:34610486-34612104,1618
34613545,34620523,chr9,DCTN3,chr9:34613545-34620523,6978
43968424,43971199,chr13,DGKZP1,chr13:43968424-43971199,2775
159669069,159762529,chr6,SOD2,chr6:159669069-159762529,93460
135027734,135034813,chr5,PITX1,chr5:135027734-135034813,7079
159720415,159720540,chr6,RNU4ATAC18P,chr6:159720415-159720540,125
1211340,1214153,chr1,TNFRSF4,chr1:1211340-1214153,2813
1203508,1206592,chr1,TNFRSF18,chr1:1203508-1206592,3084
28574791,30010391,chr3,RBMS3,chr3:28574791-30010391,1435600
1471765,1497848,chr1,ATAD3B,chr1:1471765-1497848,26083
34723053,34729488,chr9,FAM205A,chr9:34723053-34729488,6435
634376,634922,chr1,MTCO3P12,chr1:634376-634922,546
47209214,47356889,chr20,ZMYND8,chr20:47209214-47356889,147675
99645129,99680569,chr14,HHIPL1,chr14:99645129-99680569,35440
97339693,97523442,chr15,LINC02254,chr15:97339693-97523442,183749
95657807,95791189,chr12,NTN4,chr12:95657807-95791189,133382
113584721,113641473,chr13,TFDP1,chr13:113584721-113641473,56752
44874608,44914990,chr3,TGM4,chr3:44874608-44914990,40382
74834127,74893359,chr2,HK2,chr2:74834127-74893359,59232
30228290,30713538,chr19,ZNF536,chr19:30228290-30713538,485248
1292390,1309609,chr1,ACAP3,chr1:1292390-1309609,17219
120511746,120988906,chr11,GRIK4,chr11:120511746-120988906,477160
19623655,19628930,chr19,LPAR2,chr19:19623655-19628930,5275
133061981,133071861,chr9,CEL,chr9:133061981-133071861,9880
36817428,36850787,chr19,ZNF790,chr19:36817428-36850787,33359
133097720,133149334,chr9,RALGDS,chr9:133097720-133149334,51614
91368631,91383317,chr5,ARRDC3,chr5:91368631-91383317,14686
34481758,34512304,chr19,WTIP,chr19:34481758-34512304,30546
42963865,42979181,chr6,PEX6,chr6:42963865-42979181,15316
55963191,56047326,chr2,MIR217HG,chr2:55963191-56047326,84135
100877714,100916626,chr15,ALDH1A3,chr15:100877714-100916626,38912
56183990,56386172,chr2,CCDC85A,chr2:56183990-56386172,202182
47753916,47782751,chr12,SLC48A1,chr12:47753916-47782751,28835
3799431,3849834,chr3,LRRN1,chr3:3799431-3849834,50403
38867830,38878275,chr19,RINL,chr19:38867830-38878275,10445
45159774,45160175,chr3,RPS24P8,chr3:45159774-45160175,401
19148510,19535642,chr3,KCNH8,chr3:19148510-19535642,387132
45954465,46052759,chr13,ZC3H13,chr13:45954465-46052759,98294
68610855,68671901,chr12,RAP1B,chr12:68610855-68671901,61046
30910467,31155202,chr2,GALNT14,chr2:30910467-31155202,244735
631074,632616,chr1,MTCO1P12,chr1:631074-632616,1542
2301997,2318204,chr11,TSPAN32,chr11:2301997-2318204,16207
59768352,59769146,chr15,RPS3AP6,chr15:59768352-59769146,794
58479512,58512413,chr19,SLC27A5,chr19:58479512-58512413,32901
111662621,111997464,chr5,NREP,chr5:111662621-111997464,334843
101252886,101270316,chr2,CNOT11,chr2:101252886-101270316,17430
64943753,65126112,chr16,CDH11,chr16:64943753-65126112,182359
1331280,1335314,chr1,TAS1R3,chr1:1331280-1335314,4034
39704481,39709444,chr19,LGALS14,chr19:39704481-39709444,4963
133152948,133163933,chr9,GBGT1,chr9:133152948-133163933,10985
111511645,111522399,chrX,SERTM2,chrX:111511645-111522399,10754
23235967,23275108,chr7,GPNMB,chr7:23235967-23275108,39141
63938959,63957319,chr11,NAA40,chr11:63938959-63957319,18360
84748592,84806445,chr15,ZNF592,chr15:84748592-84806445,57853
632757,633438,chr1,MTCO2P12,chr1:632757-633438,681
2425980,2505532,chr1,PLCH2,chr1:2425980-2505532,79552
63998558,64166113,chr11,MACROD1,chr11:63998558-64166113,167555
74871362,75000173,chr16,WDR59,chr16:74871362-75000173,128811
133328776,133336188,chr9,SURF6,chr9:133328776-133336188,7412
96261902,96336995,chr8,PTDSS1,chr8:96261902-96336995,75093
96120220,96322147,chr7,SLC25A13,chr7:96120220-96322147,201927
47190861,47215128,chrX,UBA1,chrX:47190861-47215128,24267
26581205,26641366,chr2,CIB4,chr2:26581205-26641366,60161
36354749,36355114,chr2,CRIM1-DT,chr2:36354749-36355114,365
43967862,43998326,chr19,ZNF155,chr19:43967862-43998326,30464
118923557,118951885,chr8,TNFRSF11B,chr8:118923557-118951885,28328
38899700,38908893,chr19,NFKBIB,chr19:38899700-38908893,9193
94895767,95116455,chr8,NDUFAF6,chr8:94895767-95116455,220688
79069767,79090069,chr5,BHMT2,chr5:79069767-79090069,20302
67518418,67546788,chr16,RIPOR1,chr16:67518418-67546788,28370
43074331,43074739,chr6,KLC4-AS1,chr6:43074331-43074739,408
43076307,43161719,chr6,PTK7,chr6:43076307-43161719,85412
83940554,84384880,chr5,EDIL3,chr5:83940554-84384880,444326
126600925,126627252,chr5,PHAX,chr5:126600925-126627252,26327
40079106,40535807,chr13,LINC00598,chr13:40079106-40535807,456701
68365282,68397453,chr2,PLEK,chr2:68365282-68397453,32171
97504663,97690180,chr5,LINC01340,chr5:97504663-97690180,185517
50347330,50350826,chr3,NPRL2,chr3:50347330-50350826,3496
43649123,43649280,chr15,PDIA3P2,chr15:43649123-43649280,157
106568258,106716679,chr13,LINC00551,chr13:106568258-106716679,148421
133376366,133406096,chr9,STKLD1,chr9:133376366-133406096,29730
113816738,113966325,chr12,RBM19,chr12:113816738-113966325,149587
41599735,41605984,chr19,CEACAMP3,chr19:41599735-41605984,6249
133406059,133418096,chr9,REXO4,chr9:133406059-133418096,12037
54529343,54529801,chr2,RPL23AP32,chr2:54529343-54529801,458
71929018,71997597,chr11,RNF121,chr11:71929018-71997597,68579
133414358,133459402,chr9,ADAMTS13,chr9:133414358-133459402,45044
112480853,112491062,chr7,LSMEM1,chr7:112480853-112491062,10209
69167135,69178245,chr5,CCNB1,chr5:69167135-69178245,11110
19947097,19985175,chr3,RAB5A,chr3:19947097-19985175,38078
87830023,87869507,chr16,SLC7A5,chr16:87830023-87869507,39484
43804492,43824690,chr15,MFAP1,chr15:43804492-43824690,20198
21302862,21348721,chr13,LINC00539,chr13:21302862-21348721,45859
24049701,24063681,chr2,FKBP1B,chr2:24049701-24063681,13980
121237675,121298308,chr12,CAMKK2,chr12:121237675-121298308,60633
97756333,97995948,chr2,TMEM131,chr2:97756333-97995948,239615
44400173,44405984,chr13,TUSC8,chr13:44400173-44405984,5811
120464300,120687332,chr5,PRR16,chr5:120464300-120687332,223032
32978592,33064888,chr19,RHPN2,chr19:32978592-33064888,86296
18892298,18984114,chrX,PHKA2,chrX:18892298-18984114,91816
151048292,151052756,chr7,ASIC3,chr7:151048292-151052756,4464
40798996,40808434,chr19,EGLN2,chr19:40798996-40808434,9438
18915243,18915535,chrX,RN7SL48P,chrX:18915243-18915535,292
133459965,133470848,chr9,CACFD1,chr9:133459965-133470848,10883
88512960,88531053,chr16,ZFPM1-AS1,chr16:88512960-88531053,18093
2944431,2992377,chr11,NAP1L4,chr11:2944431-2992377,47946
133471094,133479127,chr9,SLC2A6,chr9:133471094-133479127,8033
12567910,12618210,chr1,DHRS3,chr1:12567910-12618210,50300
49956670,50125720,chr13,DLEU2,chr13:49956670-50125720,169050
75652000,75710985,chr2,GCFC2,chr2:75652000-75710985,58985
97121659,97122489,chr9,FAM220CP,chr9:97121659-97122489,830
97156570,97221235,chr9,ANKRD18CP,chr9:97156570-97221235,64665
73263212,73301789,chr6,KHDC1-AS1,chr6:73263212-73301789,38577
117730515,118266267,chr5,LINC02147,chr5:117730515-118266267,535752
3746460,3771645,chr1,CCDC27,chr1:3746460-3771645,25185
73373108,73373263,chr6,RPL39P3,chr6:73373108-73373263,155
73391038,73391767,chr6,RPS6P8,chr6:73391038-73391767,729
73394828,73417566,chr6,DDX43,chr6:73394828-73417566,22738
79991311,80083287,chr5,THBS4,chr5:79991311-80083287,91976
110863987,110870330,chr13,PRECSIT,chr13:110863987-110870330,6343
22859050,22916369,chr13,LINC00621,chr13:22859050-22916369,57319
64945814,64973226,chr14,RAB15,chr14:64945814-64973226,27412
36036913,36124455,chr9,RECK,chr9:36036913-36124455,87542
9606142,9606609,chr11,RPL23AP65,chr11:9606142-9606609,467
77976042,77993057,chr15,ADAMTS7P3,chr15:77976042-77993057,17015
66574030,66731223,chr2,LINC01798,chr2:66574030-66731223,157193
78104606,78131535,chr15,CIB2,chr15:78104606-78131535,26929
34788527,34832869,chr19,LINC01801,chr19:34788527-34832869,44342
99181223,99200757,chr13,UBAC2-AS1,chr13:99181223-99200757,19534
36190856,36304781,chr9,CLTA,chr9:36190856-36304781,113925
84516455,84819589,chr2,DNAH6,chr2:84516455-84819589,303134
110858239,110859147,chr6,CNN2P9,chr6:110858239-110859147,908
10305073,10307397,chr11,ADM,chr11:10305073-10307397,2324
110874770,110898879,chr6,AMD1,chr6:110874770-110898879,24109
15834474,15848147,chr1,FLJ37453,chr1:15834474-15848147,13673
10511673,10541230,chr11,RNF141,chr11:10511673-10541230,29557
35695214,35699413,chr7,HERPUD2-AS1,chr7:35695214-35699413,4199
109573978,109691791,chr8,SYBU,chr8:109573978-109691791,117813
155264013,155276548,chr6,CLDN20,chr6:155264013-155276548,12535
155395368,155455839,chr6,NOX3,chr6:155395368-155455839,60471
66433452,66573869,chr2,MEIS1,chr2:66433452-66573869,140417
112105357,112106882,chr13,LINC00404,chr13:112105357-112106882,1525
125200542,125234161,chr9,RABEPK,chr9:125200542-125234161,33619
125234853,125241382,chr9,HSPA5,chr9:125234853-125241382,6529
2590639,2633016,chr1,MMEL1,chr1:2590639-2633016,42377
45885651,45906465,chr11,MAPK8IP1,chr11:45885651-45906465,20814
58345178,58353492,chr19,A1BG,chr19:58345178-58353492,8314
32384603,32454769,chr9,ACO1,chr9:32384603-32454769,70166
45906513,45907272,chr11,C11orf94,chr11:45906513-45907272,759
68787660,68796253,chr14,ZFP36L1,chr14:68787660-68796253,8593
43826980,43868412,chr15,WDR76,chr15:43826980-43868412,41432
30983718,30989903,chr6,MUC21,chr6:30983718-30989903,6185
76344474,76348415,chr12,BBS10,chr12:76344474-76348415,3941
101345550,101387503,chr2,CREG2,chr2:101345550-101387503,41953
31114750,31140092,chr6,PSORS1C1,chr6:31114750-31140092,25342
93677375,93894840,chr12,CRADD,chr12:93677375-93894840,217465
1280436,1292029,chr1,SCNN1D,chr1:1280436-1292029,11593
88643289,88651054,chr16,CYBA,chr16:88643289-88651054,7765
58347718,58355455,chr19,A1BG-AS1,chr19:58347718-58355455,7737
46277662,46321409,chr11,CREB3L1,chr11:46277662-46321409,43747
54253178,54256229,chr2,TSPYL6,chr2:54253178-54256229,3051
38815422,38831841,chr19,ECH1,chr19:38815422-38831841,16419
63687179,64369176,chr8,LINC01414,chr8:63687179-64369176,681997
108606850,108787594,chr8,TMEM74,chr8:108606850-108787594,180744
123497889,123541206,chr8,FBXO32,chr8:123497889-123541206,43317
1173880,1197936,chr1,TTLL10,chr1:1173880-1197936,24056
50558025,50571027,chr3,C3orf18,chr3:50558025-50571027,13002
32540544,32552586,chr9,TOPORS,chr9:32540544-32552586,12042
136494433,136546048,chr9,NOTCH1,chr9:136494433-136546048,51615
88715338,88785220,chr16,PIEZO1,chr16:88715338-88785220,69882
16246840,16352480,chr1,FBXO42,chr1:16246840-16352480,105640
61561569,62297609,chr3,PTPRG,chr3:61561569-62297609,736040
18871430,18902724,chr1,ALDH4A1,chr1:18871430-18902724,31294
71125085,71441898,chr12,TSPAN8,chr12:71125085-71441898,316813
43287470,43313512,chr5,HMGCS1,chr5:43287470-43313512,26042
28875404,29064993,chr14,LINC02326,chr14:28875404-29064993,189589
72107234,72209565,chr5,MAP1B,chr5:72107234-72209565,102331
70447284,70554193,chr2,TGFA,chr2:70447284-70554193,106909
79676048,79809716,chr16,LINC01229,chr16:79676048-79809716,133668
8352397,8848921,chr1,RERE,chr1:8352397-8848921,496524
64704102,64750249,chr14,PLEKHG3,chr14:64704102-64750249,46147
58354357,58362848,chr19,ZNF497,chr19:58354357-58362848,8491
36507702,36573391,chr20,DLGAP4-AS1,chr20:36507702-36573391,65689
21085576,21106514,chr20,LINC00237,chr20:21085576-21106514,20938
16265160,16350299,chr3,OXNAD1,chr3:16265160-16350299,85139
57435325,57447101,chr19,ZNF749,chr19:57435325-57447101,11776
166383189,166384824,chr6,MPC1-DT,chr6:166383189-166384824,1635
166460663,166465383,chr6,RPS6KA2-IT1,chr6:166460663-166465383,4720
166157656,166168700,chr6,TBXT,chr6:166157656-166168700,11044
76081946,76084186,chr5,SV2C-AS1,chr5:76081946-76084186,2240
52545352,52685917,chr3,PBRM1,chr3:52545352-52685917,140565
43403061,43510728,chr15,TP53BP1,chr15:43403061-43510728,107667
50162765,50166233,chr20,LINC01275,chr20:50162765-50166233,3468
98768650,98798643,chr5,RGMB,chr5:98768650-98798643,29993
48961378,48971844,chrX,KCND1,chrX:48961378-48971844,10466
56099680,56233330,chr5,ANKRD55,chr5:56099680-56233330,133650
57372477,57385044,chr16,CX3CL1,chr16:57372477-57385044,12567
33386950,33521791,chr19,PEPD,chr19:33386950-33521791,134841
58228940,58309494,chr20,PPP4R1L,chr20:58228940-58309494,80554
39623565,39708120,chr7,RALA,chr7:39623565-39708120,84555
39833571,39834718,chr7,SSBP3P1,chr7:39833571-39834718,1147
39733430,39793092,chr7,LINC00265,chr7:39733430-39793092,59662
96497646,96508109,chr2,NEURL3,chr2:96497646-96508109,10463
93424486,93574730,chr7,CALCR,chr7:93424486-93574730,150244
26562585,26579532,chr2,FAM166C,chr2:26562585-26579532,16947
62772980,62776996,chr20,LINC00659,chr20:62772980-62776996,4016
62352988,62356480,chr20,LAMA5-AS1,chr20:62352988-62356480,3492
141907813,142106747,chr7,MGAM,chr7:141907813-142106747,198934
52012765,52030240,chr19,ZNF614,chr19:52012765-52030240,17475
33980679,33994357,chr20,RALY-AS1,chr20:33980679-33994357,13678
54497752,54548243,chr12,NCKAP1L,chr12:54497752-54548243,50491
126340115,126348875,chr6,CENPW,chr6:126340115-126348875,8760
2508537,2526597,chr1,PANK4,chr1:2508537-2526597,18060
52031378,52095738,chr19,ZNF432,chr19:52031378-52095738,64360
102242040,102242619,chr8,SUMO2P19,chr8:102242040-102242619,579
133019486,133020874,chr9,EEF1A1P5,chr9:133019486-133020874,1388
130366017,130443067,chr6,TMEM200A,chr6:130366017-130443067,77050
138903493,138988261,chr6,REPS1,chr6:138903493-138988261,84768
3630767,3652761,chr1,WRAP73,chr1:3630767-3652761,21994
38446343,38450940,chr20,SNHG11,chr20:38446343-38450940,4597
139795808,139844466,chr5,PSD2,chr5:139795808-139844466,48658
86576368,86583478,chr16,FOXL1,chr16:86576368-86583478,7110
43575801,43583964,chr19,PINLYP,chr19:43575801-43583964,8163
72782885,73891871,chr16,ZFHX3,chr16:72782885-73891871,1108986
17065598,17276843,chr5,BASP1,chr5:17065598-17276843,211245
2098813,3057959,chr3,CNTN4,chr3:2098813-3057959,959146
66040765,66049161,chr11,GAL3ST3,chr11:66040765-66049161,8396
66050729,66069308,chr11,SF3B2,chr11:66050729-66069308,18579
101550547,101554700,chrX,ARMCX1,chrX:101550547-101554700,4153
136132845,136188747,chr5,SMAD5,chr5:136132845-136188747,55902
66902857,66906297,chr7,LINC02604,chr7:66902857-66906297,3440
101622797,101627843,chrX,ARMCX3,chrX:101622797-101627843,5046
150685697,150693641,chr7,GIMAP2,chr7:150685697-150693641,7944
150791285,150801360,chr7,TMEM176B,chr7:150791285-150801360,10075
30874514,30895065,chr14,COCH,chr14:30874514-30895065,20551
74667506,74668706,chr16,TMPOP2,chr16:74667506-74668706,1200
150800403,150805118,chr7,TMEM176A,chr7:150800403-150805118,4715
63627179,63628824,chr20,MHENCR,chr20:63627179-63628824,1645
66278175,66285301,chr11,CNIH2,chr11:66278175-66285301,7126
23356586,23358175,chr20,LINC01431,chr20:23356586-23358175,1589
81988855,82011481,chr16,SDR42E1,chr16:81988855-82011481,22626
38419638,38435409,chr20,SNHG17,chr20:38419638-38435409,15771
101280105,101386618,chr12,UTP20,chr12:101280105-101386618,106513
79111809,79132288,chr5,BHMT,chr5:79111809-79132288,20479
66291894,66296664,chr11,TMEM151A,chr11:66291894-66296664,4770
45306413,45322875,chr19,CKM,chr19:45306413-45322875,16462
66314494,66317044,chr11,CD248,chr11:66314494-66317044,2550
36281616,36347511,chr4,DTHD1,chr4:36281616-36347511,65895
102153708,102155977,chrX,BEX5,chrX:102153708-102155977,2269
127451489,127503499,chr9,LRSAM1,chr9:127451489-127503499,52010
71439798,71586310,chr12,LGR5,chr12:71439798-71586310,146512
66337333,66345125,chr11,BRMS1,chr11:66337333-66345125,7792
153684070,153706260,chr4,TLR2,chr4:153684070-153706260,22190
37861880,37984469,chr3,CTDSPL,chr3:37861880-37984469,122589
114055926,114496500,chr5,KCNN2,chr5:114055926-114496500,440574
58440448,58445849,chr19,ZNF132-DT,chr19:58440448-58445849,5401
119588337,119606443,chrX,NKRF,chrX:119588337-119606443,18106
88453280,88537031,chr16,ZFPM1,chr16:88453280-88537031,83751
55434373,55579197,chr6,HMGCLL1,chr6:55434373-55579197,144824
66345374,66347629,chr11,B4GAT1,chr11:66345374-66347629,2255
101686542,102124907,chr8,NCALD,chr8:101686542-102124907,438365
66362521,66372214,chr11,SLC29A2,chr11:66362521-66372214,9693
11822423,12724523,chrX,FRMPD4,chrX:11822423-12724523,902100
19664875,19680966,chr1,HTR6,chr1:19664875-19680966,16091
58025754,58046901,chr16,MMP15,chr16:58025754-58046901,21147
11609468,11613358,chr1,LINC01647,chr1:11609468-11613358,3890
85380571,85749358,chr15,AKAP13,chr15:85380571-85749358,368787
3454665,3481113,chr1,ARHGEF16,chr1:3454665-3481113,26448
52765380,52772784,chr10,MBL2,chr10:52765380-52772784,7404
109127327,109128930,chr2,SH3RF3-AS1,chr2:109127327-109128930,1603
99782640,99852594,chr10,ABCC2,chr10:99782640-99852594,69954
74654228,74683853,chr2,SEMA4F,chr2:74654228-74683853,29625
681829,689271,chr4,SLC49A3,chr4:681829-689271,7442
75906695,77649964,chr3,ROBO2,chr3:75906695-77649964,1743269
129109629,129113294,chr12,TMEM132D-AS1,chr12:129109629-129113294,3665
9100305,9129102,chr1,GPR157,chr1:9100305-9129102,28797
100267140,100341715,chr12,SCYL2,chr12:100267140-100341715,74575
22428838,22531157,chr1,ZBTB40,chr1:22428838-22531157,102319
105894775,106004027,chr4,NPNT,chr4:105894775-106004027,109252
166167920,166171376,chr6,LNCDAT,chr6:166167920-166171376,3456
101034868,101076407,chr8,FLJ42969,chr8:101034868-101076407,41539
5997999,6007605,chr6,NRN1,chr6:5997999-6007605,9606
6144084,6321013,chr6,F13A1,chr6:6144084-6321013,176929
67987746,68079320,chr16,DUS2,chr16:67987746-68079320,91574
130953907,131141469,chr12,ADGRD1,chr12:130953907-131141469,187562
130293134,130324180,chr7,CPA4,chr7:130293134-130324180,31046
36355778,36551135,chr2,CRIM1,chr2:36355778-36551135,195357
110290730,110304938,chr10,SMNDC1,chr10:110290730-110304938,14208
2536647,2732573,chr4,FAM193A,chr4:2536647-2732573,195926
61742455,61743106,chr3,RPL10AP6,chr3:61742455-61743106,651
33302857,33305054,chr19,CEBPA-DT,chr19:33302857-33305054,2197
110497907,110511533,chr10,DUSP5,chr10:110497907-110511533,13626
130486171,130506465,chr7,MEST,chr7:130486171-130506465,20294
86876388,86991149,chr3,VGLL3,chr3:86876388-86991149,114761
30309801,30374448,chr10,MTPAP,chr10:30309801-30374448,64647
84423528,84460045,chr2,SUCLG1,chr2:84423528-84460045,36517
43369221,43409771,chr15,TUBGCP4,chr15:43369221-43409771,40550
154675249,154751583,chrX,GAB3,chrX:154675249-154751583,76334
69088103,69104805,chr10,SRGN,chr10:69088103-69104805,16702
128552558,128633662,chr9,SPTAN1,chr9:128552558-128633662,81104
50674927,51384198,chr3,DOCK3,chr3:50674927-51384198,709271
102233986,102296284,chr5,SLCO4C1,chr5:102233986-102296284,62298
100671783,100732123,chrX,SYTL4,chrX:100671783-100732123,60340
88863333,88866660,chr16,PABPN1L,chr16:88863333-88866660,3327
72888046,72998138,chr3,GXYLT2,chr3:72888046-72998138,110092
123458088,123473154,chr12,SNRNP35,chr12:123458088-123473154,15066
85690084,85751129,chr16,C16orf74,chr16:85690084-85751129,61045
74954418,74956772,chr15,RPP25,chr15:74954418-74956772,2354
61897301,61920269,chr11,RAB3IL1,chr11:61897301-61920269,22968
86474529,86509099,chr16,FENDRR,chr16:86474529-86509099,34570
96832254,96995956,chr10,LCOR,chr10:96832254-96995956,163702
96875986,96919703,chr5,ERAP2,chr5:96875986-96919703,43717
100257060,100336218,chr8,RNF19A,chr8:100257060-100336218,79158
88874858,88977207,chr16,CBFA2T3,chr16:88874858-88977207,102349
66162671,66268867,chrX,HEPH,chrX:66162671-66268867,106196
26172059,26184655,chr6,H2BC6,chr6:26172059-26184655,12596
31494881,31511124,chr6,MICB,chr6:31494881-31511124,16243
109129205,109504634,chr2,SH3RF3,chr2:109129205-109504634,375429
133130575,133159465,chr12,ZNF10,chr12:133130575-133159465,28890
52143043,52143336,chr19,RPL37P23,chr19:52143043-52143336,293
5226196,5244199,chr12,LINC02443,chr12:5226196-5244199,18003
5890203,5937594,chr10,FBH1,chr10:5890203-5937594,47391
108116695,108147603,chr11,ACAT1,chr11:108116695-108147603,30908
67828157,67847811,chr16,CENPT,chr16:67828157-67847811,19654
75446769,75491202,chr3,ENPP7P2,chr3:75446769-75491202,44433
85530144,85654428,chr14,FLRT2,chr14:85530144-85654428,124284
80335730,80963750,chr4,CFAP299,chr4:80335730-80963750,628020
96143169,96145440,chr2,DUSP2,chr2:96143169-96145440,2271
113890063,113962596,chr2,ACTR3,chr2:113890063-113962596,72533
117814691,117832377,chr2,DDX18,chr2:117814691-117832377,17686
41194741,41260096,chr3,CTNNB1,chr3:41194741-41260096,65355
60516936,60623644,chr8,RAB2A,chr8:60516936-60623644,106708
90871952,90908553,chr10,RPP30,chr10:90871952-90908553,36601
130622325,130903234,chrX,ENOX2,chrX:130622325-130903234,280909
99472890,99503650,chr7,ZNF789,chr7:99472890-99503650,30760
31586124,31588909,chr6,LST1,chr6:31586124-31588909,2785
113599036,113601261,chr2,DDX11L2,chr2:113599036-113601261,2225
101393116,101407772,chr12,ARL1,chr12:101393116-101407772,14656
41935368,41956806,chr2,LINC02898,chr2:41935368-41956806,21438
99558406,99576453,chr7,ZNF655,chr7:99558406-99576453,18047
118842171,118847648,chr2,EN1,chr2:118842171-118847648,5477
68310387,68350090,chr4,YTHDC1,chr4:68310387-68350090,39703
17052,17119,chr16,MIR6859-4,chr16:17052-17119,67
17089296,17217047,chr5,BASP1-AS1,chr5:17089296-17217047,127751
147234963,147387855,chr5,STK32A,chr5:147234963-147387855,152892
44228729,44305046,chr19,ZNF235,chr19:44228729-44305046,76317
2964216,2968383,chr16,KREMEN2,chr16:2964216-2968383,4167
27459756,27479883,chr8,CHRNA2,chr8:27459756-27479883,20127
20124525,20141838,chrX,EIF1AX,chrX:20124525-20141838,17313
7954291,7985505,chr1,PARK7,chr1:7954291-7985505,31214
26335352,26833194,chr12,ITPR2,chr12:26335352-26833194,497842
127183832,127220313,chr2,CYP27C1,chr2:127183832-127220313,36481
20149911,20267519,chrX,RPS6KA3,chrX:20149911-20267519,117608
95907603,96033745,chr10,CC2D2B,chr10:95907603-96033745,126142
2549920,2557031,chr1,TNFRSF14-AS1,chr1:2549920-2557031,7111
173075435,173268015,chr2,MAP3K20,chr2:173075435-173268015,192580
16241213,16241398,chr1,MT1XP1,chr1:16241213-16241398,185
31670167,31673776,chr6,LY6G5B,chr6:31670167-31673776,3609
31676684,31684040,chr6,LY6G5C,chr6:31676684-31684040,7356
31754720,31755121,chr12,IFITM3P2,chr12:31754720-31755121,401
27206930,27207796,chr1,NPM1P39,chr1:27206930-27207796,866
99923266,99929620,chr7,GJC3,chr7:99923266-99929620,6354
27392622,27395814,chr1,GPR3,chr1:27392622-27395814,3192
146116002,148420998,chr7,CNTNAP2,chr7:146116002-148420998,2304996
6783892,6784843,chr1,CAMTA1-DT,chr1:6783892-6784843,951
43628503,43668118,chr15,CATSPER2,chr15:43628503-43668118,39615
64914361,64944591,chr14,CHURC1,chr14:64914361-64944591,30230
101166805,101169629,chr8,ZNNT1,chr8:101166805-101169629,2824
16352575,16398145,chr1,SZRD1,chr1:16352575-16398145,45570
128236716,128318868,chr2,HS6ST1,chr2:128236716-128318868,82152
58183029,58213562,chr19,ZNF274,chr19:58183029-58213562,30533
45847042,45851541,chrX,LINC02595,chrX:45847042-45851541,4499
122560665,122643736,chr10,DMBT1,chr10:122560665-122643736,83071
6785454,7769706,chr1,CAMTA1,chr1:6785454-7769706,984252
86503430,86563479,chr2,CHMP3,chr2:86503430-86563479,60049
76201896,76287288,chr7,SRRM3,chr7:76201896-76287288,85392
120120953,120245273,chrX,NKAPP1,chrX:120120953-120245273,124320
35053928,35072668,chr9,VCP,chr9:35053928-35072668,18740
16440721,16460078,chr1,NECAP2,chr1:16440721-16460078,19357
76389334,76409697,chr7,SSC4D,chr7:76389334-76409697,20363
120341330,120369164,chr12,MSI1,chr12:120341330-120369164,27834
26169516,26171831,chr1,ZNF593OS,chr1:26169516-26171831,2315
104138587,104180894,chr14,KIF26A,chr14:104138587-104180894,42307
72189558,72196323,chr11,FOLR1,chr11:72189558-72196323,6765
23321457,23326163,chr14,PABPN1,chr14:23321457-23326163,4706
109614364,109618990,chr2,SOWAHC,chr2:109614364-109618990,4626
3088890,3099295,chr16,ZSCAN10,chr16:3088890-3099295,10405
103845151,103919548,chrX,TMSB15B-AS1,chrX:103845151-103919548,74397
16461481,16530580,chr7,SOSTDC1,chr7:16461481-16530580,69099
1793293,1808872,chr4,FGFR3,chr4:1793293-1808872,15579
105744912,105894274,chr2,NCK2,chr2:105744912-105894274,149362
118246084,118246962,chr12,RPS2P5,chr12:118246084-118246962,878
24439766,24442905,chr14,SDR39U1,chr14:24439766-24442905,3139
54517759,54546586,chr5,SNX18,chr5:54517759-54546586,28827
8959628,8963981,chr4,UNC93B8,chr4:8959628-8963981,4353
31739677,31762676,chr6,MSH5,chr6:31739677-31762676,22999
117144284,117176894,chr11,PAFAH1B2,chr11:117144284-117176894,32610
120036236,120146855,chrX,RHOXF1-AS1,chrX:120036236-120146855,110619
3355889,3357306,chr16,OR2C1,chr16:3355889-3357306,1417
5592816,5606655,chr7,FSCN1,chr7:5592816-5606655,13839
43192702,43207299,chr19,PSG4,chr19:43192702-43207299,14597
140709562,140793215,chrX,LINC00632,chrX:140709562-140793215,83653
3443649,3486953,chr16,NAA60,chr16:3443649-3486953,43304
63222993,63561095,chrX,LINC01278,chrX:63222993-63561095,338102
119165034,119245673,chr8,MAL2,chr8:119165034-119245673,80639
173166446,173282036,chr2,MAP3K20-AS1,chr2:173166446-173282036,115590
22003106,22003673,chr14,TRAV18,chr14:22003106-22003673,567
22007512,22008181,chr14,TRAV19,chr14:22007512-22008181,669
72537225,72938349,chr8,KCNB2,chr8:72537225-72938349,401124
68842197,68971570,chr12,CPM,chr12:68842197-68971570,129373
44512535,44541330,chr7,NPC1L1,chr7:44512535-44541330,28795
45745210,45770274,chrX,MIR222HG,chrX:45745210-45770274,25064
38335775,38370943,chr19,CATSPERG,chr19:38335775-38370943,35168
73940435,74293574,chrX,FTX,chrX:73940435-74293574,353139
105851705,105856218,chr14,IGHM,chr14:105851705-105856218,4513
31923438,32173018,chr15,CHRNA7,chr15:31923438-32173018,249580
105863198,105863258,chr14,IGHJ6,chr14:105863198-105863258,60
31740020,31764851,chr6,MSH5-SAPCD1,chr6:31740020-31764851,24831
117232625,117286454,chr11,RNF214,chr11:117232625-117286454,53829
65669961,65698029,chr4,EPHA5-AS1,chr4:65669961-65698029,28068
87152409,87196337,chr7,DMTF1,chr7:87152409-87196337,43928
105913222,105913237,chr14,IGHD4-4,chr14:105913222-105913237,15
31756951,31757053,chr6,RNU6-850P,chr6:31756951-31757053,102
31762996,31764851,chr6,SAPCD1,chr6:31762996-31764851,1855
117314557,117413266,chr11,CEP164,chr11:117314557-117413266,98709
105357712,105438513,chr2,FHL2,chr2:105357712-105438513,80801
25543606,25568886,chr1,LDLRAP1,chr1:25543606-25568886,25280
87303789,87322886,chr4,HSD17B13,chr4:87303789-87322886,19097
6204840,6205780,chr1,RNF207-AS1,chr1:6204840-6205780,940
57181747,57191717,chr11,LRRC55,chr11:57181747-57191717,9970
3539033,3577403,chr16,NLRC3,chr16:3539033-3577403,38370
87336515,87391188,chr4,HSD17B11,chr4:87336515-87391188,54673
132626015,132961395,chrX,HS6ST2,chrX:132626015-132961395,335380
146638893,146642474,chr4,POU4F2,chr4:146638893-146642474,3581
62398346,62875416,chr3,CADPS,chr3:62398346-62875416,477070
42696598,42722597,chr6,PRPH2,chr6:42696598-42722597,25999
136557046,136792477,chr6,MAP3K5,chr6:136557046-136792477,235431
47935977,48016681,chr4,CNGA1,chr4:47935977-48016681,80704
116671192,116850251,chr10,HSPA12A,chr10:116671192-116850251,179059
78887127,78939438,chr4,PAQR3,chr4:78887127-78939438,52311
126552443,126558478,chr8,LRATD2,chr8:126552443-126558478,6035
118995452,119108455,chr8,COLEC10,chr8:118995452-119108455,113003
127735434,127742951,chr8,MYC,chr8:127735434-127742951,7517
136922301,136925660,chr6,SLC35D3,chr6:136922301-136925660,3359
136982165,136993234,chr6,NHEG1,chr6:136982165-136993234,11069
96274338,96321271,chr2,SNRNP200,chr2:96274338-96321271,46933
114791653,114791929,chr8,CARS1P2,chr8:114791653-114791929,276
128702503,128720916,chr9,PKN3,chr9:128702503-128720916,18413
73731824,73733638,chr10,DUSP8P5,chr10:73731824-73733638,1814
178113532,178126081,chr5,N4BP3,chr5:178113532-178126081,12549
71320449,71741229,chr14,SIPA1L1,chr14:71320449-71741229,420780
32968594,32981505,chr6,BRD2,chr6:32968594-32981505,12911
34140674,34210096,chr15,KATNBL1,chr15:34140674-34210096,69422
32226994,32312987,chr5,MTMR12,chr5:32226994-32312987,85993
82806515,82808021,chr3,CYP51A1P1,chr3:82806515-82808021,1506
112570380,112898881,chr12,RPH3A,chr12:112570380-112898881,328501
99504662,99534700,chr7,ZKSCAN5,chr7:99504662-99534700,30038
38990714,39032785,chr19,FBXO27,chr19:38990714-39032785,42071
98846488,98870771,chr7,TMEM130,chr7:98846488-98870771,24283
4331549,4355607,chr16,PAM16,chr16:4331549-4355607,24058
31179745,31239887,chr1,NKAIN1,chr1:31179745-31239887,60142
56643159,56657247,chr19,SMIM17,chr19:56643159-56657247,14088
45972489,46003742,chr10,TIMM23,chr10:45972489-46003742,31253
9539465,9585173,chr1,SLC25A33,chr1:9539465-9585173,45708
4354542,4425705,chr16,CORO7,chr16:4354542-4425705,71163
21424625,21427967,chr1,NBPF2P,chr1:21424625-21427967,3342
1159768,1289426,chr10,LINC00200,chr10:1159768-1289426,129658
15756607,15786594,chr1,FBLIM1,chr1:15756607-15786594,29987
34229784,34338060,chr15,SLC12A6,chr15:34229784-34338060,108276
69123512,69174412,chr10,VPS26A,chr10:69123512-69174412,50900
121132819,121188032,chr12,P2RX7,chr12:121132819-121188032,55213
69180234,69209099,chr10,SUPV3L1,chr10:69180234-69209099,28865
68754620,68844410,chr11,CPT1A,chr11:68754620-68844410,89790
33132090,33175799,chr19,WDR88,chr19:33132090-33175799,43709
147390808,147510068,chr5,DPYSL3,chr5:147390808-147510068,119260
57240632,57262728,chr19,ZNF805,chr19:57240632-57262728,22096
52336243,52367778,chr19,ZNF610,chr19:52336243-52367778,31535
122732702,122744942,chr4,BBS12,chr4:122732702-122744942,12240
24171853,24180257,chr14,REC8,chr14:24171853-24180257,8404
36324152,36390125,chr7,KIAA0895,chr7:36324152-36390125,65973
69048932,69136316,chr11,TPCN2,chr11:69048932-69136316,87384
67123357,67397980,chr2,LINC01829,chr2:67123357-67397980,274623
54953130,55001142,chr19,NLRP2,chr19:54953130-55001142,48012
27168135,27243046,chr10,ACBD5,chr10:27168135-27243046,74911
27342020,27353937,chr1,SYTL1,chr1:27342020-27353937,11917
1871393,1982207,chr4,NSD2,chr4:1871393-1982207,110814
75658534,75659014,chr3,RARRES2P1,chr3:75658534-75659014,480
143368876,143384221,chr8,RHPN1,chr8:143368876-143384221,15345
129476946,129513687,chr9,LINC00963,chr9:129476946-129513687,36741
108786757,108885477,chr2,CCDC138,chr2:108786757-108885477,98720
122485194,122733804,chr8,LINC01151,chr8:122485194-122733804,248610
96617188,96618236,chr3,MTRNR2L12,chr3:96617188-96618236,1048
144158162,144170714,chr5,YIPF5,chr5:144158162-144170714,12552
65070696,65130331,chr2,RAB1A,chr2:65070696-65130331,59635
127322183,127420066,chr8,POU5F1B,chr8:127322183-127420066,97883
70573218,70608416,chr8,TRAM1,chr8:70573218-70608416,35198
63817748,63818462,chr9,DUX4L50,chr9:63817748-63818462,714
63819574,63819654,chr9,MIR4477B,chr9:63819574-63819654,80
43576185,43620523,chr6,POLH,chr6:43576185-43620523,44338
113022099,113488823,chr5,MCC,chr5:113022099-113488823,466724
70529060,71446904,chr9,TRPM3,chr9:70529060-71446904,917844
43605316,43629264,chr6,GTPBP2,chr6:43605316-43629264,23948
70109782,70403808,chr8,NCOA2,chr8:70109782-70403808,294026
130012065,130040560,chr2,FAR2P1,chr2:130012065-130040560,28495
108878308,108878460,chr2,RPL39P16,chr2:108878308-108878460,152
92574105,92655395,chr10,KIF11,chr10:92574105-92655395,81290
31365253,31376850,chr1,FABP3,chr1:31365253-31376850,11597
171922448,171983686,chr2,HAT1,chr2:171922448-171983686,61238
123089241,123194266,chr5,PRDM6,chr5:123089241-123194266,105025
12746200,12763699,chr1,C1orf158,chr1:12746200-12763699,17499
15112424,15247208,chr11,INSC,chr11:15112424-15247208,134784
3976133,4012704,chr1,LINC02780,chr1:3976133-4012704,36571
96349554,96350939,chr3,HNRNPKP4,chr3:96349554-96350939,1385
16197854,16212652,chr1,ARHGEF19,chr1:16197854-16212652,14798
130356045,130375405,chr2,PTPN18,chr2:130356045-130375405,19360
114682292,114767989,chr12,TBX3-AS1,chr12:114682292-114767989,85697
94026340,94048930,chr14,OTUB2,chr14:94026340-94048930,22590
70147289,70170523,chr10,SAR1A,chr10:70147289-70170523,23234
75629993,75634057,chr3,CLUHP10,chr3:75629993-75634057,4064
75724577,75814286,chr4,USO1,chr4:75724577-75814286,89709
6247353,6261098,chr1,GPR153,chr1:6247353-6261098,13745
30748293,30761176,chr16,PHKG2,chr16:30748293-30761176,12883
47045909,47048624,chr19,TMEM160,chr19:47045909-47048624,2715
52369917,52385795,chr19,ZNF880,chr19:52369917-52385795,15878
111642146,111685956,chr12,BRAP,chr12:111642146-111685956,43810
35545600,35547526,chr19,TMEM147,chr19:35545600-35547526,1926
100363431,100401089,chr3,TOMM70,chr3:100363431-100401089,37658
89360787,89498130,chr9,SEMA4D,chr9:89360787-89498130,137343
58755854,58985179,chr17,PPM1E,chr17:58755854-58985179,229325
13892792,15118043,chr1,KAZN,chr1:13892792-15118043,1225251
75913660,75941013,chr4,NAAA,chr4:75913660-75941013,27353
1289887,1340147,chr4,MAEA,chr4:1289887-1340147,50260
12166991,12209228,chr1,TNFRSF1B,chr1:12166991-12209228,42237
143304384,143359979,chr8,TOP1MT,chr8:143304384-143359979,55595
114670255,114684175,chr12,TBX3,chr12:114670255-114684175,13920
131758031,131767221,chr2,CDRT15P4,chr2:131758031-131767221,9190
105140982,105168824,chr14,JAG2,chr14:105140982-105168824,27842
196133583,196176503,chr2,STK17B,chr2:196133583-196176503,42920
78605233,78632155,chr17,SCAT1,chr17:78605233-78632155,26922
21428303,21429536,chr1,HS6ST1P1,chr1:21428303-21429536,1233
15164344,15171317,chr1,TMEM51-AS2,chr1:15164344-15171317,6973
96754553,96778129,chr9,ZNF510,chr9:96754553-96778129,23576
102152176,102163871,chr10,NOLC1,chr10:102152176-102163871,11695
116423112,117415070,chr9,ASTN2,chr9:116423112-117415070,991958
63849292,63864379,chr17,TCAM1P,chr17:63849292-63864379,15087
130416755,130431363,chr2,FAR2P2,chr2:130416755-130431363,14608
150323263,150338156,chr7,LRRC61,chr7:150323263-150338156,14893
74216242,74343414,chr2,SLC4A5,chr2:74216242-74343414,127172
123973241,124316024,chr12,RFLNA,chr12:123973241-124316024,342783
150363777,150372590,chr7,REPIN1-AS1,chr7:150363777-150372590,8813
135557917,135648757,chr7,NUP205,chr7:135557917-135648757,90840
118063593,118136026,chr12,VSIG10,chr12:118063593-118136026,72433
101728648,101739472,chr12,SYCP3,chr12:101728648-101739472,10824
7965310,8158832,chr4,ABLIM2,chr4:7965310-8158832,193522
46719511,46746994,chr19,STRN4,chr19:46719511-46746994,27483
142108779,142154440,chr5,NDFIP1,chr5:142108779-142154440,45661
31815543,31817946,chr6,HSPA1A,chr6:31815543-31817946,2403
38556765,38671216,chr5,LIFR-AS1,chr5:38556765-38671216,114451
74670578,74747335,chr17,RAB37,chr17:74670578-74747335,76757
140636281,140638283,chr8,ERICD,chr8:140636281-140638283,2002
49967194,49977139,chr12,AQP6,chr12:49967194-49977139,9945
121444991,121499844,chr9,GGTA1,chr9:121444991-121499844,54853
178764861,178818435,chr5,AACSP1,chr5:178764861-178818435,53574
137168758,137170051,chr9,LRRC26,chr9:137168758-137170051,1293
109171974,109321059,chr9,EPB41L4B,chr9:109171974-109321059,149085
103770453,103841234,chr12,NT5DC3,chr12:103770453-103841234,70781
3137728,3172841,chr10,PITRM1,chr10:3137728-3172841,35113
44104345,44114562,chr7,AEBP1,chr7:44104345-44114562,10217
15111815,15153618,chr1,TMEM51-AS1,chr1:15111815-15153618,41803
143289676,143299952,chr8,ZNF696,chr8:143289676-143299952,10276
625573,670782,chr4,PDE6B,chr4:625573-670782,45209
29236516,29326813,chr1,PTPRU,chr1:29236516-29326813,90297
143366631,143368548,chr8,RHPN1-AS1,chr8:143366631-143368548,1917
133408006,133409107,chr8,ST13P6,chr8:133408006-133409107,1101
45252234,45277846,chr15,SLC28A2,chr15:45252234-45277846,25612
142212080,142403182,chr8,TSNARE1,chr8:142212080-142403182,191102
31114489,31131393,chr16,KAT8,chr16:31114489-31131393,16904
73683025,73705161,chr7,BUD23,chr7:73683025-73705161,22136
57280051,57294069,chr19,ZNF460,chr19:57280051-57294069,14018
190343570,190371665,chr2,INPP1,chr2:190343570-190371665,28095
50341110,50345732,chr3,ZMYND10,chr3:50341110-50345732,4622
45361124,45402327,chr15,GATM,chr15:45361124-45402327,41203
92451684,92574096,chr10,IDE,chr10:92451684-92574096,122412
31131433,31135727,chr16,PRSS8,chr16:31131433-31135727,4294
216632828,216664436,chr2,IGFBP2,chr2:216632828-216664436,31608
73699206,73719672,chr7,STX1A,chr7:73699206-73719672,20466
45402336,45421415,chr15,SPATA5L1,chr15:45402336-45421415,19079
31665227,31670343,chr6,CSNK2B,chr6:31665227-31670343,5116
26938470,26966650,chr12,FGFR1OP2,chr12:26938470-26966650,28180
31201486,31203450,chr16,PYCARD,chr16:31201486-31203450,1964
133454848,133571940,chr8,ST3GAL1,chr8:133454848-133571940,117092
31214091,31231537,chr16,TRIM72,chr16:31214091-31231537,17446
97822011,97944984,chr3,CRYBG3,chr3:97822011-97944984,122973
79920178,79923119,chr10,MBL1P,chr10:79920178-79923119,2941
229357629,229714555,chr2,DNER,chr2:229357629-229714555,356926
105472962,105480162,chr14,CRIP2,chr14:105472962-105480162,7200
99638475,99799226,chr3,COL8A1,chr3:99638475-99799226,160751
45587214,45615945,chr15,BLOC1S6,chr15:45587214-45615945,28731
135839626,135876443,chr2,MCM6,chr2:135839626-135876443,36817
130780301,131040909,chr8,ADCY8,chr8:130780301-131040909,260608
39550033,39619803,chr12,ABCD2,chr12:39550033-39619803,69770
80078646,80092557,chr10,TMEM254,chr10:80078646-80092557,13911
73768997,73770270,chr7,CLDN3,chr7:73768997-73770270,1273
69359710,69390870,chr12,YEATS4,chr12:69359710-69390870,31160
67909395,67964140,chr4,TMPRSS11A,chr4:67909395-67964140,54745
158124474,158173318,chr4,GASK1B,chr4:158124474-158173318,48844
12111952,12112036,chr12,MIR1244-4,chr12:12111952-12112036,84
93741591,93764749,chr11,C11orf54,chr11:93741591-93764749,23158
45631148,45691281,chr15,SQOR,chr15:45631148-45691281,60133
6185020,6209389,chr1,RPL22,chr1:6185020-6209389,24369
128350325,128361685,chr7,PRRT4,chr7:128350325-128361685,11360
6205475,6221299,chr1,RNF207,chr1:6205475-6221299,15824
105366909,105576900,chr3,ALCAM,chr3:105366909-105576900,209991
119544432,119662251,chr2,CFAP221,chr2:119544432-119662251,117819
1688574,1788674,chr12,ADIPOR2,chr12:1688574-1788674,100100
135693407,135704498,chr9,SOHLH1,chr9:135693407-135704498,11091
32887273,33005792,chr10,ITGB1,chr10:32887273-33005792,118519
143246821,143262705,chr8,ZFP41,chr8:143246821-143262705,15884
111979010,111993368,chr3,ABHD10,chr3:111979010-111993368,14358
135702185,135795508,chr9,KCNT1,chr9:135702185-135795508,93323
1791963,1918666,chr12,CACNA2D4,chr12:1791963-1918666,126703
112120839,112133270,chr3,GCSAM,chr3:112120839-112133270,12431
39838110,39883511,chr1,TRIT1,chr1:39838110-39883511,45401
81030708,81057627,chr4,BMP3,chr4:81030708-81057627,26919
190024367,190027257,chr4,FRG2,chr4:190024367-190027257,2890
45467995,45475179,chr19,FOSB,chr19:45467995-45475179,7184
154445997,154461053,chr5,SAP30L,chr5:154445997-154461053,15056
2078998,2242276,chr4,HAUS3,chr4:2078998-2242276,163278
96645242,97149654,chr8,CPQ,chr8:96645242-97149654,504412
165279664,165309605,chr6,C6orf118,chr6:165279664-165309605,29941
24806117,24980204,chr4,CCDC149,chr4:24806117-24980204,174087
124766498,124800706,chr11,MSANTD2,chr11:124766498-124800706,34208
66257294,66267860,chr11,KLC2,chr11:66257294-66267860,10566
56657731,56660698,chr16,MT1F,chr16:56657731-56660698,2967
21238874,21303083,chr16,CRYM,chr16:21238874-21303083,64209
105583731,105588395,chr14,IGHA2,chr14:105583731-105588395,4664
44885903,44951306,chr11,TP53I11,chr11:44885903-44951306,65403
105639559,105644790,chr14,IGHG2,chr14:105639559-105644790,5231
21879338,21919156,chr16,SMG1P4,chr16:21879338-21919156,39818
105647924,105649057,chr14,COPDA1,chr14:105647924-105649057,1133
100537147,100587417,chr14,BEGAIN,chr14:100537147-100587417,50270
138588235,138914041,chr8,COL22A1,chr8:138588235-138914041,325806
109542799,109614143,chr2,SEPTIN10,chr2:109542799-109614143,71344
10636604,10796650,chr1,CASZ1,chr1:10636604-10796650,160046
160393148,160400054,chr5,ZBED8,chr5:160393148-160400054,6906
15571699,15585051,chr1,AGMAT,chr1:15571699-15585051,13352
138178719,138187723,chr5,KIF20A,chr5:138178719-138187723,9004
21524646,21743630,chr10,MLLT10,chr10:21524646-21743630,218984
28239693,28240668,chr16,GAPDHP35,chr16:28239693-28240668,975
30485940,30486590,chr6,RANP1,chr6:30485940-30486590,650
140657900,141002216,chr8,PTK2,chr8:140657900-141002216,344316
103519667,103522833,chr14,CKB,chr14:103519667-103522833,3166
186486253,186509361,chr2,ZC3H15,chr2:186486253-186509361,23108
114257787,114313536,chr11,NNMT,chr11:114257787-114313536,55749
1820267,1836753,chr12,LRTM2,chr12:1820267-1836753,16486
30557280,30563723,chr6,PRR3,chr6:30557280-30563723,6443
14443440,14500027,chr11,COPB1,chr11:14443440-14500027,56587
1946053,2004535,chr12,DCP1B,chr12:1946053-2004535,58482
161416297,161425870,chr2,TBR1,chr2:161416297-161425870,9573
71675414,71754773,chr3,EIF4E3,chr3:71675414-71754773,79359
163593396,163736012,chr2,FIGN,chr2:163593396-163736012,142616
30617840,30626395,chr6,MRPS18B,chr6:30617840-30626395,8555
106449775,107240671,chr3,LINC00882,chr3:106449775-107240671,790896
119268692,119399688,chr5,TNFAIP8,chr5:119268692-119399688,130996
32267751,32378798,chr10,EPC1,chr10:32267751-32378798,111047
80197526,80387757,chr14,DIO2,chr14:80197526-80387757,190231
32892811,32993316,chr11,QSER1,chr11:32892811-32993316,100505
8940361,8949761,chr12,M6PR,chr12:8940361-8949761,9400
98531978,98534681,chr3,GPR15,chr3:98531978-98534681,2703
64251530,64269150,chr11,PLCB3,chr11:64251530-64269150,17620
45224466,45226287,chr3,TMEM158,chr3:45224466-45226287,1821
89701590,89774939,chr10,KIF20B,chr10:89701590-89774939,73349
112332347,112362812,chr3,CD200,chr3:112332347-112362812,30465
37802945,37808208,chr1,YRDC,chr1:37802945-37808208,5263
28974221,28984548,chr16,SPNS1,chr16:28974221-28984548,10327
90383721,90513402,chr7,CLDN12,chr7:90383721-90513402,129681
145936578,146081791,chr5,SH3RF2,chr5:145936578-146081791,145213
68731766,68953297,chr3,TAFA4,chr3:68731766-68953297,221531
33921693,34049388,chr9,UBAP2,chr9:33921693-34049388,127695
15736258,15741392,chr1,SLC25A34,chr1:15736258-15741392,5134
30647039,30653210,chr6,C6orf136,chr6:30647039-30653210,6171
17406760,17439677,chr1,RCC2,chr1:17406760-17439677,32917
172325000,172454525,chr5,SH3PXD2B,chr5:172325000-172454525,129525
98134624,98244897,chr10,R3HCC1L,chr10:98134624-98244897,110273
9239986,9240331,chr12,PTMAP4,chr12:9239986-9240331,345
57755450,57930003,chr3,SLMAP,chr3:57755450-57930003,174553
33750679,33799231,chr9,PRSS3,chr9:33750679-33799231,48552
122954381,122997513,chr10,PSTK,chr10:122954381-122997513,43132
57363551,57365405,chr19,TRAPPC2B,chr19:57363551-57365405,1854
52453553,52516882,chr19,ZNF578,chr19:52453553-52516882,63329
57434784,57452062,chr12,INHBC,chr12:57434784-57452062,17278
127907103,128085855,chr10,PTPRE,chr10:127907103-128085855,178752
91264433,91271326,chr7,FZD1,chr7:91264433-91271326,6893
116524994,116561179,chr7,CAV1,chr7:116524994-116561179,36185
86374736,86423109,chr11,CCDC81,chr11:86374736-86423109,48373
223957463,223967714,chr2,MRPL44,chr2:223957463-223967714,10251
77086688,77166909,chr5,ZBED3-AS1,chr5:77086688-77166909,80221
57472264,57488814,chr12,ARHGAP9,chr12:57472264-57488814,16550
136199114,136200503,chr2,HNRNPKP2,chr2:136199114-136200503,1389
29454501,29458219,chr16,SLX1B,chr16:29454501-29458219,3718
116672196,116798377,chr7,MET,chr7:116672196-116798377,126181
206443532,206621127,chr2,ADAM23,chr2:206443532-206621127,177595
111782195,111871581,chr11,ALG9,chr11:111782195-111871581,89386
29455105,29464963,chr16,SLX1B-SULT1A4,chr16:29455105-29464963,9858
138501770,138573547,chr2,SPOPL,chr2:138501770-138573547,71777
122519141,122520082,chr9,OR1J4,chr9:122519141-122520082,941
95871264,96121154,chr9,ERCC6L2,chr9:95871264-96121154,249890
119498547,119525090,chr3,TIMMDC1,chr3:119498547-119525090,26543
56476826,56477987,chr8,SEPTIN10P1,chr8:56476826-56477987,1161
29995715,30005793,chr16,INO80E,chr16:29995715-30005793,10078
63536808,63546462,chr11,PLAAT4,chr11:63536808-63546462,9654
9148011,9198906,chr1,MIR34AHG,chr1:9148011-9198906,50895
42916828,42932185,chr7,PSMA2,chr7:42916828-42932185,15357
109095110,109174418,chr6,CEP57L1,chr6:109095110-109174418,79308
3824127,4348392,chr9,GLIS3,chr9:3824127-4348392,524265
63681446,63759891,chr11,RTN3,chr11:63681446-63759891,78445
42932376,42948958,chr7,MRPL32,chr7:42932376-42948958,16582
62950430,63125062,chr3,LINC00698,chr3:62950430-63125062,174632
75641849,75724589,chr4,G3BP2,chr4:75641849-75724589,82740
30005514,30023270,chr16,DOC2A,chr16:30005514-30023270,17756
52704955,52711148,chr3,SPCS1,chr3:52704955-52711148,6193
37996770,38005606,chr1,FHL3,chr1:37996770-38005606,8836
18069935,18106087,chr11,SAAL1,chr11:18069935-18106087,36152
52495338,52524495,chr3,STAB1,chr3:52495338-52524495,29157
176365487,176401865,chr5,ARL10,chr5:176365487-176401865,36378
200510008,200584096,chr2,SGO2,chr2:200510008-200584096,74088
38409051,38426305,chr19,RASGRP4,chr19:38409051-38426305,17254
57519163,57519259,chr12,MIR616,chr12:57519163-57519259,96
103352730,103446207,chr7,SLC26A5,chr7:103352730-103446207,93477
57591174,57603418,chr12,PIP4K2C,chr12:57591174-57603418,12244
142727223,142736927,chr8,THEM6,chr8:142727223-142736927,9704
103140713,103230305,chr8,BAALC,chr8:103140713-103230305,89592
142670308,142682725,chr8,PSCA,chr8:142670308-142682725,12417
124965710,125055997,chr3,HEG1,chr3:124965710-125055997,90287
120535745,120813273,chr8,SNTB1,chr8:120535745-120813273,277528
108047545,108168956,chr4,LEF1,chr4:108047545-108168956,121411
71753855,71756496,chr3,GPR27,chr3:71753855-71756496,2641
30092314,30096915,chr16,YPEL3,chr16:30092314-30096915,4601
28994785,29005316,chr6,ZNF311,chr6:28994785-29005316,10531
34179005,34252523,chr9,UBAP1,chr9:34179005-34252523,73518
127968785,128520616,chr6,PTPRK,chr6:127968785-128520616,551831
557595,560107,chr11,LMNTD2-AS1,chr11:557595-560107,2512
45082277,45146422,chr3,CDCP1,chr3:45082277-45146422,64145
140520156,140635633,chr8,AGO2,chr8:140520156-140635633,115477
185500660,185535507,chr4,PDLIM3,chr4:185500660-185535507,34847
568089,568198,chr11,MIR210,chr11:568089-568198,109
34252380,34329268,chr9,KIF24,chr9:34252380-34329268,76888
91409280,91514829,chr10,HECTD2,chr10:91409280-91514829,105549
119524293,119559614,chr3,CD80,chr3:119524293-119559614,35321
98497912,98523066,chr3,CLDND1,chr3:98497912-98523066,25154
30183505,30184957,chr16,CORO1A-AS1,chr16:30183505-30184957,1452
30193892,30204310,chr16,SLX1A-SULT1A3,chr16:30193892-30204310,10418
65635537,66192133,chr17,CEP112,chr17:65635537-66192133,556596
612553,615983,chr11,IRF7,chr11:612553-615983,3430
111896814,111935369,chr9,UGCG,chr9:111896814-111935369,38555
50780340,50781150,chr1,PHBP12,chr1:50780340-50781150,810
45076510,45092635,chr19,GEMIN7-AS1,chr19:45076510-45092635,16125
616577,626078,chr11,CDHR5,chr11:616577-626078,9501
79819083,79827704,chr17,LINC01977,chr17:79819083-79827704,8621
74191198,74191294,chr7,MIR590,chr7:74191198-74191294,96
48321509,48330553,chr19,EMP3,chr19:48321509-48330553,9044
103328570,103370346,chr7,PSMC2,chr7:103328570-103370346,41776
78484882,78503056,chr17,DNAH17-AS1,chr17:78484882-78503056,18174
626309,627181,chr11,SCT,chr11:626309-627181,872
637269,640706,chr11,DRD4,chr11:637269-640706,3437
72216000,72235860,chr10,ANAPC16,chr10:72216000-72235860,19860
87345664,87399794,chr7,CROT,chr7:87345664-87399794,54130
95885098,95961851,chr5,ELL2,chr5:95885098-95961851,76753
175923882,176002839,chr2,LNPK,chr2:175923882-176002839,78957
17589032,17617374,chr10,HACD1,chr10:17589032-17617374,28342
69244311,69327244,chr17,ABCA5,chr17:69244311-69327244,82933
17644151,17716824,chr10,STAM,chr10:17644151-17716824,72673
148025683,148137382,chr5,SPINK5,chr5:148025683-148137382,111699
59747277,61251459,chr3,FHIT,chr3:59747277-61251459,1504182
101398851,101410660,chr9,ZNF189,chr9:101398851-101410660,11809
87401696,87480435,chr7,ABCB4,chr7:87401696-87480435,78739
988434,1019932,chr10,GTPBP4,chr10:988434-1019932,31498
55802851,55833337,chr16,CES1,chr16:55802851-55833337,30486
112736349,112764664,chr2,CKAP2L,chr2:112736349-112764664,28315
116645902,116646727,chr3,BZW1P2,chr3:116645902-116646727,825
58505136,58537283,chr3,ACOX2,chr3:58505136-58537283,32147
172084740,172089677,chr2,DLX1,chr2:172084740-172089677,4937
1022630,1045425,chr10,IDI2-AS1,chr10:1022630-1045425,22795
155854738,155920406,chr4,TDO2,chr4:155854738-155920406,65668
39769523,39771348,chr1,OXCT2,chr1:39769523-39771348,1825
37566816,37595937,chr1,GNL2,chr1:37566816-37595937,29121
53051991,53100873,chr6,FBXO9,chr6:53051991-53100873,48882
66856426,66932141,chr9,ZNF658,chr9:66856426-66932141,75715
118900557,119146068,chr3,IGSF11,chr3:118900557-119146068,245511
87503017,87713323,chr7,ABCB1,chr7:87503017-87713323,210306
69324567,69392558,chr9,FAM189A2,chr9:69324567-69392558,67991
53366656,53368245,chr1,LINC02812,chr1:53366656-53368245,1589
110045846,110199199,chr4,ELOVL6,chr4:110045846-110199199,153353
32391698,32483067,chr3,CMTM7,chr3:32391698-32483067,91369
180300698,180353336,chr5,GFPT2,chr5:180300698-180353336,52638
2181794,2184389,chr1,PRKCZ-AS1,chr1:2181794-2184389,2595
68827531,68895432,chr10,STOX1,chr10:68827531-68895432,67901
80219699,80253500,chr17,SLC26A11,chr17:80219699-80253500,33801
68901286,68946847,chr10,DDX50,chr10:68901286-68946847,45561
36510709,36593156,chr11,RAG1,chr11:36510709-36593156,82447
30606601,30694142,chr3,TGFBR2,chr3:30606601-30694142,87541
223751686,223838027,chr2,AP1S3,chr2:223751686-223838027,86341
98613405,98645113,chr12,IKBIP,chr12:98613405-98645113,31708
10393186,10419659,chr6,TFAP2A,chr6:10393186-10419659,26473
108958248,109118134,chr3,MORC1,chr3:108958248-109118134,159886
87521461,87522410,chr7,HNRNPA1P9,chr7:87521461-87522410,949
98515579,98550351,chr12,TMPO,chr12:98515579-98550351,34772
19484403,19629821,chr1,MICOS10,chr1:19484403-19629821,145418
66176376,66178464,chr8,CRH,chr8:66176376-66178464,2088
125430358,125438403,chr8,TRIB1,chr8:125430358-125438403,8045
14071319,14266773,chr16,MRTFB,chr16:14071319-14266773,195454
80134369,80147151,chr17,EIF4A3,chr17:80134369-80147151,12782
71396920,71815947,chr10,CDH23,chr10:71396920-71815947,419027
40620680,40665682,chr1,RIMS3,chr1:40620680-40665682,45002
44848416,44849568,chr7,LINC01952,chr7:44848416-44849568,1152
44026951,44041892,chr7,RASA4CP,chr7:44026951-44041892,14941
52895910,52927212,chr1,ECHDC2,chr1:52895910-52927212,31302
64364304,64387687,chr15,PCLAF,chr15:64364304-64387687,23383
71109684,71130239,chr2,MCEE,chr2:71109684-71130239,20555
214725646,214809683,chr2,BARD1,chr2:214725646-214809683,84037
119635526,119636150,chr3,RPL10P7,chr3:119635526-119636150,624
51907956,51990700,chr1,RAB3B,chr1:51907956-51990700,82744
61631680,61632012,chr8,RN7SKP97,chr8:61631680-61632012,332
2930561,2934834,chr4,MFSD10,chr4:2930561-2934834,4273
55158939,55177540,chr19,DNAAF3-AS1,chr19:55158939-55177540,18601
98048856,98048962,chr8,RNU6-703P,chr8:98048856-98048962,106
55171196,55180289,chr19,SYT5,chr19:55171196-55180289,9093
102421197,102421322,chr8,RNU6ATAC8P,chr8:102421197-102421322,125
79347469,79355334,chr10,PPIF,chr10:79347469-79355334,7865
30572738,30600647,chr15,ULK4P2,chr15:30572738-30600647,27909
30616998,30625773,chr15,ARHGAP11B-DT,chr15:30616998-30625773,8775
42942897,43106113,chr15,UBR1,chr15:42942897-43106113,163216
55181247,55209506,chr19,PTPRH,chr19:55181247-55209506,28259
32039974,32042828,chr17,SH3GL1P1,chr17:32039974-32042828,2854
128836315,128867373,chr11,KCNJ1,chr11:128836315-128867373,31058
53062052,53085501,chr1,PODN,chr1:53062052-53085501,23449
86435256,86521792,chr10,WAPL,chr10:86435256-86521792,86536
43115702,43116493,chr15,RPS3AP47,chr15:43115702-43116493,791
43123279,43185144,chr15,TMEM62,chr15:43123279-43185144,61865
65278643,65491430,chr12,MSRB3,chr12:65278643-65491430,212787
51577179,51798427,chr1,OSBPL9,chr1:51577179-51798427,221248
94938658,94990091,chr10,CYP2C9,chr10:94938658-94990091,51433
43185118,43197177,chr15,CCNDBP1,chr15:43185118-43197177,12059
18948898,18949762,chr7,NPM1P13,chr7:18948898-18949762,864
55719627,55732121,chr17,TMEM100,chr17:55719627-55732121,12494
52708444,52770946,chr3,NEK4,chr3:52708444-52770946,62502
29606283,29617237,chr19,POP4,chr19:29606283-29617237,10954
94940253,94941121,chr10,MTND4P20,chr10:94940253-94941121,868
95036772,95069497,chr10,CYP2C8,chr10:95036772-95069497,32725
48958554,48968596,chr17,GIP,chr17:48958554-48968596,10042
74199652,74229834,chr7,LAT2,chr7:74199652-74229834,30182
180967248,181076585,chr2,UBE2E3,chr2:180967248-181076585,109337
38600661,38601200,chr8,RNF5P1,chr8:38600661-38601200,539
50057548,50083611,chr12,ASIC1,chr12:50057548-50083611,26063
83261536,83284914,chr4,COQ2,chr4:83261536-83284914,23378
11790005,11790386,chr8,SUB1P1,chr8:11790005-11790386,381
11795573,11839304,chr8,FDFT1,chr8:11795573-11839304,43731
46921124,46921249,chr17,RNU6ATAC3P,chr17:46921124-46921249,125
83292461,83335153,chr4,HPSE,chr4:83292461-83335153,42692
105235290,105396097,chr12,C12orf75,chr12:105235290-105396097,160807
51391285,51397908,chr3,RBM15B,chr3:51391285-51397908,6623
36196744,36232790,chr6,BRPF3,chr6:36196744-36232790,36046
98247690,98268194,chr10,LOXL4,chr10:98247690-98268194,20504
43323649,43330582,chr15,LCMT2,chr15:43323649-43330582,6933
98383565,98415182,chr10,PYROXD2,chr10:98383565-98415182,31617
42950526,42980528,chr17,PTGES3L-AARSD1,chr17:42950526-42980528,30002
155311697,155313427,chr2,MTND5P30,chr2:155311697-155313427,1730
181887851,181891663,chr2,ITPRID2-DT,chr2:181887851-181891663,3812
51341655,51408005,chr15,GLDN,chr15:51341655-51408005,66350
119497678,119498181,chr3,TIMMDC1-DT,chr3:119497678-119498181,503
86220265,86259657,chr9,C9orf153,chr9:86220265-86259657,39392
119829404,119892556,chr10,MCMBP,chr10:119829404-119892556,63152
35358460,35360489,chr19,FFAR3,chr19:35358460-35360489,2029
283164,287215,chr16,PDIA2,chr16:283164-287215,4051
54643889,54670359,chr19,LILRB4,chr19:54643889-54670359,26470
67717931,67744531,chr17,NOL11,chr17:67717931-67744531,26600
67648338,67665406,chr12,DYRK2,chr12:67648338-67665406,17068
105107324,105169130,chr12,WASHC4,chr12:105107324-105169130,61806
119892730,119944657,chr10,SEC23IP,chr10:119892730-119944657,51927
132317369,132368298,chr3,ACP3,chr3:132317369-132368298,50929
68125777,68152468,chr17,LRRC37A16P,chr17:68125777-68152468,26691
40348456,40380439,chr19,PLD3,chr19:40348456-40380439,31983
134735464,134918710,chr2,CCNT2-AS1,chr2:134735464-134918710,183246
215996329,216082955,chr2,PECR,chr2:215996329-216082955,86626
37433219,37482827,chr6,CMTR1,chr6:37433219-37482827,49608
52842511,52894998,chr1,ZYG11A,chr1:52842511-52894998,52487
75120409,75352327,chr8,CASC9,chr8:75120409-75352327,231918
111360685,111484745,chr9,ECPAS,chr9:111360685-111484745,124060
50205246,50221486,chr3,SLC38A3,chr3:50205246-50221486,16240
2857680,2877174,chr12,FOXM1,chr12:2857680-2877174,19494
36243203,36313955,chr6,PNPLA1,chr6:36243203-36313955,70752
55324203,55330756,chr16,IRX6,chr16:55324203-55330756,6553
111732497,111976517,chr3,PHLDB2,chr3:111732497-111976517,244020
4796968,4802880,chr16,ROGDI,chr16:4796968-4802880,5912
142941114,142962363,chr7,KEL,chr7:142941114-142962363,21249
49366584,49527425,chr12,SPATS2,chr12:49366584-49527425,160841
168706567,168720884,chr5,SLIT3-AS2,chr5:168706567-168720884,14317
224378698,224402107,chr2,FAM124B,chr2:224378698-224402107,23409
51723011,51751585,chr15,LYSMD2,chr15:51723011-51751585,28574
33310962,33866121,chr15,RYR3,chr15:33310962-33866121,555159
181891730,181930738,chr2,ITPRID2,chr2:181891730-181930738,39008
52020131,52055191,chr1,TXNDC12,chr1:52020131-52055191,35060
32844078,32846500,chr6,PSMB8-AS1,chr6:32844078-32846500,2422
32844136,32859851,chr6,PSMB9,chr6:32844136-32859851,15715
38474668,38608354,chr5,LIFR,chr5:38474668-38608354,133686
111686053,111757107,chr12,ACAD10,chr12:111686053-111757107,71054
73413515,73452297,chr6,CGAS,chr6:73413515-73452297,38782
129036621,129072082,chr9,MIGA2,chr9:129036621-129072082,35461
40524878,40574685,chr3,ZNF621,chr3:40524878-40574685,49807
128257909,128659185,chr5,FBN2,chr5:128257909-128659185,401276
49815096,49815562,chr10,RPL21P89,chr10:49815096-49815562,466
26481396,26490484,chr4,CCKAR,chr4:26481396-26490484,9088
10751246,10801625,chr11,CTR9,chr11:10751246-10801625,50379
50305586,50625163,chr10,SGMS1,chr10:50305586-50625163,319577
24998847,25030946,chr4,LGI2,chr4:24998847-25030946,32099
4553386,4666674,chr9,SPATA6L,chr9:4553386-4666674,113288
100602363,100608175,chr7,PCOLCE,chr7:100602363-100608175,5812
55039447,55064852,chr1,PCSK9,chr1:55039447-55064852,25405
10797050,10808940,chr11,EIF4G2,chr11:10797050-10808940,11890
136148917,136197241,chr3,MSL2,chr3:136148917-136197241,48324
25160663,25279204,chr4,PI4K2B,chr4:25160663-25279204,118541
87659613,87747705,chr10,PAPSS2,chr10:87659613-87747705,88092
105334027,105337475,chr2,C2orf49-DT,chr2:105334027-105337475,3448
33473386,33513185,chr8,TTI2,chr8:33473386-33513185,39799
100620416,100642779,chr7,TFR2,chr7:100620416-100642779,22363
30199228,30204310,chr16,SULT1A3,chr16:30199228-30204310,5082
8858127,8864772,chr9,PTPRD-AS1,chr9:8858127-8864772,6645
87751512,87841361,chr10,ATAD1,chr10:87751512-87841361,89849
15469865,15601552,chr4,CC2D2A,chr4:15469865-15601552,131687
61901684,62096944,chr10,ARID5B,chr10:61901684-62096944,195260
121987323,122022247,chr3,ILDR1,chr3:121987323-122022247,34924
73422259,73422696,chr10,RPL26P6,chr10:73422259-73422696,437
133245603,133257207,chr3,TMEM108-AS1,chr3:133245603-133257207,11604
52772194,52772648,chr1,RPS13P2,chr1:52772194-52772648,454
10812074,10858796,chr11,ZBED5,chr11:10812074-10858796,46722
7970251,8001862,chr11,EIF3F,chr11:7970251-8001862,31611
136336236,136752403,chr3,STAG1,chr3:136336236-136752403,416167
121024125,121113108,chr11,TBCEL-TECTA,chr11:121024125-121113108,88983
30009730,30017030,chr11,KCNA4,chr11:30009730-30017030,7300
114442299,115845780,chr2,DPP10,chr2:114442299-115845780,1403481
140388453,140427661,chr4,CLGN,chr4:140388453-140427661,39208
110289233,110738956,chr5,TMEM232,chr5:110289233-110738956,449723
18781111,18806714,chr17,TVP23B,chr17:18781111-18806714,25603
140524168,140553770,chr4,ELMOD2,chr4:140524168-140553770,29602
100735396,100829944,chr10,PAX2,chr10:100735396-100829944,94548
64745095,64833232,chr1,RAVER2,chr1:64745095-64833232,88137
79611117,79666158,chr8,STMN2,chr8:79611117-79666158,55041
70010751,70065945,chr16,PDXDC2P,chr16:70010751-70065945,55194
120392293,120450993,chr3,FSTL1,chr3:120392293-120450993,58700
63322567,63325128,chr1,FOXD3,chr1:63322567-63325128,2561
109827972,109849123,chr4,RRH,chr4:109827972-109849123,21151
214411054,214578976,chr2,VWC2L,chr2:214411054-214578976,167922
113275642,113294009,chr9,PRPF4,chr9:113275642-113294009,18367
109848107,109872315,chr4,LRIT3,chr4:109848107-109872315,24208
1571353,1599184,chr11,KRTAP5-AS1,chr11:1571353-1599184,27831
1584342,1585283,chr11,KRTAP5-1,chr11:1584342-1585283,941
100969518,100985871,chr10,SEMA4G,chr10:100969518-100985871,16353
53226900,53238518,chr1,MAGOH,chr1:53226900-53238518,11618
68496676,68538627,chr1,DEPDC1-AS1,chr1:68496676-68538627,41951
74234700,74321540,chr8,JPH1,chr8:74234700-74321540,86840
55226638,55228784,chr19,TMEM86B,chr19:55226638-55228784,2146
70219574,70246612,chr16,SMG1P7,chr16:70219574-70246612,27038
1616492,1616595,chr19,RNU6-1223P,chr19:1616492-1616595,103
63597353,63602428,chr15,FBXL22,chr15:63597353-63602428,5075
74599775,74823313,chr8,MIR2052HG,chr8:74599775-74823313,223538
50960745,50974634,chr1,CDKN2C,chr1:50960745-50974634,13889
113648385,113696646,chr3,USF3,chr3:113648385-113696646,48261
70289663,70335305,chr16,DDX19B,chr16:70289663-70335305,45642
74603244,74604244,chr8,PCBP2P2,chr8:74603244-74604244,1000
49308797,49308868,chr19,MIR4324,chr19:49308797-49308868,71
17864380,17910365,chr8,FGL1,chr8:17864380-17910365,45985
19338775,19485539,chr1,CAPZB,chr1:19338775-19485539,146764
39083913,39111493,chr19,ACP7,chr19:39083913-39111493,27580
113386312,113401290,chr9,ALAD,chr9:113386312-113401290,14978
117678693,117691005,chr3,LINC02024,chr3:117678693-117691005,12312
630858,664196,chr12,NINJ2-AS1,chr12:630858-664196,33338
113407235,113410675,chr9,POLE3,chr9:113407235-113410675,3440
65319563,65670495,chr4,EPHA5,chr4:65319563-65670495,350932
179101678,179264832,chr2,SESTD1,chr2:179101678-179264832,163154
152936323,152979671,chr4,FHDC1,chr4:152936323-152979671,43348
101007679,101032295,chr10,PDZD7,chr10:101007679-101032295,24616
39328353,39342372,chr19,GMFG,chr19:39328353-39342372,14019
45016399,45306209,chr1,ZSWIM5,chr1:45016399-45306209,289810
67717411,67719178,chr9,FAM27E3,chr9:67717411-67719178,1767
67832765,67920552,chr9,ANKRD20A1,chr9:67832765-67920552,87787
214847128,214847445,chr2,RPL10P6,chr2:214847128-214847445,317
147393422,147510293,chr3,ZIC1,chr3:147393422-147510293,116871
28532493,28623112,chr10,WAC,chr10:28532493-28623112,90619
131647990,131767404,chr2,C2orf27A,chr2:131647990-131767404,119414
66999350,67054148,chr1,SLC35D1,chr1:66999350-67054148,54798
241776822,241804287,chr2,GAL3ST2,chr2:241776822-241804287,27465
24823637,24978723,chr15,SNRPN,chr15:24823637-24978723,155086
70315442,70346806,chr16,DDX19A-DT,chr16:70315442-70346806,31364
100679507,100694250,chr7,GIGYF1,chr7:100679507-100694250,14743
39406847,39409412,chr19,ZFP36,chr19:39406847-39409412,2565
7080214,7092540,chr12,C1R,chr12:7080214-7092540,12326
138494344,138594538,chr3,CEP70,chr3:138494344-138594538,100194
21077104,21077942,chr9,IFNB1,chr9:21077104-21077942,838
70454595,70480274,chr16,FCSK,chr16:70454595-70480274,25679
156011530,156254950,chr2,LINC01876,chr2:156011530-156254950,243420
87674860,87702233,chr6,AKIRIN2,chr6:87674860-87702233,27373
87590067,87667453,chr6,ORC3,chr6:87590067-87667453,77386
111611639,111884690,chr2,ANAPC1,chr2:111611639-111884690,273051
173232109,173235311,chr5,NKX2-5,chr5:173232109-173235311,3202
159865080,159973012,chr5,ADRA1B,chr5:159865080-159973012,107932
143332605,143333239,chr5,RPL7P21,chr5:143332605-143333239,634
177022696,177081189,chr5,ZNF346,chr5:177022696-177081189,58493
47565336,47584562,chr11,NDUFS3,chr11:47565336-47584562,19226
133262420,133276868,chr10,ADAM8,chr10:133262420-133276868,14448
28319200,28328685,chr17,TMEM97,chr17:28319200-28328685,9485
40679915,40693735,chr5,PTGER4,chr5:40679915-40693735,13820
470291,746105,chr9,KANK1,chr9:470291-746105,275814
47572197,47578976,chr11,KBTBD4,chr11:47572197-47578976,6779
238848032,238910534,chr2,TWIST2,chr2:238848032-238910534,62502
47589667,47594411,chr11,C1QTNF4,chr11:47589667-47594411,4744
47617315,47642607,chr11,MTCH2,chr11:47617315-47642607,25292
84491985,84499292,chr4,NKX6-1,chr4:84491985-84499292,7307
82422565,82430462,chr4,HNRNPDL,chr4:82422565-82430462,7897
158968640,159232659,chr2,TANC1,chr2:158968640-159232659,264019
133324072,133336935,chr10,CALY,chr10:133324072-133336935,12863
47716494,47767443,chr11,FNBP4,chr11:47716494-47767443,50949
151437046,151492379,chr5,SLC36A1,chr5:151437046-151492379,55333
26521709,26527404,chr6,HCG11,chr6:26521709-26527404,5695
39498895,39508481,chr19,DLL3,chr19:39498895-39508481,9586
27837880,27838375,chr6,H2AC15,chr6:27837880-27838375,495
30031713,30033003,chr6,ETF1P1,chr6:30031713-30033003,1290
128739292,128773400,chr7,CALU,chr7:128739292-128773400,34108
199269500,199471266,chr2,SATB2,chr2:199269500-199471266,201766
109713825,109770495,chr12,FAM222A,chr12:109713825-109770495,56670
109734166,109773508,chr12,FAM222A-AS1,chr12:109734166-109773508,39342
126704240,126960420,chr3,CHCHD6,chr3:126704240-126960420,256180
52032103,52033810,chr1,KTI12,chr1:52032103-52033810,1707
53946085,53968168,chr1,LRRC42,chr1:53946085-53968168,22083
46647551,46661182,chr19,DACT3,chr19:46647551-46661182,13631
72274552,72275159,chr1,GDI2P2,chr1:72274552-72275159,607
73305609,73355253,chr1,LINC01360,chr1:73305609-73355253,49644
112973272,113071962,chr4,ANK2-AS1,chr4:112973272-113071962,98690
158666675,158672255,chr4,C4orf46,chr4:158666675-158672255,5580
49679651,49710261,chr10,C10orf53,chr10:49679651-49710261,30610
57484534,57515780,chr11,SLC43A1,chr11:57484534-57515780,31246
62436297,62451804,chr1,USP1,chr1:62436297-62451804,15507
63048553,63086053,chr8,TTPA,chr8:63048553-63086053,37500
152116801,152175763,chr2,STAM2,chr2:152116801-152175763,58962
46005088,46030623,chr10,NCOA4,chr10:46005088-46030623,25535
75443054,75465497,chr16,TMEM170A,chr16:75443054-75465497,22443
77282019,77559966,chr1,AK5,chr1:77282019-77559966,277947
214931542,215138626,chr2,ABCA12,chr2:214931542-215138626,207084
74824534,74855029,chr8,PI15,chr8:74824534-74855029,30495
6583183,6604103,chr19,CD70,chr19:6583183-6604103,20920
129144707,129169699,chr7,TSPAN33,chr7:129144707-129169699,24992
6677704,6730562,chr19,C3,chr19:6677704-6730562,52858
41848146,41894053,chr15,SPTBN5,chr15:41848146-41894053,45907
1650629,1684867,chr17,PRPF8,chr17:1650629-1684867,34238
129188633,129213545,chr7,SMO,chr7:129188633-129213545,24912
16436943,16513745,chr10,PTER,chr10:16436943-16513745,76802
23439075,23442377,chr10,OTUD1,chr10:23439075-23442377,3302
79512533,79516440,chr10,EIF5AL1,chr10:79512533-79516440,3907
158709127,158723396,chr4,PPID,chr4:158709127-158723396,14269
49818279,49970203,chr10,PARG,chr10:49818279-49970203,151924
41960949,42264100,chr7,GLI3,chr7:41960949-42264100,303151
87891843,87894015,chr4,HSP90AB3P,chr4:87891843-87894015,2172
88007635,88077777,chr4,PKD2,chr4:88007635-88077777,70142
129748196,129786624,chr8,GSDMC,chr8:129748196-129786624,38428
44537125,44563029,chr15,EIF3J,chr15:44537125-44563029,25904
20363685,20383782,chr11,HTATIP2,chr11:20363685-20383782,20097
35638247,35642296,chr10,FZD8,chr10:35638247-35642296,4049
67701475,67833467,chr1,GNG12,chr1:67701475-67833467,131992
88090150,88231628,chr4,ABCG2,chr4:88090150-88231628,141478
1702816,1710377,chr17,TLCD2,chr17:1702816-1710377,7561
1742836,1755265,chr17,SERPINF2,chr17:1742836-1755265,12429
7754077,7778928,chr4,AFAP1-AS1,chr4:7754077-7778928,24851
59650764,59736002,chr10,SLC16A9,chr10:59650764-59736002,85238
78180866,78182046,chr4,SERBP1P5,chr4:78180866-78182046,1180
172641263,172691540,chr5,NEURL1B,chr5:172641263-172691540,50277
103928456,104052667,chr14,TDRD9,chr14:103928456-104052667,124211
216107464,216206303,chr2,XRCC5,chr2:216107464-216206303,98839
1762029,1777565,chr17,SERPINF1,chr17:1762029-1777565,15536
139475533,139482935,chr5,STING1,chr5:139475533-139482935,7402
24573268,24694193,chr7,PALS2,chr7:24573268-24694193,120925
64470129,64693058,chr1,CACHD1,chr1:64470129-64693058,222929
161083883,161105411,chr3,B3GALNT1,chr3:161083883-161105411,21528
1779485,1830634,chr17,SMYD4,chr17:1779485-1830634,51149
14145049,14974777,chr7,DGKB,chr7:14145049-14974777,829728
87439523,87459044,chr2,LINC01943,chr2:87439523-87459044,19521
1829702,1900082,chr17,RPA1,chr17:1829702-1900082,70380
158695916,159099916,chr5,EBF1,chr5:158695916-159099916,404000
32148359,32153083,chr6,PRRT1,chr6:32148359-32153083,4724
84925583,84997113,chr1,MCOLN2,chr1:84925583-84997113,71530
91102629,91111494,chr12,LUM,chr12:91102629-91111494,8865
104853287,104858574,chr2,POU3F3,chr2:104853287-104858574,5287
32153441,32163678,chr6,PPT2,chr6:32153441-32163678,10237
60419609,60479160,chr15,ICE2,chr15:60419609-60479160,59551
80408013,80483379,chr5,ZFYVE16,chr5:80408013-80483379,75366
62784132,62865516,chr1,ATG4C,chr1:62784132-62865516,81384
72121020,72126416,chr17,SOX9,chr17:72121020-72126416,5396
144352219,144354914,chr8,TMEM249,chr8:144352219-144354914,2695
72067099,72237203,chr17,SOX9-AS1,chr17:72067099-72237203,170104
32153845,32171978,chr6,PPT2-EGFL8,chr6:32153845-32171978,18133
49598884,49678163,chr17,SPOP,chr17:49598884-49678163,79279
1039152,1049119,chr10,IDI1,chr10:1039152-1049119,9967
32164595,32168281,chr6,EGFL8,chr6:32164595-32168281,3686
105209286,105315589,chr14,BRF1,chr14:105209286-105315589,106303
173707614,173746279,chr5,LINC01484,chr5:173707614-173746279,38665
120522664,120523443,chr12,RPL29P24,chr12:120522664-120523443,779
180459,181179,chr16,HBQ1,chr16:180459-181179,720
45863989,45873797,chr19,FOXA3,chr19:45863989-45873797,9808
84076331,84077931,chr1,PRKACB-DT,chr1:84076331-84077931,1600
45995461,46021318,chr19,CCDC61,chr19:45995461-46021318,25857
39692182,39763914,chr1,PPIE,chr1:39692182-39763914,71732
187341964,187448460,chr2,CALCRL,chr2:187341964-187448460,106496
165772904,165837462,chr3,BCHE,chr3:165772904-165837462,64558
45795713,45815308,chr19,RSPH6A,chr19:45795713-45815308,19595
177519789,177554563,chr5,FAM193B,chr5:177519789-177554563,34774
49064676,49070025,chr12,RHEBL1,chr12:49064676-49070025,5349
60347134,60402883,chr15,ANXA2,chr15:60347134-60402883,55749
175477062,175529742,chr5,SFXN1,chr5:175477062-175529742,52680
196967017,197311173,chr2,ANKRD44,chr2:196967017-197311173,344156
6709452,6709552,chr12,RNU6-781P,chr12:6709452-6709552,100
169013227,169037998,chr5,SLIT3-AS1,chr5:169013227-169037998,24771
163437569,163446151,chr5,CCNG1,chr5:163437569-163446151,8582
183078559,183100008,chr2,DUSP19,chr2:183078559-183100008,21449
87338511,87339035,chr2,IGKV3OR2-268,chr2:87338511-87339035,524
102794383,102868896,chr4,UBE2D3,chr4:102794383-102868896,74513
49788648,49835026,chr17,KAT7,chr17:49788648-49835026,46378
14966668,14972351,chr11,CALCA,chr11:14966668-14972351,5683
101770109,101780371,chr10,FGF8,chr10:101770109-101780371,10262
133663560,133739955,chr9,SARDH,chr9:133663560-133739955,76395
129904465,130186634,chr5,CHSY3,chr5:129904465-130186634,282169
73974672,73982843,chr11,UCP2,chr11:73974672-73982843,8171
116056925,116276803,chr10,GFRA1,chr10:116056925-116276803,219878
161424332,161985282,chr2,SLC4A10,chr2:161424332-161985282,560950
83865024,83999150,chr1,TTLL7,chr1:83865024-83999150,134126
53225724,53251637,chr8,OPRK1,chr8:53225724-53251637,25913
49990005,49995224,chr17,DLX3,chr17:49990005-49995224,5219
6772512,6778455,chr12,LAG3,chr12:6772512-6778455,5943
86965345,86971311,chr10,ADIRF-AS1,chr10:86965345-86971311,5966
139517434,139539829,chr3,RBP1,chr3:139517434-139539829,22395
57940833,57947706,chr19,ZNF256,chr19:57940833-57947706,6873
87094161,87191465,chr10,SHLD2,chr10:87094161-87191465,97304
132750819,132807241,chr5,SEPTIN8,chr5:132750819-132807241,56422
49889654,49929539,chr19,IL4I1,chr19:49889654-49929539,39885
27504174,27543207,chr10,RAB18,chr10:27504174-27543207,39033
58882868,58931897,chr1,LINC02777,chr1:58882868-58931897,49029
85649417,85708433,chr1,ZNHIT6,chr1:85649417-85708433,59016
6828407,6839847,chr12,P3H3,chr12:6828407-6839847,11440
112149865,112215377,chr10,GPAM,chr10:112149865-112215377,65512
75084326,75206267,chr6,COL12A1,chr6:75084326-75206267,121941
81339183,81345966,chr17,RENO1,chr17:81339183-81345966,6783
81400716,81400778,chr17,MIR4740,chr17:81400716-81400778,62
81451104,81451188,chr17,MIR3186,chr17:81451104-81451188,84
81480523,81481570,chr17,LINC01971,chr17:81480523-81481570,1047
14877440,14892231,chr11,CYP2R1,chr11:14877440-14892231,14791
170990823,171231314,chr2,TLK1,chr2:170990823-171231314,240491
143184917,143223874,chr4,USP38,chr4:143184917-143223874,38957
31318495,31529814,chr10,ZEB1,chr10:31318495-31529814,211319
83899115,83951445,chr16,MLYCD,chr16:83899115-83951445,52330
23047062,23057538,chr14,CDH24,chr14:23047062-23057538,10476
87328880,87348923,chr1,LMO4,chr1:87328880-87348923,20043
141228726,141367753,chr3,PXYLP1,chr3:141228726-141367753,139027
17170083,17170189,chr17,RNU6-767P,chr17:17170083-17170189,106
85156889,85201016,chr1,SYDE2,chr1:85156889-85201016,44127
17246616,17281273,chr17,COPS3,chr17:17246616-17281273,34657
179911651,180072113,chr5,RNF130,chr5:179911651-180072113,160462
218859805,218874233,chr2,WNT6,chr2:218859805-218874233,14428
53974969,53976031,chr1,HNRNPA3P12,chr1:53974969-53976031,1062
76074746,76634603,chr1,ST6GALNAC3,chr1:76074746-76634603,559857
136818647,136855888,chr3,SLC35G2,chr3:136818647-136855888,37241
37248118,37347031,chr10,LINC00993,chr10:37248118-37347031,98913
55066359,55215364,chr1,USP24,chr1:55066359-55215364,149005
50511600,50514690,chr19,ASPDH,chr19:50511600-50514690,3090
6924463,6942321,chr12,ATN1,chr12:6924463-6942321,17858
17303335,17347663,chr17,NT5M,chr17:17303335-17347663,44328
17383377,17384012,chr17,RPL13P12,chr17:17383377-17384012,635
6946468,6961316,chr12,PTPN6,chr12:6946468-6961316,14848
50819146,50823787,chr19,KLK1,chr19:50819146-50823787,4641
75252924,75284948,chr6,TMEM30A,chr6:75252924-75284948,32024
169861303,169980495,chr5,INSYN2B,chr5:169861303-169980495,119192
136975298,137598379,chr5,SPOCK1,chr5:136975298-137598379,623081
97840912,97923497,chr5,LINC02234,chr5:97840912-97923497,82585
130136391,130184521,chr10,GLRX3,chr10:130136391-130184521,48130
13586939,13630859,chr10,PRPF18,chr10:13586939-13630859,43920
170864875,170870208,chr3,RPL22L1,chr3:170864875-170870208,5333
36334453,36379201,chr19,ZFP14,chr19:36334453-36379201,44748
6970913,6997428,chr12,EMG1,chr12:6970913-6997428,26515
36534774,36605276,chr19,ZNF529,chr19:36534774-36605276,70502
169447867,169477052,chr3,MECOM-AS1,chr3:169447867-169477052,29185
11011708,11012006,chr19,RN7SL192P,chr19:11011708-11012006,298
11089462,11133820,chr19,LDLR,chr19:11089462-11133820,44358
34579487,34639318,chr17,TMEM132E,chr17:34579487-34639318,59831
6867119,6870948,chr12,TPI1,chr12:6867119-6870948,3829
14081843,14398983,chr9,NFIB,chr9:14081843-14398983,317140
31471585,31477960,chr16,TGFB1I1,chr16:31471585-31477960,6375
130344816,130368730,chr7,CPA5,chr7:130344816-130368730,23914
236165236,236168386,chr2,GBX2,chr2:236165236-236168386,3150
21197954,21214176,chr17,TMEM11,chr17:21197954-21214176,16222
187464230,187565760,chr2,TFPI,chr2:187464230-187565760,101530
65833834,65856896,chr11,SNX32,chr11:65833834-65856896,23062
161500885,161507705,chr2,AHCTF1P1,chr2:161500885-161507705,6820
132416805,132646582,chr2,GPR39,chr2:132416805-132646582,229777
130730697,130734207,chr7,KLF14,chr7:130730697-130734207,3510
167284799,168264157,chr5,TENM2,chr5:167284799-168264157,979358
79898840,79923702,chr15,ST20,chr15:79898840-79923702,24862
176495255,176819180,chr2,LINC01117,chr2:176495255-176819180,323925
79922771,79926993,chr15,ST20-AS1,chr15:79922771-79926993,4222
203867771,203873965,chr2,CTLA4,chr2:203867771-203873965,6194
98211439,98215457,chr7,BHLHA15,chr7:98211439-98215457,4018
40440844,40444335,chr19,SERTAD3,chr19:40440844-40444335,3491
42871521,42874060,chr10,LINC02623,chr10:42871521-42874060,2539
146110566,146182696,chr5,LARS1,chr5:146110566-146182696,72130
43077064,43130351,chr10,RET,chr10:43077064-43130351,53287
171783405,171999859,chr2,SLC25A12,chr2:171783405-171999859,216454
6794134,6826770,chr7,CCZ1B,chr7:6794134-6826770,32636
110873263,111038470,chr9,LPAR1,chr9:110873263-111038470,165207
43194535,43267065,chr10,RASGEF1A,chr10:43194535-43267065,72530
69801880,69964275,chr10,COL13A1,chr10:69801880-69964275,162395
92224818,92896473,chr11,FAT3,chr11:92224818-92896473,671655
29858357,29863414,chr16,CDIPT,chr16:29858357-29863414,5057
100889994,100896974,chr7,ACHE,chr7:100889994-100896974,6980
76214040,76283783,chr4,FAM47E,chr4:76214040-76283783,69743
29900375,29919864,chr16,ASPHD1,chr16:29900375-29919864,19489
77881348,77889539,chr1,NEXN-AS1,chr1:77881348-77889539,8191
99542387,99568825,chr6,CCNC,chr6:99542387-99568825,26438
55158661,55166722,chr19,DNAAF3,chr19:55158661-55166722,8061
29905012,29926236,chr16,KCTD13,chr16:29905012-29926236,21224
76158737,76234536,chr4,SCARB2,chr4:76158737-76234536,75799
119557086,119673453,chr8,ENPP2,chr8:119557086-119673453,116367
22625075,22690665,chr12,ETNK1,chr12:22625075-22690665,65590
52633168,52669683,chr1,SHISAL2A,chr1:52633168-52669683,36515
86571181,86696311,chr1,CLCA4-AS1,chr1:86571181-86696311,125130
93866284,93879918,chr1,DNTTIP2,chr1:93866284-93879918,13634
167065831,167066320,chr3,PPIAP74,chr3:167065831-167066320,489
9573670,9593457,chr11,WEE1,chr11:9573670-9593457,19787
60914158,60923443,chr11,TMEM109,chr11:60914158-60923443,9285
60924460,60937159,chr11,TMEM132A,chr11:60924460-60937159,12699
44678420,44700928,chr4,GUF1,chr4:44678420-44700928,22508
60971680,61020377,chr11,CD6,chr11:60971680-61020377,48697
65194760,65211473,chr15,CILP,chr15:65194760-65211473,16713
44682200,44726588,chr4,GNPDA2,chr4:44682200-44726588,44388
65296051,65296166,chr15,RNU5A-1,chr15:65296051-65296166,115
130111669,130201336,chr3,LINC02021,chr3:130111669-130201336,89667
23685400,23687305,chr15,NDN,chr15:23685400-23687305,1905
38386207,38409527,chr8,LETM2,chr8:38386207-38409527,23320
140941830,140980995,chr3,SLC25A36,chr3:140941830-140980995,39165
1776712,1793700,chr16,SPSB3,chr16:1776712-1793700,16988
60937060,60952653,chr11,SLC15A3,chr11:60937060-60952653,15593
170357678,170396835,chr3,SKIL,chr3:170357678-170396835,39157
22419444,22727613,chr7,STEAP1B,chr7:22419444-22727613,308169
152835131,152841439,chr3,P2RY1,chr3:152835131-152841439,6308
180100795,180209211,chr5,RASGEF1C,chr5:180100795-180209211,108416
180868141,180982753,chr3,FXR1,chr3:180868141-180982753,114612
76611376,76906114,chr9,PRUNE2,chr9:76611376-76906114,294738
3671083,3797792,chr11,NUP98,chr11:3671083-3797792,126709
46652915,46678190,chr6,SLC25A27,chr6:46652915-46678190,25275
40058290,40093867,chr17,THRA,chr17:40058290-40093867,35577
170928464,170967130,chr2,GORASP2,chr2:170928464-170967130,38666
169583636,169604778,chr5,SPDL1,chr5:169583636-169604778,21142
128091200,128195677,chr2,UGGT1,chr2:128091200-128195677,104477
136868652,137020255,chr7,CHRM2,chr7:136868652-137020255,151603
17042457,17217679,chr17,MPRIP,chr17:17042457-17217679,175222
139025706,139036042,chr7,ZC3HAV1L,chr7:139025706-139036042,10336
54849627,54887195,chr1,DHCR24,chr1:54849627-54887195,37568
172828736,172829176,chr3,ATP5MC1P4,chr3:172828736-172829176,440
171058414,171460408,chr3,TNIK,chr3:171058414-171460408,401994
153337705,153357422,chr2,LINC01850,chr2:153337705-153357422,19717
86288704,86320711,chr1,LINC02795,chr1:86288704-86320711,32007
154190730,154420984,chr5,GALNT10,chr5:154190730-154420984,230254
70755035,70773251,chr16,VAC14-AS1,chr16:70755035-70773251,18216
52010999,52019095,chr15,MAPK6-DT,chr15:52010999-52019095,8096
4269771,4305353,chr12,CCND2,chr12:4269771-4305353,35582
143716340,143722458,chr8,MAPK15,chr8:143716340-143722458,6118
151181052,151224093,chr5,CCDC69,chr5:151181052-151224093,43041
10743786,10769351,chr16,NUBP1,chr16:10743786-10769351,25565
55743122,55757264,chr12,GDF11,chr12:55743122-55757264,14142
143723933,143738234,chr8,FAM83H,chr8:143723933-143738234,14301
122301303,122310691,chr7,FEZF1,chr7:122301303-122310691,9388
33441156,33447596,chr9,AQP3,chr9:33441156-33447596,6440
143733083,143733153,chr8,MIR4664,chr8:143733083-143733153,70
122064583,122144308,chr7,AASS,chr7:122064583-122144308,79725
10760919,10818794,chr16,TVP23A,chr16:10760919-10818794,57875
54998933,55017172,chr1,BSND,chr1:54998933-55017172,18239
4094707,4138932,chr11,RRM1,chr11:4094707-4138932,44225
136881912,136926607,chr9,TRAF2,chr9:136881912-136926607,44695
47220822,47232766,chr19,BBC3,chr19:47220822-47232766,11944
178859953,178888122,chr5,ZNF354B,chr5:178859953-178888122,28169
16324826,16328685,chr19,KLF2,chr19:16324826-16328685,3859
113876282,114056593,chr9,ZNF618,chr9:113876282-114056593,180311
101295419,101305737,chr15,SNRPA1-DT,chr15:101295419-101305737,10318
39064710,39288315,chr9,CNTNAP3,chr9:39064710-39288315,223605
101175727,101252048,chr15,CHSY1,chr15:101175727-101252048,76321
178208471,178232802,chr5,PHYKPL,chr5:178208471-178232802,24331
101602786,101614531,chr15,LINC02348,chr15:101602786-101614531,11745
103471381,103989658,chr7,RELN,chr7:103471381-103989658,518277
68178857,68256237,chr2,PPP3R1,chr2:68178857-68256237,77380
101653596,101724473,chr15,TARS3,chr15:101653596-101724473,70877
12961541,12989597,chr11,LINC00958,chr11:12961541-12989597,28056
124001670,124033301,chr9,LHX2,chr9:124001670-124033301,31631
218059155,218065729,chr2,CXCR2P1,chr2:218059155-218065729,6574
50665899,50846519,chr5,PARP8,chr5:50665899-50846519,180620
183607442,183608119,chr2,CACYBPP2,chr2:183607442-183608119,677
101289784,101525202,chr15,PCSK6,chr15:101289784-101525202,235418
82689559,82689768,chr11,RPS28P7,chr11:82689559-82689768,209
214854,465259,chr9,DOCK8,chr9:214854-465259,250405
230415942,230545606,chr2,SP100,chr2:230415942-230545606,129664
143857324,143878467,chr8,EPPK1,chr8:143857324-143878467,21143
1738630,1742291,chr7,ELFN1-AS1,chr7:1738630-1742291,3661
2339150,2426699,chr16,ABCA17P,chr16:2339150-2426699,87549
2383698,2388652,chr7,KIF19BP,chr7:2383698-2388652,4954
40690380,40692066,chr1,NFYC-AS1,chr1:40690380-40692066,1686
48740852,48746909,chr19,IZUMO1,chr19:48740852-48746909,6057
48795062,48811029,chr19,BCAT2,chr19:48795062-48811029,15967
82973133,83071923,chr11,RAB30,chr11:82973133-83071923,98790
144012280,144047114,chr8,SPATC1,chr8:144012280-144047114,34834
86704570,86748184,chr1,SH3GLB1,chr1:86704570-86748184,43614
48813018,48836510,chr19,HSD17B14,chr19:48813018-48836510,23492
32013270,32013787,chr6,STK19B,chr6:32013270-32013787,517
48837097,48868617,chr19,PLEKHA4,chr19:48837097-48868617,31520
369499,382117,chr11,B4GALNT4,chr11:369499-382117,12618
238426742,238452250,chr2,ASB1,chr2:238426742-238452250,25508
8314246,10613002,chr9,PTPRD,chr9:8314246-10613002,2298756
144107726,144118328,chr8,WDR97,chr8:144107726-144118328,10602
2475051,2509560,chr16,TBC1D24,chr16:2475051-2509560,34509
137007234,137028915,chr9,ABCA2,chr9:137007234-137028915,21681
144141214,144143664,chr8,TSSK5P,chr8:144141214-144143664,2450
62500218,62511894,chr2,TMEM17,chr2:62500218-62511894,11676
57095408,57132139,chr12,STAT6,chr12:57095408-57132139,36731
130089433,130094304,chr3,LINC02014,chr3:130089433-130094304,4871
73307235,73309361,chr11,ARHGEF17-AS1,chr11:73307235-73309361,2126
7438273,7444937,chr17,FGF11,chr17:7438273-7444937,6664
73264498,73305103,chr11,P2RY6,chr11:73264498-73305103,40605
146069440,146163653,chr3,PLOD2,chr3:146069440-146163653,94213
48933699,48944969,chr19,DHDH,chr19:48933699-48944969,11270
200305881,200482264,chr2,SPATS2L,chr2:200305881-200482264,176383
7445061,7457710,chr17,CHRNB1,chr17:7445061-7457710,12649
48965309,48966879,chr19,FTL,chr19:48965309-48966879,1570
44213455,44220681,chr1,DMAP1,chr1:44213455-44220681,7226
94048287,94081202,chr14,DDX24,chr14:94048287-94081202,32915
38392702,38398661,chr9,ALDH1B1,chr9:38392702-38398661,5959
7855066,7856099,chr17,TMEM88,chr17:7855066-7856099,1033
38406528,38424454,chr9,IGFBPL1,chr9:38406528-38424454,17926
61187559,61550976,chr14,PRKCH,chr14:61187559-61550976,363417
181711925,181714436,chr3,SOX2,chr3:181711925-181714436,2511
182793503,182921629,chr3,ATP11B,chr3:182793503-182921629,128126
120792403,120801787,chr9,B3GALT9,chr9:120792403-120801787,9384
41503637,41513887,chr15,LTK,chr15:41503637-41513887,10250
94896949,94927223,chr1,CNN3,chr1:94896949-94927223,30274
23125295,23183674,chr14,SLC7A8,chr14:23125295-23183674,58379
104260531,104260826,chr5,RN7SL255P,chr5:104260531-104260826,295
118974586,118974670,chr5,MIR1244-2,chr5:118974586-118974670,84
83455012,85627922,chr11,DLG2,chr11:83455012-85627922,2172910
8039034,8049134,chr17,ALOX15B,chr17:8039034-8049134,10100
53802771,55627942,chr10,PCDH15,chr10:53802771-55627942,1825171
143353400,143362770,chr7,FAM131B,chr7:143353400-143362770,9370
168768146,168768255,chr5,MIR218-2,chr5:168768146-168768255,109
35154730,35169881,chr19,FXYD5,chr19:35154730-35169881,15151
143381295,143391111,chr7,ZYX,chr7:143381295-143391111,9816
8072636,8087716,chr17,ALOX12B,chr17:8072636-8087716,15080
8120592,8124106,chr17,HES7,chr17:8120592-8124106,3514
96446930,96448318,chr1,EEF1A1P11,chr1:96446930-96448318,1388
66870749,66922048,chr8,MCMDC2,chr8:66870749-66922048,51299
95117355,95197607,chr1,TLCD4,chr1:95117355-95197607,80252
38043829,38046793,chr1,POU3F1,chr1:38043829-38046793,2964
406428,477967,chr8,FBXO25,chr8:406428-477967,71539
101236865,101243713,chr1,S1PR1,chr1:101236865-101243713,6848
85018082,85048500,chr1,MCOLN3,chr1:85018082-85048500,30418
177446445,177456286,chr5,PRR7,chr5:177446445-177456286,9841
5855781,5856426,chr9,AK4P4,chr9:5855781-5856426,645
78898840,78898936,chr15,RNU6-415P,chr15:78898840-78898936,96
21209136,21269494,chr14,HNRNPC,chr14:21209136-21269494,60358
177483394,177497606,chr5,PDLIM7,chr5:177483394-177497606,14212
118894152,118909171,chr6,ASF1A,chr6:118894152-118909171,15019
118813442,118935162,chr6,MCM9,chr6:118813442-118935162,121720
216257865,216372483,chr2,MARCHF4,chr2:216257865-216372483,114618
93240020,93419687,chr6,EPHA7,chr6:93240020-93419687,179667
215611563,215848954,chr2,LINC00607,chr2:215611563-215848954,237391
236324147,236507535,chr2,IQCA1,chr2:236324147-236507535,183388
100509752,100559784,chr8,ANKRD46,chr8:100509752-100559784,50032
177511577,177516961,chr5,DDX41,chr5:177511577-177516961,5384
98346188,98398601,chr2,CNGA3,chr2:98346188-98398601,52413
113161006,113221458,chr9,FKBP15,chr9:113161006-113221458,60452
47841537,47943048,chr12,VDR,chr12:47841537-47943048,101511
94148988,94275068,chr1,ARHGAP29,chr1:94148988-94275068,126080
157259742,157533619,chr3,VEPH1,chr3:157259742-157533619,273877
78068297,78079862,chr11,NDUFC2,chr11:78068297-78079862,11565
149993118,150000654,chr5,TIGD6,chr5:149993118-150000654,7536
6595072,6603616,chr11,RRP8,chr11:6595072-6603616,8544
22889371,23014130,chr7,FAM126A,chr7:22889371-23014130,124759
23100214,23105703,chr7,KLHL7-DT,chr7:23100214-23105703,5489
23129178,23129841,chr7,AK3P3,chr7:23129178-23129841,663
113078331,113087778,chr7,GPR85,chr7:113078331-113087778,9447
95937901,96022890,chr1,LINC02790,chr1:95937901-96022890,84989
35490111,35561898,chr9,RUSC2,chr9:35490111-35561898,71787
233059967,233207903,chr2,INPP5D,chr2:233059967-233207903,147936
55485188,55487568,chr19,NAT14,chr19:55485188-55487568,2380
83980798,84004074,chr9,RMI1,chr9:83980798-84004074,23276
8377516,8383213,chr17,RPL26,chr17:8377516-8383213,5697
6680385,6683340,chr11,MRPL17,chr11:6680385-6683340,2955
55576774,55580848,chr19,ZNF579,chr19:55576774-55580848,4074
6621330,6655809,chr11,DCHS1,chr11:6621330-6655809,34479
29730713,29730985,chr15,HMGN2P5,chr15:29730713-29730985,272
55635016,55643470,chr19,ZNF580,chr19:55635016-55643470,8454
55641062,55653161,chr19,CCDC106,chr19:55641062-55653161,12099
33461353,33473930,chr9,NOL6,chr9:33461353-33473930,12577
74174231,74197122,chr7,EIF4H,chr7:74174231-74197122,22891
42341767,42342634,chr8,RPL5P23,chr8:42341767-42342634,867
76607853,76630465,chr11,LINC02757,chr11:76607853-76630465,22612
5274369,5306912,chr7,SLC29A4,chr7:5274369-5306912,32543
191495,196334,chr5,LRRC14B,chr5:191495-196334,4839
36852906,37449223,chr7,ELMO1,chr7:36852906-37449223,596317
89575758,89597246,chr16,CPNE7,chr16:89575758-89597246,21488
113979391,114035572,chr1,OLFML3,chr1:113979391-114035572,56181
470456,524449,chr5,SLC9A3,chr5:470456-524449,53993
47760528,47997385,chr1,TRABD2B,chr1:47760528-47997385,236857
137220247,137222240,chr9,RNF208,chr9:137220247-137222240,1993
93885199,93909456,chr1,GCLM,chr1:93885199-93909456,24257
91680343,91906335,chr1,TGFBR3,chr1:91680343-91906335,225992
42412823,42491141,chr15,ZNF106,chr15:42412823-42491141,78318
73799542,73832690,chr7,CLDN4,chr7:73799542-73832690,33148
612340,667168,chr5,CEP72,chr5:612340-667168,54828
55538884,55588947,chr15,PYGO1,chr15:55538884-55588947,50063
57046532,57055239,chr6,KIAA1586,chr6:57046532-57055239,8707
55365337,55433737,chr7,LANCL2,chr7:55365337-55433737,68400
41546381,41602384,chr6,FOXP4,chr6:41546381-41602384,56003
89711856,89718165,chr16,VPS9D1-AS1,chr16:89711856-89718165,6309
59429022,59465380,chr14,GPR135,chr14:59429022-59465380,36358
28267058,28278224,chr6,ZSCAN26,chr6:28267058-28278224,11166
138795911,138904070,chr6,ECT2L,chr6:138795911-138904070,108159
1505022,1513604,chr19,ADAMTSL5,chr19:1505022-1513604,8582
88612431,88792953,chr14,EML5,chr14:88612431-88792953,180522
169215780,169254050,chr6,THBS2,chr6:169215780-169254050,38270
96349241,96389956,chr11,CCDC82,chr11:96349241-96389956,40715
67884656,67918390,chr10,SIRT1,chr10:67884656-67918390,33734
72332830,72355149,chr10,DNAJB12,chr10:72332830-72355149,22319
1446302,1473244,chr19,APC2,chr19:1446302-1473244,26942
29585121,29590500,chr6,OR2H2,chr6:29585121-29590500,5379
123762188,123935720,chr12,DNAH10,chr12:123762188-123935720,173532
36968141,36986298,chr6,MTCH1,chr6:36968141-36986298,18157
57375967,57550717,chr15,CGNL1,chr15:57375967-57550717,174750
185417495,185418778,chr3,RPL4P4,chr3:185417495-185418778,1283
106573663,107164706,chr10,SORCS1,chr10:106573663-107164706,591043
73368555,73395133,chr6,OOEP,chr6:73368555-73395133,26578
31399784,31415315,chr6,MICA,chr6:31399784-31415315,15531
94529173,94541759,chr1,F3,chr1:94529173-94541759,12586
99998301,99999069,chr9,UPF3AP3,chr9:99998301-99999069,768
119047405,119064785,chr1,WARS2-IT1,chr1:119047405-119064785,17380
120388875,120580170,chr9,CDK5RAP2,chr9:120388875-120580170,191295
31479973,31494935,chr6,MICB-DT,chr6:31479973-31494935,14962
31463170,31478936,chr6,HCP5,chr6:31463170-31478936,15766
100719742,100739045,chr1,VCAM1,chr1:100719742-100739045,19303
188969,229463,chr16,LUC7L,chr16:188969-229463,40494
32812757,32838570,chr7,DPY19L1P2,chr7:32812757-32838570,25813
10729777,10815164,chr17,TMEM220-AS1,chr17:10729777-10815164,85387
56317177,56318008,chr19,VN2R17P,chr19:56317177-56318008,831
101226994,101229463,chr10,LBX1,chr10:101226994-101229463,2469
27258762,27288824,chr10,ODAD2P1,chr10:27258762-27288824,30062
74019349,74082863,chr14,BBOF1,chr14:74019349-74082863,63514
11241213,11564063,chr17,SHISA6,chr17:11241213-11564063,322850
74056847,74084492,chr14,ALDH6A1,chr14:74056847-74084492,27645
135965728,136147894,chr3,PPP2R3A,chr3:135965728-136147894,182166
56397966,56436035,chr19,ZNF583,chr19:56397966-56436035,38069
4115693,4135597,chr6,ECI2,chr6:4115693-4135597,19904
33094797,33109405,chr7,RP9,chr7:33094797-33109405,14608
126012381,126388477,chr10,ADAM12,chr10:126012381-126388477,376096
74285269,74303055,chr14,ABCD4,chr14:74285269-74303055,17786
104738597,104804107,chr7,LHFPL3-AS1,chr7:104738597-104804107,65510
104894628,104926645,chr7,LHFPL3-AS2,chr7:104894628-104926645,32017
187368385,187372076,chr3,RTP4,chr3:187368385-187372076,3691
166922113,166957191,chr6,RNASET2,chr6:166922113-166957191,35078
27696388,27710803,chr12,MRPS35-DT,chr12:27696388-27710803,14415
37125598,37232567,chr10,ANKRD30A,chr10:37125598-37232567,106969
27710822,27756295,chr12,MRPS35,chr12:27710822-27756295,45473
74084956,74201493,chr14,LIN52,chr14:74084956-74201493,116537
12020829,12143830,chr17,MAP2K4,chr17:12020829-12143830,123001
97545701,97546958,chr1,SEC63P1,chr1:97545701-97546958,1257
49693105,49753150,chr14,KLHDC1,chr14:49693105-49753150,60045
29699367,29968915,chr15,TJP1,chr15:29699367-29968915,269548
87934143,88202889,chr7,ADAM22,chr7:87934143-88202889,268746
10221433,10231331,chr19,S1PR2,chr19:10221433-10231331,9898
10230413,10230485,chr19,MIR4322,chr19:10230413-10230485,72
113011687,113073113,chr1,LRIG2-DT,chr1:113011687-113073113,61426
8911139,8920084,chr11,AKIP1,chr11:8911139-8920084,8945
151494017,151621193,chr6,CCDC170,chr6:151494017-151621193,127176
116752197,116765719,chr6,FAM162B,chr6:116752197-116765719,13522
119468963,119494708,chr3,POGLUT1,chr3:119468963-119494708,25745
65758020,65826997,chr12,RPSAP52,chr12:65758020-65826997,68977
8947202,8965011,chr11,TMEM9B,chr11:8947202-8965011,17809
6328757,6342114,chr12,TNFRSF1A,chr12:6328757-6342114,13357
131948176,131951372,chr6,CCN2,chr6:131948176-131951372,3196
10289952,10296778,chr19,ICAM5,chr19:10289952-10296778,6826
84999147,85133138,chr1,DNAI3,chr1:84999147-85133138,133991
190514051,190659750,chr3,IL1RAP,chr3:190514051-190659750,145699
10304803,10309880,chr19,ZGLP1,chr19:10304803-10309880,5077
9004093,9067776,chr11,NRIP3-DT,chr11:9004093-9067776,63683
9019476,9138114,chr11,SCUBE2,chr11:9019476-9138114,118638
10310045,10316015,chr19,FDX2,chr19:10310045-10316015,5970
170813213,170861151,chr2,GAD1,chr2:170813213-170861151,47938
34709113,34714823,chr14,CFL2,chr14:34709113-34714823,5710
99971437,100342005,chr15,ADAMTS17,chr15:99971437-100342005,370568
13494032,13601929,chr17,HS3ST3A1,chr17:13494032-13601929,107897
113924000,113929495,chr1,HIPK1-AS1,chr1:113924000-113929495,5495
110031577,110074641,chr1,STRIP1,chr1:110031577-110074641,43064
52527652,52564464,chr19,ZNF808,chr19:52527652-52564464,36812
76309478,76384521,chr17,PRPSAP1,chr17:76309478-76384521,75043
76699789,76700538,chr1,TPI1P1,chr1:76699789-76700538,749
188291669,188595931,chr2,GULP1,chr2:188291669-188595931,304262
42174718,42207709,chr8,PLAT,chr8:42174718-42207709,32991
100400395,100544995,chr15,CERS3,chr15:100400395-100544995,144600
108522214,108561400,chr12,SART3,chr12:108522214-108561400,39186
98890245,99005032,chr1,PLPPR5,chr1:98890245-99005032,114787
50548396,50649249,chr16,NKD1,chr16:50548396-50649249,100853
34874343,34876459,chr14,BAZ1A-AS1,chr14:34874343-34876459,2116
57571566,57578911,chr19,ZNF416,chr19:57571566-57578911,7345
108272943,108337853,chr1,SLC25A24P1,chr1:108272943-108337853,64910
64515654,64688000,chr3,ADAMTS9,chr3:64515654-64688000,172346
79976716,79991262,chr5,MTX3,chr5:79976716-79991262,14546
186032884,186422432,chr2,LINC01473,chr2:186032884-186422432,389548
98210747,98272658,chr1,LINC01776,chr1:98210747-98272658,61911
160187367,160238735,chr5,FABP6,chr5:160187367-160238735,51368
113073198,113132260,chr1,LRIG2,chr1:113073198-113132260,59062
76527356,76551175,chr17,CYGB,chr17:76527356-76551175,23819
76527586,76553578,chr17,PRCD,chr17:76527586-76553578,25992
9384652,9448127,chr11,IPO7,chr11:9384652-9448127,63475
37551406,37614179,chr19,ZNF540,chr19:37551406-37614179,62773
61102489,61127852,chr11,CD5,chr11:61102489-61127852,25363
108589851,108598320,chr12,TMEM119,chr12:108589851-108598320,8469
37554782,37594792,chr19,ZNF571,chr19:37554782-37594792,40010
13196723,13219941,chr12,EMP1,chr12:13196723-13219941,23218
41219223,41261766,chr19,AXL,chr19:41219223-41261766,42543
15422734,15465953,chr9,SNAPC3,chr9:15422734-15465953,43219
241356285,241494841,chr2,FARP2,chr2:241356285-241494841,138556
99850361,99924023,chr1,AGL,chr1:99850361-99924023,73662
32845209,32853816,chr6,TAP1,chr6:32845209-32853816,8607
168008689,168095924,chr3,GOLIM4,chr3:168008689-168095924,87235
35161992,35405338,chr9,UNC13B,chr9:35161992-35405338,243346
77088749,77217101,chr17,SEC14L1,chr17:77088749-77217101,128352
43793723,43806328,chr12,TWF1,chr12:43793723-43806328,12605
68635282,69390571,chr6,ADGRB3,chr6:68635282-69390571,755289
7158624,7411488,chr10,SFMBT2,chr10:7158624-7411488,252864
20695332,20753386,chr12,SLCO1C1,chr12:20695332-20753386,58054
240998618,241095568,chr2,SNED1,chr2:240998618-241095568,96950
77474394,77498816,chr14,ISM2,chr14:77474394-77498816,24422
77505997,77616637,chr14,SPTLC2,chr14:77505997-77616637,110640
124539101,124580648,chr8,NDUFB9,chr8:124539101-124580648,41547
69259277,69357033,chr14,GALNT16,chr14:69259277-69357033,97756
43385617,43409186,chr10,HNRNPF,chr10:43385617-43409186,23569
82659281,82710112,chr15,AP3B2,chr15:82659281-82710112,50831
43556344,43574618,chr10,ZNF239,chr10:43556344-43574618,18274
122202577,122229626,chr9,LHX6,chr9:122202577-122229626,27049
110150494,110202202,chr1,SLC6A17,chr1:110150494-110202202,51708
159712457,159771027,chr2,MARCHF7,chr2:159712457-159771027,58570
64016950,64061612,chr9,FLJ43315,chr9:64016950-64061612,44662
21453802,21559900,chr9,MIR31HG,chr9:21453802-21559900,106098
30678066,30727846,chr8,GSR,chr8:30678066-30727846,49780
44508275,44921848,chr12,NELL2,chr12:44508275-44921848,413573
18173162,18178117,chr19,IFI30,chr19:18173162-18178117,4955
86948629,87002033,chr9,GAS1RR,chr9:86948629-87002033,53404
136721366,136728184,chr9,SNHG7,chr9:136721366-136728184,6818
18196784,18204042,chr19,RAB3A,chr19:18196784-18204042,7258
77210449,77428256,chr5,PDE8B,chr5:77210449-77428256,217807
18208652,18248200,chr19,PDE4C,chr19:18208652-18248200,39548
128663129,128684493,chr9,HMGA1P4,chr9:128663129-128684493,21364
157006307,157007132,chr7,MNX1-AS2,chr7:157006307-157007132,825
157010805,157016426,chr7,MNX1-AS1,chr7:157010805-157016426,5621
30774457,30814314,chr8,PPP2CB,chr8:30774457-30814314,39857
70815948,70881184,chr10,SGPL1,chr10:70815948-70881184,65236
30831544,30913008,chr8,TEX15,chr8:30831544-30913008,81464
132685007,132760712,chr8,TMEM71,chr8:132685007-132760712,75705
21635342,21757857,chr12,LDHB,chr12:21635342-21757857,122515
101031234,101041244,chr10,SFXN3,chr10:101031234-101041244,10010
94104836,94116695,chr14,IFI27,chr14:94104836-94116695,11859
3526466,3691814,chr9,RFX3-AS1,chr9:3526466-3691814,165348
189031898,189225312,chr2,COL5A2,chr2:189031898-189225312,193414
103472804,103479240,chr10,CALHM3,chr10:103472804-103479240,6436
69738860,69823204,chr12,RAB3IP,chr12:69738860-69823204,84344
18418864,18434562,chr19,SSBP4,chr19:18418864-18434562,15698
124658412,124698631,chr9,MIR181A2HG,chr9:124658412-124698631,40219
62248591,63014000,chr8,NKAIN3,chr8:62248591-63014000,765409
150944961,150978321,chr7,KCNH2,chr7:150944961-150978321,33360
73537143,73543796,chr14,ACOT1,chr14:73537143-73543796,6653
73567620,73575658,chr14,ACOT2,chr14:73567620-73575658,8038
73591873,73595766,chr14,ACOT4,chr14:73591873-73595766,3893
46816516,46832476,chr10,AGAP13P,chr10:46816516-46832476,15960
18434388,18438167,chr19,ISYNA1,chr19:18434388-18438167,3779
46911396,47002488,chr10,PTPN20,chr10:46911396-47002488,91092
73711783,73714384,chr14,PNMA1,chr14:73711783-73714384,2601
143734139,143790645,chr8,IQANK1,chr8:143734139-143790645,56506
241492670,241509730,chr2,STK25,chr2:241492670-241509730,17060
43299710,43308826,chr6,CRIP3,chr6:43299710-43308826,9116
118189455,118622112,chr8,SAMD12,chr8:118189455-118622112,432657
196211487,196243178,chr3,SLC51A,chr3:196211487-196243178,31691
72959485,72969466,chr7,TRIM74,chr7:72959485-72969466,9981
43310231,43310357,chr6,RPL12P47,chr6:43310231-43310357,126
131808016,131895155,chr6,ENPP1,chr6:131808016-131895155,87139
58872149,58920504,chr12,LRIG3,chr12:58872149-58920504,48355
22024125,22036897,chr8,NPM2,chr8:22024125-22036897,12772
54369133,54391298,chr12,ZNF385A,chr12:54369133-54391298,22165
33391823,33409896,chr6,KIFC1,chr6:33391823-33409896,18073
113900284,113979727,chr4,ARSJ,chr4:113900284-113979727,79443
6710128,6753862,chr7,PMS2CL,chr7:6710128-6753862,43734
22042398,22048809,chr8,FGF17,chr8:22042398-22048809,6411
103525691,103555239,chr1,RNPC3,chr1:103525691-103555239,29548
7346685,7479897,chr12,CD163L1,chr12:7346685-7479897,133212
82809628,82836108,chr15,WHAMM,chr15:82809628-82836108,26480
22106874,22109419,chr8,NUDT18,chr8:22106874-22109419,2545
113894194,113905201,chr1,AP4B1,chr1:113894194-113905201,11007
49856970,49859289,chr19,PTOV1-AS2,chr19:49856970-49859289,2319
109213918,109238182,chr1,SARS1,chr1:109213918-109238182,24264
79703227,79714681,chr10,NUTM2B,chr10:79703227-79714681,11454
70025247,70043113,chr5,SERF1B,chr5:70025247-70043113,17866
86756601,86932825,chr10,BMPR1A,chr10:86756601-86932825,176224
24809454,25050147,chr14,STXBP6,chr14:24809454-25050147,240693
15303811,15341632,chr17,TEKT3,chr17:15303811-15341632,37821
131967684,131981967,chr10,BNIP3,chr10:131967684-131981967,14283
67819779,68730218,chr14,RAD51B,chr14:67819779-68730218,910439
100896076,100981757,chr1,SLC30A7,chr1:100896076-100981757,85681
44370165,44386493,chr10,CXCL12,chr10:44370165-44386493,16328
112956415,113047055,chr1,SLC16A1-AS1,chr1:112956415-113047055,90640
133430394,133431318,chr10,OR6L2P,chr10:133430394-133431318,924
109687814,109709039,chr1,GSTM1,chr1:109687814-109709039,21225
86935002,87141039,chr4,AFF1,chr4:86935002-87141039,206037
105880002,105932642,chr14,FAM30A,chr14:105880002-105932642,52640
191245185,191425389,chr2,MYO1B,chr2:191245185-191425389,180204
38738155,38948273,chr14,LINC00639,chr14:38738155-38948273,210118
68230595,68232113,chr10,ATOH7,chr10:68230595-68232113,1518
108621895,108633894,chr12,SELPLG,chr12:108621895-108633894,11999
75423683,75427741,chr14,JDP2-AS1,chr14:75423683-75427741,4058
27092993,27096000,chr7,HOXA1,chr7:27092993-27096000,3007
27095647,27100265,chr7,HOTAIRM1,chr7:27095647-27100265,4618
108645109,108731526,chr12,CORO1C,chr12:108645109-108731526,86417
101552221,101560438,chr14,DIO3OS,chr14:101552221-101560438,8217
116909916,116990353,chr1,PTGFRN,chr1:116909916-116990353,80437
38094334,38150293,chr10,ZNF37A,chr10:38094334-38150293,55959
27141052,27143681,chr7,HOXA5,chr7:27141052-27143681,2629
27145396,27150603,chr7,HOXA6,chr7:27145396-27150603,5207
69403903,69416918,chr10,TACR2,chr10:69403903-69416918,13015
27193503,27200091,chr7,HOXA13,chr7:27193503-27200091,6588
185712528,185729787,chr3,IGF2BP2-AS1,chr3:185712528-185729787,17259
72379215,72379710,chr15,RPL12P35,chr15:72379215-72379710,495
49950737,49958878,chr12,AQP2,chr12:49950737-49958878,8141
139560180,139678017,chr3,NMNAT3,chr3:139560180-139678017,117837
57152466,57186116,chr16,PSME3IP1,chr16:57152466-57186116,33650
73220624,73235945,chr7,NCF1B,chr7:73220624-73235945,15321
20368537,20688583,chr12,PDE3A,chr12:20368537-20688583,320046
6448859,6496723,chr5,UBE2QL1,chr5:6448859-6496723,47864
73293497,73301161,chr7,POM121B,chr7:73293497-73301161,7664
73302516,73308826,chr7,NSUN5,chr7:73302516-73308826,6310
6599239,6633291,chr5,NSUN2,chr5:6599239-6633291,34052
86441108,86672636,chr11,ME3,chr11:86441108-86672636,231528
187721377,187745725,chr3,BCL6,chr3:187721377-187745725,24348
73312536,73328082,chr7,TRIM50,chr7:73312536-73328082,15546
36594369,36675695,chr11,IFTAP,chr11:36594369-36675695,81326
120419850,120467739,chr1,NBPF8,chr1:120419850-120467739,47889
72367340,72626131,chr10,MICU1,chr10:72367340-72626131,258791
70480568,70523560,chr16,COG4,chr16:70480568-70523560,42992
84983556,84984506,chr7,HNRNPA1P8,chr7:84983556-84984506,950
84995553,85187056,chr7,SEMA3D,chr7:84995553-85187056,191503
64341673,64387986,chr14,TEX21P,chr14:64341673-64387986,46313
34911580,34982584,chr14,SRP54-AS1,chr14:34911580-34982584,71004
185582496,185633551,chr3,SENP2,chr3:185582496-185633551,51055
60778331,60794852,chr10,CDK1,chr10:60778331-60794852,16521
70809841,70815994,chr14,MAP3K9-DT,chr14:70809841-70815994,6153
55496786,55580888,chr14,KTN1-AS1,chr14:55496786-55580888,84102
24583609,24723887,chr10,ARHGAP21,chr10:24583609-24723887,140278
145738868,145824095,chr1,RNF115,chr1:145738868-145824095,85227
24993424,25006403,chr12,LINC02909,chr12:24993424-25006403,12979
97924637,97978124,chr14,LINC01550,chr14:97924637-97978124,53487
25092715,25093900,chr12,CENPUP2,chr12:25092715-25093900,1185
25108289,25195162,chr12,DNAI7,chr12:25108289-25195162,86873
44382298,44401608,chr19,ZNF285,chr19:44382298-44401608,19310
68537173,68576413,chr4,UGT2B17,chr4:68537173-68576413,39240
58265365,58298134,chr14,PSMA3-AS1,chr14:58265365-58298134,32769
99873200,99893707,chr8,COX6C,chr8:99873200-99893707,20507
68646597,68670652,chr4,UGT2B15,chr4:68646597-68670652,24055
41837775,41848147,chr15,PLA2G4B,chr15:41837775-41848147,10372
193241128,193277738,chr3,PLAAT1,chr3:193241128-193277738,36610
1712858,1745171,chr4,TACC3,chr4:1712858-1745171,32313
812488,821955,chr19,PLPPR3,chr19:812488-821955,9467
197298252,197303755,chr3,DLG1-AS1,chr3:197298252-197303755,5503
151197949,151249536,chr1,PIP5K1A,chr1:151197949-151249536,51587
198110112,198111878,chr3,FRG2FP,chr3:198110112-198111878,1766
51993652,52020363,chr4,LRRC66,chr4:51993652-52020363,26711
77511753,77611834,chr4,CXCL13,chr4:77511753-77611834,100081
195514428,195543386,chr3,PPP1R2,chr3:195514428-195543386,28958
67184379,67190185,chr16,EXOC3L1,chr16:67184379-67190185,5806
25195216,25209645,chr12,ETFRF1,chr12:25195216-25209645,14429
19377721,19383544,chr17,MAPK7,chr17:19377721-19383544,5823
86514435,86561498,chr8,CPNE3,chr8:86514435-86561498,47063
81087370,81215222,chr4,PRKG2,chr4:81087370-81215222,127852
70671918,70672856,chr12,FAHD2P1,chr12:70671918-70672856,938
109097597,109110992,chr12,UNG,chr12:109097597-109110992,13395
45162928,45178237,chr19,TRAPPC6A,chr19:45162928-45178237,15309
196468783,196503768,chr3,RNF168,chr3:196468783-196503768,34985
196197452,196211437,chr3,ZDHHC19,chr3:196197452-196211437,13985
34926903,34945170,chr19,ZNF30,chr19:34926903-34945170,18267
1049538,1132384,chr10,WDR37,chr10:1049538-1132384,82846
126283065,126298845,chr11,TIRAP,chr11:126283065-126298845,15780
109448655,109477359,chr12,KCTD10,chr12:109448655-109477359,28704
117640812,117641639,chr1,VDAC2P3,chr1:117640812-117641639,827
52109263,52112775,chr15,BCL2L10,chr15:52109263-52112775,3512
19445970,19446852,chr17,RPS2P46,chr17:19445970-19446852,882
8095900,8119047,chr17,ALOXE3,chr17:8095900-8119047,23147
22156913,22164479,chr8,SFTPC,chr8:22156913-22164479,7566
192796815,192917856,chr3,MB21D2,chr3:192796815-192917856,121041
81556887,81648465,chr17,NPLOC4,chr17:81556887-81648465,91578
67237683,67272191,chr16,SLC9A5,chr16:67237683-67272191,34508
24033405,24129968,chr19,ZNF254,chr19:24033405-24129968,96563
106697427,106698013,chr8,TAGLN2P1,chr8:106697427-106698013,586
128954180,129055173,chr7,TNPO3,chr7:128954180-129055173,100993
189956728,190122437,chr3,P3H2,chr3:189956728-190122437,165709
67289428,67326760,chr16,KCTD19,chr16:67289428-67326760,37332
37467585,37488652,chr19,ZNF570,chr19:37467585-37488652,21067
35738801,35742453,chr19,IGFLR1,chr19:35738801-35742453,3652
67326798,67385204,chr16,LRRC36,chr16:67326798-67385204,58406
195568705,195584033,chr3,APOD,chr3:195568705-195584033,15328
11444375,11466177,chr2,E2F6,chr2:11444375-11466177,21802
150268200,150280916,chr1,C1orf54,chr1:150268200-150280916,12716
67389809,67393518,chr16,TPPP3,chr16:67389809-67393518,3709
156324437,156342348,chr2,NR4A2,chr2:156324437-156342348,17911
121396754,121463508,chr1,LINC02798,chr1:121396754-121463508,66754
188947214,189325304,chr3,TPRG1,chr3:188947214-189325304,378090
115976513,116070054,chr1,SLC22A15,chr1:115976513-116070054,93541
143620952,143730410,chr7,TCAF2,chr7:143620952-143730410,109458
13099033,13103161,chr19,LYL1,chr19:13099033-13103161,4128
7640711,7968020,chr7,UMAD1,chr7:7640711-7968020,327309
8206736,8262421,chr19,CERS4,chr19:8206736-8262421,55685
69320140,69339583,chr16,COG8,chr16:69320140-69339583,19443
115836377,115843917,chr1,NHLH2,chr1:115836377-115843917,7540
140547662,140549576,chr5,EIF4EBP3,chr5:140547662-140549576,1914
140631728,140633701,chr5,CD14,chr5:140631728-140633701,1973
140691430,140699305,chr5,HARS2,chr5:140691430-140699305,7875
8302127,8308358,chr19,CD320,chr19:8302127-8308358,6231
121118195,121118610,chr1,H3P4,chr1:121118195-121118610,415
89088375,89164121,chr16,ACSF3,chr16:89088375-89164121,75746
190852737,190892429,chr3,GMNC,chr3:190852737-190892429,39692
8363289,8374370,chr19,ANGPTL4,chr19:8363289-8374370,11081
64307459,64356634,chr7,ZNF736,chr7:64307459-64356634,49175
75721328,75757818,chr17,ITGB4,chr17:75721328-75757818,36490
64500825,64501729,chr7,HNRNPCP7,chr7:64500825-64501729,904
64519878,64563075,chr7,ZNF680,chr7:64519878-64563075,43197
47418769,47426473,chr11,PSMC3,chr11:47418769-47426473,7704
89159146,89164245,chr16,LINC00304,chr16:89159146-89164245,5099
64551498,64552066,chr7,BNIP3P42,chr7:64551498-64552066,568
64678954,64687393,chr7,BNIP3P11,chr7:64678954-64687393,8439
188151206,188154057,chr3,LPP-AS2,chr3:188151206-188154057,2851
184561785,184582408,chr3,EPHB3,chr3:184561785-184582408,20623
57571363,57598220,chr3,ARF4,chr3:57571363-57598220,26857
150243916,150323725,chr7,ACTR3C,chr7:150243916-150323725,79809
31514090,31658720,chr7,ITPRID1,chr7:31514090-31658720,144630
191029576,191151596,chr2,STAT4,chr2:191029576-191151596,122020
170888418,170908644,chr3,EIF5A2,chr3:170888418-170908644,20226
65065999,65066132,chr7,SNORA22C,chr7:65065999-65066132,133
111292719,111665750,chr3,CD96,chr3:111292719-111665750,373031
23450658,23450722,chr7,RNU7-143P,chr7:23450658-23450722,64
23490473,23491364,chr7,RPS2P32,chr7:23490473-23491364,891
46490750,46542577,chr2,ATP6V1E2,chr2:46490750-46542577,51827
26277609,26285638,chr6,H4C8,chr6:26277609-26285638,8029
4348140,4419058,chr4,NSG1,chr4:4348140-4419058,70918
48382575,48391551,chr19,KDELR1,chr19:48382575-48391551,8976
23597382,23644708,chr7,CCDC126,chr7:23597382-23644708,47326
46580937,46617055,chr2,PIGF,chr2:46580937-46617055,36118
23680130,23703249,chr7,FAM221A,chr7:23680130-23703249,23119
27110111,27155266,chr10,YME1L1,chr10:27110111-27155266,45155
75776434,75785893,chr17,H3-3B,chr17:75776434-75785893,9459
140966470,141012347,chr5,PCDHAC2,chr5:140966470-141012347,45877
104994235,105023168,chr11,CASP5,chr11:104994235-105023168,28933
71841560,71844412,chr8,MSC,chr8:71841560-71844412,2852
75827225,75844552,chr17,UNC13D,chr17:75827225-75844552,17327
143419182,143430732,chr8,MAFA,chr8:143419182-143430732,11550
170246233,170297815,chr5,LCP2,chr5:170246233-170297815,51582
92084987,92134803,chr7,CYP51A1,chr7:92084987-92134803,49816
72059034,72089032,chr10,SPOCK2,chr10:72059034-72089032,29998
44114212,44114310,chr3,MIR138-1,chr3:44114212-44114310,98
48637946,48646187,chr19,CA11,chr19:48637946-48646187,8241
110567684,110606048,chr10,SMC3,chr10:110567684-110606048,38364
116965112,116965227,chr3,RNU5E-8P,chr3:116965112-116965227,115
6716174,6717664,chr4,BLOC1S4,chr4:6716174-6717664,1490
6781375,6884170,chr4,KIAA0232,chr4:6781375-6884170,102795
140673035,140691537,chr5,HARS1,chr5:140673035-140691537,18502
83112738,83207823,chr15,HDGFL3,chr15:83112738-83207823,95085
83255884,83284664,chr15,BNC1,chr15:83255884-83284664,28780
11342776,11346518,chr19,TMEM205,chr19:11342776-11346518,3742
118998138,119015793,chr11,CENATAC,chr11:118998138-119015793,17655
143574785,143578649,chr8,NAPRT,chr8:143574785-143578649,3864
119015712,119018691,chr11,RPS25,chr11:119015712-119018691,2979
11344684,11354944,chr19,CCDC159,chr19:11344684-11354944,10260
86666785,86736072,chr10,LDB3,chr10:86666785-86736072,69287
148991408,149031775,chr3,GYG1,chr3:148991408-149031775,40367
51848223,51852729,chr12,FIGNL2-DT,chr12:51848223-51852729,4506
140071312,140109274,chr5,MALINC1,chr5:140071312-140109274,37962
11374666,11376951,chr19,SWSAP1,chr19:11374666-11376951,2285
119102198,119118544,chr11,C2CD2L,chr11:119102198-119118544,16346
11384341,11419328,chr19,RGL3,chr19:11384341-11419328,34987
26163455,26435131,chr4,RBPJ,chr4:26163455-26435131,271676
76004502,76027306,chr17,EVPL,chr17:76004502-76027306,22804
119121580,119136059,chr11,HINFP,chr11:119121580-119136059,14479
44554818,44663688,chr15,SPG11,chr15:44554818-44663688,108870
11420604,11435782,chr19,ODAD3,chr19:11420604-11435782,15178
76038775,76072517,chr17,SRP68,chr17:76038775-76072517,33742
112885094,112885745,chr5,XBP1P1,chr5:112885094-112885745,651
100345001,100520277,chr1,CDC14A,chr1:100345001-100520277,175276
90458209,90474771,chr5,MBLAC2,chr5:90458209-90474771,16562
90471748,90514557,chr5,POLR3G,chr5:90471748-90514557,42809
1227272,1230184,chr16,TPSB2,chr16:1227272-1230184,2912
2405562,2511891,chr17,METTL16,chr17:2405562-2511891,106329
128479427,128493201,chr3,GATA2,chr3:128479427-128493201,13774
103587273,103766719,chr12,STAB2,chr12:103587273-103766719,179446
162000057,162162977,chr5,GABRG2,chr5:162000057-162162977,162920
128489212,128502970,chr3,GATA2-AS1,chr3:128489212-128502970,13758
2593210,2685615,chr17,PAFAH1B1,chr17:2593210-2685615,92405
119212587,119295518,chr4,USP53,chr4:119212587-119295518,82931
102245371,102382899,chr10,GBF1,chr10:102245371-102382899,137528
37342827,37373322,chr2,QPCT,chr2:37342827-37373322,30495
57546026,57586633,chr12,KIF5A,chr12:57546026-57586633,40607
1329078,1329777,chr16,RPS20P2,chr16:1329078-1329777,699
101521891,101522979,chr3,FAM172BP,chr3:101521891-101522979,1088
11574660,11579008,chr19,ACP5,chr19:11574660-11579008,4348
39287456,39366375,chr4,RFC1,chr4:39287456-39366375,78919
119206298,119313926,chr11,CBL,chr11:119206298-119313926,107628
102648784,102655725,chr8,KLF10,chr8:102648784-102655725,6941
49388219,49417990,chr19,KASH5,chr19:49388219-49417990,29771
73593194,73624543,chr7,MLXIPL,chr7:73593194-73624543,31349
119308529,119321521,chr11,MCAM,chr11:119308529-119321521,12992
113856635,113901237,chr1,AP4B1-AS1,chr1:113856635-113901237,44602
108808725,109302752,chr4,COL25A1,chr4:108808725-109302752,494027
49429401,49442360,chr19,SLC17A7,chr19:49429401-49442360,12959
56978129,57006768,chr17,SCPEP1,chr17:56978129-57006768,28639
121184811,121392874,chr1,SRGAP2C,chr1:121184811-121392874,208063
81426393,82044244,chr4,RASGEF1B,chr4:81426393-82044244,617851
74453790,74602605,chr7,GTF2IRD1,chr7:74453790-74602605,148815
10293131,10321112,chr3,SEC13,chr3:10293131-10321112,27981
150282543,150287093,chr1,CIART,chr1:150282543-150287093,4550
154818492,154859252,chr5,FAXDC2,chr5:154818492-154859252,40760
57619527,57626151,chr12,SLC26A10,chr12:57619527-57626151,6624
102864271,103002424,chr8,MAILR,chr8:102864271-103002424,138153
48856926,48898904,chr3,SLC25A20,chr3:48856926-48898904,41978
57861243,57955412,chr17,CUEDC1,chr17:57861243-57955412,94169
161288429,161549044,chr5,GABRB2,chr5:161288429-161549044,260615
153678688,153693992,chr1,NPR1,chr1:153678688-153693992,15304
99013266,99877580,chr8,VPS13B,chr8:99013266-99877580,864314
67583742,67586656,chr11,GSTP1,chr11:67583742-67586656,2914
67602880,67606706,chr11,NDUFV1-DT,chr11:67602880-67606706,3826
73073376,73258798,chr4,ANKRD17,chr4:73073376-73258798,185422
153774354,153780157,chr1,SLC27A3,chr1:153774354-153780157,5803
40177010,40195656,chr17,RAPGEFL1,chr17:40177010-40195656,18646
114276913,114310288,chr3,TIGIT,chr3:114276913-114310288,33375
215311956,215349773,chr2,ATIC,chr2:215311956-215349773,37817
15865719,15888625,chr16,CEP20,chr16:15865719-15888625,22906
154321090,154325325,chr1,AQP10,chr1:154321090-154325325,4235
132747426,132754403,chr5,CCNI2,chr5:132747426-132754403,6977
144785298,144785588,chr8,RN7SL395P,chr8:144785298-144785588,290
136999971,137045180,chr6,IL20RA,chr6:136999971-137045180,45209
142310427,142326455,chr5,SPRY4,chr5:142310427-142326455,16028
56663341,56688408,chr12,PTGES3,chr12:56663341-56688408,25067
67682772,67683058,chr11,RPL37P2,chr11:67682772-67683058,286
30378106,30400108,chr16,ZNF48,chr16:30378106-30400108,22002
151364304,151372707,chr1,SELENBP1,chr1:151364304-151372707,8403
30443631,30445874,chr16,SEPHS2,chr16:30443631-30445874,2243
168834132,168913371,chr2,SPC25,chr2:168834132-168913371,79239
30553764,30558374,chr16,ZNF764,chr16:30553764-30558374,4610
101961603,101976543,chr15,WASH3P,chr15:101961603-101976543,14940
30573740,30585769,chr16,ZNF785,chr16:30573740-30585769,12029
56670450,56670746,chr12,RN7SL809P,chr12:56670450-56670746,296
101973524,101973591,chr15,MIR6859-3,chr15:101973524-101973591,67
30650717,30656413,chr16,PRR14,chr16:30650717-30656413,5696
75996338,76048004,chr7,STYXL1,chr7:75996338-76048004,51666
8413131,8490411,chr17,NDEL1,chr17:8413131-8490411,77280
56752161,56787790,chr12,HSD17B6,chr12:56752161-56787790,35629
147175351,147243050,chr1,FMO5,chr1:147175351-147243050,67699
76048051,76067508,chr7,MDH2,chr7:76048051-76067508,19457
76453351,76470117,chr17,AANAT,chr17:76453351-76470117,16766
49289206,49362473,chr17,ZNF652,chr17:49289206-49362473,73267
30541381,30556489,chr6,GNL1,chr6:30541381-30556489,15108
6481501,6484681,chr11,TIMM10B,chr11:6481501-6484681,3180
49690898,49713731,chr19,CPT1C,chr19:49690898-49713731,22833
43918697,43920054,chr7,TUBG1P,chr7:43918697-43920054,1357
43926436,43956136,chr7,UBE2D4,chr7:43926436-43956136,29700
154697455,154870281,chr1,KCNN3,chr1:154697455-154870281,172826
4987775,5018031,chr10,AKR1C2,chr10:4987775-5018031,30256
184598529,184939492,chr2,ZNF804A,chr2:184598529-184939492,340963
139716753,140154184,chr4,MAML3,chr4:139716753-140154184,437431
58157907,58198106,chr16,CSNK2A2,chr16:58157907-58198106,40199
106487364,106544297,chr2,CD8B2,chr2:106487364-106544297,56933
43940895,44019175,chr7,POLR2J4,chr7:43940895-44019175,78280
120432204,120434052,chr1,PFN1P2,chr1:120432204-120434052,1848
160400564,160428670,chr1,VANGL2,chr1:160400564-160428670,28106
76609986,76627279,chr7,POMZP3,chr7:76609986-76627279,17293
16379055,16393954,chr16,NPIPA7,chr16:16379055-16393954,14899
15949138,16143257,chr16,ABCC1,chr16:15949138-16143257,194119
48831018,48866522,chr17,CALCOCO2,chr17:48831018-48866522,35504
48408313,48645721,chr15,FBN1,chr15:48408313-48645721,237408
49277917,49281838,chr16,CBLN1,chr16:49277917-49281838,3921
47761476,47766772,chr7,LINC00525,chr7:47761476-47766772,5296
47795291,47819847,chr7,PKD1L1-AS1,chr7:47795291-47819847,24556
47963288,47979615,chr7,HUS1,chr7:47963288-47979615,16327
53295291,53299452,chr12,PFDN5,chr12:53295291-53299452,4161
42313309,42325064,chr19,TMEM145,chr19:42313309-42325064,11755
95577485,95609470,chr6,MANEA,chr6:95577485-95609470,31985
11331012,11332360,chr8,SLC35G5,chr8:11331012-11332360,1348
47740202,47948466,chr7,PKD1L1,chr7:47740202-47948466,208264
85449584,85495791,chr6,NT5E,chr6:85449584-85495791,46207
29457338,29736959,chr10,SVIL,chr10:29457338-29736959,279621
11421476,11475908,chr8,FAM167A,chr8:11421476-11475908,54432
86440647,86492716,chr2,KDM3A,chr2:86440647-86492716,52069
56809860,56821742,chr4,SPINK2,chr4:56809860-56821742,11882
141943581,141969741,chr5,PCDH12,chr5:141943581-141969741,26160
11486894,11564599,chr8,BLK,chr8:11486894-11564599,77705
61792980,61867354,chr11,FADS2,chr11:61792980-61867354,74374
140639435,140645408,chr5,TMCO6,chr5:140639435-140645408,5973
37891084,38139175,chr4,TBC1D1,chr4:37891084-38139175,248091
39868202,39877896,chr17,ZPBP2,chr17:39868202-39877896,9694
4347780,4349061,chr19,EIF1P6,chr19:4347780-4349061,1281
97142161,97283217,chr6,MMS22L,chr6:97142161-97283217,141056
17351800,17377341,chr11,NCR3LG1,chr11:17351800-17377341,25541
238060924,238099413,chr2,SCLY,chr2:238060924-238099413,38489
30938941,30991628,chr15,MTMR10,chr15:30938941-30991628,52687
115623510,115721490,chr3,GAP43,chr3:115623510-115721490,97980
26224199,26227473,chr6,H3C6,chr6:26224199-26227473,3274
72692143,72887694,chr10,MCU,chr10:72692143-72887694,195551
31001061,31161273,chr15,TRPM1,chr15:31001061-31161273,160212
2537810,2555694,chr7,BRAT1,chr7:2537810-2555694,17884
17547259,17647150,chr11,OTOG,chr11:17547259-17647150,99891
13438484,13529014,chr10,BEND7,chr10:13438484-13529014,90530
101162509,101165569,chr7,VGF,chr7:101162509-101165569,3060
11370365,11832198,chr7,THSD7A,chr7:11370365-11832198,461833
238138668,238152947,chr2,KLHL30,chr2:238138668-238152947,14279
66552587,66579135,chr16,CKLF-CMTM1,chr16:66552587-66579135,26548
4522531,4535224,chr19,PLIN5,chr19:4522531-4535224,12693
93993931,94332823,chr10,PLCE1,chr10:93993931-94332823,338892
127346790,127431924,chr7,ZNF800,chr7:127346790-127431924,85134
185643130,185825042,chr3,IGF2BP2,chr3:185643130-185825042,181912
238238267,238240662,chr2,HES6,chr2:238238267-238240662,2395
149492982,149551471,chr5,CSNK1A1,chr5:149492982-149551471,58489
68474152,68497221,chr1,DEPDC1,chr1:68474152-68497221,23069
66926036,67101551,chr10,LRRTM3,chr10:66926036-67101551,175515
49085419,49108605,chr19,SNRNP70,chr19:49085419-49108605,23186
54362445,54364487,chr12,GPR84,chr12:54362445-54364487,2042
238320441,238400897,chr2,TRAF3IP1,chr2:238320441-238400897,80456
96521595,96555276,chr6,UFL1,chr6:96521595-96555276,33681
6491886,6493841,chr12,MRPL51,chr12:6491886-6493841,1955
148295180,148297556,chr1,LINC02806,chr1:148295180-148297556,2376
110871795,110900006,chr10,PDCD4,chr10:110871795-110900006,28211
6493356,6531955,chr12,NCAPD2,chr12:6493356-6531955,38599
90127394,91605295,chr4,CCSER1,chr4:90127394-91605295,1477901
6532290,6533498,chr12,GAPDH-DT,chr12:6532290-6533498,1208
111077029,111080907,chr10,ADRA2A,chr10:111077029-111080907,3878
232479827,232487834,chr2,ECEL1,chr2:232479827-232487834,8007
103367966,103389065,chr10,TAF5,chr10:103367966-103389065,21099
30345131,30346884,chr6,RPP21,chr6:30345131-30346884,1753
172630249,172711218,chr3,NCEH1,chr3:172630249-172711218,80969
30326469,30343729,chr6,TRIM39,chr6:30326469-30343729,17260
88852633,88891944,chr1,GTF2B,chr1:88852633-88891944,39311
14125015,14143680,chr3,TMEM43,chr3:14125015-14143680,18665
27814302,27814777,chr6,H2AC14,chr6:27814302-27814777,475
27815022,27815489,chr6,H2BC14,chr6:27815022-27815489,467
27831174,27831560,chr6,H4C12,chr6:27831174-27831560,386
6588108,6654983,chr6,LY86,chr6:6588108-6654983,66875
162378841,162386812,chr1,C1orf226,chr1:162378841-162386812,7971
2427638,2456959,chr19,LMNB2,chr19:2427638-2456959,29321
109910242,109930992,chr1,CSF1,chr1:109910242-109930992,20750
62689289,62709845,chr11,BSCL2,chr11:62689289-62709845,20556
2476122,2478259,chr19,GADD45B,chr19:2476122-2478259,2137
90388242,90502239,chr15,IQGAP1,chr15:90388242-90502239,113997
28364356,28404049,chr17,SARM1,chr17:28364356-28404049,39693
116443555,116574823,chr5,SEMA6A,chr5:116443555-116574823,131268
151510510,151538692,chr1,CGN,chr1:151510510-151538692,28182
146175703,146200000,chr4,LSM6,chr4:146175703-146200000,24297
28394642,28407197,chr17,SLC46A1,chr17:28394642-28407197,12555
129576132,129710177,chr6,ARHGAP18,chr6:129576132-129710177,134045
163244505,163321894,chr1,RGS5,chr1:163244505-163321894,77389
28546708,28552631,chr17,UNC119,chr17:28546708-28552631,5923
73995642,73998677,chr4,CXCL5,chr4:73995642-73998677,3035
165327287,165988117,chr6,PDE10A,chr6:165327287-165988117,660830
146214515,146232267,chr4,REELD1,chr4:146214515-146232267,17752
128965060,129279324,chr11,ARHGAP32,chr11:128965060-129279324,314264
32517353,32530287,chr6,HLA-DRB5,chr6:32517353-32530287,12934
28573115,28576948,chr17,ALDOC,chr17:28573115-28576948,3833
77713387,77819615,chr4,CNOT6L,chr4:77713387-77819615,106228
149141483,149260542,chr5,ABLIM3,chr5:149141483-149260542,119059
32628179,32647062,chr6,HLA-DQA1,chr6:32628179-32647062,18883
29146569,29514328,chr7,CHN2,chr7:29146569-29514328,367759
167239843,167407874,chr3,ZBBX,chr3:167239843-167407874,168031
3463306,3501473,chr4,DOK7,chr4:3463306-3501473,38167
68956135,68985068,chr10,DDX21,chr10:68956135-68985068,28933
32659467,32668383,chr6,HLA-DQB1,chr6:32659467-32668383,8916
98444854,98594392,chr2,INPP4A,chr2:98444854-98594392,149538
74598500,74645414,chr15,CLK3,chr15:74598500-74645414,46914
32578769,32589848,chr6,HLA-DRB1,chr6:32578769-32589848,11079
3293021,3439913,chr4,RGS12,chr4:3293021-3439913,146892
100492619,100577444,chr3,TMEM45A,chr3:100492619-100577444,84825
1763888,1958627,chr8,KBTBD11-OT1,chr8:1763888-1958627,194739
28577565,28599025,chr17,SPAG5,chr17:28577565-28599025,21460
148697914,148801110,chr7,CUL1,chr7:148697914-148801110,103196
106391290,106468413,chr2,RGPD3,chr2:106391290-106468413,77123
67468174,67491154,chr11,AIP,chr11:67468174-67491154,22980
128883138,129516566,chr6,LAMA2,chr6:128883138-129516566,633428
78264086,78282196,chr15,DNAJA4,chr15:78264086-78282196,18110
160485030,160523262,chr1,SLAMF6,chr1:160485030-160523262,38232
88819896,88851844,chr10,ANKRD22,chr10:88819896-88851844,31948
88879734,88975153,chr10,STAMBPL1,chr10:88879734-88975153,95419
1973677,2006936,chr8,KBTBD11,chr8:1973677-2006936,33259
2045046,2165552,chr8,MYOM2,chr8:2045046-2165552,120506
28614446,28645454,chr17,KIAA0100,chr17:28614446-28645454,31008
7595863,7618304,chr19,CAMSAP3,chr19:7595863-7618304,22441
71603260,71608040,chr11,UNC93B6,chr11:71603260-71608040,4780
77984036,78077724,chr15,TBC1D2B,chr15:77984036-78077724,93688
166057426,166167001,chr1,FAM78B,chr1:166057426-166167001,109575
177402141,177409564,chr5,F12,chr5:177402141-177409564,7423
25718944,25790039,chr3,NGLY1,chr3:25718944-25790039,71095
116811070,116922049,chr7,CAPZA2,chr7:116811070-116922049,110979
537527,554912,chr11,LRRC56,chr11:537527-554912,17385
29120252,29570979,chr15,FAM189A1,chr15:29120252-29570979,450727
158178030,158186427,chr1,CD1D,chr1:158178030-158186427,8397
7868719,7874390,chr19,PRR36,chr19:7868719-7874390,5671
66562175,66614247,chr8,MYBL1,chr8:66562175-66614247,52072
185204237,185370185,chr4,SNX25,chr4:185204237-185370185,165948
25754925,25755670,chr3,TAF9BP1,chr3:25754925-25755670,745
90233808,90245811,chr15,GDPGP1,chr15:90233808-90245811,12003
28714281,28718429,chr17,RAB34,chr17:28714281-28718429,4148
53978201,54628707,chr15,UNC13C,chr15:53978201-54628707,650506
22544986,22575788,chr8,SORBS3,chr8:22544986-22575788,30802
7924491,7926135,chr19,CTXN1,chr19:7924491-7926135,1644
7926718,7943667,chr19,TIMM44,chr19:7926718-7943667,16949
186069155,186088073,chr4,TLR3,chr4:186069155-186088073,18918
144451941,144836395,chr7,TPK1,chr7:144451941-144836395,384454
186104419,186175337,chr4,FAM149A,chr4:186104419-186175337,70918
11071541,11105773,chr10,CELF2-AS2,chr10:11071541-11105773,34232
184299198,184309050,chr3,PSMD2,chr3:184299198-184309050,9852
11316833,11319884,chr10,CELF2-AS1,chr10:11316833-11319884,3051
172555373,172608669,chr2,PDK1,chr2:172555373-172608669,53296
153661788,153671028,chr1,ILF2,chr1:153661788-153671028,9240
16646131,16706523,chr7,BZW2,chr7:16646131-16706523,60392
186170863,186171257,chr4,LTO1P1,chr4:186170863-186171257,394
169132531,169367948,chr1,NME7,chr1:169132531-169367948,235417
10783391,10837977,chr2,PDIA6,chr2:10783391-10837977,54586
77100656,77420144,chr15,PEAK1,chr15:77100656-77420144,319488
73183362,73247255,chr10,DNAJC9,chr10:73183362-73247255,63893
167630093,167708696,chr1,RCSD1,chr1:167630093-167708696,78603
73247360,73276984,chr10,DNAJC9-AS1,chr10:73247360-73276984,29624
73248843,73252693,chr10,MRPS16,chr10:73248843-73252693,3850
7492976,7508450,chr19,TEX45,chr19:7492976-7508450,15474
25861830,25929813,chr4,SMIM20,chr4:25861830-25929813,67983
168225938,168253021,chr1,SFT2D2,chr1:168225938-168253021,27083
35008504,35127006,chr10,CUL2,chr10:35008504-35127006,118502
42238447,42459715,chr12,PPHLN1,chr12:42238447-42459715,221268
70168673,70180044,chr17,KCNJ2,chr17:70168673-70180044,11371
190908460,191020960,chr2,STAT1,chr2:190908460-191020960,112500
169917761,169975930,chr4,LINC02275,chr4:169917761-169975930,58169
189764391,189940733,chr4,FRG1-DT,chr4:189764391-189940733,176342
44748581,44769881,chr7,ZMIZ2,chr7:44748581-44769881,21300
2934882,2961738,chr4,NOP14-AS1,chr4:2934882-2961738,26856
72219403,72320646,chr5,MRPS27,chr5:72219403-72320646,101243
6406592,6648508,chr8,MCPH1,chr8:6406592-6648508,241916
76210956,76216025,chr11,LINC02761,chr11:76210956-76216025,5069
77628712,77638713,chr5,OTP,chr5:77628712-77638713,10001
82543201,82648861,chr15,CPEB1,chr15:82543201-82648861,105660
57855500,57984126,chr8,LINC01602,chr8:57855500-57984126,128626
10798397,11336675,chr10,CELF2,chr10:10798397-11336675,538278
57994523,58204279,chr8,FAM110B,chr8:57994523-58204279,209756
41142116,41261438,chr5,C6,chr5:41142116-41261438,119322
142749468,142753072,chr7,PRSS1,chr7:142749468-142753072,3604
179365720,179554735,chr1,AXDND1,chr1:179365720-179554735,189015
131904093,132013642,chr8,EFR3A,chr8:131904093-132013642,109549
184334292,184353977,chr4,LINC02363,chr4:184334292-184353977,19685
76136333,76141245,chr17,FOXJ1,chr17:76136333-76141245,4912
76138432,76154650,chr17,RNF157-AS1,chr17:76138432-76154650,16218
59109857,59155260,chr17,SKA2,chr17:59109857-59155260,45403
108167525,108258037,chr4,LEF1-AS1,chr4:108167525-108258037,90512
47987148,48029119,chr7,SUN3,chr7:47987148-48029119,41971
1934677,2025334,chr17,RTN4RL1,chr17:1934677-2025334,90657
160317403,160317706,chr1,SUMO1P3,chr1:160317403-160317706,303
160678746,160711831,chr1,CD48,chr1:160678746-160711831,33085
160288594,160343273,chr1,COPA,chr1:160288594-160343273,54679
23020133,23069031,chr8,TNFRSF10B,chr8:23020133-23069031,48898
2059839,2303785,chr17,SMG6,chr17:2059839-2303785,243946
12330885,12403941,chr7,VWDE,chr7:12330885-12403941,73056
12610918,12633840,chr19,ZNF791,chr19:12610918-12633840,22922
23102921,23117445,chr8,TNFRSF10C,chr8:23102921-23117445,14524
184335926,184348421,chr3,FAM131A,chr3:184335926-184348421,12495
12646511,12666742,chr19,MAN2B1,chr19:12646511-12666742,20231
23190452,23225102,chr8,TNFRSF10A,chr8:23190452-23225102,34650
2322396,2336657,chr17,TSR1,chr17:2322396-2336657,14261
23224471,23230926,chr8,TNFRSF10A-DT,chr8:23224471-23230926,6455
23243637,23262000,chr8,CHMP7,chr8:23243637-23262000,18363
6747996,6767475,chr12,MLF2,chr12:6747996-6767475,19479
39527720,39594707,chr4,UGDH-AS1,chr4:39527720-39594707,66987
63432304,63446354,chr17,CYB561,chr17:63432304-63446354,14050
108147623,108456717,chr7,NRCAM,chr7:108147623-108456717,309094
31997376,32228543,chr4,LINC02506,chr4:31997376-32228543,231167
165400922,165445355,chr1,RXRG,chr1:165400922-165445355,44433
184380073,184390736,chr3,CHRD,chr3:184380073-184390736,10663
17228241,17237593,chr10,VIM,chr10:17228241-17237593,9352
63471604,63472093,chr17,PPIAP55,chr17:63471604-63472093,489
186311652,186375693,chr1,TPR,chr1:186311652-186375693,64041
144477969,144502121,chr8,PPP1R16A,chr8:144477969-144502121,24152
63477061,63498380,chr17,ACE,chr17:63477061-63498380,21319
173699082,174001488,chr4,LINC02269,chr4:173699082-174001488,302406
2817180,2826304,chr16,PRSS21,chr16:2817180-2826304,9124
144642919,144661357,chr4,HHIP-AS1,chr4:144642919-144661357,18438
72175984,72826041,chr2,EXOC6B,chr2:72175984-72826041,650057
104117086,104138241,chr12,NFYB,chr12:104117086-104138241,21155
67701209,68080952,chr4,UBA6-DT,chr4:67701209-68080952,379743
2852730,2858170,chr16,PRSS22,chr16:2852730-2858170,5440
78939485,79309673,chr4,LINC01088,chr4:78939485-79309673,370188
116738178,116853631,chr12,RNFT2,chr12:116738178-116853631,115453
148272304,148552044,chr6,SASH1,chr6:148272304-148552044,279740
12833951,12874952,chr19,MAST1,chr19:12833951-12874952,41001
160115759,160143591,chr1,ATP1A2,chr1:160115759-160143591,27832
65824460,65966291,chr12,HMGA2,chr12:65824460-65966291,141831
58159243,58241372,chr2,FANCL,chr2:58159243-58241372,82129
63622415,63696305,chr17,MAP3K3,chr17:63622415-63696305,73890
89948697,89968060,chr16,DEF8,chr16:89948697-89968060,19363
22316386,22320306,chr10,COMMD3,chr10:22316386-22320306,3920
112515385,112546881,chr4,NEUROG2-AS1,chr4:112515385-112546881,31496
12763003,12872740,chr19,HOOK2,chr19:12763003-12872740,109737
162395268,162412138,chr1,SH2D1B,chr1:162395268-162412138,16870
7107597,7251980,chr6,RREB1,chr6:7107597-7251980,144383
144525733,144529132,chr8,C8orf82,chr8:144525733-144529132,3399
63695888,63701172,chr17,LIMD2,chr17:63695888-63701172,5284
66547179,66565979,chr15,LCTL,chr15:66547179-66565979,18800
144720907,144756417,chr8,ZNF251,chr8:144720907-144756417,35510
114043866,114046904,chr10,ADRB1,chr10:114043866-114046904,3038
114120862,114174232,chr10,CCDC186,chr10:114120862-114174232,53370
47649476,47685505,chr17,KPNB1,chr17:47649476-47685505,36029
66582190,66685794,chr15,LINC01169,chr15:66582190-66685794,103604
32615144,32639941,chr15,ARHGAP11A,chr15:32615144-32639941,24797
100709295,100748964,chr3,TFG,chr3:100709295-100748964,39669
35314552,35336401,chr10,CCNY-AS1,chr10:35314552-35336401,21849
68643579,68658251,chr2,PROKR1,chr2:68643579-68658251,14672
40592883,40629818,chr19,LTBP4,chr19:40592883-40629818,36935
6462237,6470677,chr12,VAMP1,chr12:6462237-6470677,8440
47733236,47746122,chr17,TBX21,chr17:47733236-47746122,12886
32718004,32745106,chr15,GREM1,chr15:32718004-32745106,27102
120059780,120373573,chr8,COL14A1,chr8:120059780-120373573,313793
107826892,107892544,chr2,RGPD4,chr2:107826892-107892544,65652
230984368,230996032,chr2,SPATA3-AS1,chr2:230984368-230996032,11664
157993273,158100262,chr1,KIRREL1,chr1:157993273-158100262,106989
142760398,142774564,chr7,PRSS2,chr7:142760398-142774564,14166
122318411,122886759,chr7,CADPS2,chr7:122318411-122886759,568348
231395710,231401164,chr2,B3GNT7,chr2:231395710-231401164,5454
150218417,150236156,chr1,ANP32E,chr1:150218417-150236156,17739
35126791,35212958,chr10,CREM,chr10:35126791-35212958,86167
68035636,68047364,chr17,KPNA2,chr17:68035636-68047364,11728
67806765,67832148,chr16,TSNAXIP1,chr16:67806765-67832148,25383
64319415,64413776,chr17,PECAM1,chr17:64319415-64413776,94361
184790724,184974508,chr1,NIBAN1,chr1:184790724-184974508,183784
64477785,64497054,chr17,POLG2,chr17:64477785-64497054,19269
64542282,64662307,chr17,SMURF2,chr17:64542282-64662307,120025
64498254,64508199,chr17,DDX5,chr17:64498254-64508199,9945
48187121,48191691,chr15,CTXN2-AS1,chr15:48187121-48191691,4570
240954617,240967451,chr2,UICLM,chr2:240954617-240967451,12834
64338178,64338797,chr12,ATP6V1E1P3,chr12:64338178-64338797,619
37084451,37099244,chr2,GPATCH11,chr2:37084451-37099244,14793
28315651,28316059,chr15,RPL41P2,chr15:28315651-28316059,408
137874979,138002086,chr7,CREB3L2,chr7:137874979-138002086,127107
116514534,116571039,chr1,CD58,chr1:116514534-116571039,56505
218953401,218954050,chr2,KRT8P30,chr2:218953401-218954050,649
218959666,218962155,chr2,CDK5R2,chr2:218959666-218962155,2489
192809039,192812275,chr1,RGS2,chr1:192809039-192812275,3236
218981087,218985184,chr2,FEV,chr2:218981087-218985184,4097
218990189,218993422,chr2,CRYBA2,chr2:218990189-218993422,3233
28111040,28322179,chr15,HERC2,chr15:28111040-28322179,211139
219002846,219041527,chr2,CFAP65,chr2:219002846-219041527,38681
29806486,29917061,chr7,WIPF3,chr7:29806486-29917061,110575
73444827,73448777,chr5,FOXD1,chr5:73444827-73448777,3950
22578279,22598025,chr8,PDLIM2,chr8:22578279-22598025,19746
50693588,50734041,chr16,NOD2,chr16:50693588-50734041,40453
89853595,90225443,chr10,LINC01374,chr10:89853595-90225443,371848
160367071,160372846,chr1,NHLH1,chr1:160367071-160372846,5775
159998651,160070160,chr1,KCNJ10,chr1:159998651-160070160,71509
122207663,122227456,chr12,DIABLO,chr12:122207663-122227456,19793
23354748,23367231,chr15,GOLGA8S,chr15:23354748-23367231,12483
196652043,196747504,chr1,CFH,chr1:196652043-196747504,95461
44793119,44959724,chr10,TMEM72-AS1,chr10:44793119-44959724,166605
23430839,23435212,chr15,HERC2P6,chr15:23430839-23435212,4373
65895079,66253756,chr15,MEGF11,chr15:65895079-66253756,358677
134648785,134727909,chr5,SEC24A,chr5:134648785-134727909,79124
142111718,142222324,chr7,MGAM2,chr7:142111718-142222324,110606
65570338,65880289,chr10,LINC01515,chr10:65570338-65880289,309951
99960936,100131268,chr8,RGS22,chr8:99960936-100131268,170332
38496127,38542161,chr3,EXOG,chr3:38496127-38542161,46034
163266576,163355764,chr1,NUF2,chr1:163266576-163355764,89188
134758771,134855133,chr5,DDX46,chr5:134758771-134855133,96362
52450874,52755507,chr10,LNCAROD,chr10:52450874-52755507,304633
11679083,11742857,chr16,TXNDC11,chr16:11679083-11742857,63774
17214239,17230018,chr10,VIM-AS1,chr10:17214239-17230018,15779
38526802,38527325,chr3,RPL18AP7,chr3:38526802-38527325,523
45148475,45152099,chr17,HEXIM1,chr17:45148475-45152099,3624
78943328,79067895,chr10,ZMIZ1-AS1,chr10:78943328-79067895,124567
110869741,110872253,chr10,PDCD4-AS1,chr10:110869741-110872253,2512
6852148,6866632,chr12,USP5,chr12:6852148-6866632,14484
726936,735525,chr16,HAGHL,chr16:726936-735525,8589
66566393,66579137,chr16,CMTM1,chr16:66566393-66579137,12744
70515870,70637440,chr12,PTPRB,chr12:70515870-70637440,121570
151822513,151924851,chr5,GLRA1,chr5:151822513-151924851,102338
29409402,29512266,chr10,SVIL-AS1,chr10:29409402-29512266,102864
182641816,182684576,chr1,RGS8,chr1:182641816-182684576,42760
1526637,1556988,chr10,ADARB2-AS1,chr10:1526637-1556988,30351
38488103,38565575,chr15,RASGRP1,chr15:38488103-38565575,77472
33986165,34008104,chr5,AMACR,chr5:33986165-34008104,21939
35867899,35879792,chr19,APLP1,chr19:35867899-35879792,11893
73730562,73737790,chr10,GLUD1P3,chr10:73730562-73737790,7228
221701424,221742089,chr1,DUSP10,chr1:221701424-221742089,40665
68737292,68835537,chr16,CDH1,chr16:68737292-68835537,98245
179464346,179465328,chr3,MTHFD2P7,chr3:179464346-179465328,982
39210541,39225945,chr17,STAC2,chr17:39210541-39225945,15404
75087727,75106162,chr17,SLC16A5,chr17:75087727-75106162,18435
6580419,6616921,chr10,PRKCQ-AS1,chr10:6580419-6616921,36502
147203276,147204932,chr1,CCT8P1,chr1:147203276-147204932,1656
35887653,35902303,chr19,NFKBID,chr19:35887653-35902303,14650
75130225,75131757,chr17,NT5C,chr17:75130225-75131757,1532
806933,931821,chr10,LARP4B,chr10:806933-931821,124888
160796074,160828261,chr1,LY9,chr1:160796074-160828261,32187
13874875,13875011,chr19,MIR181D,chr19:13874875-13875011,136
18606403,18634791,chr11,SPTY2D1,chr11:18606403-18634791,28388
2883213,2885775,chr11,CDKN1C,chr11:2883213-2885775,2562
194355249,194369743,chr3,LRRC15,chr3:194355249-194369743,14494
48134632,48178353,chr15,MYEF2,chr15:48134632-48178353,43721
179591613,179691272,chr1,TDRD5,chr1:179591613-179691272,99659
96142333,96160806,chr8,GDF6,chr8:96142333-96160806,18473
5122249,5180911,chr3,ARL8B,chr3:5122249-5180911,58662
43925342,43943878,chr11,C11orf96,chr11:43925342-43943878,18536
179954773,180114875,chr1,CEP350,chr1:179954773-180114875,160102
14137146,14171267,chr19,ADGRL1-AS1,chr19:14137146-14171267,34121
18527303,19084730,chr8,PSD3,chr8:18527303-19084730,557427
44260440,44310139,chr11,ALX4,chr11:44260440-44310139,49699
219289623,219309648,chr2,PTPRN,chr2:219289623-219309648,20025
209785617,209806175,chr1,IRF6,chr1:209785617-209806175,20558
40594020,40664342,chr15,KNL1,chr15:40594020-40664342,70322
246540561,246566261,chr1,TFB2M,chr1:246540561-246566261,25700
167721192,167791919,chr1,MPZL1,chr1:167721192-167791919,70727
70047790,70098176,chr15,TLE3,chr15:70047790-70098176,50386
211940399,212035557,chr1,INTS7,chr1:211940399-212035557,95158
75271369,75273895,chr17,MIF4GD-DT,chr17:75271369-75273895,2526
219069357,219160865,chr2,NHEJ1,chr2:219069357-219160865,91508
185076838,185153060,chr3,C3orf70,chr3:185076838-185153060,76222
106093308,106194301,chr2,UXS1,chr2:106093308-106194301,100993
36192589,36242279,chr5,NADK2,chr5:36192589-36242279,49690
103402013,103402586,chr11,MTCO3P15,chr11:103402013-103402586,573
103404309,103405834,chr11,MTCO1P15,chr11:103404309-103405834,1525
103407441,103408376,chr11,MTND1P36,chr11:103407441-103408376,935
36221055,36221902,chr5,NADK2-AS1,chr5:36221055-36221902,847
39200283,39204840,chr17,RPL19,chr17:39200283-39204840,4557
236348257,236502915,chr1,EDARADD,chr1:236348257-236502915,154658
12182096,12194133,chr8,FAM86B1,chr8:12182096-12194133,12037
130229379,130232106,chr2,NOC2LP1,chr2:130229379-130232106,2727
130850595,131016712,chr3,ATP2C1,chr3:130850595-131016712,166117
7484366,7514616,chr17,POLR2A,chr17:7484366-7514616,30250
142449430,142545009,chr8,ADGRB1,chr8:142449430-142545009,95579
4498881,4539035,chr17,SPNS2,chr17:4498881-4539035,40154
47075707,47079959,chr12,AMIGO2,chr12:47075707-47079959,4252
217426992,217631090,chr1,GPATCH2,chr1:217426992-217631090,204098
53598153,53703938,chr16,RPGRIP1L,chr16:53598153-53703938,105785
34853094,34916379,chr11,APIP,chr11:34853094-34916379,63285
81257975,81759553,chr12,PPFIA2,chr12:81257975-81759553,501578
105110704,105399308,chr7,SRPK2,chr7:105110704-105399308,288604
34915829,35020591,chr11,PDHX,chr11:34915829-35020591,104762
45240302,45286341,chr11,SYT13,chr11:45240302-45286341,46039
169690665,169711702,chr1,SELL,chr1:169690665-169711702,21037
2867335,2883445,chr19,ZNF556,chr19:2867335-2883445,16110
95310928,95318263,chr1,LINC01760,chr1:95310928-95318263,7335
10486125,10503558,chr19,KEAP1,chr19:10486125-10503558,17433
227683763,227718028,chr2,SLC19A3,chr2:227683763-227718028,34265
117285232,117316259,chr11,BACE1,chr11:117285232-117316259,31027
43997897,44010124,chr7,SPDYE1,chr7:43997897-44010124,12227
185045526,185102603,chr1,RNF2,chr1:185045526-185102603,57077
4785285,4786433,chr17,VMO1,chr17:4785285-4786433,1148
11027024,11027763,chr16,RPL7P46,chr16:11027024-11027763,739
80404350,80597933,chr15,ARNT2,chr15:80404350-80597933,193583
10651862,10653844,chr19,ILF3-DT,chr19:10651862-10653844,1982
130448645,130476645,chr11,ADAMTS15,chr11:130448645-130476645,28000
11677595,11827409,chr2,LPIN1,chr2:11677595-11827409,149814
603185,608482,chr7,PRKAR1B-AS1,chr7:603185-608482,5297
35202430,35254100,chr7,TBX20,chr7:35202430-35254100,51670
4538798,4560047,chr12,RAD51AP1,chr12:4538798-4560047,21249
152651593,152717997,chr2,PRPF40A,chr2:152651593-152717997,66404
4897771,4934438,chr17,CHRNE,chr17:4897771-4934438,36667
4899418,4902934,chr17,C17orf107,chr17:4899418-4902934,3516
57994676,58000672,chr16,ZNF319,chr16:57994676-58000672,5996
42514188,42514307,chr17,MIR5010,chr17:42514188-42514307,119
30569672,30572734,chr16,ZNF688,chr16:30569672-30572734,3062
42546764,42548706,chr17,HSD17B1P1,chr17:42546764-42548706,1942
42552436,42554748,chr17,HSD17B1-AS1,chr17:42552436-42554748,2312
94543921,94549895,chr11,FUT4,chr11:94543921-94549895,5974
55224280,55225908,chr2,CDPF1P1,chr2:55224280-55225908,1628
50024410,50037088,chr16,CNEP1R1,chr16:50024410-50037088,12678
102120183,102197520,chr12,PARPBP,chr12:102120183-102197520,77337
74719542,74725536,chr15,CYP1A1,chr15:74719542-74725536,5994
170662728,170739421,chr1,PRRX1,chr1:170662728-170739421,76693
89969791,89972534,chr16,CENPBD1,chr16:89969791-89972534,2743
55282319,55284522,chr2,PRORSD1P,chr2:55282319-55284522,2203
75355207,75368612,chr15,MAN2C1,chr15:75355207-75368612,13405
43718992,43758793,chr12,PUS7L,chr12:43718992-43758793,39801
185296388,185317273,chr1,IVNS1ABP,chr1:185296388-185317273,20885
67277510,67289499,chr16,PLEKHG4,chr16:67277510-67289499,11989
229763837,229923239,chr2,TRIP12,chr2:229763837-229923239,159402
6844793,6851292,chr12,CDCA3,chr12:6844793-6851292,6499
207708,215113,chr11,RIC8A,chr11:207708-215113,7405
149517235,149736714,chr3,WWTR1,chr3:149517235-149736714,219479
144529179,144685846,chr8,ARHGAP39,chr8:144529179-144685846,156667
66378797,66501263,chr3,LRIG1,chr3:66378797-66501263,122466
151012209,151024499,chr7,ATG9B,chr7:151012209-151024499,12290
43444252,43483893,chr5,TMEM267,chr5:43444252-43483893,39641
147386046,147406809,chr3,ZIC4,chr3:147386046-147406809,20763
212035553,212107400,chr1,DTL,chr1:212035553-212107400,71847
141853090,141879246,chr5,PCDH1,chr5:141853090-141879246,26156
184371935,184381968,chr3,THPO,chr3:184371935-184381968,10033
243056307,243101744,chr1,LINC01347,chr1:243056307-243101744,45437
63588609,63607197,chr2,MDH1,chr2:63588609-63607197,18588
77877330,77884119,chr17,LINC01973,chr17:77877330-77884119,6789
46383789,46391776,chr11,CHRM4,chr11:46383789-46391776,7987
45668221,45683722,chr19,GIPR,chr19:45668221-45683722,15501
110577042,110713189,chr11,ARHGAP20,chr11:110577042-110713189,136147
56727418,57079329,chr3,ARHGEF3,chr3:56727418-57079329,351911
73729104,73737400,chr2,TPRKB,chr2:73729104-73737400,8296
132257696,132273454,chr5,PDLIM4,chr5:132257696-132273454,15758
235975830,236065109,chr1,NID1,chr1:235975830-236065109,89279
73762184,73780157,chr2,DUSP11,chr2:73762184-73780157,17973
30830369,31369810,chr11,DCDC1,chr11:30830369-31369810,539441
132294394,132344190,chr5,SLC22A4,chr5:132294394-132344190,49796
203305491,203309602,chr1,BTG2,chr1:203305491-203309602,4111
131370478,132336822,chr11,NTM,chr11:131370478-132336822,966344
50606489,50611774,chr3,CISH,chr3:50606489-50611774,5285
36888124,36916291,chr19,ZNF829,chr19:36888124-36916291,28167
197911902,197935478,chr1,LHX9,chr1:197911902-197935478,23576
244653103,244709033,chr1,DESI2,chr1:244653103-244709033,55930
18086949,19002416,chr7,HDAC9,chr7:18086949-19002416,915467
51689128,51712387,chr19,SPACA6,chr19:51689128-51712387,23259
78248493,78254416,chr17,THA1P,chr17:78248493-78254416,5923
8780384,8797642,chr16,TMEM186,chr16:8780384-8797642,17258
17523301,17553839,chr19,NIBAN3,chr19:17523301-17553839,30538
8356902,8376704,chr17,KRBA2,chr17:8356902-8376704,19802
64713445,64759431,chr12,GNS,chr12:64713445-64759431,45986
245154985,245709432,chr1,KIF26B,chr1:245154985-245709432,554447
121024072,121090776,chr11,TBCEL,chr11:121024072-121090776,66704
146580742,147084784,chr5,PPP2R2B,chr5:146580742-147084784,504042
218285293,218337983,chr1,RRP15,chr1:218285293-218337983,52690
57411161,57421934,chr19,ZNF17,chr19:57411161-57421934,10773
248095184,248101103,chr1,OR2L13,chr1:248095184-248101103,5919
35443907,35451767,chr19,FFAR2,chr19:35443907-35451767,7860
65169583,65248355,chr12,LEMD3,chr12:65169583-65248355,78772
11956207,12009769,chr11,DKK3,chr11:11956207-12009769,53562
124776856,124882668,chr12,SCARB1,chr12:124776856-124882668,105812
21908873,21913690,chr8,DOK2,chr8:21908873-21913690,4817
40382721,40394288,chr15,KNSTRN,chr15:40382721-40394288,11567
21919662,22006585,chr8,XPO7,chr8:21919662-22006585,86923
74807739,74949200,chr11,XRRA1,chr11:74807739-74949200,141461
75336329,75364001,chr5,HMGCR,chr5:75336329-75364001,27672
112086335,112131004,chr3,C3orf52,chr3:112086335-112131004,44669
112596797,112649530,chr3,CCDC80,chr3:112596797-112649530,52733
174999163,175012027,chr1,CACYBP,chr1:174999163-175012027,12864
99715697,99733561,chr15,LYSMD4,chr15:99715697-99733561,17864
396725,410367,chr16,NME4,chr16:396725-410367,13642
35825372,35869287,chr19,NPHS1,chr19:35825372-35869287,43915
158765741,158819368,chr6,EZR,chr6:158765741-158819368,53627
22048995,22082527,chr8,DMTN,chr8:22048995-22082527,33532
18017555,18046269,chr11,TPH1,chr11:18017555-18046269,28714
95583499,95596516,chr7,PDK4,chr7:95583499-95596516,13017
178237476,178590393,chr5,COL23A1,chr5:178237476-178590393,352917
44326555,44367217,chr19,ZNF112,chr19:44326555-44367217,40662
9757347,9769992,chr3,CAMK1,chr3:9757347-9769992,12645
178619728,178619998,chr5,RN7SKP70,chr5:178619728-178619998,270
71464555,71565089,chr16,ZNF19,chr16:71464555-71565089,100534
214348700,214552449,chr1,PTPN14,chr1:214348700-214552449,203749
51952106,52067375,chr15,MAPK6,chr15:51952106-52067375,115269
41905354,41921139,chr6,MED20,chr6:41905354-41921139,15785
28431930,28443502,chr6,ZSCAN23,chr6:28431930-28443502,11572
162727132,163315500,chr6,PACRG,chr6:162727132-163315500,588368
138422043,138692571,chr6,NHSL1,chr6:138422043-138692571,270528
223701593,223776018,chr1,CAPN2,chr1:223701593-223776018,74425
121737103,121767853,chr2,TSN,chr2:121737103-121767853,30750
49550666,49561907,chr6,C6orf141,chr6:49550666-49561907,11241
46297042,46343433,chr19,HIF3A,chr19:46297042-46343433,46391
42156891,42181142,chr17,KCNH4,chr17:42156891-42181142,24251
42746958,42868558,chr6,BICRAL,chr6:42746958-42868558,121600
49416778,49422685,chr3,AMT,chr3:49416778-49422685,5907
211658657,211675630,chr1,NEK2,chr1:211658657-211675630,16973
43770184,43786487,chr6,VEGFA,chr6:43770184-43786487,16303
19404161,19758029,chr8,CSGALNACT1,chr8:19404161-19758029,353868
42188799,42194532,chr17,GHDC,chr17:42188799-42194532,5733
147844517,147930826,chr2,ACVR2A,chr2:147844517-147930826,86309
114922094,115019917,chr7,MDFIC,chr7:114922094-115019917,97823
131828393,131851783,chr12,MMP17,chr12:131828393-131851783,23390
132618776,132622388,chr12,P2RX2,chr12:132618776-132622388,3612
147930396,148021604,chr2,ORC4,chr2:147930396-148021604,91208
229271062,229305894,chr1,RAB4A,chr1:229271062-229305894,34832
132123340,132648688,chr7,PLXNA4,chr7:132123340-132648688,525348
235109341,235128837,chr1,TOMM20,chr1:235109341-235128837,19496
178090677,178093984,chr1,RASAL2-AS1,chr1:178090677-178093984,3307
166856510,166876264,chr1,TADA1,chr1:166856510-166876264,19754
17643795,17801094,chr8,MTUS1,chr8:17643795-17801094,157299
230978981,231000733,chr1,ARV1,chr1:230978981-231000733,21752
179678560,179681034,chr5,CBY3,chr5:179678560-179681034,2474
223779893,223845954,chr1,TP53BP2,chr1:223779893-223845954,66061
103175133,103280410,chr7,DPY19L2P2,chr7:103175133-103280410,105277
38730187,38769904,chr19,CAPN12,chr19:38730187-38769904,39717
143579697,143599541,chr8,EEF1D,chr8:143579697-143599541,19844
109987063,109996140,chr2,LINC01123,chr2:109987063-109996140,9077
182839347,182887982,chr1,DHX9,chr1:182839347-182887982,48635
92836367,92917188,chr7,CDK6-AS1,chr7:92836367-92917188,80821
104885718,104898670,chr11,CASP12,chr11:104885718-104898670,12952
55728115,55750111,chr16,CES1P2,chr16:55728115-55750111,21996
77083681,77122332,chr7,FAM185BP,chr7:77083681-77122332,38651
75100563,75206549,chr11,SLCO2B1,chr11:75100563-75206549,105986
38647649,38731589,chr19,ACTN4,chr19:38647649-38731589,83940
20328296,20331781,chr7,ITGB8-AS1,chr7:20328296-20331781,3485
150296343,150339307,chr5,ARSI,chr5:150296343-150339307,42964
224114111,224162047,chr1,FBXO28,chr1:224114111-224162047,47936
1609290,1652615,chr19,TCF3,chr19:1609290-1652615,43325
75260122,75351705,chr11,ARRB1,chr11:75260122-75351705,91583
66376044,66493566,chr7,LINC00174,chr7:66376044-66493566,117522
132489551,132585188,chr12,FBRSL1,chr12:132489551-132585188,95637
26216200,26216688,chr6,H2BC8,chr6:26216200-26216688,488
81395457,81466332,chr17,BAHCC1,chr17:81395457-81466332,70875
27838545,27855709,chr6,H2BC15,chr6:27838545-27855709,17164
26251614,26252075,chr6,H2BC9,chr6:26251614-26252075,461
75422394,75433203,chr11,KLHL35,chr11:75422394-75433203,10809
65751037,65764225,chr7,CCT6P1,chr7:65751037-65764225,13188
9866711,9880255,chr3,CIDEC,chr3:9866711-9880255,13544
35079989,35186248,chr7,DPY19L2P1,chr7:35079989-35186248,106259
17074388,17077715,chr11,RPS13,chr11:17074388-17077715,3327
45606994,45645602,chr19,EML2,chr19:45606994-45645602,38608
722582,726954,chr16,CCDC78,chr16:722582-726954,4372
17077730,17207986,chr11,PIK3C2A,chr11:17077730-17207986,130256
67302621,67362950,chr7,STAG3L4,chr7:67302621-67362950,60329
103965822,103988874,chr12,TDG,chr12:103965822-103988874,23052
36596588,36688334,chr5,SLC1A3,chr5:36596588-36688334,91746
28241697,28252269,chr6,ZKSCAN4,chr6:28241697-28252269,10572
32916815,32943176,chr7,RP9P,chr7:32916815-32943176,26361
203340628,203351758,chr1,FMOD,chr1:203340628-203351758,11130
118510273,118531094,chr11,TTC36-AS1,chr11:118510273-118531094,20821
32641676,32697098,chr15,SCG5,chr15:32641676-32697098,55422
118527472,118531197,chr11,TTC36,chr11:118527472-118531197,3725
12424411,12436406,chr8,FAM86B2,chr8:12424411-12436406,11995
118531041,118547280,chr11,TMEM25,chr11:118531041-118547280,16239
160739057,160754821,chr1,SLAMF7,chr1:160739057-160754821,15764
62673851,63046487,chr2,EHBP1,chr2:62673851-63046487,372636
122303658,122310119,chr7,FEZF1-AS1,chr7:122303658-122310119,6461
32817997,32897824,chr3,TRIM71,chr3:32817997-32897824,79827
27450743,27473118,chr6,ZNF184,chr6:27450743-27473118,22375
29390363,29551903,chr17,TAOK1,chr17:29390363-29551903,161540
231241207,231277973,chr1,GNPAT,chr1:231241207-231277973,36766
138252380,138274621,chr5,GFRA3,chr5:138252380-138274621,22241
72829425,72837396,chr7,SBDSP1,chr7:72829425-72837396,7971
41408408,41483563,chr15,RTF1,chr15:41408408-41483563,75155
30516309,30595286,chr7,GARS1-DT,chr7:30516309-30595286,78977
57907629,58159920,chr2,VRK2,chr2:57907629-58159920,252291
118544528,118572970,chr11,IFT46,chr11:118544528-118572970,28442
218345336,218444619,chr1,TGFB2,chr1:218345336-218444619,99283
1354711,1378431,chr19,PWWP3A,chr19:1354711-1378431,23720
87322583,87399749,chr6,SMIM8,chr6:87322583-87399749,77166
17922968,18029948,chr8,PCM1,chr8:17922968-18029948,106980
205302063,205321745,chr1,NUAK2,chr1:205302063-205321745,19682
156388922,156640654,chr7,LINC01006,chr7:156388922-156640654,251732
80402178,80680273,chr12,PTPRQ,chr12:80402178-80680273,278095
118560690,118561580,chr11,RPL5P30,chr11:118560690-118561580,890
9156402,9156881,chr16,RPL21P119,chr16:9156402-9156881,479
87513459,87590028,chr6,RARS2,chr6:87513459-87590028,76569
118436456,118526832,chr11,KMT2A,chr11:118436456-118526832,90376
80099537,80380880,chr12,OTOGL,chr12:80099537-80380880,281343
77657659,77696277,chr7,APTR,chr7:77657659-77696277,38618
44983019,44986961,chr7,SNHG15,chr7:44983019-44986961,3942
146192335,146251179,chr3,PLSCR4,chr3:146192335-146251179,58844
9910606,10198606,chr17,GAS7,chr17:9910606-10198606,288000
13144058,13150383,chr19,STX10,chr19:13144058-13150383,6325
112905856,112933219,chr12,OAS1,chr12:112905856-112933219,27363
79452877,79471208,chr7,MAGI2-AS3,chr7:79452877-79471208,18331
37106228,37249376,chr5,CPLANE1,chr5:37106228-37249376,143148
145864245,145964423,chr6,SHPRH,chr6:145864245-145964423,100178
13206442,13633025,chr19,CACNA1A,chr19:13206442-13633025,426583
146515180,146544856,chr3,PLSCR1,chr3:146515180-146544856,29676
45190931,45222222,chr17,FMNL1-DT,chr17:45190931-45222222,31291
86784610,86808396,chr2,CD8A,chr2:86784610-86808396,23786
230057990,230282122,chr1,GALNT2,chr1:230057990-230282122,224132
17393595,17557780,chr6,CAP2,chr6:17393595-17557780,164185
234724042,234736720,chr1,LINC01132,chr1:234724042-234736720,12678
171248471,171285978,chr1,FMO1,chr1:171248471-171285978,37507
45929319,46121454,chr11,PHF21A,chr11:45929319-46121454,192135
160399274,160434954,chr3,SMC4,chr3:160399274-160434954,35680
231337104,231355023,chr1,SPRTN,chr1:231337104-231355023,17919
1567332,1571005,chr7,PSMG3,chr7:1567332-1571005,3673
1570073,1589626,chr7,PSMG3-AS1,chr7:1570073-1589626,19553
84631451,84647478,chr15,SCAND2P,chr15:84631451-84647478,16027
12716312,13290446,chr6,PHACTR1,chr6:12716312-13290446,574134
227918656,227947932,chr1,WNT9A,chr1:227918656-227947932,29276
128899565,128906044,chr11,C11orf45,chr11:128899565-128906044,6479
64606174,64723197,chr11,NRXN2,chr11:64606174-64723197,117023
176463171,176845601,chr1,PAPPA2,chr1:176463171-176845601,382430
41636882,41654244,chr6,MDFI,chr6:41636882-41654244,17362
98645118,98647389,chr15,IRAIN,chr15:98645118-98647389,2271
93835490,93878822,chr15,LINC02207,chr15:93835490-93878822,43332
33162681,33192499,chr6,COL11A2,chr6:33162681-33192499,29818
102239386,102253750,chr8,UBR5-DT,chr8:102239386-102253750,14364
63938554,63972918,chr17,SCN4A,chr17:63938554-63972918,34364
69834087,69854971,chr8,SLCO5A1-AS1,chr8:69834087-69854971,20884
63995418,63999899,chr17,PRR29-AS1,chr17:63995418-63999899,4481
125859721,126292788,chr8,LINC00861,chr8:125859721-126292788,433067
63998351,64004305,chr17,PRR29,chr17:63998351-64004305,5954
204617170,204685738,chr1,LRRN2,chr1:204617170-204685738,68568
71845996,71931199,chr16,IST1,chr16:71845996-71931199,85203
64002594,64020634,chr17,ICAM2,chr17:64002594-64020634,18040
94553668,94570652,chr8,VIRMA-DT,chr8:94553668-94570652,16984
156850295,156852528,chr5,PPP1R2B,chr5:156850295-156852528,2233
79768110,79802848,chr8,LINC01607,chr8:79768110-79802848,34738
160565447,160569248,chr3,KRT8P12,chr3:160565447-160569248,3801
87227271,87255556,chr3,CHMP2B,chr3:87227271-87255556,28285
119703022,119767102,chr3,CFAP91,chr3:119703022-119767102,64080
65570460,65573942,chr11,ZNRD2,chr11:65570460-65573942,3482
96110040,96327361,chr15,NR2F2-AS1,chr15:96110040-96327361,217321
171687409,171750158,chr2,DYNC1I2,chr2:171687409-171750158,62749
172532349,172611833,chr1,SUCO,chr1:172532349-172611833,79484
37980676,38062340,chr15,LINC02345,chr15:37980676-38062340,81664
76491200,76683504,chr8,ZFHX4-AS1,chr8:76491200-76683504,192304
50354950,50372202,chr15,GABPB1-AS1,chr15:50354950-50372202,17252
127517640,127555085,chr5,PRRC1,chr5:127517640-127555085,37445
71859680,71895336,chr16,ZNF821,chr16:71859680-71895336,35656
44527257,44537046,chr15,EIF3J-DT,chr15:44527257-44537046,9789
40039242,40080614,chr15,SRP14-DT,chr15:40039242-40080614,41372
22495570,22590820,chr15,HERC2P2,chr15:22495570-22590820,95250
1971153,1974768,chr8,KBTBD11-AS1,chr8:1971153-1974768,3615
127794526,128187101,chr8,PVT1,chr8:127794526-128187101,392575
72008588,72027664,chr16,DHODH,chr16:72008588-72027664,19076
69280175,69332809,chr5,CCDC125,chr5:69280175-69332809,52634
72044289,72094431,chr16,TXNL4B,chr16:72044289-72094431,50142
147204417,147390476,chr6,STXBP5,chr6:147204417-147390476,186059
44205033,44221626,chr17,UBTF,chr17:44205033-44221626,16593
125946044,125958647,chr11,VSIG10L2,chr11:125946044-125958647,12603
154154496,154356803,chr6,IPCEF1,chr6:154154496-154356803,202307
110627841,110704950,chr12,HVCN1,chr12:110627841-110704950,77109
209756032,209782320,chr1,TRAF3IP3,chr1:209756032-209782320,26288
110614027,110663431,chr12,TCTN1,chr12:110614027-110663431,49404
66934444,66945096,chr16,CES2,chr16:66934444-66945096,10652
89545424,89757812,chr8,RIPK2-DT,chr8:89545424-89757812,212388
81804132,81814008,chr17,GCGR,chr17:81804132-81814008,9876
186900198,186900557,chr3,RPS20P14,chr3:186900198-186900557,359
187120948,187180908,chr3,RPL39L,chr3:187120948-187180908,59960
186930325,187078553,chr3,ST6GAL1,chr3:186930325-187078553,148228
144049079,144051655,chr8,SMPD5,chr8:144049079-144051655,2576
90221341,90687863,chr8,LINC00534,chr8:90221341-90687863,466522
228850526,229271287,chr2,PID1,chr2:228850526-229271287,420761
223975045,224039318,chr2,SERPINE2,chr2:223975045-224039318,64273
126556323,127419050,chr8,PCAT1,chr8:126556323-127419050,862727
67164681,67169945,chr16,HSF4,chr16:67164681-67169945,5264
212791828,212816830,chr1,TATDN3,chr1:212791828-212816830,25002
128538013,129033642,chr5,SLC27A6,chr5:128538013-129033642,495629
47659591,47715389,chr11,AGBL2,chr11:47659591-47715389,55798
129094749,129114028,chr5,ISOC1,chr5:129094749-129114028,19279
49293252,49298686,chr12,PRPH,chr12:49293252-49298686,5434
196639694,196662004,chr3,NRROS,chr3:196639694-196662004,22310
16180238,16185585,chr5,MARCHF11-DT,chr5:16180238-16185585,5347
3188925,3377830,chr2,EIPR1,chr2:3188925-3377830,188905
84958989,86074429,chr3,CADM2,chr3:84958989-86074429,1115440
86302211,86345943,chr11,HIKESHI,chr11:86302211-86345943,43732
109689927,109869625,chr5,MAN2A1,chr5:109689927-109869625,179698
98608579,98618515,chr2,UNC50,chr2:98608579-98618515,9936
173314723,173328447,chr5,STC2,chr5:173314723-173328447,13724
170178145,170655171,chr2,MYO3B,chr2:170178145-170655171,477026
3611728,3680143,chr16,DNASE1,chr16:3611728-3680143,68415
140558268,140564781,chr5,APBB3,chr5:140558268-140564781,6513
81732448,81759515,chr8,CHMP4C,chr8:81732448-81759515,27067
81900958,81911432,chr17,PCYT2,chr17:81900958-81911432,10474
248838210,248849517,chr1,ZNF672,chr1:248838210-248849517,11307
162561506,162599842,chr1,UAP1,chr1:162561506-162599842,38336
162497251,162529631,chr1,UHMK1,chr1:162497251-162529631,32380
208606564,208614295,chr1,LINC01735,chr1:208606564-208614295,7731
2209253,2210905,chr16,BRICD5,chr16:2209253-2210905,1652
205381378,205455954,chr1,LEMD1,chr1:205381378-205455954,74576
17539698,17697874,chr1,ARHGEF10L,chr1:17539698-17697874,158176
101029624,101129813,chr11,PGR,chr11:101029624-101129813,100189
58453982,58460139,chr5,PLK2,chr5:58453982-58460139,6157
63840952,63891562,chr2,UGP2,chr2:63840952-63891562,50610
231528541,231566524,chr1,TSNAX,chr1:231528541-231566524,37983
56152256,56159647,chr12,MYL6B,chr12:56152256-56159647,7391
108984309,109094846,chr6,SESN1,chr6:108984309-109094846,110537
148290889,148519604,chr1,LINC01138,chr1:148290889-148519604,228715
192716132,192716653,chr1,RPS27AP5,chr1:192716132-192716653,521
208626741,208628085,chr1,LINC02769,chr1:208626741-208628085,1344
162069691,162370475,chr1,NOS1AP,chr1:162069691-162370475,300784
71886550,72403145,chr6,RIMS1,chr6:71886550-72403145,516595
81939645,81947233,chr17,MYADML2,chr17:81939645-81947233,7588
81952507,81961840,chr17,NOTUM,chr17:81952507-81961840,9333
49171598,49176486,chr3,KLHDC8B,chr3:49171598-49176486,4888
81509413,81523847,chr17,ACTG1,chr17:81509413-81523847,14434
102942995,102955732,chr11,MMP13,chr11:102942995-102955732,12737
212992182,213015867,chr1,ANGEL2,chr1:212992182-213015867,23685
17435509,17448668,chr19,TMEM221,chr19:17435509-17448668,13159
48720585,48740610,chr19,RASIP1,chr19:48720585-48740610,20025
196833004,196927796,chr2,PGAP1,chr2:196833004-196927796,94792
209675412,209676390,chr1,G0S2,chr1:209675412-209676390,978
231332753,231337852,chr1,EXOC8,chr1:231332753-231337852,5099
182598623,182604389,chr1,RGS16,chr1:182598623-182604389,5766
177170958,177282422,chr1,BRINP2,chr1:177170958-177282422,111464
42458844,42522582,chr17,ATP6V0A1,chr17:42458844-42522582,63738
198156994,198322420,chr1,NEK7,chr1:198156994-198322420,165426
230314490,230426332,chr1,PGBD5,chr1:230314490-230426332,111842
35431823,35530300,chr11,PAMR1,chr11:35431823-35530300,98477
246945547,247008093,chr1,ZNF695,chr1:246945547-247008093,62546
213051233,213274774,chr1,RPS6KC1,chr1:213051233-213274774,223541
75611182,75681773,chr5,ANKDD1B,chr5:75611182-75681773,70591
12796472,12871916,chr3,CAND2,chr3:12796472-12871916,75444
74696429,74731426,chr11,CHRDL2,chr11:74696429-74731426,34997
119821321,120094994,chr3,GSK3B,chr3:119821321-120094994,273673
99181152,99199561,chr2,MRPL30,chr2:99181152-99199561,18409
42609641,42615238,chr17,TUBG1,chr17:42609641-42615238,5597
182615254,182616629,chr1,LINC01686,chr1:182615254-182616629,1375
229440259,229508341,chr1,NUP133,chr1:229440259-229508341,68082
1838981,1841680,chr11,TNNI2,chr11:1838981-1841680,2699
220748225,220784815,chr1,MTARC2,chr1:220748225-220784815,36590
133824235,133895882,chr3,RAB6B,chr3:133824235-133895882,71647
199911293,199955935,chr2,C2orf69,chr2:199911293-199955935,44642
121216587,121285202,chr2,TFCP2L1,chr2:121216587-121285202,68615
163161675,163213023,chr1,RGS5-AS1,chr1:163161675-163213023,51348
159062484,159147096,chr1,AIM2,chr1:159062484-159147096,84612
179099330,179229684,chr1,ABL2,chr1:179099330-179229684,130354
28091137,28093664,chr6,ZSCAN12P1,chr6:28091137-28093664,2527
81844602,82169391,chr6,LINC02542,chr6:81844602-82169391,324789
105995623,106022403,chr11,MSANTD4,chr11:105995623-106022403,26780
8435568,9294133,chr6,HULC,chr6:8435568-9294133,858565
72151236,72207776,chr3,LINC00870,chr3:72151236-72207776,56540
744421,753999,chr17,GEMIN4,chr17:744421-753999,9578
35005990,35089319,chr17,RFFL,chr17:35005990-35089319,83329
197379701,197380892,chr2,NPM1P46,chr2:197379701-197380892,1191
21131194,21239796,chr12,SLCO1B1,chr12:21131194-21239796,108602
197388515,197435079,chr2,SF3B1,chr2:197388515-197435079,46564
71719275,71721048,chr5,CARTPT,chr5:71719275-71721048,1773
21437615,21471250,chr12,PYROXD1,chr12:21437615-21471250,33635
248906196,248919946,chr1,PGBD2,chr1:248906196-248919946,13750
29976042,30061640,chr6,ZNRD1ASP,chr6:29976042-30061640,85598
147155106,147172550,chr1,PRKAB2,chr1:147155106-147172550,17444
35128730,35142304,chr17,NLE1,chr17:35128730-35142304,13574
21468910,21501669,chr12,RECQL,chr12:21468910-21501669,32759
212858275,212899363,chr1,FLVCR1,chr1:212858275-212899363,41088
205789094,205813748,chr1,SLC41A1,chr1:205789094-205813748,24654
21501781,21518408,chr12,GOLT1B,chr12:21501781-21518408,16627
32727490,32755897,chr12,YARS2,chr12:32727490-32755897,28407
43891045,43938212,chr6,LINC01512,chr6:43891045-43938212,47167
248936581,248937043,chr1,RPL23AP25,chr1:248936581-248937043,462
244408494,244451909,chr1,ADSS2,chr1:244408494-244451909,43415
172750682,172821474,chr3,ECT2,chr3:172750682-172821474,70792
72216601,72221950,chr11,FOLR2,chr11:72216601-72221950,5349
170077224,170078294,chr2,NSA2P5,chr2:170077224-170078294,1070
15380050,15419141,chr19,AKAP8L,chr19:15380050-15419141,39091
41452889,41548621,chr6,FOXP4-AS1,chr6:41452889-41548621,95732
35138882,35232402,chr11,CD44,chr11:35138882-35232402,93520
123250112,123272334,chr12,CDK2AP1,chr12:123250112-123272334,22222
112523514,112620825,chr1,ST7L,chr1:112523514-112620825,97311
169827454,170084131,chr2,UBR3,chr2:169827454-170084131,256677
28846600,28874212,chr16,SH2B1,chr16:28846600-28874212,27612
29871159,29899550,chr16,SEZ6L2,chr16:29871159-29899550,28391
177227595,177392697,chr2,NFE2L2,chr2:177227595-177392697,165102
2851230,2881407,chr6,SERPINB9P1,chr6:2851230-2881407,30177
137943079,137957657,chr6,LINC02528,chr6:137943079-137957657,14578
27694027,27713706,chr6,LINC01012,chr6:27694027-27713706,19679
13437942,13982002,chr12,GRIN2B,chr12:13437942-13982002,544060
161992245,162074394,chr2,DPP4,chr2:161992245-162074394,82149
2621911,2634619,chr6,LINC01600,chr6:2621911-2634619,12708
205086142,205122015,chr1,RBBP5,chr1:205086142-205122015,35873
89195761,89201651,chr16,SLC22A31,chr16:89195761-89201651,5890
47331406,47352702,chr11,MYBPC3,chr11:47331406-47352702,21296
180632022,180890279,chr1,XPR1,chr1:180632022-180890279,258257
87949244,88077318,chr16,BANP,chr16:87949244-88077318,128074
66234079,66235234,chr12,RBMS1P1,chr12:66234079-66235234,1155
66302493,66343643,chr12,HELB,chr12:66302493-66343643,41150
15591178,15634346,chr2,DDX1,chr2:15591178-15634346,43168
200551497,200620751,chr1,KIF14,chr1:200551497-200620751,69254
127703391,127941507,chr5,CCDC192,chr5:127703391-127941507,238116
38200234,38200532,chr19,RN7SL663P,chr19:38200234-38200532,298
183929854,184037729,chr1,COLGALT2,chr1:183929854-184037729,107875
63805852,63822699,chr6,SCAT8,chr6:63805852-63822699,16847
21664184,22654455,chr6,CASC15,chr6:21664184-22654455,990271
147172744,147179622,chr1,PDIA3P1,chr1:147172744-147179622,6878
119044188,119057227,chr11,HYOU1,chr11:119044188-119057227,13039
71281389,71289715,chr16,CMTR2,chr16:71281389-71289715,8326
200404940,200410056,chr1,ZNF281,chr1:200404940-200410056,5116
71447597,71463095,chr16,ZNF23,chr16:71447597-71463095,15498
141382739,141512975,chr5,PCDHGA7,chr5:141382739-141512975,130236
141387698,141512975,chr5,PCDHGB4,chr5:141387698-141512975,125277
141412987,141512975,chr5,PCDHGA10,chr5:141412987-141512975,99988
29742463,29745990,chr16,C16orf54,chr16:29742463-29745990,3527
141421047,141512975,chr5,PCDHGA11,chr5:141421047-141512975,91928
29811382,29815892,chr16,PRRT2,chr16:29811382-29815892,4510
55820960,55830824,chr12,DNAJC14,chr12:55820960-55830824,9864
29820394,29848039,chr16,MVP,chr16:29820394-29848039,27645
141484997,141512975,chr5,PCDHGC4,chr5:141484997-141512975,27978
177212563,177223958,chr2,HNRNPA3,chr2:177212563-177223958,11395
34105617,34147670,chr11,NAT10,chr11:34105617-34147670,42053
141636950,141641064,chr5,RELL2,chr5:141636950-141641064,4114
248810446,248825915,chr1,SH3BP5L,chr1:248810446-248825915,15469
112466541,112530165,chr1,WNT2B,chr1:112466541-112530165,63624
235738005,235738989,chr1,LDHAP2,chr1:235738005-235738989,984
205712822,205750182,chr1,NUCKS1,chr1:205712822-205750182,37360
76265348,76271298,chr17,UBALD2,chr17:76265348-76271298,5950
201955503,201970664,chr1,TIMM17A,chr1:201955503-201970664,15161
68535113,68601367,chr17,FAM20A,chr17:68535113-68601367,66254
119636457,119665324,chr3,POPDC2,chr3:119636457-119665324,28867
73626158,73941993,chr5,ARHGEF28,chr5:73626158-73941993,315835
22063773,22437041,chr12,ST8SIA1,chr12:22063773-22437041,373268
245749342,246507312,chr1,SMYD3,chr1:245749342-246507312,757970
50362613,50504244,chr3,CACNA2D2,chr3:50362613-50504244,141631
106063345,106138954,chr12,NUAK1,chr12:106063345-106138954,75609
85098358,85112472,chr16,CIBAR2,chr16:85098358-85112472,14114
173714941,173786692,chr1,KLHL20,chr1:173714941-173786692,71751
71839707,71927248,chr12,TBC1D15,chr12:71839707-71927248,87541
68205481,68257712,chr17,AMZ2,chr17:68205481-68257712,52231
85137150,85149443,chr16,LINC02139,chr16:85137150-85149443,12293
22345936,22437165,chr16,CDR2,chr16:22345936-22437165,91229
22418672,22437715,chr16,RRN3P3,chr16:22418672-22437715,19043
22479121,22536521,chr16,NPIPB5,chr16:22479121-22536521,57400
17208153,17349980,chr11,NUCB2,chr11:17208153-17349980,141827
119037772,119249138,chr5,DMXL1,chr5:119037772-119249138,211366
94377316,94401419,chr11,GPR83,chr11:94377316-94401419,24103
180509380,180566523,chr1,OVAAL,chr1:180509380-180566523,57143
215567304,215621807,chr1,KCTD3,chr1:215567304-215621807,54503
54033050,54035361,chr12,HOXC5,chr12:54033050-54035361,2311
120302316,120313249,chr12,SIRT4,chr12:120302316-120313249,10933
37474580,37484377,chr1,ZC3H12A,chr1:37474580-37484377,9797
150894392,150904983,chr5,ZNF300,chr5:150894392-150904983,10591
76025447,76031776,chr12,PHLDA1,chr12:76025447-76031776,6329
103988987,104064183,chr12,GLT8D2,chr12:103988987-104064183,75196
30698209,30741409,chr16,SRCAP,chr16:30698209-30741409,43200
160830160,160862887,chr1,CD244,chr1:160830160-160862887,32727
33703010,33736479,chr11,CD59,chr11:33703010-33736479,33469
51817899,51848718,chr12,FIGNL2,chr12:51817899-51848718,30819
145471799,145835369,chr5,PRELID2,chr5:145471799-145835369,363570
75525080,75575209,chr17,LLGL2,chr17:75525080-75575209,50129
49097136,49110900,chr12,LMBR1L,chr12:49097136-49110900,13764
207454230,207489895,chr1,CR2,chr1:207454230-207489895,35665
33740939,33774543,chr11,FBXO3,chr11:33740939-33774543,33604
54236592,54242791,chr19,LILRA6,chr19:54236592-54242791,6199
233614106,233672514,chr1,KCNK1,chr1:233614106-233672514,58408
231056845,231173116,chr2,PSMD1,chr2:231056845-231173116,116271
71579531,71658706,chr5,MCCC2,chr5:71579531-71658706,79175
134355347,134375479,chr3,AMOTL2,chr3:134355347-134375479,20132
19129733,19376400,chr12,PLEKHA5,chr12:19129733-19376400,246667
181178821,181191852,chr5,LINC01962,chr5:181178821-181191852,13031
244840638,244864560,chr1,HNRNPU,chr1:244840638-244864560,23922
181193924,181205293,chr5,TRIM7,chr5:181193924-181205293,11369
167784,207399,chr11,BET1L,chr11:167784-207399,39615
181236897,181248096,chr5,RACK1,chr5:181236897-181248096,11199
752579,911452,chr12,WNK1,chr12:752579-911452,158873
70661204,70686053,chr16,MTSS2,chr16:70661204-70686053,24849
21597218,21657471,chr16,METTL9,chr16:21597218-21657471,60253
57233577,57237250,chr11,APLNR,chr11:57233577-57237250,3673
30085793,30091924,chr16,TBX6,chr16:30085793-30091924,6131
19555240,19706793,chr16,VPS35L,chr16:19555240-19706793,151553
32679200,32745650,chr12,DNM1L,chr12:32679200-32745650,66450
169479480,169506655,chr2,BBS5,chr2:169479480-169506655,27175
18278668,18322198,chr11,HPS5,chr11:18278668-18322198,43530
185734391,186190949,chr1,HMCN1,chr1:185734391-186190949,456558
169509702,169526258,chr2,KLHL41,chr2:169509702-169526258,16556
169528508,169573875,chr2,FASTKD1,chr2:169528508-169573875,45367
12825478,12835428,chr19,RTBDN,chr19:12825478-12835428,9950
18322295,18367045,chr11,GTF2H1,chr11:18322295-18367045,44750
169584342,169641406,chr2,PPIG,chr2:169584342-169641406,57064
18394560,18408425,chr11,LDHA,chr11:18394560-18408425,13865
48548870,48604912,chr17,HOXB3,chr17:48548870-48604912,56042
148402715,148402875,chr1,RNVU1-3,chr1:148402715-148402875,160
59209400,59215239,chr17,SMG8,chr17:59209400-59215239,5839
36495636,36543435,chr17,MYO19,chr17:36495636-36543435,47799
1088226,1096244,chr16,C1QTNF8,chr16:1088226-1096244,8018
9951693,10002277,chr2,GRHL1,chr2:9951693-10002277,50584
20589086,20618903,chr1,CDA,chr1:20589086-20618903,29817
193121983,193254815,chr1,CDC73,chr1:193121983-193254815,132832
193178730,193186613,chr1,B3GALT2,chr1:193178730-193186613,7883
48540894,48545109,chr17,HOXB2,chr17:48540894-48545109,4215
48591257,48593779,chr17,HOXB5,chr17:48591257-48593779,2522
70258999,70354734,chr1,ANKRD13C,chr1:70258999-70354734,95735
77280569,77500596,chr17,SEPTIN9,chr17:77280569-77500596,220027
111514778,111537043,chr11,HOATZ,chr11:111514778-111537043,22265
10302889,10427617,chr2,HPCAL1,chr2:10302889-10427617,124728
156037701,156539138,chr3,KCNAB1,chr3:156037701-156539138,501437
94895297,95003748,chr12,NDUFA12,chr12:94895297-95003748,108451
23691742,23696835,chr1,RPL11,chr1:23691742-23696835,5093
850291,892801,chr5,BRD9,chr5:850291-892801,42510
10439968,10448327,chr2,ODC1,chr2:10439968-10448327,8359
23791145,23795539,chr1,LYPLA2,chr1:23791145-23795539,4394
7914830,7919097,chr19,TGFBR3L,chr19:7914830-7919097,4267
12965159,12974760,chr19,DAND5,chr19:12965159-12974760,9601
10446714,10446849,chr2,SNORA80B,chr2:10446714-10446849,135
1065923,1086628,chr19,ARHGAP45,chr19:1065923-1086628,20705
892884,919357,chr5,TRIP13,chr5:892884-919357,26473
98593591,98606379,chr12,SLC25A3,chr12:98593591-98606379,12788
197138748,197139307,chr1,SEPTIN14P12,chr1:197138748-197139307,559
132873444,132875046,chr5,LEAP2,chr5:132873444-132875046,1602
134253548,134265855,chr11,ACAD8,chr11:134253548-134265855,12307
150166778,150184558,chr5,CDX1,chr5:150166778-150184558,17780
169637268,170083382,chr5,DOCK2,chr5:169637268-170083382,446114
54107020,54115657,chr19,TFPT,chr19:54107020-54115657,8637
81739097,81962685,chr16,PLCG2,chr16:81739097-81962685,223588
81110487,81166221,chr17,AATK,chr17:81110487-81166221,55734
81133196,81133308,chr17,MIR1250,chr17:81133196-81133308,112
29484690,29505999,chr16,NPIPB12,chr16:29484690-29505999,21309
997129,1003671,chr17,TIMM22,chr17:997129-1003671,6542
10971836,11904446,chr5,CTNND2,chr5:10971836-11904446,932610
45095806,45235110,chr11,PRDM11,chr11:45095806-45235110,139304
1344275,1400222,chr17,YWHAE,chr17:1344275-1400222,55947
174072447,174248599,chr2,OLA1,chr2:174072447-174248599,176152
155127876,155134899,chr1,EFNA1,chr1:155127876-155134899,7023
189631389,189897276,chr3,TP63,chr3:189631389-189897276,265887
174334954,174338500,chr2,SP9,chr2:174334954-174338500,3546
174348022,174395712,chr2,CIR1,chr2:174348022-174395712,47690
155169408,155173475,chr1,KRTCAP2,chr1:155169408-155173475,4067
179835133,179862173,chr5,MRNIP,chr5:179835133-179862173,27040
12611827,12645108,chr12,CREBL2,chr12:12611827-12645108,33281
12813316,12829981,chr12,DDX47,chr12:12813316-12829981,16665
133664926,133665034,chr3,RNU6-678P,chr3:133664926-133665034,108
53879190,53907652,chr19,PRKCG,chr19:53879190-53907652,28462
133932701,134052184,chr3,SLCO2A1,chr3:133932701-134052184,119483
53991637,54012666,chr19,CACNG6,chr19:53991637-54012666,21029
155277463,155289848,chr1,HCN3,chr1:155277463-155289848,12385
148697784,148743008,chr3,AGTR1,chr3:148697784-148743008,45224
18001132,18014102,chr19,ARRDC2,chr19:18001132-18014102,12970
58192257,58214697,chr3,DNASE1L3,chr3:58192257-58214697,22440
178602664,178630615,chr5,CLK4,chr5:178602664-178630615,27951
55954105,55973317,chr12,PMEL,chr12:55954105-55973317,19212
151020591,151028988,chr5,GPX3,chr5:151020591-151028988,8397
1072747,1081454,chr16,SSTR5,chr16:1072747-1081454,8707
51135982,51152334,chr16,SALL1,chr16:51135982-51152334,16352
3538261,3574290,chr19,MFSD12,chr19:3538261-3574290,36029
58969038,60522120,chr5,PDE4D,chr5:58969038-60522120,1553082
3585478,3593541,chr19,GIPC3,chr19:3585478-3593541,8063
3539171,3544030,chr19,C19orf71,chr19:3539171-3544030,4859
75480753,75503863,chr12,GLIPR1,chr12:75480753-75503863,23110
27550133,27780344,chr16,KATNIP,chr16:27550133-27780344,230211
75490863,75511636,chr12,KRR1,chr12:75490863-75511636,20773
232878701,233013256,chr2,NGEF,chr2:232878701-233013256,134555
25409307,25648579,chr12,LMNTD1,chr12:25409307-25648579,239272
8693351,8910951,chr11,DENND2B,chr11:8693351-8910951,217600
174747592,174787935,chr2,CHRNA1,chr2:174747592-174787935,40343
72249964,72276954,chr12,TRHDE-AS1,chr12:72249964-72276954,26990
74332402,74368240,chr16,PDPR2P,chr16:74332402-74368240,35838
151788984,151828492,chr2,ARL5A,chr2:151788984-151828492,39508
75536741,75556289,chr16,TMEM231,chr16:75536741-75556289,19548
72087266,72670758,chr12,TRHDE,chr12:72087266-72670758,583492
160249083,160345396,chr5,CCNJL,chr5:160249083-160345396,96313
27959588,27968093,chr1,XKR8,chr1:27959588-27968093,8505
14143342,14532128,chr5,TRIO,chr5:14143342-14532128,388786
231223763,231241187,chr1,C1orf131,chr1:231223763-231241187,17424
55411727,55414787,chr12,PHC1P1,chr12:55411727-55414787,3060
74152528,74178898,chr2,MOB1A,chr2:74152528-74178898,26370
74186172,74217565,chr2,MTHFD2,chr2:74186172-74217565,31393
55019974,55030017,chr12,NEUROD4,chr12:55019974-55030017,10043
1962058,1964841,chr16,RPS2,chr16:1962058-1964841,2783
247110160,247112417,chr1,LINC02897,chr1:247110160-247112417,2257
12875499,12876107,chr12,RPL13AP20,chr12:12875499-12876107,608
12891559,12917937,chr12,GPRC5A,chr12:12891559-12917937,26378
247507058,247577690,chr1,GCSAML,chr1:247507058-247577690,70632
218450251,218568351,chr2,USP37,chr2:218450251-218568351,118100
12940775,12952147,chr12,GPRC5D,chr12:12940775-12952147,11372
12974870,13000265,chr12,HEBP1,chr12:12974870-13000265,25395
2676001,2691200,chr12,CACNA1C-AS1,chr12:2676001-2691200,15199
83079609,83095122,chr17,METRNL,chr17:83079609-83095122,15513
42968088,42980433,chr17,PTGES3L,chr17:42968088-42980433,12345
122980060,122982913,chr12,ARL6IP4,chr12:122980060-122982913,2853
155024124,155183704,chr3,MME,chr3:155024124-155183704,159580
1966823,1968975,chr16,RNF151,chr16:1966823-1968975,2152
247416156,247449108,chr1,NLRP3,chr1:247416156-247449108,32952
218568580,218597080,chr2,CNOT9,chr2:218568580-218597080,28500
239703381,239770130,chr1,CHRM3-AS2,chr1:239703381-239770130,66749
50184101,50201632,chr17,COL1A1,chr17:50184101-50201632,17531
218607855,218637184,chr2,PLCD4,chr2:218607855-218637184,29329
239386565,239915452,chr1,CHRM3,chr1:239386565-239915452,528887
1989660,1994275,chr16,SYNGR3,chr16:1989660-1994275,4615
186538441,186546702,chr3,CRYGS,chr3:186538441-186546702,8261
51889235,51905040,chr19,ZNF649,chr19:51889235-51905040,15805
2009926,2020755,chr16,NPW,chr16:2009926-2020755,10829
12685498,12722369,chr12,CDKN1B,chr12:12685498-12722369,36871
2025356,2039026,chr16,SLC9A3R2,chr16:2025356-2039026,13670
112013348,112023449,chr12,ERP29,chr12:112013348-112023449,10101
175658030,175710756,chr5,HRH2,chr5:175658030-175710756,52726
119190250,119196769,chr11,CCDC153,chr11:119190250-119196769,6519
3039033,3069242,chr3,CNTN4-AS1,chr3:3039033-3069242,30209
3066324,3126613,chr3,IL5RA,chr3:3066324-3126613,60289
2039815,2047866,chr16,NTHL1,chr16:2039815-2047866,8051
69653076,69675416,chr11,LTO1,chr11:69653076-69675416,22340
50375059,50397523,chr17,LRRC59,chr17:50375059-50397523,22464
69698238,69704022,chr11,FGF19,chr11:69698238-69704022,5784
9178979,9188818,chr19,OR7D2,chr19:9178979-9188818,9839
109087971,109090858,chr1,TMEM167B-DT,chr1:109087971-109090858,2887
118925164,118958559,chr11,UPK2,chr11:118925164-118958559,33395
62423875,62453385,chr17,METTL2A,chr17:62423875-62453385,29510
1970772,2697950,chr12,CACNA1C,chr12:1970772-2697950,727178
94703690,95285094,chr5,MCTP1,chr5:94703690-95285094,581404
22448583,22544546,chr12,C2CD5,chr12:22448583-22544546,95963
69396113,69437628,chr2,NFU1,chr2:69396113-69437628,41515
218633329,218659655,chr2,ZNF142,chr2:218633329-218659655,26326
47465933,47565569,chr11,CELF1,chr11:47465933-47565569,99636
156061160,156070504,chr1,RAB25,chr1:156061160-156070504,9344
44248390,44268141,chr17,SLC4A1,chr17:44248390-44268141,19751
69155478,69162440,chr11,SMIM38,chr11:69155478-69162440,6962
60455846,60470752,chr11,MS4A1,chr11:60455846-60470752,14906
1238179,1239522,chr19,CBARP-DT,chr19:1238179-1239522,1343
45755449,45796536,chr3,SLC6A20,chr3:45755449-45796536,41087
57516588,57521737,chr12,DDIT3,chr12:57516588-57521737,5149
44299574,44315315,chr17,RUNDC3A-AS1,chr17:44299574-44315315,15741
44308413,44318670,chr17,RUNDC3A,chr17:44308413-44318670,10257
141121818,141125623,chr5,PCDHB4,chr5:141121818-141125623,3805
55428740,55443300,chr19,SHISA7,chr19:55428740-55443300,14560
141150057,141153287,chr5,PCDHB6,chr5:141150057-141153287,3230
141199610,141203779,chr5,PCDHB11,chr5:141199610-141203779,4169
128267170,128707911,chr12,TMEM132C,chr12:128267170-128707911,440741
141208697,141212571,chr5,PCDHB12,chr5:141208697-141212571,3874
141213919,141218979,chr5,PCDHB13,chr5:141213919-141218979,5060
46424697,46428936,chr19,PNMA8C,chr19:46424697-46428936,4239
67414968,67425607,chr11,CARNS1,chr11:67414968-67425607,10639
94047836,94063389,chr3,DHFR2,chr3:94047836-94063389,15553
137745651,137754363,chr5,HNRNPA0,chr5:137745651-137754363,8712
51813921,51814925,chr12,TMDD1,chr12:51813921-51814925,1004
6666477,6689572,chr12,ZNF384,chr12:6666477-6689572,23095
47380928,47408477,chr1,LINC01389,chr1:47380928-47408477,27549
116574399,116667755,chr1,IGSF3,chr1:116574399-116667755,93356
13931187,13953392,chr19,PODNL1,chr19:13931187-13953392,22205
44353215,44363853,chr17,FAM171A2,chr17:44353215-44363853,10638
42489299,42537573,chr3,VIPR1,chr3:42489299-42537573,48274
1828307,1837521,chr11,SYT8,chr11:1828307-1837521,9214
18868545,18896727,chr19,CERS1,chr19:18868545-18896727,28182
42506465,42533258,chr3,VIPR1-AS1,chr3:42506465-42533258,26793
54121277,54189008,chr12,SMUG1,chr12:54121277-54189008,67731
10450031,10451998,chr1,CORT,chr1:10450031-10451998,1967
246839098,246931948,chr1,AHCTF1,chr1:246839098-246931948,92850
68272443,68332381,chr12,MDM1,chr12:68272443-68332381,59938
69567922,70151945,chr1,LRRC7,chr1:69567922-70151945,584023
76615482,76623413,chr5,F2RL2,chr5:76615482-76623413,7931
76818933,76835315,chr5,F2RL1,chr5:76818933-76835315,16382
172768096,172771195,chr5,DUSP1,chr5:172768096-172771195,3099
31784779,31817961,chr11,PAX6,chr11:31784779-31817961,33182
42653697,42667580,chr3,ZBTB47,chr3:42653697-42667580,13883
1431078,1434441,chr16,PERCC1,chr16:1431078-1434441,3363
1434383,1444556,chr16,CCDC154,chr16:1434383-1444556,10173
10170542,10191804,chr12,TMEM52B,chr12:10170542-10191804,21262
175176258,175181710,chr2,ATP5MC3,chr2:175176258-175181710,5452
44555193,44594173,chr3,ZKSCAN7,chr3:44555193-44594173,38980
164555584,164899296,chr1,PBX1,chr1:164555584-164899296,343712
104801801,104958744,chr12,SLC41A2,chr12:104801801-104958744,156943
151254709,151267479,chr1,PSMD4,chr1:151254709-151267479,12770
44617128,44624797,chr3,ZNF197-AS1,chr3:44617128-44624797,7669
107685799,107713162,chr12,PWP1,chr12:107685799-107713162,27363
44648732,44660791,chr3,ZNF35,chr3:44648732-44660791,12059
176526712,176538025,chr5,RNF44,chr5:176526712-176538025,11313
22007638,22087534,chr16,MOSMO,chr16:22007638-22087534,79896
47438044,47440691,chr1,FOXD2,chr1:47438044-47440691,2647
19596979,19658456,chr1,NBL1,chr1:19596979-19658456,61477
31713229,31794869,chr16,ZNF720,chr16:31713229-31794869,81640
138032774,138037266,chr5,FAM13B-AS1,chr5:138032774-138037266,4492
15450133,15521751,chr3,COLQ,chr3:15450133-15521751,71618
43705824,43931165,chr1,ST3GAL3,chr1:43705824-43931165,225341
74916083,74923256,chr17,USH1G,chr17:74916083-74923256,7173
74950742,74973166,chr17,HID1,chr17:74950742-74973166,22424
74987632,75005800,chr17,CDR2L,chr17:74987632-75005800,18168
61590421,61591219,chr17,NACA2,chr17:61590421-61591219,798
74777574,74866966,chr5,FAM169A,chr5:74777574-74866966,89392
134032216,134067936,chr11,LINC02731,chr11:134032216-134067936,35720
115753889,115760646,chr11,LINC00900,chr11:115753889-115760646,6757
3380918,3408981,chr11,TSSC2,chr11:3380918-3408981,28063
85955666,86838904,chr12,MGAT4C,chr12:85955666-86838904,883238
174431571,174487094,chr2,GPR155,chr2:174431571-174487094,55523
192515022,192516573,chr3,FGF12-AS2,chr3:192515022-192516573,1551
48403854,48430086,chr3,PLXNB1,chr3:48403854-48430086,26232
68041130,68110948,chr2,C1D,chr2:68041130-68110948,69818
128691672,128696023,chr11,SENCR,chr11:128691672-128696023,4351
10541258,10599939,chr11,IRAG1-AS1,chr11:10541258-10599939,58681
25004342,25108335,chr12,IRAG2,chr12:25004342-25108335,103993
28956611,29052230,chr2,TOGARAM2,chr2:28956611-29052230,95619
70372246,70398488,chr11,CTTN-DT,chr11:70372246-70398488,26242
65663001,65671718,chr11,RELA-DT,chr11:65663001-65671718,8717
66473490,66480269,chr11,DPP3-DT,chr11:66473490-66480269,6779
45355371,45367577,chr11,LINC02696,chr11:45355371-45367577,12206
30584118,30632583,chr11,MPPED2-AS1,chr11:30584118-30632583,48465
7023050,7030290,chr17,BCL6B,chr17:7023050-7030290,7240
170307722,170335508,chr5,LINC01366,chr5:170307722-170335508,27786
7036015,7040117,chr17,SLC16A13,chr17:7036015-7040117,4102
113056730,113098028,chr12,DTX1,chr12:113056730-113098028,41298
78342338,78360507,chr5,SCAMP1-AS1,chr5:78342338-78360507,18169
118000253,118562199,chr5,LINC02208,chr5:118000253-118562199,561946
177438503,177447982,chr5,PRR7-AS1,chr5:177438503-177447982,9479
11848726,11883750,chr19,ZNF439,chr19:11848726-11883750,35024
91054834,91314547,chr5,LUCAT1,chr5:91054834-91314547,259713
54617158,54638022,chr19,LILRB1,chr19:54617158-54638022,20864
28950807,28967092,chr16,NFATC2IP,chr16:28950807-28967092,16285
117288453,117293578,chr11,BACE1-AS,chr11:117288453-117293578,5125
122028325,122556721,chr11,MIR100HG,chr11:122028325-122556721,528396
72236281,72665014,chr16,LINC01572,chr16:72236281-72665014,428733
37613749,37692337,chr19,ZFP30,chr19:37613749-37692337,78588
142325293,142672001,chr5,SPRY4-AS1,chr5:142325293-142672001,346708
55995167,56003649,chr5,FLJ31104,chr5:55995167-56003649,8482
85694224,85811159,chr11,SYTL2,chr11:85694224-85811159,116935
79715220,79770651,chr16,MAFTRR,chr16:79715220-79770651,55431
9546170,9550725,chr5,SNHG18,chr5:9546170-9550725,4555
89972581,90002161,chr16,AFG3L1P,chr16:89972581-90002161,29580
48688003,48740353,chr3,IP6K2,chr3:48688003-48740353,52350
30354665,30357116,chr16,CD2BP2-DT,chr16:30354665-30357116,2451
1064087,1078731,chr16,SSTR5-AS1,chr16:1064087-1078731,14644
84382424,84490765,chr5,EDIL3-DT,chr5:84382424-84490765,108341
31700558,31711986,chr16,CLUHP3,chr16:31700558-31711986,11428
98726457,99984936,chr12,ANKS1B,chr12:98726457-99984936,1258479
91380349,91612566,chr5,ARRDC3-AS1,chr5:91380349-91612566,232217
148088125,148383907,chr5,FBXO38-DT,chr5:148088125-148383907,295782
53431984,53461862,chr19,ZNF761,chr19:53431984-53461862,29878
127939152,128083172,chr5,LINC01184,chr5:127939152-128083172,144020
57681969,57717301,chr19,ZNF551,chr19:57681969-57717301,35332
57696275,57709204,chr19,ZNF154,chr19:57696275-57709204,12929
1964899,1965509,chr16,SNHG9,chr16:1964899-1965509,610
30875222,30895220,chr16,MIR762HG,chr16:30875222-30895220,19998
2839568,2842744,chr16,PRSS30P,chr16:2839568-2842744,3176
40069152,40090943,chr19,ZNF780A,chr19:40069152-40090943,21791
67001383,67004080,chr5,MAST4-AS1,chr5:67001383-67004080,2697
98929171,98995013,chr5,CHD1-DT,chr5:98929171-98995013,65842
88507546,88691057,chr5,LINC00461,chr5:88507546-88691057,183511
53159213,53193386,chr19,ZNF665,chr19:53159213-53193386,34173
53223973,53224879,chr19,NDUFV2P1,chr19:53223973-53224879,906
112160526,112164818,chr5,EPB41L4A-AS1,chr5:112160526-112164818,4292
25085168,25111555,chr16,LCMT1-AS1,chr16:25085168-25111555,26387
81201341,81301565,chr5,CKMT2-AS1,chr5:81201341-81301565,100224
82626965,83800640,chr16,CDH13,chr16:82626965-83800640,1173675
44072159,44089613,chr19,ZNF284,chr19:44072159-44089613,17454
44094361,44109886,chr19,ZNF224,chr19:44094361-44109886,15525
44112181,44134822,chr19,ZNF225,chr19:44112181-44134822,22641
109999186,110039763,chr12,ANKRD13A,chr12:109999186-110039763,40577
44141554,44160313,chr19,ZNF234,chr19:44141554-44160313,18759
16129126,16141737,chr5,MARCHF11-AS1,chr5:16129126-16141737,12611
88268868,88439337,chr5,TMEM161B-DT,chr5:88268868-88439337,170469
31657912,32077580,chr3,OSBPL10,chr3:31657912-32077580,419668
44259880,44275317,chr19,ZNF233,chr19:44259880-44275317,15437
52694486,52706032,chr3,GLT8D1,chr3:52694486-52706032,11546
111070062,111078026,chr5,TSLP,chr5:111070062-111078026,7964
14774405,14778002,chr12,H2AJ,chr12:14774405-14778002,3597
14784582,14803486,chr12,WBP11,chr12:14784582-14803486,18904
111192226,111193042,chr5,RPS3AP21,chr5:111192226-111193042,816
186789880,186807058,chr3,RFC4,chr3:186789880-186807058,17178
14825569,14843526,chr12,ART4,chr12:14825569-14843526,17957
14880864,14885857,chr12,MGP,chr12:14880864-14885857,4993
7288263,7294639,chr17,YBX2,chr17:7288263-7294639,6376
35731639,35743521,chr17,RASL10B,chr17:35731639-35743521,11882
59296638,59810647,chr1,FGGY,chr1:59296638-59810647,514009
35744511,35753239,chr17,GAS2L2,chr17:35744511-35753239,8728
35756249,35795707,chr17,MMP28,chr17:35756249-35795707,39458
51142299,51153526,chr19,SIGLEC7,chr19:51142299-51153526,11227
35760887,35765079,chr17,C17orf50,chr17:35760887-35765079,4192
146576555,146605346,chr3,PLSCR5,chr3:146576555-146605346,28791
8750381,8769628,chr3,OXTR,chr3:8750381-8769628,19247
51311644,51330891,chr19,IGLON5,chr19:51311644-51330891,19247
51331536,51342139,chr19,VSIG10L,chr19:51331536-51342139,10603
51345169,51366388,chr19,ETFB,chr19:51345169-51366388,21219
51367098,51369003,chr19,CLDND2,chr19:51367098-51369003,1905
35912635,35918010,chr17,LRRC37A9P,chr17:35912635-35918010,5375
4749192,4751590,chr3,EGOT,chr3:4749192-4751590,2398
14365676,14502931,chr12,ATF7IP,chr12:14365676-14502931,137255
47379089,47380999,chr3,PTPN23-DT,chr3:47379089-47380999,1910
29573475,29594054,chr17,GIT1,chr17:29573475-29594054,20579
54216278,54223506,chr19,LILRB3,chr19:54216278-54223506,7228
110637528,110678063,chr2,BUB1,chr2:110637528-110678063,40535
120640626,120667324,chr12,CABP1,chr12:120640626-120667324,26698
28755980,28855232,chr17,FAM222B,chr17:28755980-28855232,99252
28950513,29057216,chr17,PIPOX,chr17:28950513-29057216,106703
54415219,54436904,chr19,TTYH1,chr19:54415219-54436904,21685
158105855,158545730,chr3,RSRC1,chr3:158105855-158545730,439875
111098345,111116407,chr2,ACOXL-AS1,chr2:111098345-111116407,18062
19910263,19990105,chr2,WDR35,chr2:19910263-19990105,79842
58228594,58277495,chr19,ZNF544,chr19:58228594-58277495,48901
48241100,48299253,chr3,ZNF589,chr3:48241100-48299253,58153
48256350,48256938,chr3,MRPS18AP1,chr3:48256350-48256938,588
48372219,48401259,chr3,FBXW12,chr3:48372219-48401259,29040
101802560,101996926,chr1,OLFM3,chr1:101802560-101996926,194366
50358477,50365830,chr19,NAPSA,chr19:50358477-50365830,7353
2586491,2591469,chr1,PRXL2B,chr1:2586491-2591469,4978
50432892,50466321,chr19,MYBPC2,chr19:50432892-50466321,33429
69013176,69249327,chr2,ANTXR1,chr2:69013176-69249327,236151
49188736,49274600,chr12,TUBA1C,chr12:49188736-49274600,85864
9621249,9674662,chr19,ZNF561-AS1,chr19:9621249-9674662,53413
142596393,142713664,chr3,PLS1,chr3:142596393-142713664,117271
82371765,82377458,chr17,UTS2R,chr17:82371765-82377458,5693
12019466,12032045,chr1,MIIP,chr1:12019466-12032045,12579
142815922,142889206,chr3,PCOLCE2,chr3:142815922-142889206,73284
5680604,5688523,chr19,HSD11B1L,chr19:5680604-5688523,7919
43758944,43789543,chr12,IRAK4,chr12:43758944-43789543,30599
48762234,48817229,chr17,TTLL6,chr17:48762234-48817229,54995
32862268,32872482,chr1,FNDC5,chr1:32862268-32872482,10214
32885994,32898441,chr1,HPCA,chr1:32885994-32898441,12447
4269259,4366675,chr17,UBE2G1,chr17:4269259-4366675,97416
32894594,32901438,chr1,TMEM54,chr1:32894594-32901438,6844
36165683,36176636,chr17,TBC1D3B,chr17:36165683-36176636,10953
7921859,7929856,chr17,KCNAB3,chr17:7921859-7929856,7997
161171310,161177968,chr1,B4GALT3,chr1:161171310-161177968,6658
161184302,161199054,chr1,ADAMTS4,chr1:161184302-161199054,14752
5805067,5828324,chr19,NRTN,chr19:5805067-5828324,23257
5842888,5851471,chr19,FUT3,chr19:5842888-5851471,8583
9731729,9748019,chr3,BRPF1,chr3:9731729-9748019,16290
74466399,74484794,chr17,CD300A,chr17:74466399-74484794,18395
4174109,4182566,chr19,SIRT6,chr19:4174109-4182566,8457
82078338,82098294,chr17,FASN,chr17:82078338-82098294,19956
46201711,46208313,chr3,CCR1,chr3:46201711-46208313,6602
45823316,45916042,chr3,LZTFL1,chr3:45823316-45916042,92726
53157663,53180925,chr12,CSAD,chr12:53157663-53180925,23262
46016990,46085825,chr3,XCR1,chr3:46016990-46085825,68835
55882301,56517016,chr17,ANKFN1,chr17:55882301-56517016,634715
9933793,9945413,chr3,CRELD1,chr3:9933793-9945413,11620
6988259,7071032,chr12,C1S,chr12:6988259-7071032,82773
64094379,64171342,chr1,ROR1-AS1,chr1:64094379-64171342,76963
11980181,12015211,chr1,MFN2,chr1:11980181-12015211,35030
6865557,6898239,chr2,RSAD2,chr2:6865557-6898239,32682
6917412,7068286,chr2,RNF144A,chr2:6917412-7068286,150874
12287368,12434356,chr3,PPARG,chr3:12287368-12434356,146988
1285873,1301431,chr19,EFNA2,chr19:1285873-1301431,15558
12995475,13098796,chr19,NFIX,chr19:12995475-13098796,103321
40256427,40257967,chr1,ZMPSTE24-DT,chr1:40256427-40257967,1540
40300489,40317813,chr1,COL9A2,chr1:40300489-40317813,17324
95217746,95302799,chr12,VEZT,chr12:95217746-95302799,85053
151357592,151380046,chr2,TNFAIP6,chr2:151357592-151380046,22454
151409883,151508013,chr2,RIF1,chr2:151409883-151508013,98130
53156009,53192717,chr3,PRKCD,chr3:53156009-53192717,36708
15704232,15704900,chr17,UBE2SP1,chr17:15704232-15704900,668
25861484,25875708,chr1,PAQR7,chr1:25861484-25875708,14224
52232520,52252186,chr12,KRT7,chr12:52232520-52252186,19666
68808177,68845544,chr12,MDM2,chr12:68808177-68845544,37367
30906344,30959322,chr17,ADAP2,chr17:30906344-30959322,52978
96593170,96642787,chr2,KANSL3,chr2:96593170-96642787,49617
44674692,44725591,chr1,ARMH1,chr1:44674692-44725591,50899
30970984,30999911,chr17,RNF135,chr17:30970984-30999911,28927
44731055,44731170,chr1,RNU5D-1,chr1:44731055-44731170,115
68974488,69060949,chr17,ABCA9,chr17:68974488-69060949,86461
53328963,53813733,chr3,CACNA1D,chr3:53328963-53813733,484770
69078702,69141895,chr17,ABCA6,chr17:69078702-69141895,63193
69147214,69244846,chr17,ABCA10,chr17:69147214-69244846,97632
12163064,12189871,chr19,ZNF136,chr19:12163064-12189871,26807
96812239,96813657,chr2,CNNM3-DT,chr2:96812239-96813657,1418
43596617,43614498,chr19,SRRM5,chr19:43596617-43614498,17881
35410922,35433283,chr17,SLFN12,chr17:35410922-35433283,22361
96859718,96870757,chr2,SEMA4C,chr2:96859718-96870757,11039
35435096,35448837,chr17,SLFN13,chr17:35435096-35448837,13741
104215779,104350307,chr12,TXNRD1,chr12:104215779-104350307,134528
35350305,35373701,chr17,SLFN11,chr17:35350305-35373701,23396
7304072,7328719,chr12,ACSM4,chr12:7304072-7328719,24647
109116587,109268226,chr12,ACACB,chr12:109116587-109268226,151639
237858893,237912106,chr2,RAMP1,chr2:237858893-237912106,53213
6579994,6589280,chr1,ZBTB48,chr1:6579994-6589280,9286
222671658,222709930,chr2,MOGAT1,chr2:222671658-222709930,38272
222860942,222944639,chr2,ACSL3,chr2:222860942-222944639,83697
49928702,49933935,chr19,ATF5,chr19:49928702-49933935,5233
22563489,22603595,chr1,EPHA8,chr1:22563489-22603595,40106
41626327,41640199,chr17,KRT42P,chr17:41626327-41640199,13872
12675717,12681880,chr19,DHPS,chr19:12675717-12681880,6163
236549005,236604516,chr1,HEATR1,chr1:236549005-236604516,55511
192139390,192767764,chr3,FGF12,chr3:192139390-192767764,628374
74326210,74355820,chr17,KIF19,chr17:74326210-74355820,29610
39829716,39829802,chr19,MIR6719,chr19:39829716-39829802,86
130337887,130372637,chr12,PIWIL1,chr12:130337887-130372637,34750
78971238,78979947,chr17,LGALS3BP,chr17:78971238-78979947,8709
124905442,124953819,chr3,MUC13,chr3:124905442-124953819,48377
74361154,74392087,chr2,DCTN1,chr2:74361154-74392087,30933
16974502,16980632,chr1,MFAP2,chr1:16974502-16980632,6130
12064731,12081565,chr19,ZNF844,chr19:12064731-12081565,16834
16985958,17011928,chr1,ATP13A2,chr1:16985958-17011928,25970
46633953,46636541,chr19,GNG8,chr19:46633953-46636541,2588
79089345,79611051,chr17,RBFOX3,chr17:79089345-79611051,521706
36850361,36913029,chr19,ZNF345,chr19:36850361-36913029,62668
130396133,130768228,chr12,RIMBP2,chr12:130396133-130768228,372095
79730943,79742219,chr17,ENPP7,chr17:79730943-79742219,11276
8474207,8631376,chr17,MYH10,chr17:8474207-8631376,157169
85580761,85584589,chr1,CCN1,chr1:85580761-85584589,3828
222522258,222548104,chr1,HHIPL2,chr1:222522258-222548104,25846
222557902,222589933,chr1,TAF1A,chr1:222557902-222589933,32031
121648742,121672631,chr12,MORN3,chr12:121648742-121672631,23889
47778677,47784686,chr19,SELENOW,chr19:47778677-47784686,6009
222668013,222713210,chr1,AIDA,chr1:222668013-222713210,45197
124033369,124726325,chr3,KALRN,chr3:124033369-124726325,692956
61476032,61538741,chr2,XPO1,chr2:61476032-61538741,62709
42846573,42852477,chr1,ZNF691,chr1:42846573-42852477,5904
125827238,125916384,chr3,LINC02614,chr3:125827238-125916384,89146
56439325,56478065,chr19,ZNF667,chr19:56439325-56478065,38740
222815022,223005995,chr1,DISP1,chr1:222815022-223005995,190973
121431431,121545988,chr3,POLQ,chr3:121431431-121545988,114557
121593379,121630295,chr3,FBXO40,chr3:121593379-121630295,36916
119648411,119744218,chr1,PHGDH,chr1:119648411-119744218,95807
50329782,50340980,chr3,RASSF1,chr3:50329782-50340980,11198
51991332,52008230,chr19,ZNF615,chr19:51991332-52008230,16898
120210439,120265771,chr12,PXN,chr12:120210439-120265771,55332
165857475,165953851,chr2,TTC21B,chr2:165857475-165953851,96376
156840063,156859117,chr1,INSRR,chr1:156840063-156859117,19054
96678874,96679620,chr1,RPL7P9,chr1:96678874-96679620,746
120282303,120282716,chr12,NME2P1,chr12:120282303-120282716,413
990509,1495933,chr12,ERC1,chr12:990509-1495933,505424
201387858,201480846,chr2,STRADB,chr2:201387858-201480846,92988
36604817,36634114,chr19,ZNF382,chr19:36604817-36634114,29297
201487421,201619178,chr2,C2CD6,chr2:201487421-201619178,131757
26120030,26125037,chr12,BHLHE41,chr12:26120030-26125037,5007
25958232,26079892,chr12,RASSF8,chr12:25958232-26079892,121660
31272013,31297539,chr17,OMG,chr17:31272013-31297539,25526
201644870,201698694,chr2,MPP4,chr2:201644870-201698694,53824
40393395,40570832,chr12,MUC19,chr12:40393395-40570832,177437
29337352,29381189,chr12,ERGIC2,chr12:29337352-29381189,43837
29412474,29497686,chr12,OVCH1,chr12:29412474-29497686,85212
8322584,8343262,chr19,KANK3,chr19:8322584-8343262,20678
6057807,6124427,chr17,WSCD1,chr17:6057807-6124427,66620
9752486,9760901,chr12,CD69,chr12:9752486-9760901,8415
201700267,201782112,chr2,ALS2,chr2:201700267-201782112,81845
50188186,50310542,chr19,MYH14,chr19:50188186-50310542,122356
4493345,4847506,chr3,ITPR1,chr3:4493345-4847506,354161
45435900,45490749,chr17,PLEKHM1,chr17:45435900-45490749,54849
60443158,60526242,chr17,APPBP2,chr17:60443158-60526242,83084
153974269,153977674,chr1,JTB,chr1:153974269-153977674,3405
45393902,45434421,chr17,ARHGAP27,chr17:45393902-45434421,40519
85249953,85259672,chr1,C1orf52,chr1:85249953-85259672,9719
85265776,85276632,chr1,BCL10,chr1:85265776-85276632,10856
67825503,67984378,chr17,BPTF,chr17:67825503-67984378,158875
132918306,132956306,chr12,ZNF605,chr12:132918306-132956306,38000
50723364,50725708,chr19,CLEC11A,chr19:50723364-50725708,2344
3857267,3885429,chr1,DFFB,chr1:3857267-3885429,28162
40466241,40576464,chr19,SPTBN4,chr19:40466241-40576464,110223
16342534,16353656,chr17,CENPV,chr17:16342534-16353656,11122
184385753,184386704,chr1,C1orf21-DT,chr1:184385753-184386704,951
23281307,23287488,chr1,LINC01355,chr1:23281307-23287488,6181
31382226,31591136,chr12,DENND5B,chr12:31382226-31591136,208910
161505430,161524013,chr1,FCGR2A,chr1:161505430-161524013,18583
110672465,110674940,chr1,KCNA3,chr1:110672465-110674940,2475
244048939,244057476,chr1,ZBTB18,chr1:244048939-244057476,8537
43766533,43780976,chr19,KCNN4,chr19:43766533-43780976,14443
41930617,41966503,chr17,ODAD4,chr17:41930617-41966503,35886
24943636,24972094,chr2,DNAJC27,chr2:24943636-24972094,28458
23914876,23945159,chr19,ZNF726,chr19:23914876-23945159,30283
188153284,188890671,chr3,LPP,chr3:188153284-188890671,737387
867630,893218,chr19,MED16,chr19:867630-893218,25588
155586644,155602197,chr1,DAP3P1,chr1:155586644-155602197,15553
127701027,127811187,chr2,WDR33,chr2:127701027-127811187,110160
113098819,113136239,chr12,RASAL1,chr12:113098819-113136239,37420
155308748,155320666,chr1,FDPS,chr1:155308748-155320666,11918
127941217,128028120,chr2,SAP130,chr2:127941217-128028120,86903
36636618,36666853,chr19,ZNF461,chr19:36636618-36666853,30235
42011382,42025644,chr17,NKIRAS2,chr17:42011382-42025644,14262
57253762,57431043,chr12,R3HDM2,chr12:57253762-57431043,177281
113157325,113209396,chr2,PSD4,chr2:113157325-113209396,52071
42038232,42050601,chr17,C17orf113,chr17:42038232-42050601,12369
113211421,113276581,chr2,PAX8-AS1,chr2:113211421-113276581,65160
113215997,113278921,chr2,PAX8,chr2:113215997-113278921,62924
42025576,42098479,chr17,ZNF385C,chr17:42025576-42098479,72903
143875171,143904650,chr1,H2BP2,chr1:143875171-143904650,29479
57234903,57240715,chr12,NDUFA4L2,chr12:57234903-57240715,5812
113211003,113287459,chr3,BOC,chr3:113211003-113287459,76456
60600193,60666280,chr17,PPM1D,chr17:60600193-60666280,66087
215005775,215237090,chr1,KCNK2,chr1:215005775-215237090,231315
56316223,56334053,chr12,PAN2,chr12:56316223-56334053,17830
55231903,55235853,chr2,RPS27A,chr2:55231903-55235853,3950
25597984,25664907,chr3,TOP2B,chr3:25597984-25664907,66923
108288639,108309915,chr2,SULT1C2,chr2:108288639-108309915,21276
65528563,65561648,chr17,AXIN2,chr17:65528563-65561648,33085
27332836,27425289,chr12,ARNTL2,chr12:27332836-27425289,92453
167478684,167653983,chr3,WDR49,chr3:167478684-167653983,175299
39863323,39934626,chr19,FCGBP,chr19:39863323-39934626,71303
43172330,43254358,chr1,CFAP57,chr1:43172330-43254358,82028
191678068,191741097,chr2,NABP1,chr2:191678068-191741097,63029
41998321,42070206,chr19,GRIK5,chr19:41998321-42070206,71885
91984976,92142914,chr12,LINC01619,chr12:91984976-92142914,157938
98512973,98516422,chr12,TMPO-AS1,chr12:98512973-98516422,3449
4247981,4276252,chr12,CCND2-AS1,chr12:4247981-4276252,28271
15667236,15859771,chr3,ANKRD28,chr3:15667236-15859771,192535
14147743,14206187,chr19,ADGRL1,chr19:14147743-14206187,58444
65589111,65614169,chr12,LINC02454,chr12:65589111-65614169,25058
77695987,77759852,chr1,USP33,chr1:77695987-77759852,63865
53013921,53016123,chr19,ERVV-1,chr19:53013921-53016123,2202
69319780,69387250,chr2,GFPT1,chr2:69319780-69387250,67470
2740047,2746665,chr12,LINC02371,chr12:2740047-2746665,6618
69457997,69674349,chr2,AAK1,chr2:69457997-69674349,216352
12789498,12991643,chr17,ARHGAP44,chr17:12789498-12991643,202145
148644440,148787569,chr2,EPC2,chr2:148644440-148787569,143129
3871579,3910384,chr12,PARP11-AS1,chr12:3871579-3910384,38805
55729094,55730857,chr12,CD63-AS1,chr12:55729094-55730857,1763
31019434,31073847,chr12,DDX11-AS1,chr12:31019434-31073847,54413
120488079,120495946,chr12,NRAV,chr12:120488079-120495946,7867
38319845,38332076,chr19,KCNK6,chr19:38319845-38332076,12231
54126053,54147485,chr12,LINC02381,chr12:54126053-54147485,21432
1517718,1562792,chr17,PITPNA,chr17:1517718-1562792,45074
13862063,13880757,chr19,NANOS3,chr19:13862063-13880757,18694
1782075,1812276,chr19,ATP8B3,chr19:1782075-1812276,30201
47706058,47742294,chr12,RPAP3-DT,chr12:47706058-47742294,36236
18327860,18363563,chr17,SHMT1,chr17:18327860-18363563,35703
149038107,149215262,chr2,LYPD6B,chr2:149038107-149215262,177155
48998367,49019241,chr12,DDN-AS1,chr12:48998367-49019241,20874
149329985,149474138,chr2,LYPD6,chr2:149329985-149474138,144153
149569637,149587778,chr2,MMADHC,chr2:149569637-149587778,18141
129249606,129277773,chr3,COPG1,chr3:129249606-129277773,28167
6460786,6466175,chr1,TNFRSF25,chr1:6460786-6466175,5389
9715860,9733299,chr12,CLECL1,chr12:9715860-9733299,17439
129315392,129326225,chr3,H1-10-AS1,chr3:129315392-129326225,10833
129430947,129440179,chr3,MBD4,chr3:129430947-129440179,9232
129555214,129606676,chr3,PLXND1,chr3:129555214-129606676,51462
11237450,11241943,chr19,ANGPTL8,chr19:11237450-11241943,4493
13795443,13832254,chr19,ZSWIM4,chr19:13795443-13832254,36811
23762944,23871162,chr19,RPSAP58,chr19:23762944-23871162,108218
74549026,74557551,chr2,DOK1,chr2:74549026-74557551,8525
110211529,110245420,chr2,MTLN,chr2:110211529-110245420,33891
5158495,5340812,chr19,PTPRS,chr19:5158495-5340812,182317
63773603,63819317,chr17,DDX42,chr17:63773603-63819317,45714
58544064,58550722,chr19,TRIM28,chr19:58544064-58550722,6658
166839447,166856359,chr1,POGK,chr1:166839447-166856359,16912
44421127,44439946,chr3,C3orf86,chr3:44421127-44439946,18819
36003307,36008813,chr19,SYNE4,chr19:36003307-36008813,5506
205336061,205357090,chr1,KLHDC8A,chr1:205336061-205357090,21029
42086110,42196585,chr19,POU2F2,chr19:42086110-42196585,110475
77888513,77943895,chr1,NEXN,chr1:77888513-77943895,55382
185959943,185980872,chr3,NMRAL2P,chr3:185959943-185980872,20929
69739456,69968336,chr3,MITF,chr3:69739456-69968336,228880
102311529,102398777,chr2,IL18R1,chr2:102311529-102398777,87248
77944055,77979110,chr1,FUBP1,chr1:77944055-77979110,35055
132147591,132257969,chr2,ANKRD30BL,chr2:132147591-132257969,110378
31865060,32011230,chr2,MEMO1,chr2:31865060-32011230,146170
72129238,72147862,chr2,CYP26B1,chr2:72129238-72147862,18624
17601336,17688365,chr19,UNC13A,chr19:17601336-17688365,87029
200899020,200899121,chr2,RNU6-762P,chr2:200899020-200899121,101
16029157,16218185,chr17,NCOR1,chr17:16029157-16218185,189028
201182898,201229406,chr2,CASP10,chr2:201182898-201229406,46508
17794828,17813576,chr19,B3GNT3,chr19:17794828-17813576,18748
17816512,17821574,chr19,INSL3,chr19:17816512-17821574,5062
167430640,167518610,chr1,CD247,chr1:167430640-167518610,87970
172464262,172466022,chr2,ITGA6-AS1,chr2:172464262-172466022,1760
43637260,43767987,chr2,PLEKHH2,chr2:43637260-43767987,130727
6467122,6520074,chr1,PLEKHG5,chr1:6467122-6520074,52952
202912214,202988263,chr2,CARF,chr2:202912214-202988263,76049
18442663,18522116,chr19,ELL,chr19:18442663-18522116,79453
37312837,37369365,chr19,ZNF875,chr19:37312837-37369365,56528
178094104,178484147,chr1,RASAL2,chr1:178094104-178484147,390043
52594060,52690504,chr19,ZNF83,chr19:52594060-52690504,96444
17951293,18000085,chr19,KCNN1,chr19:17951293-18000085,48792
57599885,57612722,chr19,ZNF530,chr19:57599885-57612722,12837
51804816,51890950,chr19,ZNF577,chr19:51804816-51890950,86134
131533555,132285410,chr3,CPNE4,chr3:131533555-132285410,751855
1409096,1410618,chr1,MRPL20-DT,chr1:1409096-1410618,1522
1430539,1434573,chr1,LINC01770,chr1:1430539-1434573,4034
1434861,1442882,chr1,VWA1,chr1:1434861-1442882,8021
1449689,1470163,chr1,ATAD3C,chr1:1449689-1470163,20474
43506719,43527230,chr19,ETHE1,chr19:43506719-43527230,20511
43525497,43536130,chr19,ZNF575,chr19:43525497-43536130,10633
47349315,47382704,chr19,DHX34,chr19:47349315-47382704,33389
19882395,19912945,chr1,OTUD3,chr1:19882395-19912945,30550
47403124,47419527,chr19,MEIS3,chr19:47403124-47419527,16403
108296490,108378285,chr3,HHLA2,chr3:108296490-108378285,81795
47428017,47471893,chr19,SLC8A2,chr19:47428017-47471893,43876
47475150,47484265,chr19,KPTN,chr19:47475150-47484265,9115
86020216,86106155,chr2,POLR1A,chr2:86020216-86106155,85939
43933320,43937240,chr1,ARTN,chr1:43933320-43937240,3920
73165010,73176633,chr17,SSTR2,chr17:73165010-73176633,11623
127629185,127672802,chr3,PODXL2,chr3:127629185-127672802,43617
181457202,181538940,chr2,ITGA4,chr2:181457202-181538940,81738
43974487,43978295,chr1,ATP6V0B,chr1:43974487-43978295,3808
73283624,73312005,chr17,CDC42EP4,chr17:73283624-73312005,28381
73207353,73236753,chr17,FAM104A,chr17:73207353-73236753,29400
88364695,88365608,chr2,MRPL45P1,chr2:88364695-88365608,913
88446787,88452693,chr2,FOXI3,chr2:88446787-88452693,5906
121631399,121660927,chr3,HCLS1,chr3:121631399-121660927,29528
88857161,88857683,chr2,IGKC,chr2:88857161-88857683,522
43991500,44031467,chr1,SLC6A9,chr1:43991500-44031467,39967
88860568,88860605,chr2,IGKJ5,chr2:88860568-88860605,37
88860886,88860922,chr2,IGKJ4,chr2:88860886-88860922,36
88861886,88861923,chr2,IGKJ1,chr2:88861886-88861923,37
69829660,69881384,chr2,GMCL1,chr2:69829660-69881384,51724
69893956,69905575,chr2,SNRNP27,chr2:69893956-69905575,11619
121769761,121835079,chr3,IQCB1,chr3:121769761-121835079,65318
70087477,70089203,chr2,PCBP1,chr2:70087477-70089203,1726
121835183,121886526,chr3,EAF2,chr3:121835183-121886526,51343
121894401,121944188,chr3,SLC15A2,chr3:121894401-121944188,49787
121663199,121749755,chr3,GOLGB1,chr3:121663199-121749755,86556
1598012,1600135,chr1,FNDC10,chr1:1598012-1600135,2123
1632163,1635263,chr1,MMP23B,chr1:1632163-1635263,3100
1659529,1692795,chr1,SLC35E2B,chr1:1659529-1692795,33266
1699942,1701782,chr1,MMP23A,chr1:1699942-1701782,1840
7717744,7833742,chr17,DNAH2,chr17:7717744-7833742,115998
123610049,123884332,chr3,MYLK,chr3:123610049-123884332,274283
171517270,171517716,chr2,RPS15P4,chr2:171517270-171517716,446
36111143,36113711,chr19,OVOL3,chr19:36111143-36113711,2568
1228287,1238027,chr19,CBARP,chr19:1228287-1238027,9740
72645949,73092712,chr17,SLC39A11,chr17:72645949-73092712,446763
52904415,52923470,chr19,ZNF888,chr19:52904415-52923470,19055
54094668,54102692,chr19,OSCAR,chr19:54094668-54102692,8024
133573686,133590261,chr3,CDV3,chr3:133573686-133590261,16575
1751232,1780457,chr1,NADK,chr1:1751232-1780457,29225
1785285,1891117,chr1,GNB1,chr1:1785285-1891117,105832
158095905,158106420,chr3,SHOX2,chr3:158095905-158106420,10515
193274789,193378820,chr3,ATP13A5,chr3:193274789-193378820,104031
39679374,39686373,chr19,LGALS17A,chr19:39679374-39686373,6999
16174680,16231992,chr3,GALNT15,chr3:16174680-16231992,57312
19757366,19776423,chr19,LINC00663,chr19:19757366-19776423,19057
43952733,44004469,chr17,PYY,chr17:43952733-44004469,51736
206684905,206734281,chr1,MAPKAPK2,chr1:206684905-206734281,49376
38671703,38674957,chr17,EPOP,chr17:38671703-38674957,3254
38705273,38729795,chr17,MLLT6,chr17:38705273-38729795,24522
38730341,38735605,chr17,CISD3,chr17:38730341-38735605,5264
38733898,38749817,chr17,PCGF2,chr17:38733898-38749817,15919
206897443,206904139,chr1,IL24,chr1:206897443-206904139,6696
38765691,38800126,chr17,PIP4K2B,chr17:38765691-38800126,34435
19776586,19836193,chr19,ZNF56P,chr19:19776586-19836193,59607
38800441,38825355,chr17,CWC25,chr17:38800441-38825355,24914
41535183,41536904,chr19,LINC01480,chr19:41535183-41536904,1721
113716458,113746300,chr3,NAA50,chr3:113716458-113746300,29842
63523334,63548977,chr17,KCNH6,chr17:63523334-63548977,25643
207018522,207032756,chr1,C1orf116,chr1:207018522-207032756,14234
36573070,36594712,chr19,ZNF529-AS1,chr19:36573070-36594712,21642
31576485,31587686,chr1,TINAGL1,chr1:31576485-31587686,11201
31629866,31644896,chr1,PEF1,chr1:31629866-31644896,15030
52368677,52369244,chr1,PLA2G12AP1,chr1:52368677-52369244,567
52372829,52404423,chr1,ORC1,chr1:52372829-52404423,31594
176099795,176102489,chr2,HOXD12,chr2:176099795-176102489,2694
176108790,176119937,chr2,HOXD10,chr2:176108790-176119937,11147
20340262,20424978,chr19,ZNF826P,chr19:20340262-20424978,84716
176129694,176132695,chr2,HOXD8,chr2:176129694-176132695,3001
176151550,176153226,chr2,HOXD4,chr2:176151550-176153226,1676
176164051,176188958,chr2,HAGLR,chr2:176164051-176188958,24907
23399097,23416075,chr19,LINC01224,chr19:23399097-23416075,16978
225982702,225999343,chr1,SDE2,chr1:225982702-225999343,16641
226045561,226061898,chr1,H3-3A-DT,chr1:226045561-226061898,16337
99337371,99401326,chr2,EIF5B,chr2:99337371-99401326,63955
226144679,226186741,chr1,ACBD3,chr1:226144679-226186741,42062
224175756,224193441,chr1,DEGS1,chr1:224175756-224193441,17685
171600404,171810950,chr3,PLD1,chr3:171600404-171810950,210546
224227334,224330189,chr1,NVL,chr1:224227334-224330189,102855
75587800,75626849,chr17,MYO15B,chr17:75587800-75626849,39049
99545419,100192428,chr2,AFF3,chr2:99545419-100192428,647009
100391860,100417668,chr2,CHST10,chr2:100391860-100417668,25808
39678648,39691485,chr1,HPCAL4,chr1:39678648-39691485,12837
150600851,150629612,chr1,ENSA,chr1:150600851-150629612,28761
189674290,189761193,chr2,ANKAR,chr2:189674290-189761193,86903
135531455,135725270,chr2,R3HDM1,chr2:135531455-135725270,193815
126524155,126543291,chr3,CHST13,chr3:126524155-126543291,19136
150800473,150801031,chr1,UBE2D3P3,chr1:150800473-150801031,558
150560895,150579738,chr1,MCL1,chr1:150560895-150579738,18843
226731312,226799820,chr2,IRS1,chr2:226731312-226799820,68508
73805754,73902960,chr3,LINC02005,chr3:73805754-73902960,97206
75214631,75215636,chr3,HNRNPA3P6,chr3:75214631-75215636,1005
227221052,227325711,chr2,MFF-DT,chr2:227221052-227325711,104659
227325151,227357836,chr2,MFF,chr2:227325151-227357836,32685
228114997,228115473,chr1,CIAO2AP2,chr1:228114997-228115473,476
228165804,228182257,chr1,IBA57,chr1:228165804-228182257,16453
119579268,119589945,chr3,ADPRH,chr3:119579268-119589945,10677
227472152,227561217,chr2,AGFG1,chr2:227472152-227561217,89065
68101874,68161227,chr17,LINC00674,chr17:68101874-68161227,59353
25822469,25822950,chr2,PTGES3P2,chr2:25822469-25822950,481
43338741,43389226,chr17,LINC00910,chr17:43338741-43389226,50485
6853861,6954107,chr17,ALOX12P2,chr17:6853861-6954107,100246
26173088,26189663,chr2,GAREM2,chr2:26173088-26189663,16575
43938257,43938963,chr17,LINC01976,chr17:43938257-43938963,706
24496254,24535400,chr1,RCAN3AS,chr1:24496254-24535400,39146
58776845,58784048,chr1,JUN,chr1:58776845-58784048,7203
66133610,66388116,chr3,SLC25A26,chr3:66133610-66388116,254506
21428263,21574517,chr17,LINC02693,chr17:21428263-21574517,146254
224385146,224437033,chr1,WDR26,chr1:224385146-224437033,51887
32179675,32198285,chr1,TXLNA,chr1:32179675-32198285,18610
227002714,227164453,chr2,COL4A4,chr2:227002714-227164453,161739
241809065,241817413,chr2,NEU4,chr2:241809065-241817413,8348
8220624,8224043,chr17,LINC00324,chr17:8220624-8224043,3419
64145958,64146476,chr17,SNHG25,chr17:64145958-64146476,518
241849884,241858894,chr2,PDCD1,chr2:241849884-241858894,9010
241970683,241977276,chr2,LINC01238,chr2:241970683-241977276,6593
237324003,237414328,chr2,COL6A3,chr2:237324003-237414328,90325
60526272,60550798,chr17,APPBP2-DT,chr17:60526272-60550798,24526
331205,333488,chr17,RPH3AL-AS1,chr17:331205-333488,2283
184115352,184117898,chr3,HSP90AA5P,chr3:184115352-184117898,2546
184134019,184135238,chr3,EIF2B5-DT,chr3:184134019-184135238,1219
47527008,47535199,chr2,MSH2-OT1,chr2:47527008-47535199,8191
47789316,47906498,chr2,FBXO11,chr2:47789316-47906498,117182
220832763,220880140,chr1,HLX-AS1,chr1:220832763-220880140,47377
220879431,220885059,chr1,HLX,chr1:220879431-220885059,5628
88556741,88691518,chr2,EIF2AK3,chr2:88556741-88691518,134777
184155377,184173614,chr3,DVL3,chr3:184155377-184173614,18237
220690363,220699153,chr1,C1orf115,chr1:220690363-220699153,8790
173824653,173858808,chr1,DARS2,chr1:173824653-173858808,34155
181535041,181680665,chr2,CERKL,chr2:181535041-181680665,145624
181668295,181680827,chr2,NEUROD1,chr2:181668295-181680827,12532
226668897,226676345,chr1,ITPKB-AS1,chr1:226668897-226676345,7448
170037995,170085392,chr3,GPR160,chr3:170037995-170085392,47397
161037631,161038977,chr1,TSTD1,chr1:161037631-161038977,1346
170057301,170057429,chr3,RNU4-38P,chr3:170057301-170057429,128
173880850,173965373,chr2,SP3,chr2:173880850-173965373,84523
161046946,161069970,chr1,ARHGAP30,chr1:161046946-161069970,23024
161070998,161089558,chr1,NECTIN4,chr1:161070998-161089558,18560
161098361,161100346,chr1,KLHDC9,chr1:161098361-161100346,1985
150408298,150466422,chr3,TSC22D2,chr3:150408298-150466422,58124
43286512,43424764,chr3,SNRK,chr3:43286512-43424764,138252
43079229,43106085,chr3,POMGNT2,chr3:43079229-43106085,26856
11272309,11557665,chr3,ATG7,chr3:11272309-11557665,285356
208359714,208854503,chr2,PTH2R,chr2:208359714-208854503,494789
111117163,111140203,chr1,DRAM2,chr1:111117163-111140203,23040
96122818,96138502,chr2,ASTL,chr2:96122818-96138502,15684
154402328,154406564,chr1,IL6R-AS1,chr1:154402328-154406564,4236
154405193,154469450,chr1,IL6R,chr1:154405193-154469450,64257
226360210,226408154,chr1,PARP1,chr1:226360210-226408154,47944
101827991,101861022,chr3,NFKBIZ,chr3:101827991-101861022,33031
49803261,49805030,chr3,INKA1,chr3:49803261-49805030,1769
49887002,49903873,chr3,MST1R,chr3:49887002-49903873,16871
45620044,45624057,chr1,CCDC17,chr1:45620044-45624057,4013
89085177,89085787,chr2,IGKV3-15,chr2:89085177-89085787,610
90114838,90115402,chr2,IGKV3D-15,chr2:90114838-90115402,564
74557883,74648338,chr2,M1AP,chr2:74557883-74648338,90455
124025287,124921219,chr2,CNTNAP5,chr2:124025287-124921219,895932
203014608,203226378,chr2,NBEAL1,chr2:203014608-203226378,211770
122384161,122412334,chr3,FAM162A,chr3:122384161-122412334,28173
181954241,182131398,chr2,PPP1R1C,chr2:181954241-182131398,177157
127298668,127388465,chr2,MAP3K2,chr2:127298668-127388465,89797
67407810,67430415,chr1,SERBP1,chr1:67407810-67430415,22605
218034960,218090581,chr2,RUFY4,chr2:218034960-218090581,55621
24491254,24770702,chr2,NCOA1,chr2:24491254-24770702,279448
98782188,98783193,chr3,PDLIM1P4,chr3:98782188-98783193,1005
98795941,98901695,chr3,DCBLD2,chr3:98795941-98901695,105754
209424047,209734118,chr2,MAP2,chr2:209424047-209734118,310071
247099962,247104372,chr1,ZNF669,chr1:247099962-247104372,4410
101686827,101713301,chr3,PDCL3P4,chr3:101686827-101713301,26474
193012250,193060080,chr1,UCHL5,chr1:193012250-193060080,47830
200973718,201071671,chr2,FAM126B,chr2:200973718-201071671,97953
138608606,138633376,chr3,FAIM,chr3:138608606-138633376,24770
65353525,66038918,chr3,MAGI1,chr3:65353525-66038918,685393
127436207,127526886,chr2,IWS1,chr2:127436207-127526886,90679
127638381,127681786,chr2,LIMS2,chr2:127638381-127681786,43405
3772749,3775982,chr1,SMIM1,chr1:3772749-3775982,3233
56994778,58546734,chr1,DAB1,chr1:56994778-58546734,1551956
73385758,73625166,chr2,ALMS1,chr2:73385758-73625166,239408
239048168,239401654,chr2,HDAC4,chr2:239048168-239401654,353486
192636138,192660311,chr1,RGS13,chr1:192636138-192660311,24173
8852690,9003709,chr2,MBOAT2,chr2:8852690-9003709,151019
58717365,59050084,chr3,CFAP20DC,chr3:58717365-59050084,332719
128909866,129002690,chr3,CFAP92,chr3:128909866-129002690,92824
165724293,165827755,chr1,TMCO1,chr1:165724293-165827755,103462
46370946,46376206,chr3,CCR5,chr3:46370946-46376206,5260
4303332,4317265,chr3,SETMAR,chr3:4303332-4317265,13933
158962235,159897629,chr3,IQCJ-SCHIP1,chr3:158962235-159897629,935394
1635225,1659012,chr1,CDK11B,chr1:1635225-1659012,23787
128462437,128466968,chr3,DNAJB8,chr3:128462437-128466968,4531
179236691,179267002,chr3,KCNMB3,chr3:179236691-179267002,30311
64684909,65053439,chr3,ADAMTS9-AS2,chr3:64684909-65053439,368530
150703486,150723005,chr3,ERICH6-AS1,chr3:150703486-150723005,19519
198053522,198080737,chr3,ANKRD18DP,chr3:198053522-198080737,27215
110888384,111071553,chr3,NECTIN3-AS1,chr3:110888384-111071553,183169
194247617,194260720,chr3,LINC02037,chr3:194247617-194260720,13103
196225779,196609225,chr1,KCNT2,chr1:196225779-196609225,383446
233307816,233347055,chr2,SAG,chr2:233307816-233347055,39239
157543246,157677749,chr3,SLC66A1L,chr3:157543246-157677749,134503
4490317,4493201,chr3,ITPR1-DT,chr3:4490317-4493201,2884
123585300,123644568,chr3,MYLK-AS1,chr3:123585300-123644568,59268
165206929,165846519,chr3,LINC01322,chr3:165206929-165846519,639590
130097782,130111506,chr3,FAM86HP,chr3:130097782-130111506,13724
194583991,194590260,chr3,TMEM44-AS1,chr3:194583991-194590260,6269
161344798,161372880,chr3,SPTSSB,chr3:161344798-161372880,28082
161429127,161429597,chr3,RPL23AP42,chr3:161429127-161429597,470
226231149,226309869,chr1,LIN9,chr1:226231149-226309869,78720
27650809,27663840,chr2,SUPT7L,chr2:27650809-27663840,13031
89006679,89022894,chr1,GBP3,chr1:89006679-89022894,16215
89051882,89065360,chr1,GBP1,chr1:89051882-89065360,13478
112645939,112663825,chr2,SLC20A1,chr2:112645939-112663825,17886
89104285,89104767,chr1,PTGES3P1,chr1:89104285-89104767,482
96112876,96116571,chr2,ADRA2B,chr2:96112876-96116571,3695
89181144,89198942,chr1,GBP4,chr1:89181144-89198942,17798
27612064,27635185,chr1,FGR,chr1:27612064-27635185,23121
39249266,39437301,chr2,MAP4K3,chr2:39249266-39437301,188035
27666064,27672212,chr1,IFI6,chr1:27666064-27672212,6148
109494052,109502932,chr1,CYB561D1,chr1:109494052-109502932,8880
158456952,158682879,chr2,PKP4,chr2:158456952-158682879,225927
186671791,186680922,chr1,PTGS2,chr1:186671791-186680922,9131
86143932,86195472,chr2,IMMT,chr2:86143932-86195472,51540
115285904,115338770,chr1,NGF,chr1:115285904-115338770,52866
916865,921016,chr1,LINC02593,chr1:916865-921016,4151
998962,1000172,chr1,HES4,chr1:998962-1000172,1210
65227788,65271253,chr2,ACTR2,chr2:65227788-65271253,43465
230712842,230821075,chr2,CAB39,chr2:230712842-230821075,108233
230642481,230693982,chr1,COG2,chr1:230642481-230693982,51501
175072250,175168382,chr2,ATF2,chr2:175072250-175168382,96132
230747384,230802003,chr1,CAPN9,chr1:230747384-230802003,54619
230837119,230869589,chr1,C1orf198,chr1:230837119-230869589,32470
230690776,230745576,chr1,AGT,chr1:230690776-230745576,54800
154502219,154548147,chr1,TDRD10,chr1:154502219-154548147,45928
154553609,154555017,chr1,UBE2Q1-AS1,chr1:154553609-154555017,1408
47695530,47810063,chr2,MSH6,chr2:47695530-47810063,114533
54972187,55112621,chr2,RTN4,chr2:54972187-55112621,140434
226870184,226927726,chr1,PSEN2,chr1:226870184-226927726,57542
161749758,161757238,chr1,DUSP12,chr1:161749758-161757238,7480
211326615,211374946,chr1,TRAF5,chr1:211326615-211374946,48331
132671788,133568463,chr2,NCKAP5,chr2:132671788-133568463,896675
211417025,211417934,chr1,SNX25P1,chr1:211417025-211417934,909
211571568,211579161,chr1,SLC30A1,chr1:211571568-211579161,7593
211476522,211492162,chr1,RD3,chr1:211476522-211492162,15640
64524305,64593005,chr2,AFTPH,chr2:64524305-64593005,68700
75724431,75787575,chr1,ACADM,chr1:75724431-75787575,63144
75796882,75913242,chr1,MSH4,chr1:75796882-75913242,116360
197504748,197775696,chr1,DENND1B,chr1:197504748-197775696,270948
160272151,160493807,chr2,RBMS1,chr2:160272151-160493807,221656
197084121,197146694,chr1,ASPM,chr1:197084121-197146694,62573
136765545,137677718,chr2,THSD7B,chr2:136765545-137677718,912173
162371407,162838767,chr2,KCNH7,chr2:162371407-162838767,467360
119366924,119372550,chr2,DBI,chr2:119366924-119372550,5626
210477682,210679107,chr2,CPS1,chr2:210477682-210679107,201425
156806243,156816848,chr1,SH2D2A,chr1:156806243-156816848,10605
51236273,51273447,chr1,RNF11,chr1:51236273-51273447,37174
817371,819837,chr1,FAM87B,chr1:817371-819837,2466
1070967,1074306,chr1,RNF223,chr1:1070967-1074306,3339
1081818,1116361,chr1,C1orf159,chr1:1081818-1116361,34543
923923,944575,chr1,SAMD11,chr1:923923-944575,20652
100148448,100178273,chr1,LRRC39,chr1:100148448-100178273,29825
100213293,100213670,chr1,BRI3P1,chr1:100213293-100213670,377
32200595,32205453,chr1,CCDC28B,chr1:32200595-32205453,4858
55287842,55419895,chr2,CCDC88A,chr2:55287842-55419895,132053
92832737,92961522,chr1,DIPK1A,chr1:92832737-92961522,128785
74705482,74733408,chr1,CRYZ,chr1:74705482-74733408,27926
74733152,74766678,chr1,TYW3,chr1:74733152-74766678,33526
228647912,228648032,chr1,RNA5SP18,chr1:228647912-228648032,120
228650241,228651379,chr1,DUSP5P1,chr1:228650241-228651379,1138
224470150,224585397,chr2,CUL3,chr2:224470150-224585397,115247
1631887,1744852,chr2,PXDN,chr2:1631887-1744852,112965
149636766,149636929,chr1,RNVU1-30,chr1:149636766-149636929,163
149842875,149846486,chr1,H2BC19P,chr1:149842875-149846486,3611
149844498,149850937,chr1,H2BC20P,chr1:149844498-149850937,6439
149886918,149887411,chr1,H2AC20,chr1:149886918-149887411,493
149887469,149887965,chr1,H2AC21,chr1:149887469-149887965,496
149903318,149917844,chr1,SV2A,chr1:149903318-149917844,14526
200872981,200874178,chr1,GPR25,chr1:200872981-200874178,1197
201190824,201228952,chr1,IGFN1,chr1:201190824-201228952,38128
84298366,84389957,chr1,SAMD13,chr1:84298366-84389957,91591
225777813,225790468,chr1,SRP9,chr1:225777813-225790468,12655
225845536,225882380,chr1,TMEM63A,chr1:225845536-225882380,36844
225810124,225845563,chr1,EPHX1,chr1:225810124-225845563,35439
11026523,11047239,chr1,MASP2,chr1:11026523-11047239,20716
156920632,156933094,chr1,LRRC71,chr1:156920632-156933094,12462
32775237,32817380,chr1,YARS1,chr1:32775237-32817380,42143
61888724,62147247,chr2,COMMD1,chr2:61888724-62147247,258523
178829757,179050137,chr2,CCDC141,chr2:178829757-179050137,220380
26321698,26360080,chr1,CRYBG2,chr1:26321698-26360080,38382
219514170,219538772,chr2,ASIC4,chr2:219514170-219538772,24602
25227855,25342590,chr2,DNMT3A,chr2:25227855-25342590,114735
52142089,52348671,chr1,ZFYVE9,chr1:52142089-52348671,206582
237485428,237555322,chr2,MLPH,chr2:237485428-237555322,69894
27078615,27086403,chr2,EMILIN1,chr2:27078615-27086403,7788
27098889,27119128,chr2,CGREF1,chr2:27098889-27119128,20239
27123789,27130812,chr2,ABHD1,chr2:27123789-27130812,7023
1418420,1421769,chr1,ANKRD65,chr1:1418420-1421769,3349
227728200,227781826,chr1,SNAP47,chr1:227728200-227781826,53626
27322145,27336400,chr1,TMEM222,chr1:27322145-27336400,14255
27275433,27281499,chr2,DNAJC5G,chr2:27275433-27281499,6066
207043849,207052980,chr1,YOD1,chr1:207043849-207052980,9131
227730425,227735411,chr1,JMJD4,chr1:227730425-227735411,4986
151612006,151699091,chr1,SNX27,chr1:151612006-151699091,87085
27212041,27217178,chr2,ATRAID,chr2:27212041-27217178,5137
151800264,151805419,chr1,LINGO4,chr1:151800264-151805419,5155
151982915,151993859,chr1,S100A10,chr1:151982915-151993859,10944
97713576,97739862,chr2,ZAP70,chr2:97713576-97739862,26286
97492663,97589877,chr2,ANKRD36B,chr2:97492663-97589877,97214
144364364,144521057,chr2,ZEB2,chr2:144364364-144521057,156693
95836919,95991831,chr2,ANKRD36C,chr2:95836919-95991831,154912
205042937,205078289,chr1,CNTN2,chr1:205042937-205078289,35352
229321011,229343294,chr1,CCSAP,chr1:229321011-229343294,22283
204545475,205620162,chr2,PARD3B,chr2:204545475-205620162,1074687
28592200,28595449,chr1,RAB42,chr1:28592200-28595449,3249
103553815,103579534,chr1,AMY2B,chr1:103553815-103579534,25719
206114817,206159509,chr2,NDUFS1,chr2:206114817-206159509,44692
206203543,206265326,chr2,GPR1-AS,chr2:206203543-206265326,61783
92299059,92402056,chr1,RPAP2,chr1:92299059-92402056,102997
92473043,92486925,chr1,GFI1,chr1:92473043-92486925,13882
200810594,200827338,chr2,BZW1,chr2:200810594-200827338,16744
45329163,45340893,chr1,MUTYH,chr1:45329163-45340893,11730
29097705,29199777,chr2,CLIP4,chr2:29097705-29199777,102072
218274197,218292586,chr2,TMBIM1,chr2:218274197-218292586,18389
32539427,32605941,chr1,ZBTB8A,chr1:32539427-32605941,66514
218269651,218346793,chr2,PNKD,chr2:218269651-218346793,77142
14404,29570,chr1,WASH7P,chr1:14404-29570,15166
17369,17436,chr1,MIR6859-1,chr1:17369-17436,67
167293001,167874045,chr2,B3GALT1,chr2:167293001-167874045,581044
248197265,248212925,chr1,OR2M3,chr1:248197265-248212925,15660
71081324,71489976,chr1,ZRANB2-AS2,chr1:71081324-71489976,408652
85537462,85538666,chr2,PARTICL,chr2:85537462-85538666,1204
181088700,181092900,chr1,IER5,chr1:181088700-181092900,4200
85584431,85593406,chr2,VAMP5,chr2:85584431-85593406,8975
241497511,241519799,chr1,FH,chr1:241497511-241519799,22288
85602856,85649283,chr2,USP39,chr2:85602856-85649283,46427
241628851,241640369,chr1,CHML,chr1:241628851-241640369,11518
164894354,164955525,chr2,SLC38A11,chr2:164894354-164955525,61171
53767804,53775196,chr2,CHAC2,chr2:53767804-53775196,7392
53864069,53970993,chr2,PSME4,chr2:53864069-53970993,106924
1534778,1540624,chr1,TMEM240,chr1:1534778-1540624,5846
1541673,1574863,chr1,SSU72,chr1:1541673-1574863,33190
1615454,1630605,chr1,MIB2,chr1:1615454-1630605,15151
53787009,53833038,chr2,ERLEC1,chr2:53787009-53833038,46029
33436324,33564750,chr2,RASGRP3,chr2:33436324-33564750,128426
33532744,33599347,chr2,FAM98A,chr2:33532744-33599347,66603
108449107,108509415,chr2,GCC2,chr2:108449107-108509415,60308
108534355,108687246,chr2,LIMS1,chr2:108534355-108687246,152891
66628440,66628517,chr1,MIR3117,chr1:66628440-66628517,77
66752459,66779047,chr1,DYNLT5,chr1:66752459-66779047,26588
66812885,66924856,chr1,DNAI4,chr1:66812885-66924856,111971
108719482,108785809,chr2,RANBP2,chr2:108719482-108785809,66327
66533267,66751139,chr1,SGIP1,chr1:66533267-66751139,217872
225401502,225428925,chr1,LBR,chr1:225401502-225428925,27423
217799588,218033982,chr2,TNS1,chr2:217799588-218033982,234394
232805416,232809929,chr1,MAP10,chr1:232805416-232809929,4513
75128434,75161533,chr1,LHX8,chr1:75128434-75161533,33099
99264292,99309590,chr1,PLPPR4,chr1:99264292-99309590,45298
39651229,39672107,chr1,NT5C1A,chr1:39651229-39672107,20878
1425871,1430255,chr1,TMEM88B,chr1:1425871-1430255,4384
46340789,46365152,chr1,NSUN4,chr1:46340789-46365152,24363
247121975,247172020,chr1,ZNF124,chr1:247121975-247172020,50045
151291797,151327715,chr1,PI4KB,chr1:151291797-151327715,35918
172427354,172506459,chr2,ITGA6,chr2:172427354-172506459,79105
240906330,240993311,chr2,CROCC2,chr2:240906330-240993311,86981
131104847,131353709,chr2,PLEKHB2,chr2:131104847-131353709,248862
54723499,54972025,chr2,EML6,chr2:54723499-54972025,248526
106801600,106887108,chr2,ST6GAL2,chr2:106801600-106887108,85508
241188509,241225976,chr2,ANO7,chr2:241188509-241225976,37467
16460948,16468481,chr1,LINC01772,chr1:16460948-16468481,7533
16467436,16499257,chr1,CROCCP3,chr1:16467436-16499257,31821
16533886,16535649,chr1,LINC01783,chr1:16533886-16535649,1763
25377198,25673647,chr2,DTNB,chr2:25377198-25673647,296449
16618253,16657232,chr1,CROCCP2,chr1:16618253-16657232,38979
21822244,21937310,chr1,HSPG2,chr1:21822244-21937310,115066
22024558,22031223,chr1,LINC00339,chr1:22024558-22031223,6665
22028317,22052927,chr1,CDC42-AS1,chr1:22028317-22052927,24610
22117313,22143969,chr1,WNT4,chr1:22117313-22143969,26656
206203346,206464436,chr1,SRGAP2,chr1:206203346-206464436,261090
176177717,176179009,chr2,HAGLROS,chr2:176177717-176179009,1292
206470476,206496889,chr1,IKBKE,chr1:206470476-206496889,26413
73947322,73982164,chr2,DGUOK-AS1,chr2:73947322-73982164,34842
206507531,206589448,chr1,RASSF5,chr1:206507531-206589448,81917
104430130,104532747,chr2,LINC01102,chr2:104430130-104532747,102617
16687339,16720157,chr1,ESPNP,chr1:16687339-16720157,32818
231508420,231514396,chr2,LINC00471,chr2:231508420-231514396,5976
212950520,212992037,chr1,VASH2,chr1:212950520-212992037,41517
222318275,222352989,chr2,CT75,chr2:222318275-222352989,34714
74502552,74505091,chr2,LBX2-AS1,chr2:74502552-74505091,2539
46816697,46859009,chr2,LINC01119,chr2:46816697-46859009,42312
109483479,109492804,chr1,ATXN7L2,chr1:109483479-109492804,9325
173799550,173824883,chr1,CENPL,chr1:173799550-173824883,25333
178413635,178440243,chr2,CHROMR,chr2:178413635-178440243,26608
241881363,242078722,chr2,LINC01237,chr2:241881363-242078722,197359
117001750,117036552,chr1,CD101,chr1:117001750-117036552,34802
143894544,143905977,chr1,H3-2,chr1:143894544-143905977,11433
182789293,182830384,chr1,NPL,chr1:182789293-182830384,41091
199457697,199476935,chr2,SATB2-AS1,chr2:199457697-199476935,19238
33256492,33300719,chr1,ZNF362,chr1:33256492-33300719,44227
1724838,1745992,chr1,SLC35E2A,chr1:1724838-1745992,21154
153543613,153550136,chr1,S100A4,chr1:153543613-153550136,6523
96010526,96023398,chr2,FAHD2CP,chr2:96010526-96023398,12872
36306368,36329340,chr1,SH3D21,chr1:36306368-36329340,22972
36339624,36385924,chr1,STK40,chr1:36339624-36385924,46300
216479030,216498770,chr2,RPL37A-DT,chr2:216479030-216498770,19740
3558439,3564842,chr2,RNASEH1-AS1,chr2:3558439-3564842,6403
44940153,44941916,chr2,SIX3-AS1,chr2:44940153-44941916,1763
207662375,207679116,chr2,LINC01857,chr2:207662375-207679116,16741
115126622,115161384,chr2,DPP10-AS1,chr2:115126622-115161384,34762
104764932,104853183,chr2,PANTR1,chr2:104764932-104853183,88251
177623244,178108339,chr2,PDE11A,chr2:177623244-178108339,485095
180912897,180951614,chr1,KIAA1614,chr1:180912897-180951614,38717
180972712,181023121,chr1,STX6,chr1:180972712-181023121,50409
181033374,181061938,chr1,MR1,chr1:181033374-181061938,28564
93149742,93180516,chr1,TMED5,chr1:93149742-93180516,30774
101696850,101894690,chr2,MAP4K4,chr2:101696850-101894690,197840
170531819,170553834,chr1,GORAB,chr1:170531819-170553834,22015
24119771,24143140,chr1,IL22RA1,chr1:24119771-24143140,23369
24154168,24187959,chr1,IFNLR1,chr1:24154168-24187959,33791
156893698,156916429,chr1,PEAR1,chr1:156893698-156916429,22731
33513998,34165842,chr1,CSMD2,chr1:33513998-34165842,651844
92508696,92792404,chr1,EVI5,chr1:92508696-92792404,283708
155033824,155050930,chr1,DCST1,chr1:155033824-155050930,17106
149928651,149936879,chr1,MTMR11,chr1:149928651-149936879,8228
145164099,145216058,chr1,LINC01145,chr1:145164099-145216058,51959
145866560,145885866,chr1,ANKRD35,chr1:145866560-145885866,19306
145891208,145910111,chr1,ITGA10,chr1:145891208-145910111,18903
145959441,145964575,chr1,ANKRD34A,chr1:145959441-145964575,5134
145964690,145978848,chr1,POLR3GL,chr1:145964690-145978848,14158
48532854,50023954,chr1,AGBL4,chr1:48532854-50023954,1491100
144442606,144443004,chr1,PFN1P6,chr1:144442606-144443004,398
149390621,149471833,chr1,NOTCH2NLC,chr1:149390621-149471833,81212
15236521,15400283,chr1,FHAD1,chr1:15236521-15400283,163762
20806292,21177285,chr1,EIF4G3,chr1:20806292-21177285,370993
226631690,226739323,chr1,ITPKB,chr1:226631690-226739323,107633
144421390,144461676,chr1,NBPF15,chr1:144421390-144461676,40286
145289900,145405567,chr1,NBPF20,chr1:145289900-145405567,115667
26911489,26913975,chr1,NR0B2,chr1:26911489-26913975,2486
26993692,27000886,chr1,TRNP1,chr1:26993692-27000886,7194
26462756,26468014,chr1,DHDDS-AS1,chr1:26462756-26468014,5258
26281328,26318363,chr1,UBXN11,chr1:26281328-26318363,37035
240767636,241357374,chr1,RGS7,chr1:240767636-241357374,589738
171781660,171814023,chr1,METTL13,chr1:171781660-171814023,32363
171817887,172418466,chr1,DNM3,chr1:171817887-172418466,600579
245206444,245234501,chr1,KIF26B-AS1,chr1:245206444-245234501,28057
228464213,228464594,chr1,H2BU2P,chr1:228464213-228464594,381
16562319,16613562,chr1,NBPF1,chr1:16562319-16613562,51243
51789191,51878805,chr1,NRDC,chr1:51789191-51878805,89614
1311585,1324687,chr1,INTS11,chr1:1311585-1324687,13102
21596221,21669357,chr1,RAP1GAP,chr1:21596221-21669357,73136
109733932,109741038,chr1,GSTM3,chr1:109733932-109741038,7106
50437028,50960267,chr1,FAF1,chr1:50437028-50960267,523239
171485530,171593511,chr1,PRRC2C,chr1:171485530-171593511,107981
6424776,6461367,chr1,ESPN,chr1:6424776-6461367,36591
111139627,111185104,chr1,CEPT1,chr1:111139627-111185104,45477
1335276,1349418,chr1,DVL1,chr1:1335276-1349418,14142
235661041,235883640,chr1,LYST,chr1:235661041-235883640,222599
155946851,156007070,chr1,ARHGEF2,chr1:155946851-156007070,60219
11845709,11848345,chr1,NPPA,chr1:11845709-11848345,2636
175067833,175148075,chr1,TNN,chr1:175067833-175148075,80242
56645314,56715335,chr1,PRKAA2,chr1:56645314-56715335,70021
156147366,156177752,chr1,SEMA4A,chr1:156147366-156177752,30386
1385711,1399335,chr1,CCNL2,chr1:1385711-1399335,13624
960584,965719,chr1,KLHL17,chr1:960584-965719,5135
155173787,155184971,chr1,TRIM46,chr1:155173787-155184971,11184
214603195,214664571,chr1,CENPF,chr1:214603195-214664571,61376
156463727,156500779,chr1,MEF2D,chr1:156463727-156500779,37052
28812170,28871267,chr1,OPRD1,chr1:28812170-28871267,59097
68045886,68051717,chr1,DIRAS3,chr1:68045886-68051717,5831
31652263,31704319,chr1,COL16A1,chr1:31652263-31704319,52056
165662216,165698562,chr1,ALDH9A1,chr1:165662216-165698562,36346
167935783,168075843,chr1,DCAF6,chr1:167935783-168075843,140060
225486829,225653142,chr1,ENAH,chr1:225486829-225653142,166313
81426456,81427605,chr1,HNRNPA3P14,chr1:81426456-81427605,1149
81557121,81557832,chr1,MED28P8,chr1:81557121-81557832,711
81721693,81723068,chr1,ST13P20,chr1:81721693-81723068,1375
20290875,20359518,chr1,VWA5B1,chr1:20290875-20359518,68643
201464278,201469237,chr1,PHLDA3,chr1:201464278-201469237,4959
201829149,201884291,chr1,IPO9,chr1:201829149-201884291,55142
70852353,71047816,chr1,PTGER3,chr1:70852353-71047816,195463
145921556,145927678,chr1,RBM8A,chr1:145921556-145927678,6122
112718905,112727235,chr1,TAFA3,chr1:112718905-112727235,8330
112673141,112700756,chr1,MOV10,chr1:112673141-112700756,27615
219968600,220046530,chr1,EPRS1,chr1:219968600-220046530,77930
220148293,220272529,chr1,RAB3GAP2,chr1:220148293-220272529,124236
220253570,220254536,chr1,MORF4L1P1,chr1:220253570-220254536,966
162790702,162812823,chr1,HSD17B7,chr1:162790702-162812823,22121
39081316,39487177,chr1,MACF1,chr1:39081316-39487177,405861
162824458,162868761,chr1,CCDC190,chr1:162824458-162868761,44303
46175073,46185962,chr1,TSPAN1,chr1:46175073-46185962,10889
99646113,99694541,chr1,PALMD,chr1:99646113-99694541,48428
226548764,226609230,chr1,STUM,chr1:226548764-226609230,60466
237042184,237833988,chr1,RYR2,chr1:237042184-237833988,791804
120913184,121009291,chr1,LINC00623,chr1:120913184-121009291,96107
109539872,109548406,chr1,GPR61,chr1:109539872-109548406,8534
202891116,202928636,chr1,KLHL12,chr1:202891116-202928636,37520
202961873,202967275,chr1,CYB5R1,chr1:202961873-202967275,5402
203083129,203086012,chr1,MYOG,chr1:203083129-203086012,2883
19282573,19288770,chr1,AKR7A3,chr1:19282573-19288770,6197
203026491,203078740,chr1,PPFIA4,chr1:203026491-203078740,52249
6634168,6701924,chr1,DNAJC11,chr1:6634168-6701924,67756
100989623,101026088,chr1,DPH5,chr1:100989623-101026088,36465
184690237,184754907,chr1,EDEM3,chr1:184690237-184754907,64670
183620846,183635783,chr1,ARPC5,chr1:183620846-183635783,14937
108815898,108963484,chr1,AKNAD1,chr1:108815898-108963484,147586
108881885,108963527,chr1,CLCC1,chr1:108881885-108963527,81642
2050411,2185395,chr1,PRKCZ,chr1:2050411-2185395,134984
1915108,1917296,chr1,CALML6,chr1:1915108-1917296,2188
111414319,111427735,chr1,OVGP1,chr1:111414319-111427735,13416
111473792,111478512,chr1,C1orf162,chr1:111473792-111478512,4720
86862445,86914424,chr1,SELENOF,chr1:86862445-86914424,51979
87129765,87169198,chr1,LINC01140,chr1:87129765-87169198,39433
228434777,228457873,chr1,H2AW,chr1:228434777-228457873,23096
228458103,228463104,chr1,H2BU1,chr1:228458103-228463104,5001
121167646,121185539,chr1,FAM72B,chr1:121167646-121185539,17893
5990927,6101193,chr1,KCNAB2,chr1:5990927-6101193,110266
152106317,152115444,chr1,TCHH,chr1:152106317-152115444,9127
31790422,31816022,chr1,SPOCD1,chr1:31790422-31816022,25600
146052566,146061952,chr1,LINC01719,chr1:146052566-146061952,9386
121107175,121117294,chr1,H2BP1,chr1:121107175-121117294,10119
3900352,3917225,chr1,LINC01134,chr1:3900352-3917225,16873
200253419,200400705,chr1,LINC00862,chr1:200253419-200400705,147286
60515716,60640507,chr1,LINC01748,chr1:60515716-60640507,124791
209428817,209432848,chr1,MIR205HG,chr1:209428817-209432848,4031
110347116,110443817,chr1,LAMTOR5-AS1,chr1:110347116-110443817,96701
825138,859446,chr1,LINC01128,chr1:825138-859446,34308
32231656,32241710,chr1,MTMR9LP,chr1:32231656-32241710,10054
9672405,9687573,chr1,PIK3CD-AS2,chr1:9672405-9687573,15168
100251528,100266179,chr1,RTCA-AS1,chr1:100251528-100266179,14651
16215907,16228027,chr1,ANO7L1,chr1:16215907-16228027,12120
149606209,149705716,chr1,LINC00869,chr1:149606209-149705716,99507
119140391,119275973,chr1,WARS2-AS1,chr1:119140391-119275973,135582
23581495,23640568,chr1,MDS2,chr1:23581495-23640568,59073
226656080,226675089,chr1,ITPKB-IT1,chr1:226656080-226675089,19009
19210355,19240704,chr1,EMC1-AS1,chr1:19210355-19240704,30349
63320878,63324441,chr1,FOXD3-AS1,chr1:63320878-63324441,3563
23706901,23778325,chr1,ELOA-AS1,chr1:23706901-23778325,71424
93591972,93605573,chr1,BCAR3-AS1,chr1:93591972-93605573,13601
